"id";"title";"description";"created_at";"cached_votes_total";"cached_votes_up";"cached_votes_down";"comments_count";"hot_score";"confidence_score"
"3";"¿Qué os parece este nuevo espacio de debate?";"<p>Empezamos a abrir secciones con este espacio de debate abierto, esperamos que os sea útil.</p>
";"06/09/2015 14";"1546";"1331";"215";"322";"862534855";"96079"
"4";"Basuras Moncloa";"<p>Ya sé que es un debate manido, pero el distrito está más sucio que nunca y no solo por culpa del ayuntamiento. Muchos años de abandono y negligencia crean malos hábitos. Los contenedores de reciclado se han convertido en cubos de basura donde se amontona lo que nadie quiere, bolsas de basura, a menudo tiradas desde los balcones de los primeros pisos, e incluso escombros de obras de remodelación.
Pasear por Rosales los sábados o domingos por la mañana es hacerlo entre restos de botellón y papeleras a rebosar de basura que nadie ha limpiado. El domingo es aún peor. El botellón de la zona es salvaje y constante, jueves, viernes y sábado con ruidos hasta bien entrada la madrugada...</p>

<p>Pagamos impuestos elevados, incluidos los de basura, ¿sería mucho pedir que se limpiara el barrio, con campañas de concienciación incluidas? ¿Que se pusiera trabas al botellón, que campa a sus anchas en detrimento de la convivencia? Y por favor, ¿podrían alguna vez BALDEAR las calles como se hacía antiguamente?</p>

<p>Esta ciudad, este modelo de ciudad, nos va a echar a todos los vecinos de su almendra central...</p>
";"07/09/2015 10";"57";"52";"5";"1";"859606961";"4287"
"5";"Funciones de la policía municipal de Madrid. ";"<p>Propongo <strong>repensar algunas de las funciones de la policía municipal de Madrid</strong>. En algunas otras ciudades se está ya planteando que la policía municipal no participe en deshucios, por ejemplo. (Referencia: http://ccaa.elpais.com/ccaa/2015/09/02/valencia/1441207546_192232.html) </p>

<p>También sería interesante, además de este nuevo catálogo de tareas generales y responsablidades de la policía municial, <strong>repensar el papel de las Unidades Centrales de Seguridad (UCS), conocidas como «antidisturbios»</strong>. Ya existen cuerpos similares del Cuerpo Nacional de Policñia y Guardia Civil y hay que preguntarse si la ciudad necesita una unidad de ese tipo.</p>

<p>Igualmente propondría una <strong>reflexión sobre la vestimenta de los agentes.</strong> La uniformidad y color negro usado por la UCS tiene connotaciones paramilitares poco adecuadas para la tarea civil que tiene que llevar a cabo. (Foto de la UCS: http://www.abc.es/Media/201106/25/jose--644x362.jpg)  En Europa desde hace tiempo se vienen desmilitarizando las policías y asignándoles colores como el azul o el blanco. </p>

<p>Por último propongo regular mejor -y hacer cumplir- la <strong>normativa en cuanto a la identificación de los agentes de la policía municipal.</strong> En muchas ocasiones el número de identificación no es visible durante su trabajo en espacios públicos y en el caso de llevar un chaleco de protección prácticamente ningún agente lo lleva visible. </p>

<p>Muchas gracias. </p>

<p>  </p>
";"07/09/2015 10";"248";"189";"59";"14";"860632412";"9907"
"7";"Madrid ciclista y bicimad";"<p>Me gustaría saber qué problemas detectamos que se puedan resolver en una legislatura, cómo imaginamos un Madrid ciclista y cuáles son los ejemplos en los que Madrid podría inspirarse. Para esto os propongo algunas preguntas que me hago habitualmente,</p>

<ul>
	<li>¿Qué deberíamos mejorar inmediatamente si tuviésemos un presupuesto en manos de la ciudadanía (biciMad, carril bici... etc.) para esta legislatura?</li>
	<li>¿Qué sistemas de convivencia bici-coche y/o bici-peatón conocéis que existen y funcionan? Con ejemplos o enlaces, por favor!</li>
	<li>¿Cuales serían nuestas ciudades de ejemplo, teniendo en cuenta clima y orografía de Madrid ciudad?</li>
</ul>

<p>Por supuesto, respuesta abierta. La idea es plantear <strong>qué problemas tenemos ahora que podamos solucionar a corto plazo y cómo nos imaginamos un Madrid compatible con las bicicletas.</strong></p>
";"07/09/2015 10";"318";"256";"62";"142";"863816823";"15617"
"8";"¿SOPLADORAS? NO GRACIAS";"<p>La sopladoras son máquinas realmente infernales: levantan el polvo y lo ponen en suspensión con grave perjuicio para personas sensibles y con afecciones respiratorias; además, pese a que una parte se pueda recoger, es cambiar la porquería de sitio más que limpiarla y, por último, su ruido es un molestísimo foco de contaminación acústica.</p>

<p>Para los ciudadanos y ciudadanas que tenemos que soportarlas son de las peores cosas de esta ciudad, y qué decir para las personas que tienen que manejarlas, que han de ir cubiertas de medidas de protección personal, por lo que no parece que sea una maquinaria muy benigna, ciertamente.</p>

<p>En su lugar, barrer las calles y/o baldearlas hace que las tareas de limpieza sean menos agresivas con la ciudadanía y aumenta la cantidad necesaria de trabajadores y trabajadoras para realizar dichas tareas, lo cual se traduce en empleo...</p>
";"07/09/2015 10";"847";"713";"134";"41";"867898123";"48739"
"9";"Fuentes públicas, bancos y sombras";"<p>Las calles y plazas de Madrid se han vuelto duras: solo cemento, sin fuentes, bancos ni sombras. Se supone que facilita el mantenimiento, pero en realidad se hace para incitar al consumo en grandes establecimientos al buscar refugio y para facilitar la invasión privada de espacios públicos con terrazas, actos de promoción, etc.</p>

<p>Hay que crear una red de fuentes de agua potable e instalar más bancos y sombras en todas las calles y plazas. Esto estimularía el deporte, la peatonalidad y el intercambio social.</p>
";"07/09/2015 11";"3299";"3107";"192";"124";"877311700";"274534"
"10";"Madrid Río y la convivencia entre ciclistas y peatones";"<p>Propongo realizar una <strong>adaptación a la realidad en el uso del parque lineal ""Madrid Rio"". </strong>Como vecino de Arganzuela y habitual persona que pasea, corre, monta en bici por Madrid Rio, he observado en estos años un gran problema:</p>

<p>El hecho de que el paseo sea compartido con viandantes y ciclistas/bicicletas, puede suponer un gran problema, ya que ademas de ser muy incomodo para los segundo (no poder ir medianamente ligero, y tener que ir a velocidad de peatón, 20km/h como límite máximo establecido), se suma el riesgo (muy elevado) de atropello, tanto de adultos como de niños (ya que estos corren, se mueven, disfrutan; como debe ser; y no mantienen trayectos rectos, sino imprevisibles, y por lo tanto muy difícil de evitar con la bicicleta).</p>

<p>Ante tan magna obra, creo que sería sumamente fácil,<strong> delimitar una parte del paseo</strong> (ya que este tiene aprox. 6 m. de ancho) <strong>como carril bici</strong>, bien mediante <strong>bajos bolardos</strong>, o bien mediante una delimitación con <strong>""<em>tierra de albero</em></strong>"" de distinto color o pintura.</p>

<p>En su día el Ayuntamiento de Madrid (abril del 2011) argumentaban qué:</p>

<p> </p>

<p></p>

<p> </p>

<p></p>

<p><em>Si se divide el espacio transitable, tendríamos un espacio libre dividido en franjas estrechas reservadas para cada uno de los posibles tipos de usuarios del paseo.</em></p>

<p><em>Frente a ello, se ha optado por un diseño de parque que promueve la convivencia civilizada entre los diferentes usuarios, sin que se molesten unos a otros, como ya sucede en otros parques de la ciudad, como el Retiro, en donde los diferentes usuarios conviven sin problemas.</em></p>

<p><em>El tipo de senda de convivencia entre peatones y ciclistas que estamos promoviendo en el parque Madrid Río, está previsto en la normativa vigente, con el nombre de ""senda ciclable"". Así se recoge en el Anexo I, apartado 75 de la Ley de Tráfico y Seguridad Vial, vigente desde el año 2001. En dicho documento se define la senda ciclable como ""Vía para peatones y ciclos, segregada del tráfico motorizado, y que discurre por espacios abiertos, parques, jardines o bosques"" [...]</em></p>

<p><em>Si, por el contrario, se hubiese optado por marcar una zona exclusiva para bicicletas, eso hubiera fomentado la circulación a velocidades elevadas al sentirse los ciclistas en un espacio propio, lo que a la larga podría resultar peligroso para los peatones, que difícilmente pueden controlar en todo momento a los niños para que no invadan la zona contigua, por señalizada que esté, e incluso los propios adultos, durante el paseo, pueden entrar en la zona señalizada. Igualmente, los perros, aun circulando con correa, podrían en ocasiones entrar en la zona reservada a ciclistas.</em></p>

<p>Ante esa respuesta (recuerdo, abril del 2011), estuve investigando un poco sobre este tipo de vías y algunos estudios de otros ayuntamientos en relación a la movilidad urbana, así encontre que la Gerencia de Urbanismo del Excm. Ayto de Malaga (""Normas básicas para el diseño de vías ciclables"") dice cosas tan interesantes como:</p>

<p>[]En imprescindible, como criterio de diseño, limitar al máximo las pérdidas de energía cinética en los desplazamientos en bicicleta, significando ello pues que el ciclista no debe ser obligado a frenar continuamente su velocidad más de lo estrictamente necesario y que los tratamiento formales de estas infraestructuras deben ser adecuadas a este principio. Por lo tanto, si se pretende maximizar el uso de una vía ciclable, es necesario intentar por todos los medios, priorizar la movilidad continua de la bicicleta []</p>

<p> </p>

<p></p>

<p>Así pues, el diseño eficiente de una vía ciclable pasa necesariamente por la premisa indispensable de limitar el frenado continuo para los ciclistas, aún a costa de las preferencias teóricas de otros usuarios, que en cualquier caso podrían asumir sin tan alto coste dicha situación. []</p>

<p>[]La bicicleta posee como vehículo una inestabilidad estructural derivada de su limitación a dos puntos de apoyo, que sólo puede ser compensada mediante la aceleración cetrífuga obtenida a partir de cierta velocidad.</p>

<p>[]De este modo el ciclista se ve obligado a realizar continuos microcambios en la trayectoria para corregir la citada inestabilidad hasta alcanzar la velocidad necesaria, momento a partir del cual el vaivén se reduce casi totalmente. Por lo tanto, la longitud del arco de vaivén es tanto mayor cuanto menor es la velocidad. (Gerencia de Urbanismo. Ayto de Málaga)</p>

<p>Así pues el hecho del que el/la ciclista deba estar continuamente ajustando su velocidad mediante cambios bruscos de velocidad, frenazos, giros, microgiros...genera una inestabilidad en el/la ciclista, y por lo tanto el consiguiente riesgo de accidentes, tanto del ciclista como por el riesgo de atropello a otros viandantes.</p>

<p>Por lo tanto sugiero la posibilidad de <strong>implementar alguna/s de estas soluciones:</strong></p>

<ol>
	<li>Teniendo en cuenta los diferentes estudios de la siniestralidad de <strong>aceras-bicis (vías ciclables) frente a carriles-bici</strong> (donde la sinisetralidad disminuye en muchos casos en mas de un 70%), propongo r<strong>eplantear la condición de ""acera-bici"" de Madrid Río</strong>, y plantear la <strong>delimitación de una parte de esa acera como ""carril-bici"" de doble dirección.</strong>
</li>
	<li>Con el fin de que esta sea una <strong>medidad de bajo coste</strong>, tan solo con <strong>delimitar este carril-bici con un color de aslfato muy diferente al resto de la acera</strong> se crearía una percepción clara al resto de viandantes, así como el incluir señales horizontales sobre el mismo carril-bici y verticales.</li>
	<li>Como medida suplementaría se podrían instalar una <strong>pequeños bolardos</strong> (no superiores en altura a los 5cm) para remarcar aún más la delimitación de carril-bici frente a la acera.</li>
	<li>De forma paralela, en aquello <strong>lugares de intersección, cruce o cercanía a parques infantiles</strong>, se debería poner un asfalto mas rugoso y otras medidas persuasorias para que las bicicletas disminuyan la velocidad al atravesar dichas zonas, con el fin de ganar en seguridad.</li>
</ol>

<p> </p>

<p>Muchas gracias</p>

<p> </p>
";"07/09/2015 11";"581";"510";"71";"96";"868095168";"38535"
"12";"Publicidad sexual en coches";"<p>A nadie que tenga coche y no disponga de garage escapa que cada vez son mayores el número y la frecuencia de anuncios de contenidos sexual que aparecen en los vehículos cada mañana. No solo son un lastre para la limpieza de nuestras calles, ya que muchos de ellos acaban en la acera o el asfalto, sino que también quedan a la vista de todos, incluidos niños que no tienen por qué estar siendo bombardeados con anuncios en los que se muestra a las mujeres como si fuesen carne, fomentando la cosificación de la mujer contra la que por otros medios tratamos de luchar. </p>

<p>He comprobado en primera persona este problema en barrios como Carabanchel, Legazpi o Ciudad Lineal, pero no creo que se trate de casos aislados. </p>

<p>A mi entender, urge regular y perseguir esta actividad que va en detrimento de la mayoría de madrileños y madrileñas, así como de quienes visitan o residen en nuestra ciudad. Espero que desde el nuevo Ayuntamiento puedan luchar contra este y otros males de nuestra ciudad, ahora que por fin los ciudadanos tenemos algo de voz en las instituciones. </p>

<p> </p>

<p>Gracias</p>
";"07/09/2015 11";"628";"506";"122";"67";"865756000";"30940"
"13";"Devolver ON29";"<p>Propongo que se devuelva el solar de Ofelia Nieto, 29 a la familia que vivia en el, y que se les ayude a reconstruir su vivienda.</p>
";"07/09/2015 11";"67";"52";"15";"3";"857061303";"2871"
"14";"Limpieza de graffitis y remodelación de Aluche";"<p>Los vecinos de Aluche vemos día tras día como nuestro querido barrio está cada vez más sucio y descuidado.</p>

<p>Graffitis y basura por todas partes, aceras rotas, baches en la carretera, zonas de jardines destrozadas...</p>

<p>Propongo que se lleven a cabo un estudio y posteriores acciones para mejorar el aspecto del barrio, sobre todo en cuanto a limpieza. Las propuestas concretas serían: limpiar todos los graffittis (multa a infractores), arreglar las aceras, mejorar las zonas de los contenedores (más medios para la limpieza, más contenedores de todo tipo).</p>
";"07/09/2015 11";"167";"152";"15";"23";"864566618";"12469"
"15";"Limpieza de las calles";"<p>Buscar la manera de que los ciudadanos mantengan limpias las calles de la ciudad. No puede ser que existan barrios enteros llenos de cacas de perro y colillas. Habría que sancionar estos comportamientos. </p>

<p>Quizás los controladores del S.E.R. podrían multar comportamientos incívicos como dejar la caca del perro en mitad de la acera o tirar basura a la calle.</p>

<p>Saludos a todos</p>
";"07/09/2015 11";"1085";"1030";"55";"44";"873390190";"92557"
"16";"NO a los ruidos. Reducir el número de decibelios permitido.";"<p>Muchos vecinos trabajamos todo el día y regresamos a nuestras casas para descansar. Muchas veces esto es imposible porque la ley actual permite que se ponga la música alta a horas poco apropiadas (noches, hora de la siesta, fines de semana...).

Propongo que se<strong> baje el número de decibelios permitidos</strong>, tanto para los<strong> bares y discotecas</strong> como para los <strong>particulares</strong>. Y que se <strong>facilite la denuncia</strong> de este tipo de actividades y se <strong>endurezcan las sanciones</strong>.</p>

<p> Ese vecino que pone la música alta a todas horas, incluso en la hora de la siesta, por la noche... esa otra persona que se duerme con la radio puesta a todo volumen, o la televisión, el joven y no tan joven que decide aparcar debajo de tu terraza con la música del coche a todo volumen, la motocicleta con el escape roto...</p>

<p>Queremos descansar. NO más ruidos.</p>
";"07/09/2015 11";"411";"354";"57";"63";"866546046";"25581"
"17";"Transporte Público Gratuito en días de Alta Contaminación";"<p>Habilitar el transporte público gratuito en Madrid los días que la contaminación sobrepase los límites permitidos.</p>

<p>Esta es una medida de caracter urgente que ya se realiza en otras ciudades europeas cuando los índices de contaminación son muy elevados.</p>

<p> </p>

<p>Estos días no se contabilizarían en los abonos mensuales. </p>
";"07/09/2015 12";"1290";"1071";"219";"24";"869422871";"70735"
"18";"devolver las aceras a los peatones";"<p>me gustaria que las aceras volvieran a ser para uso exclusivamente peatonal.que lo que gallardon nos quito nos sea devuelto a los que ni queremos ni podemos utilizar motos, y que ahora campan a sus anchas por las aceras.el otro dia casi fui atropellado por una .</p>

<p>que se les reserve area de aparcamiento en el aparcamiento para coches,por ejemplo el 10% pagando la parte proporcional al espacio ocupado .gracias .</p>
";"07/09/2015 12";"190";"157";"33";"12";"862495802";"10246"
"19";"Apps de servicios municipales disponibles en la web municipal.";"<p>Sería interesante que cuando el Ayuntamiento contrata con un tercero el desarrollo de una aplicación para los ciudadanos (bicimad, contaminación, EMT...) no olvidase que algunos madrileños no usamos los servicios de las grandes empresas de internet para manejar nuestro móviles (appStore, Googleplay). Me he dirigido en numerosas ocasiones a los departamentos del Ayuntamiento interesados y la respuesta siempre es la misma: no podemos servir la aplicación fuera de la tienda de apps de la macroempresa (Google Inc, Apple).</p>

<p>Y digo yo, ¿es necesario estar registrado en esas empresas y ceder mis datos para acceder a información municipal?</p>

<p>Y me respondo: No, no es necesario, todo depende de la política tecnológica por la que se apueste. Ojalá cambie el modelo y la nueva corporación de servicios a todos, y no sólo a las mayorías que han decidido vender su privacidad.</p>

<p> </p>

<p>Muchas Gracias.</p>

<p> </p>
";"07/09/2015 12";"58";"46";"12";"6";"857428939";"2696"
"20";"Abono Anual Uso Libre (Abono Deporte Madrid)";"<p>Tener la posibilidad de un Abono Anual de Uso Libre para las instalaciones deportivas como ha existido en los últimos años y en las mismas condiciones. Este año ha sido suprimido por Abonos mensuales elevando el coste a las actividades deportivas.</p>

<p>Un Saludo.</p>
";"07/09/2015 12";"133";"118";"15";"5";"863041405";"9138"
"21";"Sistema de previo aviso a través de watsapp sobre multas y retirada de coches";"<p>Se trata de habilitar un sistema para facilitar un aviso previo a través del teléfono vía por ejemplo watsapp de infracción leve (como casos que no interrumpan la circulación viaria y sobre todo referido al aparcamiento, doble fila, etc...) a los ciudadanos de Madrid que conlleve la posibilidad de que el usuario infractor esté informado y pueda acudir con celeridad (habilitar un tiempo determinado ya sean 5 o diez munitos) para retirar su vehículo y evitar la sanción (este método podría a la vez tener un límite avisos que pudiera ser ampliado o disminuido en base a la no comisión de infracciones, como ya se da en el carnet por puntos). A la vez implantar ese mismo método cuando un vehículo es o va a ser retirado de las vías por las grúas municipales.</p>

<p>Se conseguiría trasladar al ciudadano que su Ayuntamiento (como muchas veces se cree) no está para multar o sancionar haciendo cumplir las leyes de tráfico sino también está para informarle y consecuentemente  ser más empático y cercano en este tipo de situaciones que se producen todos los días.</p>
";"07/09/2015 12";"158";"64";"94";"14";"839183713";"-1215"
"22";"Abono transporte gratuito para los menores de 14 años";"<p>La gratuidad del transporte público para los menores de 14 años puede incentivar y educar en el uso de ese transporte tanto a los niños como a los padres que ahora llevan a sus hijos en coche al colegio.</p>

<p> </p>
";"07/09/2015 12";"140";"90";"50";"7";"855599742";"2571"
"23";"Farolas LED";"<p>Las farolas que se instalaron hace unos meses en algunas zonas (concretamente San Blas, en mi caso) me parecen una buena idea para reducir el consumo energético, además de la contaminación lumínica; se nota bastante.</p>

<p>Pero tienen un problema: iluminan muy poco las zonas circundantes. Caminar a partir de cierta hora y comprobar que hay muchas mas zonas de sombra que antes, es inquietante. A unos quince metros de una farola podría perfectamente permanecer alguien de pie que costaría bastante distinguir (con buena vista, no me imagino alguien mas mayor o con peor vista que yo)</p>

<p>Y la solución tampoco es aumentar las farolas creo, pues el radio de acción de éstas es tan limitado que probablemente harían falta más de las que compensarían el ahorro energético.</p>
";"07/09/2015 12";"896";"847";"49";"13";"872614177";"75435"
"24";"Velocidad y señalización adecuada en calles y carreteras";"<p>Creo que sería de gran ayuda al medio ambiente el tener un apartado donde los ciudadanos pudiéramos avisar de sitios donde haya señales contradictorias y zonas en las que la velocidad máxima de la vía varía sin sentido aparente.</p>

<p>Respecto a esto último, concretamente en los túneles de la M-30, las salidas de este hacia la calle que se reducen de 70 km/h a 30 o 50 kms/h hacen que se produzcan frenazos, atascos y por consiguiente la bajada de marcha y mayor contaminación al volver a acelerar. Todas estas salidas son cuesta arriba, hay que tomarlos con marchas bajas y por ello son puntos con alta concentración de CO2, lo que perjudica a los vecinos cercanos a dichas salidas. Creo que se debería estudiar estos puntos para poner la bajada de la velocidad a la salida de estos, a la finalización de la cuesta arriba. Un ejemplo de ello está en la salida del bypass dede la A3 a la M30 descubierta (Pte Vallecas).</p>
";"07/09/2015 12";"83";"75";"8";"1";"861691175";"6054"
"25";"Sensores de Contaminación para Vehículos Contaminantes";"<p>Hoy en día los costes de un sensor de contaminación con GPS integrado conectado vía wifi/4G en todos los vehículos serían bastante bajos. Popongo que se incentive por ley/ordenanza la instalación en los vehículos que circulan por nuestra ciudad para hacer un cálculo objectivo de cuanto contamina un vehículo y dónde lo hace. </p>

<p>Es posible que esto pueda vulnerar el derecho a la privacidad, sin embargo me parece mucho más importante el derecho a respirar aire puro. Según este artículo (http://www.elmundo.es/blogs/elmundo/por-amor-al-aire/2015/03/05/la-otra-verdad-incomoda.html), la contaminación mata en la UE a más de 400.000 personas al año sin contar todos los problemas de salud no directamente letales. Quién quiera tener un vehículo contaminante tendrá que sacrificar su privacidad por el bien de todos, de lo contrario tendrá que abstenerse de usar uno en nuestra ciudad.</p>

<p>Cuando se recojan los datos, ya podremos incentivar/sancionar acorde con el interés general de reducir la contaminación y disfrutar del verdadero aire que todos conocemos cuando vamos a la Sierra.</p>
";"07/09/2015 12";"55";"35";"20";"3";"852866440";"954"
"26";"Autobuses EMT: Ruido y Contaminación";"<p>Los autobuses de la EMT que vayan haciendose viejos deberian sustituirse por autobuses menos ruidosos y no contaminantes.</p>
";"07/09/2015 12";"236";"207";"29";"22";"865114564";"15612"
"27";"Invitaciones para aparcar en zona SER";"<p>Para los usuarios que pagamos la cuota del Servicio Regulado de Estacionamiento nos sería muy util disponer de invitaciones para que los coches aparcasen en la zona SER de manera ""temporal"".</p>

<p>En Madrid muchos somos de fuera , y cuando vienen familiares, amigos a pasar unos días tienen muchos problemas para aparcar sin tener que estar preocupado por los límites horarios y el costo del mismo.</p>

<p>La propuesta va enfocada a que a los que pagan el SER y lo soliciten dispongan de X invitaciones que permitan aparcar a un coche durante un periodo de 24 horas en la zona SER.</p>

<p>Para que no sea un abuso y esté regulado se puede limitar a un número de invitaciones máximas al año.</p>
";"07/09/2015 12";"76";"45";"31";"8";"852415314";"828"
"28";"Acera sin motos, espacio pa todos";"<p>Propongo un debate alrededor de la siguiente propuesta que, con un coste mínimo, beneficiaría a todas las personas de Madrid al mejorar la accesibilidad, la calidad y la habitabilidad de las aceras, poniendo de manifiesto cuáles son las prioridades de la movilidad urbana: poner al centro las personas y las relaciones entre ellas en lugar de los vehículos</p>

<p><strong>Acción</strong>: Habilitar aparcamientos de motos en batería en la calzada en lugar de una o dos plazas de coches en correspondencia de las intersecciones.</p>

<p><strong>Objetivo</strong>: Una actuación permanente, incremental y al mismo tiempo concienciante para re-establecer las prioridades en la movilidad urbana, empezando por las personas que caminan (que somos todas).</p>

<p><strong>Cómo</strong>: Se podría empezar con una calle principal por cada barrio y poco a poco extender la actuación a todas las calles. En la calle afectada, la norma que permite el aparcamiento de motos en las aceras se suspendería, imponiendo la obligación de aparcar la moto en los espacios libres en calzada. El objetivo final sería llegar a abrogar esa normativa de manera gradual, generando el debate y la reflexión sobre las ventajas que una acera sin vehículos genera para todas las personas. Para las que usan la moto no habría mucha diferencia. Los más afectados serían los usuarios de coches que dispondrían de menos plazas para aparcar.</p>

<p><strong>Beneficios</strong>:</p>

<ul>
	<li>aumentaría la calidad y la seguridad de las aceras como espacios sin vehículos al sacar las motos aparcadas y al evitar sus maniobras a menudo realizadas a motor encendido.</li>
	<li>aumentaría la visibilidad de los peatones y su seguridad en el acto de cruzar la calle, ya que estos nuevos espacios para motos se situarían en la plaza de aparcamiento más próxima a un paso de cebra o a un semáforo, ampliando la permeabilidad visual.</li>
	<li>sería una actuación muy visible, de carácter permanente y que generaría debate sobre las nuevas prioridades de la movilidad urbana, que ponen al centro las personas y las relaciones entre ellas en lugar de los vehículos.</li>
</ul>

<p><strong>Costes</strong>:</p>

<ul>
	<li>bajos costes de actuación, ya que se necesitaría solo pintura, como ya se ha realizado en Valencia (ver aquí)</li>
	<li>posible hostilidad de los usuarios de coches, que habría que prevenir y neutralizar con una intensa campaña de comunicación</li>
</ul>

<p><strong>Comunicación</strong>: En tema de movilidad, Madrid empieza por las personas que caminan, ¡que somos todas!</p>
";"07/09/2015 12";"127";"82";"45";"11";"855635225";"2388"
"29";"Metro 24h";"<p>Seria muy buena opcion el metro 24h todos los dÍas, o por lo menos fines de semana 24h. Se reduciria los accidentes de alchol en fin de semana que la gente coge coche por que si no tiene que esperar hasta las 6 am que es cuando abre, y al final no cogen taxis y cogen el coche, ademas de que se crearian mas puestos de trabajo, mas seguridad mas conductores de metro etc.</p>
";"07/09/2015 12";"425";"310";"115";"21";"862106713";"14223"
"30";"Ley de Transportes publico 100% eléctricos";"<p>Deberian sacar por ley que el transporte publico fuera 100% electrico (no hibrido) esto se reduciria mucho la contaminacion en Madrid, por que un gran porcentaje de vehiculos en Madrid son taxis y autobus y muchos de ellos muy contaminantes todavia.</p>

<p>Deberian sacar por ley que fuera obligatorio que los taxis y autobuses sean electricos, por supuesto dando su margen de tiempo para que se vayan cambiando, y dando ayudas o subvenciones para que los taxis se vayan cambiando rapido al electrico.</p>

<p> </p>
";"07/09/2015 12";"164";"141";"23";"6";"863187643";"10145"
"31";"¿Cómo harías un Madrid más sostenible?";"<p>La semana que viene celebramos nuestra primera Semana Europea de La Movilidad con vosotros. El lema elegido para 2015 es ""Elige, cambia y combina cómo te mueves"". </p>

<p>Queremos saber cómo pensáis que podría mejorar Madrid en términos de sostenibilidad ambiental, y qué medidas os gustaría que pusiéramos en marcha desde el Ayuntamiento. ¡Somos todo orejas!</p>
";"07/09/2015 12";"96";"80";"16";"40";"861051058";"5333"
"33";"Tarjeta única ciudadana";"<p>En Zaragoza existe desde hace unos años una única tarjeta que junta las siguientes funciones (resumo las más importantes):</p>

<p>-Abono transportes</p>

<p>-Tarjeta de BiciMAD</p>

<p>-Carnet de piscina</p>

<p>-Carnet de Bibloteca</p>

<p>-Pago de zona azul</p>

<p>¿Qué hace falta en Madrid para poder implantar algo así?</p>
";"07/09/2015 12";"1645";"1530";"115";"57";"874706264";"131607"
"34";"Madrid necesita una limpieza en serio";"<p>Madrid necesita una limpieza en serio. Pintadas en los edificios, basura alrededor de los contenedores, papeles por los suelos, publicidad en los coches, excrementos caninos, mugre en las calles... Madrid está más sucio que nunca. Ni limpieza de choque ni nada de nada. Han limpiado 4 calles para la foto, ha habido más recursos públicos para publicitar una limpieza casi inexistente que en la propia limpieza. </p>
";"07/09/2015 12";"2237";"2142";"95";"106";"877130160";"196006"
"35";"Conexión L3 de Metro y Metrosur";"<p>No veo normal que sigan sin ponerse de acuerdo Ayuntamiento y Comunidad en dar continuidad al trazado de la L3 de Metro desde las cocheras que están justo enfrente de Getafe y conectar con El Casar (Metrosur/Renfe). El sur madrileño (Aranjuez, Parla, Valdemoro, Getafe..) sólo puede tomar el tren para ir al centro de Madrid o dar una vuelta impresionante hasta Alcorcón para tomar la L10 (sólo hay que consultar el mapa)</p>
";"07/09/2015 12";"69";"55";"14";"6";"858382493";"3268"
"36";"NIE para extranjeros casados con españoles sin requisitos";"<p>Lo que no hay derecho es que si un Español se enamora de una mujer Extranjera y conviven juntos en España y empadronados los dos en el mismo piso ya 5 años y casados en España no tenga derecho esa persona a un NIE por que piden de requisitos a parte de casarte o pareja de echo tener seguro medico y tener bastante dinero o que el Español tenga trabajo y ademas que cobre bien. Sino te deniegan el NIE.</p>

<p>Asi que si eres pobre y estas en el paro como muchos de los Españoles no te dejan que tu mujer tenga el nie para que pueda tener una asistencia sanitaria y por supuestos tener una identidad en España.</p>
";"07/09/2015 12";"67";"26";"41";"4";"840818448";"-582"
"37";"Cagadores para móviles con posibilidad de carga solar durante el día";"<p>Alguna vez nos ha pasado que un momento importante nos hemos quedado sin bateria en el móvil, y más hoy en dia casi todas las comunicaciones y muchos trámites lo hacemos por este medio, sería una buena opcion tener cargadores o posibilidad de cargar el móvil en bancos o cabinas como las antiguas de telefonica, donde si tienes una urgencia poder cargar el móvil aunque sea un pequeño porcentaje para poder hacer el trámite, podría ser pagando un pequeño importe por su uso y por evitar masificaciones.</p>
";"07/09/2015 12";"157";"66";"91";"15";"839603459";"-1050"
"38";"Finca Vista Alegre";"<p>Espero que este espacio de debate sirva para que los madrileños, incluido su gobierno local, podamos plantearnos este tema: La Finca Vista Alegre. Vetada al uso y disfrute de los vecinos de Madrid, y en particular los de Carabanchel desde hace más de 30 años.</p>

<p>Entiendo que en principio la titularidad de la finca es de la Comunidad de Madrid, y que alguno de los gobiernos del ayuntamiento han intentado, sin éxito, que se devuelva este espacio a la ciudadanía. Claro, que en treinta y tantos años no ha habido manera de que se le devuelva a sus legítimos dueños: El pueblo de Madrid.</p>

<p>Este es un espacio cuanto menos curioso, pues a pesar del veto a su uso público, ésta tiene dentro de su espacio residencias de ancianos, institutos, un conservatorio (o similar, no estoy muy seguro), y así hasta 43 instalaciones de la CAM pero oiga, unos señores muy amables (que ni pinchan ni cortan) de una empresa privada de seguridad impiden el paso a discrección.</p>

<p>Ahí lo dejo. Qué acciones, tanto por la vía administrativa como por la de la presión vecinal, se podrían tomar al respecto? Para mí, y tras tantísimos años de ""pasar"" de los vecinos, creo que una ""toma/invasión"" vecinal sería lo más adecuado. Presión vecinal a tope, televisión y otros medios, y nuestros queridos amiguitos del UIP, claro. Si el 2 de Mayo funcionó, por qué ahora no?</p>

<p>Saludos!</p>
";"07/09/2015 12";"129";"119";"10";"21";"864396986";"10055"
"39";"Educación (o multas) para los ciclistas";"<p>Hola,</p>

<p>Quería llamar la atención sobre un tema que me parece muy llamativo, peligroso e irresponsable. He vivido en Berlín y allí, a pesar de haber carril bici en el 80% de la ciudad, al menos la almendra central, he visto morir ciclistas con miembros amputados y atropellados por automóviles, camiones, tranvías... En muchos casos, yendo por su propio carril de forma adecuada. Pero me sorprende ver que en Madrid los ciclistas y especialmente los usuarios de bicimad NO RESPETAN ni una sola norma de circulación, poniendo (y creo que no son conscientes de hasta qué punto) en riesgo su propia vida. Van en dirección contraria, por aceras, por carreteras... ¡Se saltan semáforos y stops! Es una barbaridad la serie de infracciones de tráfico que cometen. Creo cien por cien en el uso de la bicicleta por la ciudad y por eso creo que el ciclista debe ser el que demuestre que sí se puede ir en bici por Madrid, pero precisamente por eso, debe ser responsable y dar ejemplo. Porque está en juego nuestra vida y está en juego que se extienda el uso de la bici, por eso creo que el ayuntamiento debería empezar a multar a todo aquel que comenta imprudencias con la bici. Si la bici es un medio de transporte más, ¿por qué incumple sistemáticamente con las normas de circulación?</p>
";"07/09/2015 12";"284";"211";"73";"63";"861822954";"10252"
"40";"Educación en los debates";"<p>El título del debate, creo que no es debate; solamente quiero hacer una llamada a la tolerancia y situar este canal en la tribuna de la buena educación. El debate es necesario y la buenas formas ayudan a construir entendimiento. Gracias.</p>
";"07/09/2015 12";"44";"39";"5";"0";"858984585";"3013"
"41";"Cañada Real";"<p>Este debate trata sobre los grandísimos problemas que se viven en los municipios limítrofes a la Cañada Real Galiana. El problema en sí no es competencia del ayuntamiento de Madrid, pero los terrenos en los que está enclavada la cañada real sí que son parte del ayuntamiento. Los vecinos de Rivas Vaciamadrid venimos sufriendo desde hace ya varios años, pero especialmente en los últimos días, una ola de robos, amenazas y demás coacciones por parte de ciertos individuos drogodependientes que acuden a dicha zona a por su dosis, y ante la escasez de dinero, se dedican a delinquir por dicho municipio para poder costearse su droga. Incluso Telemadrid se ha hecho eco de dichas reclamaciones en varios reportajes emitidos durante la semana pasada. Me consta que los diferentes alcaldes de Rivas se han reunido en varias ocasiones con representantes del Ayt de Madrid a fin de ver de qué manera se pueden paliar dichos problemas, pero de momento sin encontrar solución alguna</p>
";"07/09/2015 13";"44";"40";"4";"2";"859637555";"3272"
"42";"Contratación de obras";"<p>Transparencia</p>

<p>¿Se van a seguir contratando las obras del ayuntamiento de Madrid, como desde hace muchos años, entre tansólo los elegidos de siempre? </p>
";"07/09/2015 13";"27";"22";"5";"1";"855532911";"1385"
"43";"Riqueza también para Madrid zona Sur (PROPUESTA DE ZONA FINANCIERA EN ZONA SUR)";"<p>De todos es sabido que en nuestra ciudad la riqueza esta como a nivel mundial mal repartida. </p>

<p>La zona norte de Madrid tiene una grandísima estructura dónde se encuentran las sedes de todas las principales empresas. El centro financiero esta claro que se encuentra en la castellana, con todas sus torres, y la ampliación de la castellana incrementará esta diferencia entre Madrid Norte y Sur.</p>

<p>PROPUESTA</p>

<p>La propuesta sería crear centros financieros en la zona sur de Madrid, mejorando la economía y empleo, así como revalorizar zonas muy descuidadas. </p>

<p>Una posibilidad a modo de ejemplo sería la zona de contenedores de Entrevías, denominada ""El Abroñigal"". Ya existió una propuesta por un anterior alcalde de Madrid de utilizar esta zona para una expansión de la estación de Atocha. Aunque estos terrenos no son municipales, a modo de ejemplo sería utilizar esta zona para crear por ejemplo unas torres que sirvan para revitalizar la zona sur de Madrid, vendiendo terrenos a empresas privadas utilizando estos ingresos para crear infraestructura pública para los vecinos de la zona sur. </p>

<p>Esta zona estaría perfectamente comunicada con la M30, y entre la A3, A4 y a escasos metros de la estación Sur de Autobuses y Cercanías de Mendez Álvaro, lo que sería un punto muy interesante para inversores privados. </p>

<p> </p>
";"07/09/2015 13";"197";"169";"28";"37";"864195880";"12095"
"44";"Recuperación del CMU San Juan Evangelista, ""El Johnny"" ";"<p>Recuperación del CMU San Juan Evangelista, ""El Johnny"" , como centro educativo y cultural de referencia para la ciudad de Madrid. Desalojo de los allanadores actuales y mediación del Ayuntamiento para poner fin a la problemática entre la Universidad Complutense y la concesionaria del centro, el banco Unicaja. Apoyo a un nuevo proyecto de gestión en el que los precios asequibles permitan a las clases menos pudientes acceder a la universidad y en el que la oferta cultural y debate se conviertan en bandera del centro.</p>
";"07/09/2015 13";"99";"82";"17";"5";"860564535";"5383"
"45";"Campaña de Civismo para fumadores y dueños de perros y ciudadanos en general";"<p>Existe una teoría que considero que funciona muy bien para explicar lo que sucede en Madrid,<strong> la teoría de las ventanas rotas</strong> (http://elpais.com/diario/2004/10/18/catalunya/1098061644_850215.html). Básicamente, como dice el artículo, explica que si en un edificio aparece una ventana rota, y no se arregla pronto, inmediatamente el resto de ventanas acaban siendo destrozadas por los vándalos porque la ventana rota envía un mensaje: aquí no hay nadie que cuide de esto.
Esto pasa en Madrid con fumadores y dueños de perros y resto de ciudadanos en general. Si la ciudad estuviera limpia, y esto compete al ayuntamiento de Madrid, el incívico dueño de perro no dejaría la caca de su perro en la calle, o el fumador que lleva prisa cuidaría dónde dejar su colilla. El que tira las bolsas de plástico, el que deja la mierda en la papelera hasta arriba de residuos, todos cuidaríamos la limpieza general de nuestro municipio. 
En este juego de la gallina y el huevo ambos problemas necesitan solucionarse en paralelo. Primero, necesitamos una campaña de civismo que recuerde a los madrileños que o mantenemos limpia la ciudad nosotros o no lo hará el turista o el que viene a visitarla de paso. Segundo, y en paralelo, necesitamos más servicios de limpieza. </p>
";"07/09/2015 13";"269";"238";"31";"22";"866085282";"18314"
"46";"EL CHIP DE LOS ANIMALES ATROPELLADOS";"<p>Buenos días,</p>

<p>Antes de nada quiero agradecer al Ayuntamiento por ofrecernos este escaparate. Espero que sirva de algo y que los que toman decisiones al menos lo lean.</p>

<p>Como ustedes sabrán (y si no se lo digo yo), de la normativa vigente tanto en la Comunidad como en el Ayuntamiento relativa al protocolo de actuación en la recogida de residuos cuando estos están compuestos por animales domésticos muertos no existe obligación de identificar al animal. Esta situación, como compañera de tres animales domésticos, me horroriza pues supone que los propietarios de animales domésticos estamos sometidos completamente a los protocolos arbitrarios que las empresas adjudicatarias de la recogida de esta clase de residuos establecen y, por consiguiente, podríamos pasar mucho tiempo buscando a un animal perdido que bien podría estar incinerado o enterrado en una zanja sin que se le haya leído el microchip que, por otro lado, la Comunidad de Madrid nos obliga a poner a nuestros animales.</p>

Hablando con las empresas adjudicatarias estas te dicen que sí proceden a leer el chip de los animales que aparecen muertos en la vía pública y que sí avisan a los dueños, pero a efectos prácticos esto no ocurre casi nunca y, desde luego, con los gatos jamás.

 

El sentido común dice que imponer en los protocolos de actuación de las empresas adjudicatarias la identificación obligatoria del animal (aunque esté muerto), evidentemente si éste está identificado, y, si lo está, notificar el hallazgo del animal muerto en el Registro de Identificación de Animales de Compañía no supondría un gran esfuerzo ni de trabajo ni de dinero y además facilitaría la imposición de multas en el caso de que la pérdida no hubiese sido debidamente denunciada.

Gracias por su atención.

Montse
";"07/09/2015 13";"58";"54";"4";"2";"861334189";"4655"
"47";"Alumbrar Madrid con energía Cinetica";"<p>Una buena medida de utilizar energia limpia y libre de contaminacion seria alumbrar Madrid, todas las farolas, las calles etc con energia cinetica, se pones unas placas debajo de la acera y carretera y con las pisadas, personas caminando, coches circulando se genera electricidad.</p>

<p>Y tampoco es muy caro considerando que Madrid es una de las ciudades muy afluyentes de gente por lo que se conseguirian muchos kw/h. Ademas de mirar por la salud y una ciudad con energia mas limpia, ademas que Madrid seria la ciudad elegida perfecta para implantar este sistema ya que calles como gran via estan 24h con personas y coches pasando generando miles de kw/h que podrian ser aprovechados.</p>

<p>Y ademas Madrid seria un buen ejemplo con esta medida para mas ciudades. En Toulouse a disponen de este sistema.</p>
";"07/09/2015 13";"106";"83";"23";"10";"859594019";"4698"
"48";"Carriles bici y Calles bici";"<p>Creo que debería haber más carriles bici claramente separados del resto del tráfico para que circular en bicicleta sea más seguro. Y en el espacio que ahora ocupan los coches, no en las aceras...</p>

<p>Además, se deberían hacer itinerarios por ""calles-bici"", en las que los únicos vehículos permitidos fueran las bicicletas y según el tamaño de las calles, transporte público y residentes.</p>
";"07/09/2015 13";"2151";"1878";"273";"235";"873682119";"140129"
"49";"Fuentes públicas para los ciudadanos";"<p>Si de algo carece Madrid es de fuentes públicas en sus calles. Me parece de vital importancia instalarlas por el centro y por las zonas de máxima afluencia de peatones (plaza de castilla, avenida de américa, ciudad universitaria, retiro...). De esta manera los ciudadanos y los turistas podrán refrescarse gratuitamente, sin necesidad de pagar por ello y fomentando el consumo de agua en lugar de refrescos ricos en azúcar.</p>
";"07/09/2015 13";"1545";"1409";"136";"27";"873848542";"116094"
"50";"Acceso al centro por la calle Atocha y Plaza de Jacinto Benavente";"<p>En mi opinión, la zona más caótica del Centro de Madrid se encuentra en el triángulo formado por Antón Martín, Tirso de Molina y Sol. Teniendo en cuenta que en este área muchas de las calles pertenecen a las APRs (Áreas de Prioridad Residencial), el problema se acentúa en el tramo de la calle Atocha desde Antón Martín a la plaza de Jacinto Benavente, la propia plaza, Tirso de Molina y la calle Magdalena.</p>

<p>Teniendo en cuenta que en esta zona hay tres importantes teatros, unos cines que han sobrevivido a la crisis del cine y numerosos establecimientos hosteleros, creo que esta parte del centro debería reordenarse o por lo menos, estudiar soluciones para los problemas que existen actualmente:</p>

<p>- Cuando coinciden las salidas de cines y teatros resulta imposible volver a casa con el coche ya que al haber tan poco espacio en las aceras, la gente invade la calzada.</p>

<p>- La cantidad de autobuses que paran en la zona producen una contaminación acústica muy elevada además de ocupar gran parte del espacio de la plaza.</p>

<p>- Borrachos y prostitutas reclaman como suyas ciertas zonas de Jacinto Benavente y no dudan  en insultar a los viandantes, miccionar en la vía pública u ofrecer sus servicios sin importar que menores, pasen por delante.</p>

<p>- Las salidas del parking, las concesiones de terrazas y otros elementos colocados de forma caótica, invaden un espacio que debería estar destinado al peatón. Hay una terraza portátil que ocupa un gran espacio y las sillas y mesas de otro establecimiento, poco a poco han ido ocupando la acera.</p>

<p>En resumen me parece increíble que una zona que conecta los grandes atractivos turísticos de la ciudad esté tan olvidada por el consistorio. Si cada vez se cierran mas fábricas en esta ciudad habrá que apostar por otros negocios que generen riqueza y un turismo de calidad, puede crear muchos empleos.</p>
";"07/09/2015 13";"62";"42";"20";"6";"854845198";"1490"
"51";"""Comite popular asesor no decisorio inicial actividades en Centros Culturales""";"<p>Los Centros Culturales Municipales, controlados y mal gestionados hasta ahora bajo la mayoría política, deben pasar a ser la expresión activa preferente emanada de las propuestas de la base social a la que sirven/atienden en su demarcación y entorno. Ello no implica que sean decisorios, para lo que habrá que tener en cuenta a los actuales funcionarios responsables en relación a criterios de economía, organización, características, etc., pero estos controles o supervisiones técnicas no podrán en ningún momento ser limitativas o bloqueantes respecto a los proyectos populares, en todo caso se iniciaría una mesa de decisión con la participación de ambas formas representativas: Base y Administración/Gestión. En lois últimos años los Centros Culturales han permanecido prácticamente incactivos, no han aceptado casi ninguna propuesta de las bases residenciales, limitando así muchas formas expresivas y actividades de las poblaciones relacionadas espacialmente con el centro.</p>
";"07/09/2015 13";"44";"33";"11";"1";"855628584";"1650"
"52";"Instalaciones Deportivas Públicas Chamberí";"<p>Como bien se hacía eco ABC en este artículo http://www.abc.es/madrid/20150521/abci-chamberi-deportes-201505211400.html Chamberí es el distrito que menos fondos para el deporte recibe. Tenemos instalaciones, SÍ, pero sus cuotas están lejos de ser accesibles para los vecinos del barrio.</p>

<p>Chamberí es el único distrito con cero instalaciones deportivas básicas de las 477 que hay en todo Madrid y el único polideportivo de tiene una lista de espera que duplica su capacidad. Curioso dato cuando hablamos de uno de los distritos con pasado deportivo como éste. Su mítico estadio fue escenario de juegos populares y de atletismo de primer nivel. </p>

<p>Ahora estamos ante un distrito que languidece bajo la sombra del campo de golf y las pretenciosas fuentes que lo rodean. Quien corra y pasee por allí sabe del estado de las instalaciones y de la afluencia de gente.</p>

<p>Poco swing y mucho runner.</p>

<p> </p>

<p> </p>

<p> </p>
";"07/09/2015 13";"76";"69";"7";"2";"861825591";"5628"
"53";"Turismo de borrachera en mi calle";"<p>Vivo en una bonita calle del centro de Madrid, pequeña con hermosos edificios. Hace años se abrió un Cat's Hostel en ella y desde entonces los jóvenes extranjeros que se alojan en este establecimiento que se anuncia ofreciendo marcha nocturna, salen a la calle con calimochos y bebidas alcohólicas y se pasan la noche gritando, chillando y orinando incluso en los portales.</p>

<p>El jaleo nocturno es mucho mayor el fin de semana. El establecimiento no se hace responsable ya que el griterío es en la calle (en la puerta o cerca ya que la calle es muy corta), al ser estrecha la calle hace un efecto embudo con el ruido.</p>

<p>He escrito hasta al defensor del pueblo y nadie hace caso. ¿no es posible que el Cat's Hostel que se forra a costa de la salud de los vecinos se gaste en un vigilante que impida el jaleo.</p>

<p>en caso contrario el ayuntamiento debe tomar medidas. Antes la salud de los vecinos que una multinacional hotelera se haga rica a costa de nuestra salud</p>
";"07/09/2015 13";"75";"61";"14";"3";"859194086";"3822"
"54";"Asfaltado";"<p>El asfaltado está muy deteriorado en muchos lugares: grietas, baches, deformaciones y huecos. Por ejemplo: En la salida del subterráneo desde el Paseo de La Habana para incorporarse al lateral de Castellana, las grietas y huecos, te hacen desvíar la dirección. Esto ademas de peligroso, daña los vehículos. Lleva años así. </p>

<p> </p>
";"07/09/2015 13";"56";"49";"7";"4";"859829451";"3675"
"55";"Bebederos para perros en los parques";"<p>Los parques de Madrid son utilizados a diario por miles de perros y sus dueños. Desde hace tiempo pienso que sería una buena iniciativa el que hubiera sitios donde los perros pudieran beber agua limpia, en vez de tener que recurrir a charcas con aguas estancadas u obligar a sus dueños a cargar agua hasta los parques.</p>
";"07/09/2015 13";"160";"105";"55";"4";"856763328";"3281"
"56";"Razas de perros peligrosos sin bozal, sin correas por Valderribas, Vicálvaro";"<p>Buenos dias.</p>

<p>Es frecuente ver pasear razas de perros peligrosos por Valderribas sin bozal sin correas, con las consecuentes molestias y peligros para los menores. Los alrededores de calle Omega (continuación al parque infantil) y Avenida de Aurora Boreal en direccion al Parque de Valdebernardo suelen estar concurridas por estas peligrosas razas de perro.  En un par de ocasiones he tenido que alzar a mi bebé ante el avalanzamiento de la mascota, y en otra ocasión nos hemos quedado en medio de una monumental bronca canina.</p>

<p>Ni que decir tiene la cantidad de mierda y meados de perro por las calles y parques infantiles de Vicálvaro.</p>

<p>¿ Para cuando tiene pensado la policia local y el ayuntamiento hacer cumplir las ordenanzas vigentes en cuestión de razas peligrosas  ? ¿ Y las que atañen a la salud publica por excrementos de perros en calles, plazas y parques infantiles ?</p>

<p>Muchas Gracias. Saludos.</p>
";"07/09/2015 13";"106";"92";"14";"11";"862129090";"6769"
"57";"Reapertura de la Biblioteca del Barrio del Pilar";"<p>Desde hace años los vecinos del Barrio del Pilar estamos reclamando la reapertura de la Biblioteca Municipal ubicada en la C/ Ponferrada, 14. Dicha biblioteca fue abierta, y cerrada, por Fundación Obra Social Caja Madrid, actualmente Bankia, que prometió que la cerraría temporalmente para reformarla. Llevamos años esperando y la promesa no se ha cumplido, de hecho el edifico parece cada vez más abandonado.</p>

<p>Esta biblioteca servía de punto de encuentro para todos aquellos que buscaban leer libros y alquilarlos, estudiantes necesitados de un sitio silencioso para estudiar y personas sin ordenador en sus casas o sin internet. Además se convocaban talleres par los niños y ancianos de fomento de la lectura y utilización de las nuevas tecnologías.</p>

<p>Los vecinos pedimos que se reabra este centro de cultura y formento de la lectura</p>
";"07/09/2015 13";"165";"153";"12";"0";"865482872";"13074"
"58";"asfaltado";"<p>por favor, cuando se va a asfaltar el paseo de la ermita del santo, en carabanchel  solo se han puesto parches</p>
";"07/09/2015 13";"42";"33";"9";"3";"856526479";"1885"
"59";"Normas de circulacion vial para bicicletas";"<p>Cada vez veo mas peligroso el hecho de que los usuarios de bicicleta se salten todos los semaforos y contemplen mínimamente las normas de circulación. Y bajo mi opinión creo que deben respetar las normas, ya sea como viandantes o como vehículos. ¿Prevee el ayuntamiento actividades al respecto??</p>
";"07/09/2015 13";"344";"283";"61";"56";"865179209";"18263"
"60";"SEGURIDAD VIAL EN LA CIUDAD";"<p>Hola a todos.</p>

<p>Abro este debate para hablar de la seguridad vial de mi barrio, El Barrio del Pilar, pero estoy segura de que esto pasa en todas partes.</p>

<p>En la Calle del Valle de Pinares Llanos, una calle 100% residencial, con una velocidad máxima de 30 km/h, con varios pasos de peatones, parques al rededor y escasamente iluminada en algunos de sus tramos, los coches circulan muy rápido (mucho) y no se paran en los pasos de peatones a no ser que les obligues. Cualquier día ocurrirá una desgracia y todos nos echaremos las manos a la cabeza.</p>

<p>En la rotonda que se forma en el cruce de las calles Ginzo de Limia y la Avenida de la Ilustración (la famosa rotonda de los arcos) los coches se saltan contínuamente los semáforos no solo en ambar sino en rojo, incluso con peatones cruzando (recordarles que es la M30, que los coches van muy rápido y que ya ha habido atropellos y muertes en la zona).</p>

<p>La Calle Santiago de Compostela es de una sola dirección (de este a oeste) y, además, es muy larga. Cuando los repartidores de comida en moto tienen que hacer una entrega y vienen del oeste invariablemente y sin excepción circulan por la acera y a gran velocidad (aunque daría igual que lo hicieran despacio porque está prohibido).</p>

<p>En varios parques del barrio, que cuentan con rampas para el acceso de vehículos, los chavales meten las motos y circulan por los parques como si de la carretera se tratara (Plaza de Esquivias, Plaza de la Carolina, parque que hay entre las Calles Fermín Caballero, Sangenjo y Patones...).</p>

<p>Es inadmisible.</p>

<p>Gracias y un saludo,</p>

<p>Montse</p>
";"07/09/2015 13";"22";"20";"2";"4";"857192072";"1636"
"61";"Aparcar en zonas SER vecinas";"<p>Ahora no tengo coche, pero cuando lo tenía sufría el «efecto frontera» de mi zona SER.</p>

<p>Como vivo justo en el límite de mi zona, la mayoría del aparcamiento al que tenía acceso estaba lejos de mi casa. Al menos más lejos que los que viven en el centro de la zona. Además con la casualidad de que justo al otro lado de la frontera había muchos sitios libres.</p>

<p>Creo que esto se podría mitigar si los residentes de una zona pudieran aparcar en las zonas vecinas. Y por mucho que pienso no veo los inconvenientes que podría añadir</p>
";"07/09/2015 13";"91";"78";"13";"5";"861193671";"5571"
"62";"Apagar la luz de las oficinas públicas por la noche";"<p>Vivo en S. blás y cuando paso por el edificio de la junta municipal por la noche, veo que están las luces encendidas y dentro no hay nadie, obviamente. ¿No debería apagarse la luz para ahorrar y por cuidar el medio ambiente, si no hay nadie trabajando? Propongo que se apague la luz por la noche de las oficinas de los Ayuntamiento en los distritos.</p>
";"07/09/2015 13";"3260";"3148";"112";"53";"879220742";"293169"
"64";"PARQUE SAN ISIDRO ";"<p>Hay verdadero peligro con los nidos de cotorras en lo alto de los  Árboles , hay alguno seco y han talado varios. También faltan farolas y deberían cambiarse a led</p>
";"07/09/2015 13";"34";"28";"6";"2";"856734294";"1811"
"65";"Menos páginas web y más eficacia";"<p>Si el tiempo que invierten en el Ayuntamiento de Madrid a crear páginas web de desmentidos, de diario de un ayuntamiento, de participación ciudadana, de Twitter para unas cosas y otras se dedicaran a trabajar de verdad por los ciudadanos de Madrid, el Ayuntamiento sería más eficaz. Por favor, menos propaganda política, menos enchufismos y más trabajar o dejar trabajar a los que saben. Los problemas de Madrid no se resuelven debatiendo sino trabajando, cosa que algunos de los que están gobernando no han hecho en su vida.</p>
";"07/09/2015 13";"346";"77";"269";"47";"840089691";"-4272"
"66";"Tranporte gratuito para los menores";"<p>Aplaudo la decisión del Gobierno Regional del abono transporte a 20 euros para los menores de 26. Aunque no sea competencia exclusiva del Ayuntamiento de Madrid, sí podría promover aunque sólo sea de momento para la EMT que sí es de titularidad municipal, que los niños menores que deben ir acompañados de un adulto viajen de manera gratuita en los autobuses, podría ser por ejemplo a los menores de doce años. Sigue siendo una cantidad de dinero importante los 20 , creo que de esta manera muchos padres dejaríamos el coche en casa.</p>
";"07/09/2015 13";"139";"96";"43";"4";"857574465";"3660"
"67";"Una biblioteca municipal en VillaVerde";"<p>Mas de 150.000 habitantes del distrito sólo disponen de la Biblioteca Pública María Moliner (CAM)</p>
";"07/09/2015 13";"146";"138";"8";"11";"865661855";"12287"
"68";"La basura y olor a orines en mi calle junto a Atocha";"<p>No se pueden poner fotos para mostrar el estado de mi calle, Cañizares, preciosa calle del centro de Madrid. Al turismo de borrachera del Cat's Hostel, se une la basura que a veces es dejada días en la calle. Hay dos montones de bolsas y desechos que llevan una semana sin que nadie lo retire. Como los borrachos del Cat's y de otros establecimientos miccionan en la calle y dejan latas y botellas o cristales rotos, el aspecto de la calle Cañizares y el olor son degradantes. </p>

<p>Cuando Botella era alcaldesa nunca vi que regaran para eliminar los orines.</p>

<p>Ahora mi decepción es grande porque jamás es regada mientras que veo que más abajo Lavapies lo limpian mejor y lo riegan. </p>

<p>Es una gran decepción ver que el ayuntamiento en esto se parece al de Ana Botella. </p>

<p>Espero soluciones.</p>
";"07/09/2015 13";"101";"96";"5";"4";"864263579";"8649"
"69";"Salvemos el Pinar del Rey";"<p>El Pinar del Rey situado a la altura del numero 327 de Lopez de Hoyos en el barrio de Hortaleza es elemento unico ya que conserva sus características de pinar silvestre y esta ya rodeado por la ciudad. Un pinar que ha resistido el paso del tiempo y varios intentos de reconvertirlo en parque o a otros fines. Tenemos un trocito de campo en medio de la ciudad que esta agonizando por la falta de reposición de los pinos que se van secando, por la falta de riego en epocas de sequia y por el mal trato que se da a los pinos que se reponen que hace que la mayoria mueran prematuramente.</p>

<p>El objetivo de este debate es reclamar ideas y propuestas para ver como podemos salvar este pedacito de Pinar para que siga siendo simplemente lo que fue.</p>
";"07/09/2015 13";"117";"113";"4";"3";"865315783";"10527"
"70";"Limpieza en Ciudad Lineal ";"<p>Los vecinos de Ciudad Lineal queremos tener nuestras calles limpias, nuestros parque cuidados y regados. </p>
";"07/09/2015 13";"58";"53";"5";"7";"861138205";"4386"
"71";"CAMBIO NOMENCLATOR CALLEJERO EN CIUDAD DE LOS POETAS. VALDEZARZA, MONCLOA";"<p>""CIUDAD DE LOS POETAS"" es un hermosos nombre para una entidad urbana. Originalmente, Ciudad de los Poetas fue el nombre dado al Plan Parcial del mismo nombre con autoría de los arquitectos urbanistas Antonio Perpiñá, Luis Iglesias Martí, y De Miguel. ¿Por qué? El autor de la idea fue el promotor teatral y fecundo animador de tertulias literarias Don Conrado Blanco, activo hacia finales de los años 50 y siguientes. Don Conrado Blanco era un entusista animador de tertulias poéticas incluyendo en ellas a poetas de todas las tendencias. Fue el principal promotor económico del Plan Parcial de referencia, adquiriendo la mayoría de los terrenos que hoy conforman Ciudad de los Poetas, y su principal impulsor, siempre con la voluntad transmitida a sus finales ejecutores (Estudio Perpiñá-Iglesias y De Miguel y Constructora SACONIA-Dehesa de la Villa), de tal forma que incluyó como compromiso en los documentos de dicho Plan y las actas económicas del mismo la obligación de nombrar las calles en recuerdo a dichos poetas. Se solicita la revisión y actuación correspondiente para cambiar el nomenclator, parcial o totalmente. Además, en dicho Barrio/Conjunto habitaron y habitan varios populares poetas y escritores, y ya ostenta el callejero, los parques o centros de actividades, algunos nombres de poetas, pero no estan todos los que debieran y deseáramos.</p>
";"07/09/2015 13";"47";"22";"25";"2";"843671346";"-140"
"72";"Salas de concierto abiertas a menores de 18 años";"<p>A los jóvenes menores de 18 años nos está injustamente prohibida la entrada a salas de concierto. Es injusto ya que estos lugares están orientados en cierta parte para nosotros, con el propósito de disfrutar y de descubrir nuevos grupos y bandas de música, de definir nuestros gustos culturales y de compartir experiencias con los demás.</p>

<p>Además, si lo que antes podía ser un impedimento para permitir el acceso de menores a estas salas era el tabaco o el alcohol, a día de hoy ya no lo es, porque el primero está prohibido en cualquier sala y para cualquier edad, y el segundo no se vende a menores de 18 años.</p>

<p>La oferta de grupos no solo nacionales sino internacionales que llega a Madrid es  muy grande y variada, y es algo que los jóvenes no deberíamos desaprovechar.</p>

<p>Por tanto, propongo que el Ayuntamiento de Madrid, si entra dentro de sus competencias, consiga de cierta forma despenalizar el acceso a salas de concierto a los menores, teniendo siempre en cuenta la seguridad de estos, pero también la importante apertura cultural que les supone.</p>

<p>Gracias por esta plataforma que es todo un acierto.</p>
";"07/09/2015 13";"117";"87";"30";"6";"858808871";"4238"
"73";"Madrid Solidario.";"<p>    ¿Que podríamos hacer para paliar, en la medida de lo posible, el PARO, la DESIGUALDAD y las dificultades económicas y de índole social de nuestros vecinos?. Pensando en lo reflexionado anteriormente, me viene a la cabeza un JUEGO SOLIDARIO, donde todo el Pueblo de Madrid, podría participar y ser beneficiario a la vez, caso de necesitarlo. Este JUEGO SOLIDARIO, sería Liderado por el AYUNTAMIENTO y el Alcalde como principal figura del mismo. El Alcalde y Ayuntamiento se dirigirían a la población en general y a los Comerciantes, Profesionales e Industria de Madrid, en particular, para hacerles llegar las NORMAS DEL JUEGO SOLIDARIO, que serían, básicamente, estas:   a)     El Ayuntamiento crearía MENSUALMENTE una cantidad de Boletos para el JUEGO SOLIDARIO, y les daría un VALOR FACIAL. A continuación se dirigiría a todos para pedirles su participación SOLIDARIA en el mismo. A los Comerciantes, Profesionales e Industria, les pediría, que REGALARAN esos Boletos Solidarios, a cambio, por ejemplo del CONSUMO en sus Comercios o Negocios. Por ejemplo, todo consumidor que compre por valor de 50 o más  euros se le REGALARA el citado BOLETO SOLIDARIO.   b)    El montante de la RECAUDACION MENSUAL de este JUEGO, se destinaria INTEGRAMENTE para AYUDAR a VECINOS, en situaciones precarias debido al PARO, ENFERMEDADES o cualquier otro tipo de deficiencias y carecer de medios económicos, tales como no poder PAGAR la Cuota de la Hipoteca, la LUZ, el GAS, Libros para los Colegios de los niños, Medicamentos,etc. c)     Por su parte el AYUNTAMIENTO, se encargaría de PUBLICITAR por todo el Municipio y en lugares preferentes el citado JUEGO SOLIDARIO, para implicar a todos en el mismo.   d)    El Ayuntamiento daría todos los meses cuenta y detalle de todo lo RECAUDADO y todo lo ENTREGADO a los Vecinos necesitados, con detalle de quien lo recibe para evitar suspicacias y porque motivo lo reciben.   e)     Esto amén de hacernos a todos más SOLIDARIOS, hace que nuestra Ciudad sea más prospera, porque TODOS, tendrán dinero para vivir y mantenerse teniendo los Comerciantes y demás la posibilidad de INCREMENTAR sus VENTAS Y BENEFICIOS, entiendo, por lo cual, estos últimos serían doblemente agraciados por solidarios y para sus negocios.   f)      En cuanto a la CORPORACION gobernante, si lo hacen bien y consiguen un ÉXITO rotundo con este JUEGO SOLIDARIO, entiendo que entrarían a formar parte de una GRAN FAMILIA MUNICIPAL y su GESTION podría ser alabada por los tiempos y en próximas......     g)     SOLO QUEDA,PUES, PONERSE EN MARCHA ¿no?</p>
";"07/09/2015 13";"45";"16";"29";"5";"841652135";"-462"
"74";"Cambiar de medio de transporte público sin pagar otro billete";"<p>Creo que una manera de fomentar el transporte público sería que durante un perido de tiempo determinado, por ejemplo 1 hora, el usuario pudiera cambiar de medios de transporte. Muchas veces la parada de metro o de autobús está lejos y de esta manera sería mucho más cómodo para los usuarios. </p>

<p>Sé que existe un billete de 10 viajes similar, pero es caro y no merece la pena, lo que yo propongo es con el mismo coste del billete actual.</p>
";"07/09/2015 13";"5702";"5513";"189";"290";"881729708";"514752"
"75";"NORMATIVA DE TENENCIA DE ANIMALES DOMÉSTICOS MÁS REALISTA";"<p>Hola.</p>

<p>La normativa de tenencia de animales domésticos no se ajusta a la realidad de la calle y es un hecho que nadie está contento. Los dueños de perros no lo están y aquellos que sienten animadversión por los perros tampoco.</p>

<p>Por un lado, los que tenemos perros debemos ser escrupulósamente respetuosos con la retirada de los residuos que dejan nuestros animales por lo que se deberían imponer más multas a aquellos que no recogen las cacas y que estas fueran mucho más altas.</p>

<p>Por otro lado, con los perros no se trata de qué raza es o no peligrosa o en qué horario se puede o no llevar suelto al perro, que es un sinsentido, que además no se cumple, sino de educar a tu perro igual que harían con tu hijo. Por eso creo que no todo el mundo debería estar capacitado para tener perro, sea la que sea la raza, y que todos tendríamos que pasar un test psicotécnico y demostrar unas nociones básicas para la tenencia. Asimismo, todos los que queremos tener perro deberíamos pagar una tasa mínima que demuestre nuestra buena disposición a hacernos responsables del animal.</p>

<p>A mí me gustaría poder llevar siempre suelta a mi perra, a cualquier sitio, y entrar en cualquier parte con ella porque está perfectamente bien adistrada, hace caso de todo lo que le pido y además recojo todos sus escrementos. Y el que sabe un poco de perros sabe que la normativa tiene que ir en este sentido o seguirá sin cumplirse.</p>

<p>Gracias y un saludo,</p>

<p>Montse</p>
";"07/09/2015 13";"83";"57";"26";"31";"856778512";"2128"
"76";"Enfermedad de los olmos (plaga de galeruca)";"<p>Son ya bastantes años los que llevan nuestros olmos sufriendo la desfoliación producida por la galeruca (un insecto que empieza siendo una especie de gusano amarillo y se convierte luego en un escarabajo amarillo verdoso). No es una plaga que mate inmediatamente al árbol, sino que lo va debilitando al comerse sus hojas. Este debilitamiento supone un mayor riesgo de caída de ramas y por lo tanto de accidentes que no se resuelven con podas desproporcionadas. Los olmos afectados los podemos ver prácticamente por todo Madrid. Estos árboles forman parte de nuestro patrimonio, del verde de Madrid, y sería bueno hacer un plan de urgencia para encontrar una solución, tanto para evitar accidentes como para proteger a estos árboles tan característicos y que tan buen servicio dan a la ciudad.</p>
";"07/09/2015 13";"433";"418";"15";"14";"870836427";"38903"
"77";"Permisos paternidad-maternidad de igual duracion";"<p>Os envio una propuesta para poner en practica la medida que considero mas efectiva para mejorar la igualdad entre hombres y mujeres en nuestra sociedad: igualar la duracion de los permisos por nacimiento (o adopcion) en padres y madres. Podrian ser 4 meses obligatorios para ambos, aunque no tuviesen que coincidir necesariamente en el tiempo, aunque 6 meses seria lo optimo segun mi punto de vista. Ademas se podrian incluir mas meses optativos. Esto reduciria por ejemplo desigualdades a la hora de contratar a hombre y mujeres en edad de tener hijos (pues los padres tambien tendrian el ""riesgo"" de tener que usar su permiso de paternidad), y las desigualdades que se crean en el hogar por las deferencias de tareas que crea el permiso de maternidad m'as largo para la mujer.  Hay mucho hablado y esrito sobre el tema.</p>

<p>Creo que el ayuntamiento no tiene competencia para cambiar la ley, pero si podria tomar alguna medidad para fomentar/forzar el debate sobre esta medida, por ejemplo ponerlo en marcha para los empleados municipales, dar una ayuda extra (opcional para los padres), o algo asi...</p>
";"07/09/2015 13";"209";"167";"42";"7";"862487157";"9988"
"78";"Dispensadores de agua y pienso para animales en la calle";"<p>En otros países europeos existen unos dispensadores de agua y pienso para los animales que viven con nosotros en nuestras calles. Muchas personas realizan una ayuda social con los animales dándoles de comer pero no es suficiente.
Animales que en la mayoría de los casos son por el abandono de personas. Somos el primero país europeo en tasas de abandono de animales en España se abandonan unos 300.000 al año, cada 5 minutos se abandona un perro.
Si quieres un Madrid más amigo de los animales vota la iniciativa.</p>
";"07/09/2015 13";"255";"65";"190";"17";"840170472";"-3186"
"79";"Volver a poner las líneas L";"<p>Hace ya casi dos años se suprimió el servicio de autobuses nocturnos denominados L, que hacían el servicio de las líneas de metro y así no se mantenía el servicio abierto de madrugada. </p>

<p>Con la supresión de estas líneas la movilidad nocturna en Madrid es casi nula, con dificultades para volver a los barrios debido a la escasez de autobuses nocturnos. Es cierto que existen los ""N"", pero su frecuencia no es la adecuada y en muchas líneas van tan llenos que no paran a recoger a nadie.</p>

<p>Por favor, vuelvan a poner este servicio que nos hacía la vida más fácil a todos.</p>
";"07/09/2015 13";"937";"838";"99";"23";"871399031";"66091"
"80";"Eliminar la";"<p>Sin perjuicio de otras medidas que se pudieran tomar para garantizar la dignidad de las personas sin hogar, debe eliminarse la arquitectura disuasoria que tiene como objetivo evitar que los sin techo puedan dormir o descansar en determinados sitios, se deben eliminar cosas como las marquesinas de autobús con reposabrazos en el medio...</p>
";"07/09/2015 13";"50";"34";"16";"3";"854404382";"1224"
"81";"Aceptar Abono Mensual en centros deportivos municipales de gestión privada";"<p>Actualmente el Abono de Deporte Mensual que se adquiere en un centro de gestión privada (casi todos los que se han abierto últimamente) es sólo válido en ese centro deportivo. Sin embargo, los bonos adquiridos en centros de gestión pública pueden utilizarse en cualquier otro centro de gestión pública.</p>

<p>El que un centro sea de gestión privada no debería ocasionarnos pérdida de derechos a los ciudadanos, por ello propongo que los abonos y los bonos (por ejemplo el de 10 sesiones) puedan ser utilizados en cualquier centro deportivo municipal.</p>

<p>Yo trabajo cerca de un centro de gestión pública y vivo cerca de uno de gestión pública, lo que me supone que si compro el abono mensual no puedo utilizar los dos.</p>

<p> </p>
";"07/09/2015 13";"98";"82";"16";"7";"861073265";"5522"
"82";"Más Locales de Ensayo Municipales y para Cualquier Ciudadano/a de Madrid";"<p>Los locales de ensayo existentes son únicamente para menores de 35 años. Los viejos rockeros también somos ciudadanos y queremos poder disfrutar de este servicio.</p>

<p>Enlace a la página de inforjoven de madrid.org: http://www.madrid.org/cs/Satellite?cid=1142685756697&amp;pagename=PortalJoven%2FPage%2FJUVE_contenidoFinalMenuIzquierdo</p>

<p>Por favor, habiliten más locales (hay poquísimos para una ciudad con una historia musical tan grande como Madrid) y por favor, que sean para todos.</p>

<p>Aunque a alguien no le pueda parecer así, la música es una afición que se lleva de por vida.</p>
";"07/09/2015 13";"170";"131";"39";"1";"860884893";"7089"
"83";"trabajo digno, transporte adulto barato.";"<p>Creo que la gente joven se merece de una vez empezar una vida adulta en condiciones y en condiciones me refiero a no seguir en casa de los padres a los 30 años.</p>

<p>Hay más trabajo, eso es un hecho, pero se deberían de tomar medidas URGENTES para vigilar muy de cerca esas condiciones laborales.</p>

<p>Me preocupa la resignación que veo ante hechos como que no te dejen ir al baño en horario de trabajo, que no puedas saber nunca tus horarios o esté permitido que alguien cobre 4 euros la hora.</p>

<p>Para ir al trabajo uno necesita de un medio de transporte que a mi ver debe de bajar ya mismo, no puede ser que ahora el joven baje a 20 euros y haya un desfase de 34 euros de diferencia con el adulto, el precio del abono quita un cuarto de un salario que no da para más que vivir muy al día.</p>
";"07/09/2015 13";"92";"75";"17";"2";"860155970";"4728"
"84";"Operación Chamartín: Necesaria";"<p>Buenos días! Como estreno en Gobierno abierto quiero plantear mi visión y opinión sobre la ""operación chamartín"". Como ha dicho muchas veces los miembros del nuevo Ayuntamiento, no hacen falta más viviendas en Madrid. Sin embargo, sí hace falta una operación en la zona norte de Chamartín.</p>

<p>Este área está completamente abandonada, entre M-30 y M-40, relativamente cerca del centro y de zonas importantes como Plaza de Castilla. Desde la estación de Chamartín hasta el nudo de M-40 con la carretera de Colmenar, la dejadez es absoluta.</p>

<ul>
	<li>
<strong>Coche:</strong> Las Tablas ahora mismo es una ratonera, de donde sólo se puede salir en coche por 2 accesos: A1 (colapsada las 25 h del día) y la carretera de Fuencarral a Alcobendas, con una rotonda que debió ser construida en los 80.</li>
	<li>
<strong>Metro:</strong> En cuanto a Metro, sólo hay 1 parada de L10, inútil porque está lejos de muchas partes del barrio, y además conecta con el centro con un transbordo muy agradable. Del metro ligero no vale la pena hablar, porque supone pagar para llegar más tarde a los sitios que a pie.</li>
	<li>
<strong>Cercanías:</strong> Esta es la peor parte. La estación de Fuencarral está geográficamente al lado de las Tablas, pero el acceso es lamentable, tanto a pie como en coche. Estoy hablando de una estación con una línea de Cercanías que comunicaría el barrio con Sol en menos de 20 minutos. Debe ser accesible para peatones y vehículos (bici, coches) desde todas las zonas alrededor. Esto puede ahorrar muchos (muchos) kms en coche innecesarios.</li>
	<li>
<strong>Bici: </strong>Aunque hay carriles bici por las Tablas, el aislamiento con otros barrios sigue ahí. Aislamiento total, cuando se podría llegar a muchas partes fácilmente con la infraestructura adecuada.</li>
	<li>
<strong>Bus:</strong> Los autobuses sólo llegan hasta Plaza de Castilla. Pienso que dado que es una ruta corta, podría pasar por chamartín o nuevos ministerios. No todo el mundo que vive o trabaja en Las Tablas encuentra práctico Plaza de Castilla, y más teniendo tantas estaciones de Cercanías (y AVE) colindantes pero inaccesibles.</li>
</ul>

<p>Por tanto, cuando vi el proyecto de la Op. Chamartín vi cosas positivas, como nuevas estaciones de cercanías, de Metro, y la conexión con parques entre Las Tablas y Montecarmelo. Creo que habría que plantearse si los beneficios de dicho proyecto valen la pena o no. Pero, en cualquier caso, es <u><strong><em>urgente</em></strong></u> una mejora de las comunicaciones de esta zona, que puede seguir creciendo y ya está colapsada.</p>

<p>Espero opiniones :)</p>
";"07/09/2015 13";"158";"88";"70";"16";"853252321";"1002"
"85";"Eliminación de las desorbitadas multas de 600 por alcohol en vía pública";"<p>Propongo la reducción o eliminación de las excesivas multas de 600 por consumo de alcohol en vía pública ya que es desorbitada y claramente es una fuente de recaudación del Ayuntamiento. Así como la imparcialidad de la Policía Municipal para imponer este tipo de multas, fundamentalmente afecta a los jóvenes, con la sabida situación económica en la que se encuentran. No quiero fomentar el uso del llamado ""botellón"" por las consecuencias de ruido que afectan a los vecinos, pero considero vergonzoso que no puedas tomarte una simple cerveza en un parque con tu pareja o amigos con el riesgo de un castigo de 600 para cada uno. Hago recordar, que por reincidencia el monto de la multa asciende a 1200 y la Policía no tiene miramientos en si bebes o no, simplemente con el hecho de estar allí te la llevas y los recursos son en su mayoría denegados, por lo que deberías meterte en un proceso judicial. Se están cargando Madrid y la tradición del disfrute del tiempo de ocio al aire libre.</p>
";"07/09/2015 13";"397";"267";"130";"27";"860339749";"9213"
"86";"Carriles bici con señalización de número de vía como las carreteras";"<p>Estuve en Graz (Austria) y ahí los carriles bici tienen un número y letra, como las carreteras de los coches, de forma que es muy fácil situarse y seguir tu recorrido. Y si te pierdes no hace falta tener mapa ni gps. Por ejemplo, el anillo verde puede ser CB1, que tendrá indicado sus kilómetros. Y las demás vías ciclistas algo que tenga relación con las paradas de metro o carreteras cercanas, por ejemplo. O tipo según la zona, si estas al sur de Madrid S1, al noreste NE5... Para facilitar las referencias.</p>
";"07/09/2015 13";"98";"73";"25";"12";"858549383";"3575"
"87";"Que el Ayuntamiento de Madrid apoye como institución a las mareas ciudadanas.";"<p>Dado que las mareas se están constituyendo como el principal vehículo de energía, ideas y resistencia contra aquellos que tratan de usurpar lo público a toda costa  y dado que la mayoría de los principales hospitales y colegios públicos están en la ciudad de Madrid, sería importantísimo que el ayuntamiento se sumara a esta lucha para conseguir sistemas públicos de calidad y que demuestren su eficiencia, en contraposición a los formulismos liberales que gente demasiado incompetente nos trata de meter cada día, recortando nuestros derechos, nuestros presupuestos, nuestra salud y educación y convirtiendo derechos universales en su pequeño cortijo y mercado, con su mentalidad empresarial obsoleta y fuera de lugar en estos ámbitos. Dado que no se espera una gran respuesta de remunicipalización y recuperación absoluta de la gestión por parte de la Comunidad(que es quien podría solucionar el problema) al menos el ayuntamiento podría brindarnos su apoyo (a los ciudadanos) para conseguir devolver al sistema público lo que nos han robado.</p>

<p> </p>

<p>La sanidad en Madrid está en manos del marido de Cospedal. </p>

<p>Los servicios sociales en manos de Florentino Pérez y las Koplovitz.</p>

<p>La educación en demasiados casos está en manos de la iglesia, cuando debiera ser garante de laicidad.</p>

<p> </p>

<p>Por todo ello, sería un gesto muy importante. ¡Muchas gracias!</p>
";"07/09/2015 13";"97";"47";"50";"2";"843746307";"-145"
"88";"Multar por los excrementos de los perros";"<p>Buenas... Creo que las calles de muchos barrios dan asco, no tanto por la falta de limpieza (que en algunos casos también), sino sobre todo por las personas que no recogen los excrementos de sus perros. Es insufrible ir paseando por la calle, especialmente con niños o con carritos de bebés.</p>

<p>Hablo en concreo del distrito de Latina (Aluche - Águilas - San Ignacio), pero estoy segura de que el problema existe en muchos más distritos. Y está visto que apelar a la educación no funciona. Hay parques y calles que parecen auténticos campos de minas.</p>

<p>Creo que la solución pasa por poner personas que multen a los dueños de los perros, ya que parece ser el único lenguaje que entienden. Esto no sólo solucionaría el problema de lso excrementos, sino que generaría empleo municipal y sería hasta rentable, pues los sueldos de estas personas se pagarían con creces con el dinero recaudado en multas.</p>

<p>Salu2.</p>

<p> </p>
";"07/09/2015 13";"4267";"4031";"236";"421";"879714351";"358510"
"89";"Ladridos de perros";"<p>La ordenanza dice que no se puede molestar a la vecindad con los ladridos de perros. Esto es teoría, pero en la práctica hay que avisar a la policía; cuando llega, no ladra ya el perro- En el mejor de los casos, lo notifican al dueño, quen no hace ni caso, aunque lo prometa. Si a él no le molesta, ¿qué le van a importar los vecinos?.  Además los dejan de guardianes, ladrando, cuando se van, sea por pocas horas o muchas, incluso fines de semana o vacacones...    Solución: recibida denuncia, pregnta a vecinos y si lo confirman sin más, sanción al canto, que rs la única forma que tenemos de cumplir.  Si se repite, se le prohíbe a la totalidad del núcleo familiar que tengan perro, para evitar vayan cambiando titulares de propiedad.</p>
";"07/09/2015 13";"146";"74";"72";"61";"852055555";"101"
"90";"Forzar la Comunidad de Madrid y el Consorcio a mejorar el Metro.";"<p>Sé perfectamente que el Metro es competencia de la Comunidad, pero como no nos escuchan, el Ayuntamiento es la única entidad que puede negociar con ellos.</p>

<p>Madrid necesita trenes más frecuentes, estar en los andenes del Metro <strong>se está volviendo PELIGROSO</strong> por la presencia de multitudes de personas. Que contraten a gente, que inviertan más dinero, <strong>que hagan ALGO</strong>.</p>

<p>Saludos.</p>
";"07/09/2015 13";"373";"330";"43";"16";"867590123";"25391"
"91";"Multas por consumo de alcohol en la vía publica excesivas";"<p>Me gustaria abrir este debate para que el Ayuntamiento de Madrid revise los importes de las multas por consumo de alcohol en la via publica. El anterior ayuntamiento unió y mezcló en una sola ley municipal el botellón y el consumo de alcohol en la via pública.</p>

<p>El importe por consumir una cerveza en la calle ES DE UN MÍNIMO DE 600 y me gustaria que el nuevo ejecutivo municipal revisase estos importes basado en un principio de proporcionalidad. En un pais con un salario mínimo de 647, una multa de 600 por tomar una simple cerveza en la calle es totalmente injusto y desproporcionado para la ciudadanía madrileña. Es inasumible y somos muchos/as los que hemos padecido este abuso institucional.</p>

<p>En ciudadades como Amsterdam donde el salario minimo supera los 1100, estos importes rondan los 60. Madrid es la ciudad de Europa con los importes mas elevados e injustos y me gustaria que estos fueran corregidos ya que los importes son inasumibles por gran parte de la población y demasiado elevados en relación al ""delito"" (que en casos como beber alcohol en la via publica solo afectan al propio consumidor)</p>

<p>Gracias!</p>

<p> </p>
";"07/09/2015 13";"114";"75";"39";"10";"856268331";"2368"
"92";"¿Estaría bien que Madrid se rodeara de un cinturón verde aprovechando la M40?";"<p>Uno de los sumideros de CO2 más potentes y filtro de polucion son los bosques y los arboles. Rodearnos de vegetación autóctona (Bosque Mediterráneo)aprovechando los márgenes y taludes de las autopistas de circunvalación sería una buena manera de contrarrestar las emisiones que se producen en estas vías. Se daría mas calidad ambiental a la ciudad y atenuaria las olas de calor, restauración del paisaje, entre otros beneficios más. </p>
";"07/09/2015 13";"1656";"1572";"84";"45";"875938362";"141252"
"93";"Limpieza en Aluche";"<p>Limpien el barrio de Aluche por favor. Las aceras están llenas de chiles, cacas, pis... etc pegados y hay sitios en los que ya no es higiénico pasar.</p>
";"07/09/2015 13";"57";"52";"5";"3";"861114403";"4287"
"94";"Domingos y festivos";"<p>Hola desde que se puso en vigor abrir centros domingos y festivos la gente trabaja mas y cobra menos y ademas no tiene vida social por favor necesitamos que cierren domingos y festivos o que obliguen a contratar a gente para esos dias sino seguiremos trabajando mas y cobrando menos yo en mi caso solo descanso dos domingos al mes y nada mas y creo que la gente tiene derecho a tener una vida lo mejor posible porfavor pido que hagan algo ya porque esto es inhumano </p>
";"07/09/2015 13";"151";"88";"63";"27";"854651623";"1456"
"95";"Una ""guía del ocio"" para todos";"<p>La revista ""Guía del Ocio"" es un medio estupendo de difusión cultural de todo tipo (cine, teatro, música, danza...), pero donde desgraciadamente no tienen su lugar las pequeñas compañías teatrales (todas aquellas que, por ejemplo, se dedican al ""microteatro""), las salas de cine alternativas... Por eso creo que sería de gran ayuda para estas digamos ""minorías culturales"" una página web creada y/o con el apoyo del Ayuntamiento, que permita acercar estos espacios a todos y dinamizar más los espacios culturales alternativos. En definitiva, hacer que Madrid se mueva más como ciudad cultural, que su oferta en ese sentido esté a la altura de ciudades de todo tipo como Berlín, París o Nueva York.</p>

<p>Finalmente, se trata de una gran oportunidad para las pequeñas compañías teatrales o salas de cine alternativas, por ejemplo, para darse a conocer. Y para el público de disfrutar de ello de una forma más cercana, más accesible a todos los bolsillos y más variada.</p>
";"07/09/2015 13";"49";"29";"20";"4";"851738941";"532"
"97";"LOCALES DE REUNIÓN PARA GRUPO, ASOCIACIONES,CIRCULOS";"<p>Ceser locales mucicipales para reunion de todos los grupo, asociaciones,circulosd etc.</p>
";"07/09/2015 13";"73";"45";"28";"1";"853442890";"1047"
"99";"Municipalización del sector cultural (museos etc.) No más subcontratas";"<p>Somos muchas otras personas que en el marco cultural e institucional de Madrid la externalización de los servicios no es algo</p>

<p>nuevo pero si la precarización de los contratados y lo que esto afecta a la comunidad artística y </p>

<p>cultural en general.</p>

<p>En el 2012 Madrid Destino (MACSA) tenía en Matadero empleados directos entre semana y </p>

<p>subcontratados para el fin de semana a través de la empresa Avanza. Cuando decidió </p>

<p>externalizar por completo el servicio ofrecieron a los empleados directos que se integraran en </p>

<p>la plantilla de la ETT cobrando menos de la mitad. Los dos mediadores de entre semana se </p>

<p>fueron. El salario quedo entonces en unos 800 netos por 35 horas pero se aplicaron rebajas </p>

<p>en los meses sucesivos. Cuando el contrato volvió a salir a concurso y ganó Eulen, bajó aún </p>

<p>más a 677 por 35 horas semanales con pagas extras.</p>

<p>La contratación en nuestro caso es por obra y servicio. Contratadas como Mediadoras</p>

<p>Culturales, pero a nivel formal de contratación como asistente de acompañamiento. Pero la </p>

<p>cosa no queda solo ahí, aun cumpliendo los requisitos mínimos para el puesto que son:</p>

<p>Tener una licenciatura relacionada con el sector artístico (Bellas Artes) e idiomas nivel alto,</p>

<p>nuestro trabajo se reduce a estar en una sala como vigilante. Suena totalmente incongruente, </p>

<p>pero es una realidad. Para el asombro de todos/as, la institución pagaría por cada trabajador/a </p>

<p>unos 10 u 11 por hora, pero a nosotros/as se nos paga 5 brutos la hora.</p>

<p>No es solo un engaño e nivel institucional permitir tal precariedad dentro de su sistema, como </p>

<p>por lo tanto permitir a sabiendas un deterioro del arte y la cultura.</p>

<p>Por un lado se promueven grandes y majestuosos eventos artísticos, con grandes artistas que </p>

<p>atraigan el máximo número posible de visitantes y con ello la gloria de la institución. Y por el </p>

<p>otro se menosprecia a los profesionales de la cultura con sueldos ínfimos y condiciones </p>

<p>laborales de vergüenza.</p>

<p>Esta situación no es de carácter único o que ocurra solo en un museo o en una sala de</p>

<p>exposiciones del ayuntamiento de Madrid, sino que sucede de manera generalizada en todos </p>

<p>los museos e instituciones.</p>

<p>Si echamos un vistazo a las empresas subcontratadas, vemos que en su gran mayoría sería</p>

<p>perteneciente a Eulen, mírese la Fundación Telefónica, Matadero Madrid, Madrid</p>

<p>Centro etc...</p>

<p>Por eso pedimos encarecidamente una revisión de las subcontrataciones, que hacen y</p>

<p>deshacen a su antojo y menoscaban el mundo cultural y artístico. Nos gustaría que se tome en </p>

<p>consideración la importancia de una sociedad cultural y ética con sus propios principios.</p>

<p>Creemos que desde el propio ayuntamiento se pueden gestionar estas contrataciones y las</p>

<p>figuras profesionales del ámbito cultural. Favoreciendo así un sistema equitativo,</p>

<p>profesionalizado, igualitario, y de bien común.</p>

<p>No menoscabemos un sistema que no es solo de vital importancia para la cultura y la</p>

<p>educación ciudadana, tanto como lucrativo.</p>

<p>Aquí nuestra situación actual, por la cual pedimos que se revisen los parámetros de</p>

<p>contratación y se haga de forma directa desde la contratación del propio ayuntamiento,</p>

<p>asegurando un trabajo digno y controlado.</p>

<p>Ajuntamos el enlace del artículo que redacto Elena Voz Mediano para el Cultural sobre la </p>

<p>situación en la que nos encontramos</p>

<p>http://www.elcultural.com/blogs/y-tu-que-lo-veas/2015/03/obra-y-servicio-el-empleo- cultural/</p>

<p>http://www.elcultural.com/blogs/y-tu-que-lo-veas/2015/03/obra-y-servicio-el-empleo- cultural-ii/</p>

<p> </p>
";"07/09/2015 13";"588";"497";"91";"14";"867914874";"34316"
"100";"Accesos peatonales entre Méndez Alvaro, Metales, Los Puertos, Legazpi y Pacífico";"<ul>
	<li>Unir Méndez Alvaro con Pacífico a través del túnel de la Calle Alberche entre los números 6 y 10, para facilitar acceso peatonal al Polideportivo Daoiz y Velarde, Centro de Mayores y Centro de Salud en la Avda Ciudad de Barcelona y al Parque Tierno Galván, Planetario y Estación Sur de Autobuses en Méndez Alvaro. </li>
	<li>Crear un paso peatonal directo en la Avda del Planetario entre los número 10 y 20. para facilitar el acceso a colegios, Centro de Salud, Madrid Río, Matadero, etc. El túnel existente no tiene espacio habilitado para peatones o ciclistas.</li>
</ul>

<p> </p>

<p> </p>
";"07/09/2015 13";"143";"133";"10";"6";"865311644";"11439"
"101";"Taquillas en los Parques Públicos para los que hacen deporte.";"<p>Soy usuario de los parques de Madrid, sobre todo voy mucho al Retiro para correr... pero durante los meses de invierno no puedo hacerlo por el frío. Si existieran taquillas gratuitas de uso público en los parques, muchos de los que realizamos deporte podemos llegar a los parques y dejar en ellas la ropa de abrigo que nos impide correr, montar en bici, patinar etc etc... Si vives muy cerca de uno de estos parques puedes desplazarte sin pasar frío, pero si tienes que andar 20 o 25 minutos como es mi caso para llegar al Retiro, es casi imposible. Estas taquillas favorecerán que más gente pueda hacer deporte en los parques públicos.</p>
";"07/09/2015 13";"156";"56";"100";"9";"839877671";"-1579"
"102";"Diferencia entre botellón y beber en la calle.";"<p>Actualmente beber una simple lata de cerveza en la calle, sin molestar a nadie, te puede costar 600 . En mi opinión esa es una sanción extremadamente desproporcionada, sobre todo teniendo en cuenta que es la misma sanción que se aplica a quienes, durante un botellón, generan ruidos molestos hasta altas horas de la noche, dejan todo lleno de basura y en ocasiones hasta rompen mobiliario urbano. Obviamente estoy completamente a favor de sancionar esta segunda actitud, pero me parece una grave injusticia castigar la primera.</p>

<p>Beber no implica necesariamente emborracharse, un grupo de amigos puede perfectamente reunirse en un parque para disfrutar del aire libre, charlar y tomar algo sin que ello implique realizar ninguna conducta incívica. Como dice el refrán: tu libertad termina donde empieza la de los demás.</p>

<p>Hasta hace un par de años, cuando la policía nos encontraba bebiendo en el parque, nos identificaban y nos decían que si a la mañana siguiente había basura en el parque nos multarían. Y si ese día la reunión era más numerosa (y por tanto más ruidosa) de lo habitual, nos aconsejaban bajar el volumen y no provocar a los vecinos, porque si éstos volvían a quejarse, nos multarían también por el ruido. Este procedimiento me parece fantástico, porque defiende el derecho de los vecinos a descansar y a tener unos espacios públicos limpios, a la vez que defiende también el derecho a divertirse en cualquier sitio, siempre y cuando se haga con respeto a los demás.</p>

<p>Gracias por leer y por opinar.</p>
";"07/09/2015 14";"2102";"1762";"340";"135";"872398818";"119199"
"103";"Que las calles y plazas de Madrid vuelvan a tener bancos y fuentes,";"<p>En los últimos años, el espacio público ha sido enajenado de la ciudanía, en parte gracias la urbanismos que se ha llevado a cabo en nuestra ciuadad. Así pues, grandes plazas como la Plaza de Callao, seha tornado en lugaes de paso, sin bancos donde sentarse ni hacer vida, más allá que la propuesta por las iniciativas privadas, a las que se les cede constantemente el espacio público.</p>

<p>Donde antes había bancos para sentarse y pasar la tarde, ahora hay invasivas terrazas de bares. Cuando antes alguien tenía sed, había fuentes en las que beber el agua de esta ciudad. Ahora solo queda sentarse y pedir. En el caso de baños públicos, casi nunca tuvieron presencia en la ciudad, algo que se torna necesario, ya que la ciudadanía no puede hacer depender sus necesidades en el espacio público (beber, pasear,, descansar,..) únicamente de la inciativa privada. </p>

<p> </p>

<p> </p>
";"07/09/2015 14";"2512";"2379";"133";"37";"877605962";"212708"
"104";"Voluntariado callejero";"<p>Aprovechemos que hay personas, sobre todo mayores, paseanado nuestrascalles y démosles la oprtunidad de distraerse siendo útiles a la sociedad. ünicamente haría falta de dotarles de un cuaderno y un lápiz, o una dirección de página web, para que notificasen deficiencias que observen, para conocimiento rápido y pronta subsanación, que en algunos casos ahorrarían esfuerzo y dinero.</p>

<p> </p>
";"07/09/2015 14";"48";"32";"16";"8";"854286751";"1066"
"105";"Campañas de información cívica";"<p>¿Cuánto hace que no vemos una campaña institucional en condiciones para mejorar la convivencia? ¿Os acordáis del cartel de silencio en los centros de salud, del ""póntelo, pónselo"" para prevenir el SIDA o de las campañas para no arrojar papeles al suelo? </p>

<p>Nos guste o no, las instituciones deben formarnos en civismo porque, además de las deficiencias en los servicios que venimos padeciendo (limpieza, transporte y demás), existe una gran falta de educación, así en general, en la ciudadanía.</p>

<p>El Ayuntamiento de Madrid ya dispone de cientos de normativas que establecen las reglas de convivencia entre los ciudadanos: no se pueden arrojar papeles al suelo, no se pueden generar ruidos molestos, hay que respetar los límites de velocidad, no se puede aparcar en las aceras, las bicis deben ir por la calzada, etc., etc, pero de nada sirven estas normas  si no se informa al ciudadano de su existencia, si no se le educa en los valores de respeto hacia los demás, si no nos hacen ver que todo es de todos y que es nuestra obligación observar y mantener los mínimos niveles de convivencia.</p>

<p>Las campañas de información resultan mucho más económicas y, sobre todo, muchísimo más efectivas que cualquier otra medida, incluidas las multas y sanciones, y el Ayuntamiento dispone de esa capacidad para divulgar el civismo a través de varias plataformas: MUPIs, paneles de tráfico, redes sociales, medios de transporte, etc, etc.</p>
";"07/09/2015 14";"117";"101";"16";"6";"862601200";"7337"
"106";"Parkings Gratuitos en la frontera de la Zona A";"<p>Existe una práctica para gente que vive fuera de Madrid y que ha de trabajar en la capital, que es la de venirse en coche pero dejarlo aparcado en algún punto de la periferia donde se ubique una estación de metro o de autobus de Zona A. De esta manera dicha gente evita entrar en la ciudad con el coche, evita tener que gastar dinero con el sistema de parquímetros, y además adquiere sólo el abono transportes de Zona A y no uno superior.</p>

<p>La idea sería intentar habilitar más zonas de parking gratuito del ayuntamiento, ya en el interior de Zona A pero más cerca de la periferia, cercanas a estaciones o paradas clave y a radiales de entrada a Madrid, para que la gente deje los coches allí. Quizá esta medida conjugada con otras soluciones del estilo compartir coche para subir y bajar de Madrid, o el carril VAO, permitan facilitar la movilidad de la ciudad.</p>
";"07/09/2015 14";"79";"62";"17";"5";"858962087";"3531"
"107";"Torre de purificación del aire de Madrid en la futura Operación Chamartín";"<p>En lo relativo a la operación Chamartín, quería sugerir que el futuro proyecto contemple la incorporación de un sistema torre de purificación del aire de la ciudad. Para ello se puede aprovechar su ubicación en lo alto de la ciudad  y su conexión por túneles de metro (Líneas 1, 9 y 10) con toda la ciudad para construir una chimenea que succione la contaminación de la ciudad a través de su sistema de túneles. En el futuro Chamartín se ubicaría una torre chimenea con capacidad para separar y tratar los gases nocivos como ya se hace en industrias contaminantes o con el empleo del Dióxido de Titanio, TiO2.  </p>

<p>Una ciudad produce residuos sólidos, líquidos y gaseosos, pero sólo tratamos lo dos primeros. Seamos pioneros en la gestión integral de todos los residuos urbanos y aprovechemos esta oportunidad incluso para crear un centro de investigación que estudie y optimice el proyecto para en un futuro probarlo en otras ciudades. El sistema Madrid.</p>

<p>La torre se podría camuflar como un jardín vertical o fachada vegetal y quedaría integrada en una zona que cuenta ya con los edificios más altos de la ciudad. </p>

<p>Las bocas de metro y respiraderos funcionarían como sumideros de la polución atmósférica por toda la ciudad y los túneles como tuberías que lleven el aire contaminado hasta la chimenea para su tratamiento.</p>

<p>Paralelamente la torre podría funcionar como Torre Solar (central eléctrica) al instalar una turbina accionada por el efecto chimenea creado por la diferencia de alturas, el calor que se disipa en la ciudad y la geotermia del suburbano.</p>

<p> </p>

<p> </p>

<p> </p>
";"07/09/2015 14";"121";"101";"20";"8";"861932625";"6761"
"108";"Clubes Cannábicos: Regulación y legislación apropiada en común y contra la mafia";"<p>Son muchos los países que han decidido cambiar el rumbo y poner en marcha estrategias nuevas con el fin de luchar contra el mercado negro del cannabis y, de paso, sacar provecho de un negocio sumamente rentable. Además, la lucha de las instituciones contra el tráfico y consumo de cannabis siempre ha estado vinculada a la prohibición y a las multas. Pero la tendencia está cambiando y es posible regular el uso y la producción cannábica a fin de normalizar un mercado enorme y rentable.</p>

<p>Regulación respetando específicidades, tales como estas o las que se determinen:</p>

<ul>
	<li>Se puede vender un máximo de gramos por persona;</li>
	<li>Las existencias no pueden exceder un determinado número de gramos;</li>
	<li>Los clubes no pueden causar molestias;</li>
	<li>No se pueden vender drogas duras;</li>
	<li>No se pueden vender drogas blandas a los menores;</li>
	<li>Los clubes no pueden publicitar las drogas blandas.</li>
</ul>

<p>Las autoridades locales tienen la libertad de modificar el presente reglamento, a su discreción, y los clubes que violen dichas regulaciones se cierran temporalmente. Las infracciones repetidas pueden terminar con el cierre permanente.</p>
";"07/09/2015 14";"191";"120";"71";"4";"856589057";"3078"
"109";"Creación de ayudas al alquiler impulsadas por el Ayuntamiento de Madrid";"<p>El acceso a una vivienda es algo básico recogido en la CE como todos sabemos. Si bien eso no significa que todo el mundo deba de tener una casa en propiedad si que es importante que las Administraciones hagan lo posible por tener políticas activas para facilitar el acceso a la vivienda.</p>

<p>Las ayudas al alquiler para todo el Estado aprobadas en 2013 mediante el <strong>Plan Estatal de fomento del alquiler de viviendas 2013-2016, </strong>se han demostrado insuficientes. En la Comunidad de Madrid la mayor parte de los solicitantes han quedado fuera de estas ayudas a pesar de cumplir los requisitos. No parece importar tampoco las<em> </em><strong>Numerosas quejas de ciudadanos</strong> que no han podido acceder a estas ""claramente insuficientes"" subvenciones.</p>

<p>Sería interesante que desde el Ayuntamiento se valorara la posibilidad de crear una línea de ayudas al alquiler exclusivamente para la ciudad de Madrid que amplíe los requisitos para que pueda acceder más gente que lo necesita y que se queda sistemáticamente fuera de estas ayudas por uno u otro motivo.</p>

<p> </p>
";"07/09/2015 14";"207";"173";"34";"5";"863856056";"11616"
"110";"Terminar el parque de La Gavia en el ensanche de vallecas";"<p>Los vecinos de Villa de Vallecas/ Ensanche de Vallecas queremos que se finalize el proyecto abandonado del parque de la gavia, ya que lleva parado 8 años con el parque a medio hacer, sin funcionar el rio artificial, los arboles y vegetaciones secos ( produciendose incendios todos los veranos ) ya que se nos prometio que seria un pulmon verde de Madrid.</p>
";"07/09/2015 14";"337";"309";"28";"25";"868475285";"25765"
"111";"Abono tercera edad 60 años";"<p>Bajar el abono de tercera edad de 65 a 60 .Yo creo que con 60 años ya es una edad para que te dejen el abono de tercera edad,</p>
";"07/09/2015 14";"121";"56";"65";"4";"841673302";"-416"
"112";"Farolas con paneles solares.";"<p>Reemplazar las farolas cuando se rompan por farolas con paneles solares. Eso reduciria mucho el coste en electricidad y es eficiente y respeta el medio ambiente. deberian estar protegidas.</p>
";"07/09/2015 14";"1693";"1534";"159";"42";"874413038";"124586"
"114";"Zonas del SER";"<p>Sería posible que se eliminarán las zonas verdes del SER para que los residentes podamos aparcar en cualquier plaza de nuestra zona. En otras ciudades y países no existen este tipo de plazas. En mi barrio solo disponemos de unas 50 plazas para tres calles. Sin embargo hay muchas plazas azules en las cuales no podemos aparcar.</p>
";"07/09/2015 14";"68";"55";"13";"4";"859195234";"3397"
"115";"Monumento a ROTO2 en la puerta del Sol";"<p>Los madrileños queremos un monumento distintivo. Algo como la Torre Eifel, la Estatua de la Libertad, El Big Ben......</p>

<p>Queremos una estatua del famoso ROTO2 de forocoches. La imagen es esta: http://fc01.deviantart.net/fs38/f/2008/351/6/5/Roto2_in_black_by_Tavinchi.jpg</p>

<p>ROTO2 merece estar en lo mas alto del pais. Estamos dispuestos a conseguirlo. Somos 659.348 personas que veneran a ROTO2</p>

<p>¡POR LA GLORIA DE ROTO2!</p>
";"07/09/2015 14";"1720";"967";"753";"373";"860268377";"12031"
"116";"No a los beer Bike o tándem de borrachos por las calles de Madrid.";"<p>Desde hace algún tiempo vengo observando por la zona de Atocha los llamados beer Bike unos tándems para 16 personas que se alquilan y que circulan por la calzada a pedales. La diversión consiste en que los usuarios vayan pedaleando mientras vacían un barril de cerveza. Desconozco si hay una normativa específica para estos vehículos pero creo que no debería de estar permitido que personas totalmente borrachas vayan pedaleando en un carrito que circula por la calzada muchas veces sacando medio cuerpo fuera, arrojando objetos, gritando, enseñando el torsoetc.</p>

<p>La empresa lo promociona cómo una manera diferente para ir en grupo y echarte unas risas pero en mi opinión se trata de dos acciones; conducir y emborracharse que por su peligrosidad no deberían darse juntas y que ponen en peligro la seguridad vial de todos. Además de lo lamentable que resulta el paisaje urbano que ofrecen.</p>
";"07/09/2015 14";"727";"587";"140";"23";"867456999";"36092"
"117";"Asesoramiento y fomento del cooperativismo de barrio.";"<p>El Ayuntamiento de Madrid debería liderar un proyecto para la formación de cooperativas que dieran empleo a los parados de los barrios, sobre todo en los distritos más castigados de la periferia.</p>

<p>Este proyecto velaría por la formación, asesoramiento y herramientas necesarias para que la gente en los barrios se organize formando sus propias cooperativas.</p>

<p>Se debirían también ceder a estas cooperativas, dentro de lo posible, tareas municipales que se realizan en cada zona, y que suelen estar externalizadas a grandes empresas, por ejemplo, limpieza (calles, colegios, centros municipales, etc.), jardinería, obras de remodelación, rehabilitación de edificios y muchas otras actividades que los propios vecinos sabrían determinar.</p>

<p>La idea es que las tareas cercanas las realice la gente del barrio y que esto genere ese empleo de calidad que tanto se necesita, con el valor añadido de que si tu trabajas por y para tu barrio la calidad de los trabajos siempre será mejor.</p>
";"07/09/2015 14";"97";"87";"10";"4";"862980029";"6906"
"118";"Limitar las terrazas en la vía pública";"<p>Cada vez hay una mayor parte de la superficie pública ocupada con terrazas de bares, contribuyendo por tanto a la privatización del espacio público. Vivo en el centro y allí es especialmente llamativo (Plazas de Jacinto Benavente, Tirso de Molina, Cascorro...).</p>

<p>Propongo que se limiten y se devuelva el espacio público a los ciudadanos, en vez de multar a aquellos que se toman la cerveza en un banco para que los bares y las cafeterías puedan hacer su agosto a costa de nuestros bolsillos.</p>
";"07/09/2015 14";"214";"169";"45";"12";"862659838";"9792"
"119";"Eliminar Zonas de Aparcamiento SER";"<p>Creo que se debería eliminar este tipo de aparcamiento. Desde mi punto de vista, es tan caro, que limita que se acuda a determinadas zonas a consumir y comprar. Y por otro lado no es práctico: Pagar por adelantado es rídiculo y tener que salir corriendo de la consulta del médico,... a pagar por más tiempo lo es aún más.</p>
";"07/09/2015 14";"111";"49";"62";"6";"841229217";"-573"
"120";"auditoria profunda del ayto en la etapa previa a Carmena";"<p>creo es necesario auditar cuentas y contratos, de todos los años previos a la entrada del nuevo equipo de Carmena en el ayuntamiento de Madrid.</p>

<p>Sobre todo los de la etapa de Gallardon y Botella</p>

<p> </p>
";"07/09/2015 14";"952";"806";"146";"16";"869933067";"55878"
"121";"Problemas de convivencia vecinal por el parque canino de Ciudad Lineal";"<p>Soy una vecina del Distrito de Ciudad Lineal.  En el distrito hay un solar vacío y vallado por el Ayuntamiento que se ha habilitado como parque canino, entiendo que con el permiso de uso del Ayuntamiento.La presencia de perros en el citado parque desde la mañana temprano hasta altas horas de la noche, sobre todo en verano y los fines de semana, está alterando la convivencia en el barrio. Los vecinos de las calles cercanas al solar tenemos que soportar ruidos de ladridos permanentes. En ocasiones, dependiendo de la hora, se pueden llegar a juntar más de 20 perros. El problema se agudiza con el buen tiempo o en verano, ya que con las ventanas abiertas las molestias son muchos mayores. Los propietarios de los perros los sacan a pasear desde las 7 de la mañana hasta pasadas las 12 de la noche, alterando el descanso de los vecinos. Algunos vecinos han recriminado a los dueños de los perros el que no hicieran lo posible para que no ladraran o ladraran menos. A raíz de estas recriminaciones siempre hay discusiones subidas de tono, con gritos, amenazas e insultos, entre los vecinos de las casas que dan al solar y los dueños de los perros, con el consiguiente deterioro de la relaciones vecinales. En algunas ocasiones se ha tenido que dar aviso a la Policía Municipal. Este panorama día tras día está irritando profundamente a los vecinos que vivimos junto a este solar. No podemos estar tranquilamente en nuestras propias casas, sin la molestia permanente de los ladridos de los perros. Los vecinos de las casas colidantes reclamamos una solución al Ayuntamiento, que revoque el permiso de uso del solar como parque canino, que lo traslade a otro sitio que no esté rodeado de viviendas, o cualquier otra solución que estime pertinente, que nos permita a los vecinos de esa zona estar tranquilamente en nuestras casas, sin las molestias del ruido continuo que ocasiona la presencia de perros todo el día y todos los días en ese solar. Muchas gracias.</p>
";"07/09/2015 14";"54";"29";"25";"68";"853884186";"214"
"122";"Ayuda a refugiados.";"<p>Hace poco leí una entrevista en la revsta virtual VICE. La revista entrevistaba a dos chavales alemanes que, preocupados por la situación de los refugiados, habían creado una página web.</p>

<p>El suceso es el siguiente: los chavales sabían de buena mano que a los refugiados se les tenía un poco apartados de la urbe y que poseían de un baño para unas 100 personas, etc. No obstante, hay gente solidaria que ofrecen sus casas para que familias o personas se refugien en ellas. La idea de los chavales fue crear una página web la cual pusiera en contacto a las familias que ofrecen hogar con las familias de los refugiados, una especie de red de puesta en común.</p>

<p>Mi idea es simple, hacer lo mismo cuando empiezen a venir aquí, pero no tengo abslutamente un duro para poder permitirmelo,son páginas sin ánimo de lucro. Invito a que quien lo tenga lo impulse o directamente el Ayuntamiento de Madrid me lo financie y yo pudiera llevarlo a cabo. Un saludo y muchas gracias</p>
";"07/09/2015 14";"85";"53";"32";"3";"854395426";"1309"
"123";"BiciMad en los barrios";"<p>El servicio de BiciMad solventa muchos de los traslados cortos que los madrileños tenemos que hacer día a día. Moverse por el centro, dar una vuelta por El Retiro, atender algun recado... suelen ser los usos mayoritarios. Pero ¿por qué no darle prioridad a este servicio y que se convierta en la forma de viajar al trabajo? Por este motivo, pedimos que se instalen los totems y puntos de anclaje en las cercanías de las principales paradas de Metro de los barrios periféricos de la capital (Carabanchel, Vallecas, Villaverde, Usera), lo que facilitaría el transporte a muchos ciudadanos.</p>
";"07/09/2015 14";"777";"708";"69";"37";"871677349";"58225"
"124";"Replantear o eliminar las sanciones por consumo de alcohol en la vía Pública";"<p>Considero que es necesario abrir este debate, debido a la injusta y desproporcionada aplicación de la Ley 5/2002, de 27 de junio sobre Drogodependencias y otros trastornos adictivos, modificada por Ley 2/2012, de 12 de junio, en su art. 30.3, señala: No se permitirá la venta ni el <em>consumo de bebidas alcohólicas en la vía pública.... </em>El importe sancionador es de 600 euros, lo cual desde un principio es desproporcionado, aun si se está infringiendo la ley que se ha comentado con anterioridad. Me gustaría recalcar, que actualmente se ha venido sancionando incluso a personas que no estaban consumiendo alcohol. Es decir, personas que se encontraban manteniendo una conversación tranquila en la vía pública, de manera respuestuosa cuyo único 'mal' es que una de ellas portara una bolsa con bebida alcohólica debidamente cerrada. Aunque no estés bebiendo y únicamente una de las personas porte alguna bebida alcohólica cerrada en una bolsa (por ejemplo para llevársela después a casa u otro lugar), te sancionan con el importe de 600 euros. Sin ningún tipo de prueba, más allá de la percepción de la Policía Municial (quién se encarga de vigilar el cumplimiento de esta ley), por lo que la indefensión del ciudadano es enorme y la impotencia es aún mayor.</p>

<p>Por ello, debería reflexionarse sobre el fin de ésta ley: si se quiere acabar con el Botellón o bien si se quiere tener un afán recaudatorio por parte del Ayuntamiento, aunque no se esté bebiendo..</p>

<p>Si no se eliminan este tipo de sanciones, injustas y desproporcionadas, al menos que se haga un replanteamiento de la aplicación de dicha ley o se reduzcan considerablemente los importes, estableciendo una serie de pruebas que lo justifiquen y no sólo sea la percepción del Policia Municial. Por ejemplo, propongo que sí se sea estricto con aquellas personas que dejen residuos en la vía pública, sean por botellón o por consumo de otras bebidas que no tengan graduación alcohólica.</p>

<p>Gracias y un saludo!</p>

<p> </p>
";"07/09/2015 14";"157";"102";"55";"12";"857139467";"3053"
"125";"Enfrentamientos entre borrachos e insalubridad en Tirso de Molina los domingos";"<p>Cada mañana de los domingos, ponemos un puesto en esta plaza. Tenemos que aguantar los olores a orina, también las peleas entre borrachos y otros más, ante la inactividad de la Policia Municipal.</p>

<p>Para evitar todo esto propongo:</p>

<p>Olores a orina: El Ayuntamiento de Donostia-San Sebastian han colocado baños publicos que se auto-limpian y se abren automáticamente a los 10 minutos (Para evitar malos usos).</p>

<p>Enfrentamientos: Que el ayuntamiento ponga un servicio de ayuda al alcohólico (si no lo hay aún) y que la policía los derive a dicho servicio, en vez de poner multas que de nada sirven.</p>

<p>Saludos</p>
";"07/09/2015 14";"100";"94";"6";"5";"864421849";"8272"
"126";"Que cada comerciante de El Rastro recoja su propia basura ";"<p>Si habéis pasado por El Rastro a partir de las 2pm vereis una escena digna de los peores vertederos ilegales. Mierda (porque no tiene otro nombre) por doquier, comerciantes que aprovechan para deshacerse de cajas, bolsas, cartones y mercancía que no han conseguido vender.</p>

<p>Algo tan sencillo como poner contenedores al comienzo del rastro, y retirarlos a su finalización, así como proveer a los comerciantes de bolsas adecuadas, junto con la multa de turno si no cumplen, permitiría al barrio convivir de una forma más afectuosa (y salubre) con El Rastro, así como ahorrarle al Ayuntamiento una gran suma de dinero por no tener que dedicar en exclusiva a tal cantidad de barrenderos durante un día completo festivo.</p>

<p>No es guarro el que quiere, sino el que no sabe como hacerlo mejor.</p>

<p>Saludos</p>
";"07/09/2015 14";"1738";"1671";"67";"23";"876921178";"154216"
"127";"Transporte Público Gratuito";"<p>Si el transporte público fuera gratuito, se dejarían de usar los coches particulares y se reduciría enormemente la contaminación, con el lógico impacto en un gran beneficio en la salud pública. Se reduciría igualmente el problema de aparcamientos y atascos.</p>
";"07/09/2015 14";"218";"69";"149";"22";"839889829";"-2532"
"128";"Frenar la gentrificación en Lavapiés y otros barrios del Centro";"<p>Frenar la gentrificación que está sufriendo Lavapiés y otros barrios del Centro de Madrid. Por gentrificación se entiende los procesos de transformación de un barrio, en los que por implantación de nuevos usos sociales y económicos, la población de ese barrio se ve desplazada por no poder hacer frente a los costes de la vivienda, convirtiéndose en zonas homogeneas en cuanto a su composición social, con habitantes de mayor poder adquisitivo, y en muchos casos puros escaparates para el turismo.

Las medidas deberían abordar muchos frentes, pero solo apuntaré tres:</p>

<ul>
	<li>Limitación y freno de las instalaciones que solo dan servicio al turismo, evitando su concentración.</li>
	<li>Regulación de los locales de ocio, especialmente los nocturnos, evitando su concentración y disminuyendo considerablemente la ocupación del espacio público por usos privados (terrezas)</li>
	<li>Puesta en marcha de planes de vivienda que garanticen la posibilidad de acceder al alquiler a los vecinos de menos recursos, evitando así su expulsión.</li>
</ul>

<p>Para el estudio y desarrollo de estas u otras propuestas que consigan evitar la muerte de los barrios, deberían ponerse en marcha mesas de trabajo con la participación directa de los vecinos, los agentes interesados y la administración, cuyos resultados y conclusiones serían vinculantes, siempre que se adecuen a la normativa y presupuesto municipal, y teniendo en cuenta la solidaridad territorial.</p>
";"07/09/2015 14";"137";"100";"37";"31";"859737685";"4598"
"129";"Recuperar el ABONO ANUAL DE USO LIBRE con precios justos para todas";"<p>Fui usuaria de abono anual de uso libre durante el 2010, 2011, 2012. <u>el precio rondaba los 250-270 euros al año aproximadamente</u>. Necesito hacer natación por problemas de salud. pero desde el 2013 ya no puedo permitirme pagar las abusivas cuotas que tienen para unas instalaciones supuestamente publicas.</p>

<p>-A partir del 2013 el abono de uso anual subio mas de 60 euros pasando los 300 y pico, y en el 2014 y 2015 quitaron el abono anual y pusieron solo el mensual que a mi me costaria la friolera de:<u> Adulto (de 21 a 64 años): 47,45 euros, mas Cuota de inscripción Abono Deporte Madrid: 8,10 euros, eso supone al año <strong>577, 50 EUR!!!!!!</strong> </u>es mucho mas de la mitad que yo pague en el 2010, 2011 y 2012. La hipocresia y cinismo del ayuntamiento promocionando las olimpiadas en Madrid y gastandose lo que no es suyo en eventos y viajes, cuando ponen inaccesible el uso de polideportivos a tanta gente como yo que lo necesitan por problemas de salud.</p>

<p>-Ademas pagar esa cantidad para usar unas <strong>instalaciones que cada vez estan peor cuidadas y mas masificadas</strong> (en concreto la piscina de daoiz y velarde). -Todo el mundo tiene menos poder adquisitivo, por no decir los que no tenemos trabajo, y nos duplican el precio de los polideportivos</p>

<p>. -Solicito que vuelvan a poner el abono de uso anual con un precio razonable como al menos estaba en el 2010, o incluso mas bajo para gente que necesitamos por prescripción medica hacer deporte o desempleados</p>

<p>. -Solicito abrir nuevos polideportivos publicos para que en centro no esten tan masificados. CON PRECIOS PUBLICOS POR Y PARA TODOS!!!</p>

<p>-La situción actual me parece completamente injusta y de una hipocresia total llegando incluso a promocionar los nuevos abonos como low cost en la misma pagina del ayuntamiento: <u>http://www.madrid.es/UnidadesDescentralizadas/Deportes/Descriptivos/ficheros/folletodeportemadrid.pdf</u>, hay que tener muy poca vergüenza para publicar esta informacion como si fuera un chollo para el ciudadano cuando es un robo!!. O este articulo del ABC (diario del regimen que bajo pago de sobre sospecho), promociona las maravillas del abono low cost: <u>http://www.abc.es/madrid/20140209/abcp-abono-deportes-cost-abarata-20140206.html</u> -Estas publicaciones a mi parecer serian incluso <strong>denunciables por informacion engañosa</strong> y por reirse en la cara del ciudadano.</p>

<p>-URGENTE: revisen y rebajen las tarifas de los polideportivos publicos URGENTE y mejoren las instalacciones.</p>

<p>-necesitamos TODAS Y TODOS acceso al deporte de manera igualitaria.</p>
";"07/09/2015 14";"114";"102";"12";"8";"863674008";"8052"
"130";"Participacionismo frente al acto de gobernar";"<p>Esta web de debates me hace pensar que el actual gobierno municipal llegó al poder sin propuestas concretas y las pretende suplir con lo que piden algunos ciudadanos que nos metemos en estos portales.</p>

<p>Por otro lado parece que los antiguos gestories del ayuntamiento lo han hecho muy bien porque los nuevos no encuentran muchos problemas importantes para solucionar y están esperando a que ""la calle"" les haga ver en qué asuntos se tienen que poner manos a la obra.</p>

<p>Madrid no está tan mal después de todo. </p>
";"07/09/2015 14";"77";"15";"62";"12";"842479462";"-915"
"131";"Prolongar el Carril Bici de General Ricardos hasta Madrid Rio";"<p>El carril Bici que va desde la Avenida de los Poblados por General Ricardos se interrumpe al llegar a la Plaza de Oporto, me gustaria proponeros que este carril bici continuara hasta Madrid Rio, de esta forma: </p>

<ul>
	<li>Tendríamos un carril bici que discurre por una de las arterias más importantes de Carabanchel, uniendo  Carabanchel Alto y Bajo con el centro de la ciudad </li>
	<li>Al unirlo con con Madrid Rio, posibilitamos que este actúe como una M-30 Ciclista y permita enlazar con el resto de avenidas que tienen carril bici, hacia el centro de Madrid o hacia los distintos barrios</li>
	<li>Permite que las personas de Carabanchel que quieran ir a Madrid Rio a disfrutar de la bici, puedan acceder mediante un carril bici seguro y continuo</li>
</ul>

<p>Muchas gracias por vuestra atención </p>
";"07/09/2015 14";"182";"151";"31";"10";"863453790";"9956"
"132";"Humanizar el tiempo de los semáforos";"<p>Madrid sigue siendo una ciudad diseñada por y para el coche, y esto se hace más evidente sin cabe en las intersecciones reguladas por semáforos. Vemos una y otra vez en diferentes calles de Madrid como los coches disponen de ciclos semafóricos privilegiados, mientras decenas de peatones nos acumulamos en los pasos y debemos esperar a veces más de dos minutos a que el semáforo se nos encienda para cruzar.Además ese tiempo a veces es tan corto que personas con movilidad reducidas o ancianos terminen de cruzar cuando el semáforo ya está en rojo. Propongo una revisión al alza del tiempo de cruce para peatones en todas las calles, o cuanto menos una revisión exhaustiva de los casos más significativos. También habría que plantearse que en los cruces menos transitados se pase a un sistema de semáforo en ámbar intermitente para los coches que permita cruzar a los peatones en cualquier momento.</p>
";"07/09/2015 14";"269";"223";"46";"15";"864844976";"14673"
"133";"Accesibilidad viviendas en Madrid";"<p>En Madrid aun hay barrios con edificios muy antigüos en los cuales no hay accesibilidad para personas con movilidad reducida, personas mayores, personas con niños que necesitan carros, etc... sigue habiendo ""quintos sin ascensor"", escaleras en los portales sin sistemas de elevación Cuando pasan la I.T.E aun no se obliga a instalarlos, aun a sabiendas que hay una ley que lo dicta.</p>

<p>Se cayeron todas las ayudas que habia en este sentido.</p>

<p>Pienso que es un derecho fundamental que las personas en general puedan tener una calidad de vida acorde a los tiempos en los que estamos.  </p>
";"07/09/2015 14";"62";"54";"8";"3";"860661971";"4006"
"134";"EDUCACIÓN EN LA NUEVA ERA DE LA INFORMACIÓN, Inteligencia Emocional";"<p>Hoy más que nunca necesitamos entender que estamos en una nueva era, ya se acabó la era industrial, hoy vivimos en la nueva era de la Información  (o tambien se está empezando a conocer como la era de la Influencia, del ""like"") hoy el conocimiento de manejo de las emociones, liderazgo pro-activo, propositivo, el desarrollo del las habilidades en PNL para una comunicación asertiva... hoy es necesario entender todos estos términos y saber como abordarlos y cómo poderlos enseñar en:</p>

<ol>
	<li>Colegios</li>
	<li>Universidades</li>
	<li>Profesorado</li>
	<li>Puestos directivos (ya no existen los Jefes ahora son los Líderes los que ocupan el escenario productivo)</li>
	<li>Funcionarios en General</li>
</ol>

<p>En Madrid, (y en España en General) está muy rezagado en el dominio de todas estas habilidades que son fundamentales para el desarrollo de la persona, si el Ayuntamiento cede un espacio, un aula yo me ofrezco sin coste a dar cursos sobre el tema. Saludos.</p>
";"07/09/2015 14";"48";"29";"19";"0";"852154509";"604"
"135";"Baños portatiles en zonas de copas";"<p>Algo tan sencillo como baños portatiles de los que la gente hace sus necesidades de pie (como en los festivales de musica), como tienen en Amsterdam o Donosti, permitiria a la gente aliviar sus necesidades sin molestar a los vecinos, que me consta sufren en silencio el asco de despertarse con un intenso y penetrante olor a pis.</p>
";"07/09/2015 14";"463";"339";"124";"21";"863310414";"15741"
"136";"Policia de barrio";"<p>¿Por qué no volver a las patrullas de agentes de a pie por los barris?</p>
";"07/09/2015 14";"98";"84";"14";"2";"861979358";"6000"
"137";"Recuperar la noche madrileña";"<p>Desde hace mucho tiempo no se ha hecho más que atentar con la noche madrileña, haciendo de Madrid una ciudad cada vez más gris y atentando contra un sector economico y cultural.</p>

<p>Permitamos horarios más laxos y terminemos con la cultura de multar para recaudar.</p>

<p>No tiene sentido las multas a los bares por lo que hacen los usuarios en las calles, ni tampoco que se criminalice a los establecimientos por superar límites de aforo complementamente absurdos.</p>
";"07/09/2015 14";"162";"115";"47";"10";"859310784";"4827"
"138";"Sensores de aparcamiento en zona centro para reducir contaminación";"<p>Sería fantástico plantearse un sistema de sensores de parking conectada con una aplicación como en los centros comerciales para saber las plazas de aparcamiento libres en las zonas más contaminadas. Sería maravilloso aparcar en menos de 10 minutos en el centro y no tardar 1 hora de reloj (siendo residente). Por otra parte creo que se debería hacer el SER urgentemente en las zonas de centro, incluyendo la latina pero urgentemente en universidad y moncloa. <strong>NO SABEMOS LO QUE RESPIRAMOS!</strong></p>
";"07/09/2015 14";"48";"33";"15";"3";"854915980";"1237"
"139";"Tarjeta monedero para Metro, EMT, Renfe etc ...";"<p>Es algo que ya se hace en otras ciudades de Europa y del mundo y es que utilizando la tecnología NFC o la ya presente en los abonos mensuales, se creasen unas tarjeta monedero en las cuales, los usuarios pudieran meter una cantidad de dinero y cada vez que cogiesen el metro, bus, renfe,... se descontará el precio del viaje. Esto permitiría dejar atrás los billetes de papel, con el consiguiente beneficio ecológico, y las molestias que estos causan (desmagnetización, roturas, perdidas por su reducido tamaño,...). Y al final, si se quiere recuperar el dinero de la tarjeta, bastaría con acercarse a un puesto donde actualmente se puedan adquirir los billetes para recuperar el dinero restante en la tarjeta. Este último aspecto, haría a la ciudad más amigable para el turista que no tendría que volverse con viajes sin usar. También con este sistema, se podrian plantear otras posibilidades como pago con tarjeta de crédito/débito, pago con teléfono movil con tecnología NFC,... </p>

<p>Espero que mi propuesta os parezca interesante y viable. Por un sistema de transportes más moderno, ecológico y eficaz.</p>
";"07/09/2015 14";"542";"513";"29";"13";"871582244";"45810"
"140";"VIVIENDAS DE ALQUILER PARA JÓVENES ";"<p> </p>

<p>Soy de esa generación que dicen ""millenials"", yo le llamaría mejor ""damnificados"".</p>

<p>Hemos nacido después de los 80 y dicen las revistas de moda que nos encanta alquilar, compartir coche y comprar cosas de segunda mano. Yo me río, no es que nos guste, es que nos obligan. Cada día lo veo en las calles, en el trabajo..veo como las generaciones de antes de los 80 pueden tener una casa digna, coche o coches, hijos, vacaciones etc.. todos estos elementos son considerados de lujo o casi inalcanzables, para nosotros los del 83...pero creo que a nivel Ayuntamiento se puede empezar por ayudarnos a volver a creer en nuestra generación y con lo más importante el pilar de cualquier familia, una casa digna!</p>

<p>Basta de estar supeditados a caseros, que como propietarios de varias viviendas nos subyugan a sus peticiones, varios meses de aval, consideran el aire acondicionado un lujo y ni se les pasa por la cabeza vaciar ese trastero que pertenece a su casa lleno de todas sus pertenencias que consideran su tesoro.</p>

<p>Nuestro tesoro es nuestro presente y nos lo están arrebatando.</p>

<p>Sería muy interesante disponer de un listado de todas las casas disponibles por el Ayuntamiento de Madrid pensados para alquiler o para compra (asequible). La manera de gestionarlo sería mediante peticiones, estudios de caso y asignación de la manera más transparente y sencilla posible. Una app, tal vez?</p>

<p>Muchas gracias</p>
";"07/09/2015 14";"120";"96";"24";"14";"861232163";"5760"
"141";"Carnet de civismo canino";"<p>¿Por qué no puedo ir con mi perro en el metro si molesta menos que un niño que grita o un pesado con la música alta? Creo que debería haber un carnet (al estilo del de coche, con puntos) que enseñándolo en taquilla de metro y en otros lugares, nos permitiese a los dueños de perros poder viajar económicamente.</p>
";"07/09/2015 14";"221";"157";"64";"44";"860651409";"6606"
"142";"Accesos al Parque Rodriguez Sahagún (Tetuán) e información sobre plazos de obras";"<p>Los vecinos de Tetuán tenemos cada vez más difícil el acceso a nuestro parque (Huerta del Obispo, llamado hoy Parque de Rodríguez Sahagún). Desde casi Villaamil hasta casi capitán Blanco Argibay, las máquinas y obras impiden el paso. Uno de los accesos (el que da servicio a la zona a la derecha de Marqués de Viana, por entendernos) es una escalera muy estrecha en estado penoso y rodeada de basura. Por ahí hemos de bajar con las bicis (izadas al peso) y los niños. De noche con poca luz. Han puesto unas barandillas bastante chapuzas, pero ni siquera han limpiado la basura acumulada (incluyendo vidrios rotos). Además, no tenemos información sobre el transcurso de las obras. Se supone que la empresa tiene 18 meses para terminar, pero el ¿qué ha de terminar en 18 meses? ¿Pueden tenernos el barrio así los 16 meses que todavía quedan para ese plazo?</p>

<p> </p>
";"07/09/2015 14";"22";"20";"2";"5";"857842561";"1636"
"143";"Más jardineros en Madrid";"<p>Incrementar el empleo en Madrid en sectores como la jardinería, que cuiden del medioambiente, que vigilen la salud de nuestros árboles, que se encarguen de los parques y jardines,...</p>
";"07/09/2015 14";"376";"342";"34";"7";"868844444";"28014"
"144";"Obras municipales en los barrios: información a los vecinos";"<p>Propongo que toda obra municipal en los barrios que dure a partir de 2 semanas ofrezca necesariamente unos datos de identificación suficientes para información de los vecinos. Con unos carteles adecuados, se debe informar, como mínimo: de qué tipo de obra se trata, empresa contratista, presupuesto asignado, fecha de comienzo, fecha de terminación, y si es posible foto-maqueta de la obra terminada como aparezca en el proyecto. En mi barrio Fuente del Berro, la parte popular del distrito de Salamanca llevamos más de 4 meses (la cosa viene del ayuntamiento de Ana Botella) sufriendo polvo, ruidos de maquinaria, invasión de los pocos aparcamientos disponibles, tala de árboles y un montón de inconvenientes por una obra de ajardinamiento (calle Ramón de Aguinaga esquina a Rufino Blanco) sin identificación alguna y que no sabemos cuánto más durará Por otro lado, sustituir lo que era un jardín urbano con árboles por un parque temático con pistas delimitadas, me parece de mal gusto, pero en fin, ¡al menos que lo acaben!</p>
";"07/09/2015 14";"129";"123";"6";"1";"865930241";"11155"
"145";"Habilitar zonas valladas en parques y zonas verdes para perros";"<p>Los perros necesitan correr y desfogar. Hay muchos parques en los que se podría poner una valla para que lo hagan, sobre todo perros potencialmente peligrosos que hay muchos o con necesidades especiales que puedan correr sin molestar a nadie y sin ser molestados...</p>
";"07/09/2015 14";"272";"228";"44";"32";"865408752";"15423"
"146";"nombramiento a familiares";"<p>Soy un admirador de la gestión que están llevando en el ayuntamiento y de los cambios que están aportando. Por eso me pregunto ¿porque se ha nombrado coordinador del Ayto. al marido de la sobrina de Carmena y se ha ascendido a Luis Maestre, padre de la portavoz.</p>

<p>No tengo alguna duda sobre sus capacidades profesionales pero opino que es un error reproducir el comportamiento de otros partidos a los que hemos criticado igualmente cuando decían que el nombramiento era legal y además era al mejor profesional.</p>

<p>En fin, lo que más me preocupa es favorecer la idea de que todos los partidos son iguales, seguramente hay otros profesionales igualmente cualificados y deberíamos cuidar las formas. La coalición del ayuntamiento está inician do fuinalmente una gestión honesta y coherente, pero tiene que encantar a los que aún no la estiman.</p>
";"07/09/2015 14";"113";"75";"38";"19";"857083338";"2455"
"147";"Rehabilitación Palacio de la Duquesa de Sueca";"<p>Desde que hace varios lustros dicho edificio fuese expropiado por el entonces alcalde, Alberto Ruiz Gallardón, la razón por la que se llevó a cabo, que no era otra sino construir apartamentos para jóvenes, con proyecto de Álvaro Siza, no se vió llevada a la práctica. Un posible ulterior uso, para alojar la sede de Servicios Sociales, entonces gestionado por la Sra. Botella, tampoco se hizo realidad.</p>

<p>A día de hoy es un edificio que con sus más de 6.000m2 de superficie está abandonado a su suerte, en pleno centro de la ciudad, y que seguro que reduciría millones de euros si su rehabilitación y uso por parte del Consistorio se llevase a buen término y no se siguiesen detrayendo millones de euros anuales en alquiler de edificios. Amén de ello, la imagen y deterioro palpables dejan mucho que desear para la buena imagen que se desearía ofrecer a cuanto visitante foráneo se acerca por dicha zona, transitada por miles durante los días de Rastro.</p>
";"07/09/2015 14";"40";"31";"9";"2";"856723780";"1705"
"148";"Metro de madrid 24 H";"<p>Metro de Madrid abierto las 24 horas.</p>

<p>La reducción de los autobuses nocturnos y su asiduidad, empuja a los usuarios a utilizar transportes económicamente inaccesibles por sus altos precios, obligándonos en ocasiones a rechazar ofertas de empleo fuera del horario, vivir en zonas del centro cercanas al lugar de trabajo (más caras) y hasta a comprar billetes de vuelo más caros -e incluso dormir en el aeropuerto- cuando los vuelos (más baratos) salen a primera hora del día.</p>

<p>Abrir el metro 24 horas crearía puestos de trabajo y facilitaría a los usuarios a realizar actividades en horarios actualmente prohibidos.</p>

<p> </p>
";"07/09/2015 14";"508";"396";"112";"16";"865445670";"22138"
"149";"Metro por las noches (Fines de semana)";"<p>Este es un debate que ya ha surgido hace tiempo y es la posibilidad de abrir el metro los fines de semana por la noche. No sería necesaria una frecuencia demasiado elevada, pero tampoco superior a los 20 minutos porque en el momento que hubiera que hacer un transbordo echaría para atrás a mucha gente. Con el anterior equipo de gobierno no cuajo mucho la cosa, a ver si con el actual hay más suerte. También sería interesante, si alguién sabe un poco más del tema, saber los contras que esto tendría, ya que creo que actualmente, no existe ningún metro en el mundo que este abierto por la noche, por lo que no creo que sea tarea fácil. </p>
";"07/09/2015 15";"2819";"2458";"361";"88";"875278393";"182845"
"150";"Carril Bici por todo Madrid";"<p>Es un peligro tener a las bicicletas circulando junto a los coches en una ciudad como Madrid. Por favor, que se fomente el carril bici. Habrá muchas más gente usando la bicicleta y sin peligro. Favoreceremos la seguridad, el deporte, la movilidad y la reducción de contaminación.</p>
";"07/09/2015 15";"1198";"1018";"180";"39";"871179334";"71209"
"151";"RECUPERAR LOS CENTROS SOCIALES DESALOJADOS DÁNDOLES CABIDA EN EDIFICIOS PÚBLICOS";"<p>Sin entrar en catalogar centros sociales o okupas, es de todos conocido el servicio que han prestado muchos ciudadanos y asociaciones a través de estas plataformas, centros de debate, de acogida y de ayuda de todo tipo a nivel de barrio. Claramente conocemos algunos que han sido desmantelados totalmente y de mala manera cuando hacian un servicio que deberían hacer otros de manera regulada y con mas herramientas y facilidades, además de la oferta cultural que promovían. sería un buen gesto del ayuntamiento darles un lugar para seguir ofreciendo su cometido (clases de música, danza, idiomas, asesoramientos jurídicos y mesas de debate...la cultura al alcance de todos). incluso con ayuda económica para garantizar ciertas necesidades y condiciones de seguridad por ser espacios abiertos al público.</p>
";"07/09/2015 15";"98";"61";"37";"1";"854907978";"1493"
"152";"Casa de Campo - Carretera de Extremadura A-5";"<p>Lo primero de todo, daros las gracias por abrir este espacio de debate.</p>

<p>  Quiero manifestar los problemas que la Carretera de Extremadura A-5 produce en el barrio El Batán. Urge tomar medidas con respecto a la Carretera de Extremadura A-5. Es un horror urbanístico, ésta divide al barrio en dos además de provocar ruido, contaminación y peligro para los vecinos desde el año 1968.</p>

<p>  La obra de soterramiento de la carretera se quedo únicamente en la Avda. Portugal no avanzando hasta Campamento,  dejando separado por una autopista el mayor pulmón de Madrid La Casa de Campo. Desde el inicio el Paseo de Extremadura fue un paseo como pueden ver en fotos antiguas (http://www.madrid.org/cartografia/visorCartografia/html/visor.htm - fotos aereas de 1961-67); la autopista actual es un horror para todos los vecinos.</p>

<p>  Ciudadanos amantes del campo, niños, ancianos, personas con discapacidad, amantes del deporte, sufren problemas para poder llegar y disfrutar de la Casa de Campo, ir a comprar (muchos comercios están pegados a la carretera) o ir a alguna de las paradas de Metro (Batán / Casa de Campo). Cabe mencionar todos los colegios de la zona.. la aventura de llegar hasta ellos a pie o en coche. Hay que cruzar por pasos subterraneos que huelen mal, con excrementos de perro, e incluso andar al lado de la autopista con riesgos para cualquier viandante. http://avcasadecampobatan.blogspot.com.es/p/p-extremadura.html</p>

<p>  Por otro lado, la rotonda de la parada de metro Casa de Campo aglutina un tráfico enorme dados los malos accesos de entrada/salida que tiene la autopista con el barrio de Aluche / Batán. Señalar además la cercanía con el colegio Lourdes y los peligros que implica para los padres y niños cruzar esta rotonda para llevarlos al parque de juegos de la casa de campo o volver en metro.  </p>

<p>  La Casa de Campo y el barrio necesita un plan de dinamización para que todos los vecinos puedan acceder y disfrutar de <em>""la mejor zona verde de Madrid""</em>. </p>

<p> </p>
";"07/09/2015 15";"86";"78";"8";"37";"863553719";"6348"
"153";"Poder prestar una plaza de aparcamiento permanentemente en una APR";"<p>Mi padre, tiene una plaza de aparcamiento en propiedad en el Barrio de Las Letras, dentro del APR (Área de Prioridad Residencial) pero no tiene vivienda, así que no puedo empadronarme y con el cambio de normativa municipal, me quedo sin acceso permanente al APR de las letras y por consiguiente a dicha propiedad a partir del 1 de Agosto del año en curso, con mi vehículo porque el Ayuntamiento de Madrid no contempla que mi padre pueda prestar la plaza de aparcamiento a un familiar o amigo, incluso que haga uso para sí mismo de un vehículo que no sea el suyo porque no lo quiera utilizar o no tuviera. Actualmente yo necesito esa plaza de aparcamiento porque voy a trabajar muy cerca y además mi padre muchas veces usa mi vehículo, por lo que es irónico y choca completamente con la libertad de uso y acceso a la propiedad, que te pidan ser titular del vehículo y de la plaza de aparcamiento al mismo tiempo, puesto que hay gente que tiene varias plazas de garaje y las presta a varios usuarios, como pueda ser un amigo, al conserje de una finca de la zona, a un trabajador que tenga en su vivienda, etc. y no busca un fin lucrativo como pueda ser el alquiler, por lo que me parece un acto meramente lucrativo por parte de la administración, que me tenga que hacer un contrato de alquiler mi padre a mí, con el consiguiente pago a hacienda que ello supone, para poder hacer uso de una propiedad que está al corriente del pago de impuestos como el IBI o la Tasa de Basuras. Pido que se transmita este mensaje que se contemple, poder prestar tanto temporalmente como ceder una plaza de aparcamiento permanentemente o anualmente por ejemplo, como estaba hasta el año pasado dentro de las APR, hay muchas personas que estamos en este caso o similares. </p>
";"07/09/2015 15";"53";"35";"18";"6";"854700439";"1122"
"154";"FUERA LOS CAMPOS DE TIERRA EN MADRID";"<p>Hay que  termianar con la imagen de campos de tierra en nuestra ciiudad, campos que cuesta un dinero el mantemiento, pintar los campos todas las jornadas allanamiento, y con la implantacion del cesped artificial, nos ahorrariamos dicho mantenimientos, evitariamos suspension de partidos por las lluvias, y el peligro de lesiones que tienen los campos de tierra,</p>

<p>Hay que fomentar el deporte empezando desde las bases, y el cesped de hierba artificial, ademas de animar a los jovenes a participar, conseguiriamos una modernizacion de nuestras instalaciones</p>
";"07/09/2015 15";"53";"21";"32";"5";"842215880";"-435"
"155";"Línea 31 de la EMT... Un desastre.";"<p>La línea del 31 de la EMT pasa por dos ambulatorios y al haber cada día menos servicio de autobuses, los ancianos van hacinados y en condiciones inhumanas. ¡¡Por favor pongan un poco más de servicio en esa línea!!</p>
";"07/09/2015 15";"22";"17";"5";"0";"854632785";"927"
"156";"Colonias felinas";"<p>Hay muchísimos gatos en Madrid que por desgracia no tienen familia o han sido abandonados... En vez de llenar perreras y matar, podríamos hacer una campaña de esterilización control y alimentación de estas colonias... Fomentemos la empatía y el desprecio al maltrato animal, hagamos de Madrid una ciudad amiga de los animales.</p>
";"07/09/2015 15";"172";"137";"35";"35";"862706513";"8124"
"157";"Bono gratis para tod@s los parados para poder mover en busca de trabajo";"<p>Hola,buenos dias a tod@s quiero pedir en nombre de todos los parados minimo bono transporte gratis para tod@s los parados para poder mover en busca de trabajo lo primero que los gobiernos deberiam hacer es pensar en como ayudar a los parados sin ningun ingresos esto es lo PRIMORDIAL por favor despues de 8 años de crisis salvemos parados sin ingresos.saludos.</p>
";"07/09/2015 15";"248";"190";"58";"13";"862697616";"10112"
"158";"Estacionamiento en centros hospitalarioss";"<p>Solución al problema de aparcamiento alrededor de los hospitales. El mejor ejemplo ""el clinico"" imposble encontar sitio para dejar el coche.</p>
";"07/09/2015 15";"98";"84";"14";"2";"862183623";"6000"
"159";"POSIBILIDAD DE CIRCULAR EN BICI POR LA ACERA";"<p>Somos muchos los madrileños que queremos ir en bicicleta al trabajo. Esto es algo que disminuye la contaminación, aunque la verdad es que Madrid no es una ciudad preparada para circular en bici. Son muchas las ciudades españolas que tienen kilómetros de carril bici, mientars que en Madrid la única posibilidad de circular sin jugarse la vida es por SOL y SERRANO.</p>

<p>Creo que es mucho más peligroso para un ciclista ir por la carretera, con el resto de coches pitando e intimidando, que para un peatón el hecho de que un ciclista vaya tranquilamente por la acera.</p>

<p>Veo inútil tener que ir por la acera mirando a todos lados por si te multan.</p>

<p> </p>

<p> </p>

<p> </p>
";"07/09/2015 15";"302";"36";"266";"44";"842976294";"-2741"
"160";"Protección del reciclaje de papel y cartón";"<p>Como muchos de quienes reciclamos sabemos, está de moda que camiones no autorizados se dediquen a sacar de los contenedores de papel y cartón lo que los ciudadanos hemos separado. Lo hacemos desinteresadamente, comprendiendo que con la venta de estos recursos el ayuntamiento obtiene un benificio que, al final, es de todos. Pero cuando se sustrae, perdemos los beneficios. No sé quién se llevará el beneficio de esta venta, pero serán mafias, organizaciones ilegales, ... que casi siempre al recogerlo rompen los contenedores y dejan todo lo que se les cae por el suelo. Por el contenedor de al lado de mi casa llegan a pasar al día 2 o 3 camiones de estos. En muchos casos se ve recogiendo cartón a menores.</p>

<p>¿Cómo puede pasar esto? El primer problema que veo es que se permite. El segundo, que se puede hacer, porque no hay barreras a la extracción del cartón de un contenedor. Y el último, que las empresas que gestionan la recogida de papel y cartón no pasan con la suficiente frecuencia.</p>

<p>Mi solución es: implantar contenedores subterráneos o mejor protegidos. Establecer normativas en las que se considere al recurso reciclado por los madrileños como algo valioso, no como basura. Y por supuesto, optimizar las recogidas y hacerlas más frecuentes.</p>
";"07/09/2015 15";"94";"84";"10";"7";"863171718";"6612"
"161";"ELIMINAR LAS AUTOPISTAS URBANAS";"<p>EL PROBLEMA:</p>

<p>No existe una capital europea con autopistas como las que tenemos en pleno centro de Madrid. Generan ruido, contaminación, agresividad en la conducción y son cicatrices urbanas que actúan como fronteras entre barrios. El comercio en estas calles está seriamente degradado y las aceras no son aptas para el tránsito de los vecinos.</p>

<p>Para colmo, los principales reclamos culturales de Madrid están atrapados en estas autopistas: Museo del Prado, CaixaFórum, Museo Reina Sofía, Casa Encendida, Price, etc.</p>

<p>LA PROPUESTA.</p>

<p>Ejecutar la primera actuación en Pº del Prado, Pº de las Delicias y Rondas de Atocha y Valencia. Pacificación del tráfico y ampliación de las zonas peatonales mediante la reducción de los carriles para vehículos de motor, limitación a 30 km/h, ensanchamiento de aceras.</p>

<p>EL RESULTADO</p>

<p>Votad la propuesta y lo veremos y lo veréis ;)</p>

<p>¡ Gracias mil !</p>
";"07/09/2015 15";"156";"95";"61";"11";"855944730";"2070"
"163";"Reservar una bici con BiciMad";"<p>Me encanta el servicio de BiciMad y lo uso diariamente para ir y volver de mi trabajo. Ademas cada día, por la mañana o por la tarde, es una lucha encontrar una estación con bicis disponible. Quiero actualizar la app para que puedo reservar una bici en una estación en un tiempo concreto. Así esta garantizado que tengo un bici y ellos pueden planificar donde tienen que mover más bicis para para satisfacer la demanda. Para ser util para los viajeros diarios al trabajo eso es necesario.</p>
";"07/09/2015 15";"80";"66";"14";"3";"860608503";"4290"
"164";"Gran Vía: ¿espacio mercantil lowcost o cultural?";"<p>me gustaría pedir al nuevo equipo de gobierno del Ayto de Madrid, que impida que la Gran Vía se convierta en una vulgar calle grande llena de franquicias low cost de comida basura, para volver a impulsar el espacio cultural que antiguamente representaba la Gran Vía, el Broadway de Madrid: Teatros, Cines, Salas de Músicas, etc, etc.</p>

<p> </p>

<p>Gracias por este espacio por cierto.</p>
";"07/09/2015 15";"148";"127";"21";"6";"863840382";"9095"
"166";"Madrid, la ciudad más sucia de Europa.";"<p>Algunas calles de madrid son NOCIVAS de la suciedad y basura que tienen. Prometieron arreglarlo pero no se ve que mejore. Madrid es la CIUDAD MÁS SUCIA DE EUROPA según la prensa europea, así la dejó Ana Botella y así sigue. A ver si hacemos algo para quitarnos ese penoso título. </p>
";"07/09/2015 15";"382";"352";"30";"22";"869582497";"29671"
"167";"Cambio de multas de tráfico por servicio a la comunidad";"<p>Sugiero que se puedan sustituir las multas de tráfico por servicios a la comunidad o cursos de conducción por lo siguiente:</p>

<ul>
	<li>No todos los ciudadanos tienen el mismo poder adquisitivo por lo que es injusto que todos paguen lo mismo por las multas.</li>
	<li>Aunque el ayuntamiento recaudaría menos dinero, tendría esfuerzo humano asequible para muchas tareas que tienen un gran coste como limpieza de calles y parques, colegios, atender comedores sociales...</li>
	<li>No está probado que se mejore la conducción a través de la imposición de multas. </li>
</ul>

<p>Saludos!</p>
";"07/09/2015 15";"211";"168";"43";"14";"863225409";"9952"
"168";"Debates en las aulas de Colegios e Institutos";"<p>No se si será competencia del Ayuntamiento, pero es una preocupación generalizada. Problemas como el maltrato, la existencia de cánones cerrados (que las mujeres piensen por ejemplo, en muchos casos, que los hijos son solo suyos,..), la prostitución,... han de hablarse abiertamente en las aulas, en asambleas y seminarios impartidos por expertos. Por desgracia, la educación no puede dejarse exclusivamente en manos de las familias, porque cada familia es un mundo, con sus luces y sus sombras. Estos problemas solo se pueden cambiar desde la eduación y el diálogo. La segregación por sexos en las aulas tampoco ayuda,... pero ese es un problema más complicado de solucionar.</p>
";"07/09/2015 15";"73";"56";"17";"2";"858666806";"2991"
"169";"Prohibir el uso del aire acondicionado de los coches en vías urbanas";"<p>Razonnamiento: Supone un aumento del consumo y por lo tanto de la contaminación, que es especialmente grave en la temporada estival.</p>

<p>Todos los usuarios sufren el calor, espacialmente peatones y ciclistas, el coche sólo debería tener este privelegio en autopistas, donde la contaminación no afecta de forma tan directa a la población. Además, si los conductores están obligados de circular con la ventana abierta, se darían cuenta del ruido que provocan!</p>

<p>Finalmente conviene hacer campañas de concienciación para que se apague el motor cuando el coche está aparcado, cosa que algunos conductores no hacen cuando se echan una siesta en su coche en el verano.</p>
";"07/09/2015 15";"314";"31";"283";"58";"843309689";"-2487"
"170";"PROHIBIR A AUTOCARES Y CAMIONES GRANDES APARCAR EN LA ALMENDRA CENTRAL.";"<p>Aunque parezca mentira las ordenanzas actuales de movilidad prohiben a los autocares y camiones grandes aparcar en los barrios fuera de la M 30 pero no lo prohiben dentro de la M 30. Solo esta prohibido si la calle es estrecha.</p>

<p>Podeis figuraros lo que es que encima de que ya nos quita bastante luz la boina de contaminacion, te encuentres un trailer aparcado delante de tus ventanas quitandote toda la luz.</p>
";"07/09/2015 15";"95";"83";"12";"12";"862806333";"6203"
"171";"Civismo necesario";"<p>En mi opinión hace falta que desde el ayuntamiento se recuerde por medio de algun tipo de campaña normas basicas de convivencia que no se estan respetando. Jovenes con musica sin auricualres en el metro o por la calle, botellon indiscriminado a cualquier hora, olores inefables en las calles del centro, suciedad por todas partes y miles de latas de cerveza por el suelo. No hay baños publicos, en los bares no dejan entrar y no hay ningun respeto por los vecinos. Hay zona en las que parece que solo por pasar te van a dar una paliza, el tema de las drogas en lavapies es una verguenza, los indigentes de la plaza san ildefonso o luna estan liandola dia si y dia tambien... y por poner el mas tonoto de los ejemplos ya ni se deja salir antes de entrar en el metro, ni se ceden asientos a personas mayores (reservados o no)... me parece mas falta de educacion en general que de cualquier otra cosa, con unas multas se iban a acordar bien de que la convivencia es asunto de todos. </p>
";"07/09/2015 15";"111";"101";"10";"6";"864344918";"8280"
"172";"Príncipe Pío necesita una Biblioteca y espacios culturales";"<p>Desde Cuesta de San Vicente hasta el final de la Avenida de Valladolid, carecemos de servicios culturales: no hay Biblioteca Pública, no hay Centro Cultural ni espacios para asociaciones, cursos, conferencias, etc ni un teatro. ¿Dónde quedó el proyecto de acondicionamiento de la antigua Estación del Norte/ Paseo del Rey?</p>
";"07/09/2015 15";"56";"46";"10";"1";"859268190";"2957"
"173";"Peligro en Madrid Río por circular personas y bicis juntas";"<p>Vivo en Arganzuela y a menudo visito el recinto de Madrid Río, por la zona de la Junta Municipal de la Casa del Reloj y en mi opinión es peligroso que caminemos personas y bicis por la misma calzada, ya que por el suelo que se instaló no se oye bien si viene alguna bici, si por alguna razón tienes que hacerte a un lado, corres el peligro de que te arrolle una bici, sin que ninguno de los dos sea el culpable, se podría solucionar? Saludos y gracias por darnos esta oportunidad</p>
";"07/09/2015 15";"168";"149";"19";"10";"865290640";"11529"
"174";"Plazas estacionamiento movilidad reducida";"<p>Creo que se debe controlar el uso de las plazas para personas con movilidad reducida, tanto los que disponen de la tarjeta como aquellos ciudadanos que no respetan estos espacios. Vehiculos que aparcan en los pasos de cebra justo en el rebaje de las aceras.</p>
";"07/09/2015 15";"24";"18";"6";"0";"854552734";"900"
"176";"INSTAURAR EN SUPERMERCADOS DE MADRID EL MODELO ALEMAN DE RECICLAJE";"<p>Desde hace 7 años, en los principales supermercados de Alemania, existen maquinas en las que los usuarios pueden reciclar todo tipo de envases (botellas, bricks, latas, etc...) y a cambio, reciben un ticket de descuento para poder comprar en ese supermercado</p>

<p>Adjunto enlace a noticia de ElPais http://blogs.elpais.com/eco-lab/2010/12/hay-que-importar-el-sistema-de-recogida-de-envases-de-alemania.html</p>
";"07/09/2015 15";"3235";"3091";"144";"126";"879672269";"281581"
"177";"Por un urbanismo asequible a la ciudadania";"<p>El urbanismo es la llave del desarrollo de la ciudad. Es en él en el que se asientan las bases de como será nuestro entorno cotidiano. Es por ello IMPRESCINDIBLE el acceso a esta fuente de información de la ciudadanía en un lenguaje fácil y sencillo de entender. La ciudadanía DEBE participar en el conocimiento de como es, y será su ciudad.</p>

<p>POR UNA INFORMACION URBANISTICA TRANSPARENTE Y VERAZ.</p>
";"07/09/2015 15";"61";"57";"4";"0";"862592392";"4952"
"179";"Carril Bici por la Castellana y Paseo del Prado";"<p>Hay varios debates abiertos sobre aumentar los carriles bici por Madrid; pero sinceramente no le veo tanta necesidad. Yo uso BiciMad prácticamente todos los días desde el principio y no he tenido problemas. Sí es cierto lo siguiente:</p>

<ul>
	<li>Algunos coches van muy rápido (deberían multar a los que van a mucha velocidad)</li>
	<li>Yo personalmente no veo seguro ir con la bici por el segundo carril por la derecha (coches a la izquierda y enfrente/detás y autobus/taxi a la derecha). Normalmente siempre voy por el carril más a la derecha ya que la bici va más rápido que el autobus.</li>
</ul>

<p>Pero <strong>donde veo una brecha importante es en la Castellana</strong>. Nunca he ido por ahí porque lo considero una locura con los coches yendo a 80-100km/h. <strong>Se debería hacer un carril bici por todo el paseo de la Castellana y Paseo del Prado</strong>; desde Atocha hasta Chamartín. Hay espacio de sobra y no creo que sea muy caro quitar un carril a los coches y poner una separación. Ahora mismo hay que desviarse a Serrano y bajar por el Retiro para evitar tanto tráfico.</p>

<p>Que por cierto, el carril bici de Serrano es ridículo y peligrosísimo porque los peatones no se dan cuenta de él.</p>
";"07/09/2015 15";"482";"416";"66";"34";"868560835";"30207"
"180";"Agua gratis en locales de Madrid";"<p>Todos los madrileños se llenan la boca cuando vuelven de un viaje diciendo: ""el agua de Madrid es la mejor"". Pero luego, cuando vamos a cenar o a tomar algo, el vaso o jarra de agua suele ser un tabú. ¿Por qué tengo que comprar agua embotellada en plástico de los Pirineos si hay agua corriente de mi ciudad? Por el beneficio del empresario, obviamente. Pues en otras ciudades (o países) como París, NY, Tokio esto no es así. ¿Son ciudades donde los empresarios no registran beneficios?</p>

<p>Creo que el Ayuntamiento podría promover esta medida, que iba a ahorrar muchos kg de CO2 al día en transporte de botellas y mucha suciedad de plástico en las calles y parques.</p>
";"07/09/2015 15";"108";"67";"41";"16";"855764270";"1612"
"181";"Opción ""Marcar como spam"" en las propuestas";"<p>Ni un día ha tardado en aparecer un personaje utilizando esto para escribir chorradas</p>

<p>https://decide.madrid.es/debates/178</p>

<p>https://decide.madrid.es/debates/175</p>

<p>Para este y futuros trolls sería interesante añadir una opción para marcar las propuestas como spam y para que desde la administración puedan ser revisadas. Ahora son solo unas cuantas, pero puede llegar a ser incómodo. </p>
";"07/09/2015 15";"315";"252";"63";"5";"864766663";"15120"
"182";"Recuperar la historia de madrid .";"<p>Rutas por el centro de madrid mostrando su historia real, recuperar lugares ocultos como tuneles de la guerra o tuneles de la antigua ciudad de madrid, rutas con personal vestido de epoca , recuperacion de los restos de las murallas arabes en calle escalinata (plaza Isabel la II) y creacion de un nuevo espacio o museo de la villa, todo ello como hacen otras ciudades como (Toledo).  </p>
";"07/09/2015 15";"474";"448";"26";"14";"871378378";"39885"
"183";"Recuperar el tranvía en centro de la ciudad";"<p>El sistema del transporte público de autobuses urbanos tiene algunos problemas estructurales que son difíciles de solucionar. En las calles principales de mayor demanda, los autobuses llegan frecuentemente al límite de su capacidad, lo que empeora la comodidad de los viajeros y reduce la velocidad comercial. Es frecuente ver cómo los autobuses hacen cola para llegar a la parada debido al gran número de líneas, su alta frecuencia y el tiempo necesario para la subida y bajada de viajeros. El tranvía tiene la virtud, además de ser más silencioso y menos contaminante, de tener mucha más capacidad, permite agrupar varias líneas de autobús y el tiempo de entrada y salida de viajeros es mucho más rápido que en el caso de los autobuses. Así que si se hiciera un estudio de viabilidad en ejes como la Castellana, calle Alcalá, Gran Vía o calle Princesa, seguramente saldría a la luz la idoneidad y superioridad de este modo de transporte en algunos ejes céntricos de Madrid. Finalmente, la introducción del tranvía es una oportunidad única para recuperar y mejorar el espacio público tal como muestran los ejemplos de Bilbao, Vitoria, Valencia, Sevilla, Zaragoza, Barcelona, etc., donde el tranvía se ha convertido en el hito de la movilidad y del espacio urbano del siglo 21.</p>
";"07/09/2015 15";"265";"108";"157";"34";"839669936";"-1996"
"185";"Bicimad. Primera media hora gratuita.";"<p>Un sistema público de transporte de bicicletas, para que sea usado como transporte diario útil, debe tener los primeros 20-30 minutos gratuitos. Es impensable y muchas veces inasequible pagar 50 cms por uso: ida y vuelta del trabajo, ida y vuelta del gimnasio / actividad frecuente sea cual sea, ida y vuelta para quedar con quien sea por ocio... Asumiendo simplemente unos 4 usos al día significa 0'50 x 4 x 30 = 60 euros al mes. De ahí restad / sumad lo que queráis, pero es una locura que salga más caro ir en bici que en metro.</p>

<p>He sido usuario de un sistema similar en otra ciudad. Y para que se note realmente la disminución del transporte privado y de la contaminación es necesario que se capte a ese ciudadano que usaría el servicio a diario y para todo prácticamente, dejando el coche o moto. Eso no se conseguirá pagando 60 euros al mes. Y la mayoría de usuarios por tanto serán esporádicos.</p>

<p>Entiendo que mantener un servicio así es difícil y caro, viví los primeros 6 años de un sistema similar. Los usuarios que queremos un sistema de transporte en bicicleta es justo para eso, para usarlo como trasporte. No usar el metro o el coche o el bus y de vez en cuando la bici. Es preferible una cuota anual mayor, (incluso 150 euros sería poco más de 12 euros al mes) y una gratuidad en el uso de la primera media hora. </p>

<p>También veo innecesario su uso por turistas. Ya hay muchas empresas de alquiler de bicicletas por días. Y la idea de un sistema como BiciMad no debería ser esa. Sino lo explicado arriba, un sistema de transporte diario que sustituya al coche o moto. </p>

<p>Seguro que hay muchos más argumentos que se podrían debatir para conseguir acercar el sistema a la realidad de los ciudadanos de Madrid. Animáos a comentar. </p>

<p>Gracias.</p>
";"07/09/2015 15";"693";"533";"160";"21";"866413490";"28688"
"186";"Multas en relación a tu sueldo (% renta) o por servicios a la comunidad.";"<p>Si las multas pretenden ser un elemento disuasorio para el que inflige una norma, una multa fija y estándar, de por ejemplo 200 , no será igual de disuasoria para alguien que gana al mes 100.000  mensuales que para una renta de 700 /mes.

Por eso, propongo que las multas, que en vez de ser una cantidad fija y estándar, sea relativas a la renta del multado (un porcentaje sobre la renta). Que, por ejemplo,  en vez de 200 de multa, se imponga una multa de 20 % sobre la renta, así para el que gana 1000 /mes la multa tendrá el mismo efecto y valor para él que para el que gana 100.000 .

Además de ser más justo, es más efectivo para evitar que el sujeto reincida, que es para lo que están establecidas las multas. Así, si decidimos guiar nuestra sociedad bajo valores capitalistas y por derecho capitalista por tanto, por lo menos que sea lo más justo posible.

En el caso de no querer o poder pagar con dinero, podría canjearse con servicios a la comunidad. La cantidad de tiempo es igual para todos, con lo que tendrá el mismo efecto disuasorio para todos.</p>
";"07/09/2015 15";"350";"254";"96";"52";"862902084";"11466"
"187";"CAMBIOS DE NOMBRES EN LAS CALLES";"<p>Me gustaría proponer al ayuntamiento que no se destine dinero público a cambios de nombres de calles y/o plazas. Destinando ese dinero a cosas más importantes, y lo que es mejor, enterrando de una vez viejas guerras entre derecha e izquierda.</p>
";"07/09/2015 15";"137";"68";"69";"9";"846573242";"-49"
"188";"RECUPERACIÓN DE LOS ESPACIOS PÚBLICOS. Apelación al Ayto. y a los madrileños";"<p><strong>RECUPERACIÓN DEL ESPACIO PÚBLICO</strong></p>

<p>El espacio público es aquel espacio que es de todos, y a la vez de nadue. Es aquel espacio en donde nos podemos encontrar con todos, y en donde tenemos la libertad de su uso, porque es de todos, y porque a la vez no es de nadie. Esto no quiere decir que por esto pueda abusar del espacio público, pues hay unas normas básicas que todos debemos conocer y aplicarnos. El espacio público es donde se han reunido históricamente los pueblos de manera libre y fraternal, esto es, sin regulaciones ni autoritarismos. Sin embargo esto con el gobierno del PP cambió.</p>

<p>PUNTOS DE DISCREPANCIAS</p>

<p>El PP con su autoritarismo y su política económica liberal ha decidido vender (o alquilar) el espacio público al mejor (o peor) postor, mutando el espacio público a una especie de espacio semi-público o medio privado en donde nos vemos inundados por terrazas de bares, falta de sitios donde sentarse, lugares que se nos han privado y un largo etc...</p>

<p>La medida fue realizada con el fin de mejorar la rentabilidad de la restauración madrileña, y así mejorar el crecimiento económico y el empleo. Soy consciente de ello. Pero lo que es inadmisible es que TODOS perdamos espacios de TODOS por el hecho de mejorar los resultados económicos de los bares y restaurantes y la recaudación del consistorio. Busquen otras fórmulas.</p>

<p>Además el proceso de PRIVATIZACIÓN DEL ESPACIO PÚBLICO SE HA CONSOLIDADO CON LAS SIGUIENTES MEDIDAS:</p>

<p>· Examen (regulación y autorización) del arte urbano, en especial de los músicos, los cuales ya no son libres de usar el espacio de todos para practicar y conseguir unas moneditas extras.</p>

<p>· Sanción de la indigencia o la mendicidad, un atroz autoritarismo que nos deja fatal como sociedad, primero que excluye y abandona en la calle a su gente y luego que la sanciona y hostiga hasta hacerla la existencia inaguantable. </p>

<p>· Legislación muy restrictiva en cuanto al uso del espacio público, las leyes Mordaza, el hostigamiento de la Policía a los jóvenes en las plazas o las leyes anti-botellón, llevan a que la gente querramos estar encerrados en casas, en espacios públicos, y poder seguir el proceso de división y venta del espacio común.</p>

<p>· Desvalorización del espacio común, quitando bancos donde sentarse o estableciendo bancos individuales en las plazas (¿acaso se han creido que la gente se va a sentar sóla en las plazas???¿que en un banco de una persona se puede ir a charlar con alguien??). En muchos sitios se han quitado árboles, sombras, bancos,...todo con el fin de que nos vayamos a sentar a la terracita del bar ¡VENGA HOMBRE!</p>

<p> </p>

<p>LA PROPUESTA</p>

<p>· Recuperar el espacio público, aboliendo leyes y medidas autoritarias y económicamente liberales</p>

<p>· Volver a valorizar el espacio público, invirtiendo en él y recuperando los sitios donde sentarse y donde tener una sombra, o un sitio para resguardarse. Esto no tiene por qué ir en contradicción con las terrazas de los bares, dejemos, que sean los ciudadanos que decidan donde sentarse, pero démosles todas las opciones. Bancos y sitios en Sol, Callao, en Chueca, en todo el centro. Ya está bien de el lucro del PP que ha quedado en esta ciudad y debe corregirse cuanto antes</p>
";"07/09/2015 15";"214";"190";"24";"2";"866298780";"14738"
"189";"ELIMINAR ZONA VERDE/AZUL EN EL MES DE AGOSTO EN LOS BARRIOS RESIDENCIALES";"<p>Soy un madrileño de toda la vida que por motivos laborales lleva algo más de 2 años viviendo en Barcelona. El pasado mes de agosto vine a Madrid (barrio de Pacífico, distrito del Retiro) en coche durante un fin de semana y mi sorpresa fue que los sábados había que pagar los parquímetros de 9 a 15 horas del sábado cuando más de la mitad de las plazas de aparcamientos estaban libres. En Barcelona resido en un barrio residencial (Camp del Arpa) en el que hay zona verde y azul, pero ésta no está operativa ni los fines de semana (sábado y domingo) ni durante el mes de agosto (que es gratis y se descuenta en la cuota trimestral que se paga en Barcelona). Me parece que no tiene sentido aparte de tener un afán recaudatorio poco disimulado, que haya que pagar por aparcar en barrios de Madrid que en el mes de Agosto tienen gran cantidad de plazas de aparcamientos vacías. Desconozco exactamente la situación de otros barrios de la capital, pero concretamente en Pacífico, distrito de Retiro creo que el estacionamiento en la zona verde/azul debería ser gratuito durante el mes de agosto, así como en otros barrios en los que se den las misma circunstancias. Un saludo!</p>

<p> </p>
";"07/09/2015 15";"188";"159";"29";"1";"864462878";"10994"
"190";"multas de estacionamiento ";"<p>porque multan teniendo puesto tarjeta de aparcamiento autorizado para minusvalido y no hay forma de que te quiten la multa diciendo que se ratifica el agente de aparcamiento regulado diciendo que no estaba puesta, loismo que con los tickets, es una vergüenza. Si ha alguien que me lo explique.</p>
";"07/09/2015 15";"26";"20";"6";"7";"855855795";"1076"
"193";"Registro mediante DNI o NIE";"<p>Ha pasado apenas una semana y ya hay troles. Propongo que no se pueda publicar debates mientras que no haya sido comprobada la identidad del usuario en su Junta de Distrito.</p>

<p> </p>

<p>Saludos</p>
";"07/09/2015 15";"596";"484";"112";"56";"867654761";"30209"
"194";"INTERCAMBIO DE LIBROS DE TEXTO";"<p>Creo que seria una buena iniciativa por parte del ayuntamiento, fomentar el intercambio de libros de texto e incluso de libros de lectura, ya que en los colegios nos cambian los libros continuamente para que no puedan pasar de unos hermanos a otros y se quedan practicamente nuevos. Ya está bien de hacer ganar tanto dinero a las editoriales, vamos a reciclar !!!!!!!</p>
";"07/09/2015 15";"115";"106";"9";"1";"864916604";"8940"
"195";"El estado de las calles en el APR Embajadores";"<p>Trabajo en Lavapies, dentro de la zona llamada APR Embajadores. Hace ya unos cuantos años Gallardón decidió que ""quedaba bonito"" cambiar el asfalto de las calles por un empedrado tipo adoquín pequeño. El caso es que desde entonces el mantenimiento de esos adoquines ha sido prácticamente nulo. El suelo de esa zona es muy blando y si hay tantas juntas entre los adoquines, el movimiento del suelo es mayor. Ahora mismo hay unos socabones enormes donde la plaza de Lavapies, huecos aquí y allá a lo largo de todas las calles y algunos de ellos sobresalen, a punto de desencajarse del suelo. Esto provoca accidentes y caídas, además de mucha incomodidad a la hora de circular a pie, en bicicleta o en moto (en coche no se nota tanto, pero también)</p>

<p>Propongo sustituirlo por un asfalto reciclado de caucho, resistente a los movimientos de tierra (hasta cierto punto) y que es bueno para el medio ambiente</p>
";"07/09/2015 15";"42";"28";"14";"7";"854641234";"933"
"196";"Remunicipalización de los servicios municipales ";"<p>En los últimos años los servicios sociales dependientes de diversas administraciones públicas (Ayuntamiento o Comunidad de Madrid) han sufrido un gravísimo deterioro, y por partida doble. - Por un lado, la degradación de la calidad de los servicios prestados precisamente al sector más vulnerable y desprotegido de la población madrileña, que en muchos casos carece de voz propia para expresar su protesta. Así, hemos sido testigos de cierres de Centros de Atención a Drogodependientes, del deterioro de las ratios de personal especializado por número de usuarios en centros de Atención a la Discapacidad o a Menores, de la clamorosa insuficiencia de medios de los Centros Municipales de Asistencia a Personas sin Hogar, etc. En muchos casos, las entidades - supuestamente sin ánimo de lucro - incumplen abiertamente los Pliegos de Condiciones del servicio que gestionan. - Y por otro, las condiciones de precariedad, salarios de auténtica miseria, desprecio a la profesionalidad, etc. son moneda corriente en el sector. La única salida que veo a esta situación es la de proceder inmediatamente a la remunicipalización de todos estos servicios, subrogándose el Ayuntamiento los contratos laboral del personal actual - naturalmente, respetando la legislación laboral y el recién firmado Convenio de Intervención Social -, y gestionándolos de forma democrática, transparente y participativa, dando voz y voto en la gestión a los profesionales del sector, a los usuarios/as y/o sus familias, y a las entidades, asociaciones y colectivos que de verdad operan en el ámbito del trabajo social sin el ánimo oculto de hacer negocio.</p>
";"07/09/2015 15";"638";"545";"93";"17";"869334977";"38611"
"197";"Intercambio de libros de texto";"<p>Creo que seria una buena iniciativa por parte del ayuntamiento, fomentar el intercambio de libros de texto e incluso de libros de lectura, ya que en los colegios nos cambian los libros continuamente para que no puedan pasar de unos hermanos a otros y se quedan practicamente nuevos. Ya está bien de hacer ganar tanto dinero a las editoriales, vamos a reciclar !!!!!!!</p>
";"07/09/2015 15";"640";"598";"42";"4";"872263200";"51951"
"198";"Libros de texto gratuitos en los colegios públicos";"<p>Se podría establecer un sistema similar al de EEUU, en el que los libros de texto son propiedad de los colegios y se ""prestan"" de forma gratuita a los alumnos durante el año escolar. Los alumnos sólo tendrían que pagarlos en caso de pérdida o deterioro grave.</p>

<p>
Supondría un gran ahorro para las familias en un bien que tiene una vida útil tan corta (normalmente sólo se emplea un año) y para los colegios no supondría una inversión demasiado grande.</p>
";"07/09/2015 15";"1097";"909";"188";"27";"870348664";"59743"
"199";"Reordenación distritos. Aravaca independiente";"<p>Madrid está dividido en 21 distritos sin tener en cuenta ni las realidades sociales ni las necesidades ni la historia de los barrios.
 </p>

<p>La propuesta es reestructurar la ciudad administrativamente de manera que tengamos una división territorial más operativa y cercana, en la que se tengan en cuenta tanto tamaño como composición y tradición del barrio. </p>

<p>Es sangrante que Aravaca pertenezca al Distrito Moncloa, cuando son barrios que tienen una composición social y tradición muy diferente a los distritos que pertenecen, y esto es sólo un ejemplo, el caso sería un modelo que tenga en cuenta tanto la identidad barrial como la operatividad.
 </p>

<p>Del mismo modo habría que plantear la ""independencia"" de aquellos municipios que fueron anexionados por Real Decreto en la década de los 50.</p>
";"07/09/2015 15";"57";"35";"22";"3";"853627255";"798"
"201";"Dos sentidos de circulación en calles de múltiples carriles";"<p>Propongo que se estudie la posibildad de reconvertir calles de sentido único y múltiples carriles en calles de doble sentido para favorecer el transporte público, la movilidad ciclista, el calmado de tráfico, seguridad vial y calles más vivas en general.</p>

<p>Prácticamente todos estos ejes de de sentido único y múltiples carriles como la calle Serrano o Velázques eran en su día de doble sentido. Ha llegado de hora de reflexionar sobre la idoniedad de este modelo en el siglo XXI y empezar a convertir algunos ejes secundarios (como Victor de la Serna) en calles de doble sentido. De este forma desincentiva también el hábito de aparcar en segundo fila.</p>
";"07/09/2015 15";"53";"20";"33";"4";"842445731";"-490"
"202";"MIgrantes.";"<p>Compañeras,</p>

<p>Últimamente los acontecimientos que rodean a las migrantes motivados por diferentes circunstancias sociales que son de conocimiento público han hecho que se nos vuelva a poner en el punto de mira lastimosamente como una factor negativo y se vuelven a referir a nosotras como problema una palabra compleja que lleva en sí intrínseco una carga totalmente contraria a lo que debería ser y nos deja en una muy mala posición con respecto al resto de la población puesto que la mayoría no saben o conocen a ciencia cierta diferenciarnos de cada una de las situaciones.</p>

<p>Desde varios medios de información a la par que movimientos sociales, políticos, ciudadanos, participativos y demás se han abierto los debates para que cada uno dentro de su verdad exponga y de su punto de vista de lo que creen o sienten al respecto de este tema pero en la gran mayoría de estas tertulias o espacios es sorprendente ver como son las nativas las que desarrollan el tema, desde la ignorancia, sin pudor alguno. Hasta ahora no nos hemos visto reflejados en ninguno de los sentidos, esa falta de empoderamiento viene acuciado por diferentes circunstancias pero sobre todo el hecho de que aun las migrantes estamos en un segundo plano en la mesa política y solo somos nombrados cuando saltan las alarmas para generar un discurso de confusión que alimentan instintos primarios y degenerados de lo que es la realidad sobre la causa-efecto de la migración, nos hemos visto abocadas a que a todas se nos incluya en un prototipo generalizado bastante alejado a la realidad pero el común denominador para ello es el simple hecho de no haber nacido aquí, groso error repetido a la saciedad pero que de momento da sus resultados puesto que se puede ver como la ultraderecha europea va haciendo su avanzada y fijando las políticas xenófobas y fascistas a nuestro alrededor, dejándonos en un total estado de indefensión.</p>

<p>Necesitamos ser actores y dar un paso más allá, saliendo al frente de toda aquella maquinaria que nos está aplastando, discriminando y excluyendo, de sobra se sabe o esperamos que se dé por sobrentendido que estamos más que preparados para ello con la diferencia de que tanto el campo político como el de las instituciones están bastante alejados de nosotras, y ahí es donde ustedes compañeras que se encuentran ya en una posición más relevante nos echen una mano y que se haga realidad aquello de una política de puertas abiertas que es lo que confiamos y creemos quienes desde nuestras pequeñas trincheras apoyamos e impulsamos este proyecto.</p>

<p>No es necesario entrar en detalles de las distintas realidades que aquejan a la población migrante sin embargo mi motivación es la de pedir a vosotras que podáis ahondar más en ellas acercándoos hacia donde está la verdadera realidad, que nos permitáis llegar a los demás siendo nuestras propias portavoces y que empecemos a sentar unas nuevas bases de una sociedad más plural en la que cada una nos veamos realmente representadas, también soy consciente de que no todo pasa por el ámbito municipalista pero si por algo empezamos seguro estoy de que podremos llegar más lejos aun y romper con moldes y mitos mal intencionados, siendo actores y protagonistas de nuestra propia historia. Somos un numero bastante considerable y muchos estamos dispuestos a ponernos en ello solo hace falta quien nos escuche y nos permita llegar a un entendimiento para el crecimiento de esta sociedad en la que todas nos movemos.</p>

<p>Espero con esto poder llegar a quien corresponda y que de esa manera esta simple inquietud de un ciudadano migrante más pueda ser escuchada.</p>

<p> Un abrazo fraterno compañeras y orgulloso de tenerlos ahí, con la esperanza de que continuéis con el cambio tan necesario que ha empezado pero que aún queda mucho trabajo por hacer, nos habéis demostrado que nada es imposible si creemos en que podemos hacerlo, los migrantes creemos en que podemos y queremos hacerlo.</p>

<p>Ricardo Naranjo Andrade</p>

<p>Migrante.</p>
";"07/09/2015 15";"34";"9";"25";"2";"843386742";"-423"
"203";"Huertos ecológicos urbanos ";"<p>hay muchas zonas verdes y zonas vacías en toda la comunidad incluidos patios vecinales, se me ocurre poder entre todos montar huertos urbanos que nos ayuden a subsistir y a alimentarnos de una manera mas ecologica, que os parece?</p>
";"07/09/2015 15";"1108";"922";"186";"26";"870552906";"61244"
"204";"Carriles bici y reglamento de circulación";"<p>La anterior junta de gobierno del ayuntamiento se jactó de que habían creado kilómetros y kilómetros de carriles-bici la ciudad. Sin embargo, en la inmensa mayoría de los casos lo único que se ha hecho ha sido pintar señales en las carreteras. Los conductores en Madrid no están lo suficientemente acostumbrados a los ciclistas y no nos tratan como un vehículo más con su forma especial de desplazamiento, sino como un estorbo.</p>

<p>Estos ""carriles bici"" son en su mayoría un peligro, algunos de ellos incluyen bandas sonoras o calzadas de piedras que desestabilizan la bicicleta.</p>

<p>Además, el reglamento de circulación de la capital nos pone grandes trabas, no nos deja circular por carriles taxi (excepto cuesta arriba) ni por las aceras en ningún caso, vendiéndonos a los coches en situaciones bastante arriesgadas en las que personalmente he vivido de todo (adelantamientos por la derecha, obligarte a tomar una dirección errónea etc.).</p>

<p>Creo que para fomentar el transporte sostenible de manera real hace falta facilitar el uso de la bicicleta mucho más. Por una parte el cambio del reglamento de circulación para permitir la circulación de bicicletas por carriles-taxi cuando su uso no obstaculice el uso que los autobuses y taxis hacen del mismo, además de la permisión de bicicletas en las aceras en algunos supuestos como cuando la anchura de la acera lo permita y bajo condiciones de velocidad mínima). Por otra parte hace falta la creación de verdaderos carriles bici físicamente separados del tráfico rodado así como de los peatones.</p>
";"07/09/2015 15";"139";"100";"39";"30";"859998078";"4388"
"206";"Asfaltado calles principales San Blas - Canillejas.";"<p>     Sabemos que el asfaltado de Madrid, en general...está hecho una pena. Pero quiero referirme en especial, a las calles: Aquitania, Suecia, Mª Sevilla Diago y Avda. Niza. Soy conductor de la EMT (línea E2). No os haceis idea de lo que sufrimos, tanto los viajeros como los conductores. La molestia de los baches, el ruído en el interior del bus (por su mal estado de la carrocería) y, un dato; más del 70% de los conductores, necesitamos ir al fisioterapeuta, al menos, una vez al mes. No nos olvidemos de la próstata, todo el día golpeándose en el asiento y por aguantarnos las ganas de orinar porque la empresa apenas nos deja tiempo de sobra para acudir al baño. Por favor, ruego que se solucione lo antes posible, por el bien de tod@s. Gracias. Mil gracias.</p>

<p> </p>
";"07/09/2015 15";"50";"39";"11";"4";"858094240";"2184"
"207";"Recuperación del nombre de la Puerta del SOL (NO VODAFONE)";"<p>Empresas y partidos políticos han intervenido espacios públicos cambiando sus nombres y cosificándolos. Tal es el caso del metro y plaza de VODAFONE SOL. Reviértase de inmediato y devuélvase a la ciudad lo que le pertenece. </p>
";"07/09/2015 15";"2531";"2075";"456";"78";"873044832";"132731"
"208";"ABONO PARA RESIDENTES Y TURISTAS - OCIO PARA RESIDENTES (CINE, MUSEOS Y TEATRO)";"<p>Abono mensual/trimestral/anual para acudir al Cine, Teatro y Museos. Concierto con Salas de Cine / Teatros / Museos (incentivar la cultura) </p>

<p>Abono para Turistas (3,5,7 días) : Museos y transporte público.</p>
";"07/09/2015 16";"69";"55";"14";"2";"859579765";"3268"
"209";"Transporte público gratuito para alumnado de la escuela pública";"<p>En Rio de Janeiro y otras ciudades del mundo, el alumnado de primaria y secundaria recibe 60 billetes mensuales gratuitos para usarlos en el transporte público [http://www.mobilize.org.br/noticias/7973/quem-tem-direito-a-gratuidade-no-transporte-publico-como-obter-o-beneficio.html ].</p>

<p>En Madrid, hacerlo así supondría un doble beneficio: quitar coches de las calles en las horas punta y apoyar desde el Ayuntamiento al sistema educativo público (no tendría sentido subvencionar al alumnado del sistema privado, ya que su condición socioeconómica le permite pagar por algo que es gratis y de calidad: la educación pública).</p>
";"07/09/2015 16";"134";"84";"50";"13";"856590643";"2131"
"210";"Vigilancia del correcto uso de contenedores de reciclaje y sanciones";"<p>Es imagen frecuente en nuestras calles la de contenedores de papel, vidrio o envases con más cajas, botellas y latas alrededor de ellos que dentro. El rótulo que anuncia sanciones de 750 a quien haga precisamente eso es absolutamente ineficaz, habida cuenta de que la gente sabe positivamente que es imposible sufrir dicha sanción porque no hay nadie que vigile y la pueda imponer. </p>

<p>La creación de patrullas de barrio serviría, entre otras muchísimas cosas, para este cometido, siendo así medida disuasoria para los incívicos que prefieren dejar sus envases en la acera que recorrer unos metros en busca de otro contenedor.</p>
";"07/09/2015 16";"116";"85";"31";"16";"859685372";"3956"
"211";"Placas solares en los tejados";"<p>Creo que era una propuesta de Ahora Madrid, pero como aún no he visto nada sobre el proyecto, lo vuelvo a proponer: Tenemos una cantidad inmensa de tejados sin aprobechar, que solo sirven para cocinar humanos dentro de sus viviendas cuando aprieta el sol. Ya que nuestras tejas recogen tanto calor, podríamos rentabilizar esa radiación solar, colocar paneles solares y no solo obtener energía gratuita sino vender el excedente y obtener rentabilidad de la inversión. Ahorraríamos espacio en nuestro país al necesitar menos centrales de producción energéticas convencionales (están en nuestros tejados), nos independizaríamos más de los recursos fósiles, daríamos otra utilidad a nuestros tejados hasta ahora monoútiles (proporcionarnos techo), obtendríamos beneficio comercial del excedente que no usáramos y dañaríamos menos al medio ambiente. Al ser una iniciativa de alto coste y sin aceptación cultural aún, en un inicio podrían sufragarse parte de los paneles solares a los ciudadanos con menos renta.</p>
";"07/09/2015 16";"2612";"2464";"148";"88";"878475721";"218477"
"212";"El ayuntamiento deberia facilitar local para debates ciudadanos.semanales.";"<p>El los ayuntamientos, deberian facilitar LOCAL para debates ciudadanos cada semana EJEMPLO yo kiero hacer un dabate y fui al ayuntamiento de usera incluso por escrito y me dijieron que no habia,absurdo asi como podemos hacer una revolucion ciudadana las y los ciudadanos deberiamos debatir de todos los temas cada fin de semanas,claro los que podamos y los que sentimos con nuestro corazon de hacer PATRIA CAMBIOS PROFUNDOS LIMPIEZA DE POLITICOS PODRIDOS CON NUEVA CONSTITUCION saludos.</p>
";"07/09/2015 16";"55";"29";"26";"1";"849367613";"158"
"213";"Medidas drásticas para reducir contaminación atmosférica y acustica";"<p>La situación irregular de Madrid en cuanto al exceso de los límites admitidos respecto de la contaminación atmosférica y acústica hace que el ayuntamiento deba adoptar medidas rápidas y radicales en ambos aspectos. En el primer caso mediante restricciones imperativas en el uso de vehículos privados y en el segundo evitando concentracion de locales de ocio en área residenciales</p>
";"07/09/2015 16";"209";"185";"24";"6";"866273918";"14251"
"214";"COTORRAS ARGENTINAS";"<p>El ayuntamiento deberia solucionar el problema de la población de cotorras argentinas (especie exótica invasora) </p>

<p> </p>
";"07/09/2015 16";"163";"137";"26";"18";"864080938";"9329"
"216";"Recuperacion de las fiestas del dos de mayo ";"<p>Buenas tardes me dirigo a usted para la posibilidad de votacion de recuperacion de las fiestas del dos de mayo que se perdieron con los gobiernos populares del señor gallardon, como vecino del barrio de maravillas hechamos de menos estas fiestas que daban vida y cultura a nuestro barrio con actuaciones musicales puestos de comida y conciertos el dia 2 con la banda de la policia municipal y la eucaristia y ofrenda a los heroes del 2 de mayo el mismo dia citado </p>
";"07/09/2015 16";"102";"75";"27";"2";"859115134";"3529"
"217";"Por una ""redistribución"" de la economía ""residual"". Ekkomoving";"<p>Apoyar un sistema complementario de recogida residuos sólidos urbanos que, sin ser impositivo ""vinculante"", te posibilite tener una compensación económica por la entrega separada de esos mismos.</p>

<p>No olvidemos que esos ""mal llamados residuos"" una vez entregados, segregados,  nunca son regalados. ¡ Son vendidos a las Empresas que los reciclan !</p>

<p>Un sistema semejante conseguirá , al márgen de una gran recuperación de reciclaje, menor contaminación, una creacíón de una pequeña gran ""economía residual"", empleo, trabajo industrial, y sostenibilidad medio ambiental.</p>
";"07/09/2015 16";"61";"51";"10";"2";"860249205";"3427"
"218";"Limpiar Madrid";"<p>Sería importante recuperar el Madrid limpio de hace unos años, cuando daba gusto pasear por la ciudad. Hoy en día, vayas por donde vayas, especialmente por el centro, te encuentras basura por todas partes. Antes me gustaba enseñar la ciudad a mis amigos que venían de fuera. Ahora lo evito. #MadridDaAsco. Debería ser una prioridad el mantener una ciudad limpia y sobre todo la zona centro que es por donde pasan millones de personas de todo el mundo. Antes era de Madrid al cielo, ahora casi de Madrid al basurero! </p>
";"07/09/2015 16";"469";"453";"16";"14";"872249907";"42209"
"219";"Arquitectura Madrid. Concienciación y sensibilización de la ciudadania";"<p>Madrid es en general una ciudad bella si nos centramos en lo que son las partes turisticas (almendra central). Si nos salimos de esa zona y vamos a otras areas residenciales como prosperidad, ciudad lineal y otras areas de extensión que se crearon en los 60, 70 y 80 nos encontramos con una ciudad bastante fea y en la que se ha permitido mediante la falta de leyes que se haga un autentico afemiento de los edificios mediante la ampliacion de salones hacia la terraza, cerramientos de aluminio , aires acondicionados, fachadas mal mantenidas...  Pongo como ejemplo parque de las avenidas . Area que en su dia se considera como una zona buena pero que viendo las fachadas de los edificios en las que se ha permitido cerramientos discontinuos a cada residente ahora muestra una apariencia bastante pobre del barrio y por ende de la ciudad. Realizando un tour con un grupo de arquitectos europeos, todos comentaba como era posible que hubieramos permitido en madrid realizar esa atrocidad en la ciudad. En otros paises el respeto por la imagen de la ciudad va más alla que permitir a un señor ampliar el salón de su casa 4 m2. Necesitamos un plan de arquitectura general para madrid a corto, medio y largo plazo. Madrid debe dejar de ser un parche tras parche. Dar un sentido estetico y cultural a madrid que dejo de tenerlo hace muchos años. Concienciar y sensibilizar a la población de lo importante que es esto, que beneficia a todos. Las leyes deberian de ser más duras en este sentido y hacernos ver que la parte exterior de los edificios no es nuestra sino que pertenece a la ciudad y es la imagen de la ciudad. </p>

<p> </p>
";"07/09/2015 16";"73";"66";"7";"3";"862779825";"5334"
"220";"Parkings para Motos fuera de las aceras";"<p>Las aceras del centro están colapsadas con la proliferación de parkines de motos ilegales que ocupan las esquinas y las zonas más anchas de las aceras así como zonas peatonales. Podría citar bastantes, en la calle Fuencarral, Reina, Infantas, Clavel, Hortaleza con Cortés, etc. </p>

<p>Deberían eliminarse plazas de aparcamiento de coches en esas mismas calles y destinarlas a parking de motos. En los metros que ocupa un sólo coche entrarían bastantes motos aparcadas en batería. </p>
";"07/09/2015 16";"158";"126";"32";"11";"862588179";"7496"
"221";"Abuso del claxon";"<p>Lo del uso del Claxon en esta ciudad es de locos, todos los dias me despierto sobre las 7 o 7:30 con el pitido de los enfermos que en cuanto se pone el semaforo en verde siete coches mas alla ya estan pitando como locos para que la gente se de prisa en salir a ver si les da tiempo pasarlo, incluidos los profesionales del volante (buses y los abonados al claxon, los taxistas). Tambien esta el caso de alguno que le han aparcado en doble fila y le han encerrado, da igual la hora que sea, el protocolo es pitar como un loco a ver si el dueño y toda la vecindad se entera. En general se abusa muchisimo de ello, no se que se podria hacer para controlarlo de alguna manera, alguna medida hay que tomar, ya que se nos ha ido de las manos.</p>

<p>Un saludo a todos y gracias por darnos la oportunidad de participar.</p>
";"07/09/2015 16";"103";"86";"17";"7";"862198019";"5761"
"222";"Permitir circular motocicletas por arcen M30 en horas punta";"<p>Hola</p>

<p>Como usuario de motocicleta para ir a trabajar, me gustaria que se valorara la opción de que en horarios punta y tramos congestionados, las motos pudieran circular por el arcen en la M30.</p>

<p>Personalmente, lo veo menos peligroso que ir circulando entre los coches, provocando menos accidentes y asi , menos retenciones</p>

<p>Un saludo</p>
";"07/09/2015 16";"113";"65";"48";"16";"854393360";"977"
"223";"Eliminar señales que obligan a usar carril bici o acera bici";"<p>Madrid dispone de 290 km de carril bici que en el mejor de los casos sirve para uso recreativo pero no para usar la bicicleta como medio de transporte. http://www.ballenablanca.es/carril-bici-nuevo/</p>

<p>La ordenanza de movilidad no impone su uso a los ciclistas previendo el uso de la calzada para quienes usamos la bicicleta como medio de transporte. Sin embargo aún quedan algunas señales que obligan a usar estos carriles bici (aceras bici en la mayoría de los casos). El anterior gobierno comenzó a sustituir estas señales con desdén dejando algunas a escasos metros de las informativas.</p>

<p>Para fomentar el uso de la bicicleta como medio de trasnporte es importante que ninguno de estos carriles o aceras bici sean obligatorios.</p>
";"07/09/2015 16";"103";"78";"25";"10";"860004580";"4013"
"224";"Un árbol para cada alcorque";"<p>En la actualidad existe en Madrid una gran cantidad de alcorques vacíos. Por enfermedad, mala plantación o simple abandono, el árbol que lo habitaba ha desaparecido y el alcorque correspondiente ha quedado convertido en un triste agujero que acumula basura y supone una molestia y un peligro para el peatón desprevenido.</p>

<p>Mi propuesta es que el Ayuntamiento lance una campaña de recuperación de estos espacios mediante la colaboración ciudadana. En muchas calles -sobre todo del centro-, comerciantes y vecinos de la calle podríamos financiar la plantación de un nuevo árbol y vigilar su mantenimiento. El ayuntamiento coordinaría la elección de la especie adecuada para cada zona y podría dar publicidad a estas plantaciones en su página web, facilitando la difusión de las donaciones a través de redes sociales.</p>

<p>Y en donde no se pueda volver a plantar un árbol, cierre y adoquinado de la acera.</p>
";"07/09/2015 16";"1286";"1247";"39";"48";"876682860";"117136"
"225";"Iluminación Madrid Río y Puentes";"<p>Por la noche toda la zona de Madrid Río se encuentra muy oscura. Quedaría muy bonito y atraería más turismo y visitantes una mejor iluminación de las riberas del río. En Moscú , iluminan los puentes con luces LED de diferentes colores. Queda muy bonito . Me gustaría poder ver algo así en Madrid. Gracias</p>
";"07/09/2015 16";"75";"60";"15";"1";"860012025";"3600"
"226";"Prohibir publicidad en los parabrisas de los coches";"<p>Hola,</p>

<p>Creo que no soy el único que ve muchos mas inconvenientes en prohibir este tipo de publicidad que puntos a favor.</p>

<p>Generan suciedad, cabreo y malestar entre los usuarios de los coches y la calle.</p>

<p>Es algo que en muchos municipios no está permitido pero aquí si.</p>

<p>¿Qué os parece?</p>
";"07/09/2015 16";"451";"383";"68";"23";"868081270";"26750"
"227";"Readmision inmediata de los barrender@s despedidos antes y durante la huelga.";"<p>Readmision de tod@s los despedidos antes y durante la huelga de limpiezas.La subrogacion fue un fraude , para despedir a gente sin control. Durante la huelga en distrito Salamanca despidieron a personas por ese motivo.</p>
";"07/09/2015 16";"81";"54";"27";"2";"856393695";"1800"
"228";"Papeleras en la calle para reciclar y multas por tirar basura al suelo.";"<p>Nuestra ciudad vive un momento en el que la cantidad de basura exparcida alegremente por sus ciudadanos para publicitar gratuitamente por el suelo los productos que consume es excesiva. Esto supone un malgasto de recursos, ya que impuestos que pueden ir a pagar a un científico para que investigue energías alternativas u otro aspecto más relevante, irán destinados a contratar barrenderos para que podamos vivir el esplendor cultural de colorear el suelo con envoltorios. Propongo para ello se hagan campañas educativas y publicitarias en TV y prensa y que se incentive a la policía poner multas, porcentuales a la renta, al que ensucia nuestra ciudad y desvía fondos finalmente a limpiar su suciedad en vez de destinarlos a otra finalidad más útil. Y luego, a nuestras papeleras dispuestas se las podría incluir 3 compartimentos para reciclar (papel, envases y otros residuos). Esto último no es una quimera, en Burgos esto está implantado.</p>
";"07/09/2015 16";"973";"927";"46";"12";"874874299";"83934"
"229";"Administración eficiente";"<p>Estaría bien que cuando vas a hacer papeleos no tardes 3 horas porque a los funcionarios encargados les apetece tomar un café y dejen vacías las mesas. También estaría bien que no fuera necesario hacer tantos papeleos inútiles, facilitar hacer trámites por internet etc. </p>
";"07/09/2015 16";"55";"43";"12";"3";"858564595";"2423"
"230";"Quitar el erte en la limpieza ";"<p>Como vemos diariamente, las calles están sucias y descuidadas ya que no contratan gente.</p>

<p>Aparte de que no hay gente,el salario tampoco es como antes.</p>

<p>Lo que se propone es que quiten el erte y así se pueda crear mas trabajo y mas limpieza en esta nuestra localidad.</p>
";"07/09/2015 16";"91";"74";"17";"8";"861255926";"4635"
"231";"Futuro proyecto de una nueva línea de metro circular";"<p>El problema es que si quieres realizar un recorrido corto desde el punto de vista geográfico de Madrid, por ejemplo desde Las Musas a Barajas, en coche son 12 minutos y en metro o autobús son 53 minutos (este es sólo un ejemplo, hay muchísimos más) porque en vez de hacer un recorrido recto, se realiza un camino en ""L"" además de diversos transbordos, despreciando así el transporte público en pro del coche, y creo que tratamos de que Madrid pueda llegar a tener algún día un transporte un público más eficiente que el coche.</p>

<p>La cuestión es que en la situación económica actual de Madrid, es cierto que no nos podemos permitir la realización de dicha obra, pero si se nos podría permitir el planteamiento del recorrido de dicha línea y tenerlo en cuenta para las presentes y futuras nuevas construcciones además de otras incidencias que podrían encarecer su futura construcción; esta presente proyección podría ahorrarnos muchos esfuerzos y materiales en el futuro, simplemente realizando una planificación de dicha línea, cosa que actualmente no supondría mucho gasto y como he dicho anteriormente, nos evitaría sorpresas futuras.</p>

<p>En definitiva, el futuro  alguna vez se convierte en presente, asi que pensar en largo plazo de alguna manera también es pensar en un presente seguro.</p>
";"07/09/2015 16";"74";"61";"13";"5";"860807919";"3956"
"233";"Renovación y reestructuración de contenedores de residuos";"<p>Los contenedores de basuras de Madrid están obsoletos: son anti higiénicos al tener que levantar las tapas con las manos; en los contenedores amarillos muchas veces no caben las bolsas porque tienen agujeros muy pequeños; no son accesibles para personas con problemas de movilidad ya que no cuentan con palancas a una altura óptima para abrirlos; se renovaron hace 20 años; su distribución en las calles es aleatoria, ilógica y hace difícil que el reciclaje sea cómodo; los carteles que indican cada tipo de contenedor están decolorados e ilegibles...</p>

<p>Por todo esto el parque de contenedores (especialmente los de los barrios fuera de la m-30 que son los grandes que sirven para multitud de portales) debería de ser renovado y reestructurado al estilo de como están diseñados en ciudades como Barcelona o Tarragona. En donde la cubos de basura están integrados en el urbanismo de la ciudad e incluso son elementos decorativos y bonitos.</p>
";"07/09/2015 16";"122";"110";"12";"7";"864898835";"8836"
"234";"App para denunciar aparcamientos en doble fila o ilegales";"<p>¿Sería posible disponer de una app para el móvil que permita realizar denuncias de un mal aparcamiento, especialmente en casos de peligro para los demás (doble fila que impide visibilidad por ejemplo), de modo que la policía o agentes de movilidad pudiera verificar y en su caso, multar a los infractores?</p>
";"07/09/2015 16";"272";"225";"47";"12";"865556201";"14724"
"235";"Inspecciones catastrales portal a portal";"<p>Según la legislación vigente para llevar a cabo una actividad económica en un edificio residencial es necesario cambiar el uso del inmueble en el catastro, algo que en la práctica no se hace probablemente por la negativa al cambio del uso y porque, entre otros impuestos, es más caro el IBI comercial que el residencial. Propongo que a partir de los carteles de oficinas, despachos de abogados, consultas médicas, etc. que se ven en los propios portales de los edificios se contraste con el catastro virtual si dicho inmueble ostenta un uso económico o residencial, y en caso de que se esté llevando una actividad comercial en un inmueble con uso residencial, llevar a cabo una inspección llegando a sancionar al dueño del inmueble y al arrendatario (si lo hubiera) tal y como está ya previsto en la normativa.</p>

<p>Estos negocios actualmente parece que tienen total impunidad para pagar menos impuestos que cualquier ciudadano corriente.</p>

<p> </p>
";"07/09/2015 16";"38";"33";"5";"0";"859454460";"2431"
"236";"Volver a poner cabinas de fumadores en el aeropuerto";"<p>No entiendo qué daño hacían. No molestaban, nadie tragaba humo fuera. </p>
";"07/09/2015 16";"230";"69";"161";"10";"840926838";"-2760"
"238";"Baños públicos y limpios";"<p>En primer lugar, enhorabuena y gracias de nuevo por esta iniciativa, y por fomentar que los ciudadanos propongan medidas de mejora para Madrid.</p>

<p>Mi propuesta es la siguiente, quienes hayan viajado por algunas ciudades europeas en los últimos años, habrán podido observar un modelo de aseos públicos del que carecemos en nuestra ciudad y que goza de una grandísima mejora en higiene y en las condiciones sanitarias.</p>

<p>En muchas ciudades europeas existen numeroso locales en cualquier calle (sobre todo en zonas céntricas) cuyo acceso está controlado, bien sea por un empleado que te recibe en la puerta como cualquier otro comercio, o bien por un torno de acceso al establecimiento (como los del metro, por ejemplo). Pagas un precio bastante simbólico (10 o 20 cent) para acceder al recinto.</p>

<p>Una vez dentro, encuentras un recibidor, lleno de productos de higiene íntima ""urgente"" como compresas, tampones o preservativos. También lencería básica que puedas necesitar en un momento dado. Todo ello puedes adquirirlo por un precio razonable.</p>

<p>Además de este ""escaparate"" de compra de productos, existen también dentro del establecimiento unos baños de uso público impecables, ya que con las ventas que genera el espacio de ""tienda"" y la regulación de la entrada, facilita la contratación de empleados que se encarguen de la seguridad y la limpieza del local.</p>

<p>Tanto para los ciudadanos de Madrid, como de cara a los turistas, haría de nuestra ciudad un lugar más higiénico y más cívico.</p>

<p>Las calles de Madrid dejarían de oler a orina, se contratarían empleados para estos puestos de trabajo y disfrutaríamos de un día fuera de casa más placentero, sin tener que recurrir a los tan conocidos bares de suelos encharcados y baños sucios, que parece que ignoren a propósito, para evitar que a los ciudadanos se nos ocurra la valentía de pedirles ""el favor"" de usarlos.</p>
";"07/09/2015 16";"543";"483";"60";"16";"870337956";"37625"
"239";"Radiales bici de los barrios al centro";"<p>Proponemos realizarunos carriles bici desde los barrios al centro, y en los propios barrios carriles que comuniquen su centro con los respectivos carriles que van al centro.</p>

<p>Estos supondrían una revolución y dinamización en la ciudad, porque por un lado contribuyes a democratizar la movilidad y a aumentar la autonomía a un gran número de personas, jovenes y menores que no tienen carnet de conducir, gente con pocos recursos pueden aumentar su capacidad de sociabilidad y de busqueda de trabajo al aumentar su movilidad. Y por otro contribuyes a un transporte limpio, sano y sin ruido.</p>

<p> </p>

<p> </p>
";"07/09/2015 16";"386";"324";"62";"20";"867324587";"21991"
"240";"FALLO DE SEGURIDAD EN LA PÁGINA";"<p>La creación de esta página es una bonita iniciativa pero hay algo inquietante...</p>

<p>Para ser miembro activo de esta página, no hace falta más que un correo electrónico, un nombre de usuario y una contraseña, lo cual sin extenderme mucho, todos podemos llegar a percibir cuantos engaños presentes y futuros puede haber: una persona o entidad se puede crear miles de usuarios y votar a favor de sus intereses.</p>

<p>Deberían de pedir como mínimo DNI y NIF, además de estudiar la posibilidad de exigir que dicha persona este empadronada en Madrid.</p>

<p>Creo que esta propuesta (y no es por ser egolatra) es de las más importantes que puede haber aquí, ya que sin el debido control todo lo que se haga aquí es inutil.</p>
";"07/09/2015 16";"130";"95";"35";"18";"860252275";"4384"
"241";"Ampliación Linea 11 del Metro.";"<p>Actualmente la linea 11 de Metro transcurre desde Plaza Eliptica a La Fortuna, por lo que no es una alternativa válida de transporte público para ir al centro de la ciudad. Esta es la única linea de metro que no tiene acceso con un olo trasbordo al centro de la ciudad ( Callao, Sol, Plaza España, Tribunal, Bilbao, Gregorio Marañon, etc) por lo que limita mucho su utilidad. Y esta infrautilizada ver. http://ccaa.elpais.com/ccaa/2014/04/27/madrid/1398619371_206280.html</p>

<p>Sería interesante reabrir las propuestas de ampliación ya existente desde hace bastantes años y que con la crisis no se han realizado:</p>

<ul>
	<li>http://www.20minutos.es/noticia/25940/0/Aguirre/disena/Metro/</li>
	<li>http://elmadridquenofue.blogspot.com.es/2014/11/proyecto-de-ampliacion-de-la-linea-11.html</li>
</ul>

<p>Tal vez la ampliación hasta chamartín es demasiado ambiciosa pero la prolongación hasta Atocha sería suficiente en una primera fase, permitiendo unir la linea 11 con la linea 3 y 1.</p>

<p> </p>
";"07/09/2015 16";"131";"104";"27";"20";"862212093";"6112"
"242";"Fin moratoria APR Opera y regularización de la señalización y parquímetros.";"<p>El centro de Madrid es un caos circulatorio. Recientemente, el 1 de Agosto pasado y tras mucho tiempo de debate y negociaciones se puso en marcha el APR de Opera.</p>

<p>La primera decepción viene al anunciar que durante el mes de Agosto va a haber una moratoria de la ordenanza por lo que no se va a multar a los vehículos que sin estar autorizados, entren el el APR.</p>

<p>La segunda decepción viene cuando en el mes de Septiembre, la moratoria se hace indefinida, es decir, a día de hoy no se sabe cuando va a entrar en vigor, de facto, el APR de Opera ya que con la moratoria, los vehículos acceden impunemente y se saltan la norma a la torera.</p>

<p>¿Hasta qué punto el Ayuntamiento puede mantener una moratoria e incumplir la norma que él mismo ha acordado y que está en vigor desde el pasado 1 de Agosto?</p>

<p>¿A qué se debe el retraso en la implantación definitiva de la medida?</p>

<p>El acceso y abuso de los vehiculos es constante, viendo como aparcan en superficie ante la pasividad de la Policía Municipal y Agentes de Movilidad.</p>

<p>Por otro lado, si el área es un APR, ¿qué sentido tiene que siga habiendo parquímetros de la ORA si no se puede aparcar en superficie si no se es residente y por qué sigue habiendo señalización antigua que da lugar a confusión con la nueva ordenanza del APR?</p>

<p>Si no se va a aplicar la ordenanza, deroguen la medida y si no, aplíquenla con todas sus consecuencias.</p>
";"07/09/2015 16";"34";"24";"10";"4";"855289808";"988"
"243";"Campañas para dar conocimiento de los servicios que presta el Ayuntamiento";"<p>El Ayuntamiento presta servicios que gran parte de los ciudadanos desconoce, y no estaría mal una campaña para darlos a conocer. Por ejemplo, a través de la web de Munimadrid es posible solicitar un servicio gratuito de enseres y muebles viejos, dar aviso de baldosas rotas en la calle, solicitar papeleras, etc. Creo que conociendo estos servicios podríamos sacarles el máximo provecho y de esta manera contribuir al mejor estado de la ciudad, ya que no veríamos muebles abandonados por la calle, o dejaríamos de quejarnos al pisar cada día la misma baldosa rota sin saber dónde llamar para que alguien lo solucione.</p>
";"07/09/2015 16";"105";"88";"17";"0";"862467499";"5950"
"244";"Poder ver todos los comentarios de un usuario para descubrir trolls ";"<p>Felicitaciones por la herramienta. Creo que sería interesante que se pudiesen ver todos los posts de un usuario porque hay propuestas que parecen cachondeo y antes de denunciarlas, estaría bien poder cercionarse.</p>

<p>He abierto la etiqueta de webmaster para facilitar el que las propuestas para mejorar la herramienta en su uso se puedan ver juntas.</p>

<p>Gracias</p>
";"07/09/2015 16";"140";"104";"36";"16";"860833534";"5051"
"245";"Madrid. diario, Madrid versión original, Decide madrid y ...";"<p>Bienvenidas. Quizás sean muchas en poco tiempo y no nos dé tiempo a asimilar quien escribe en cada una y cual es su objetivo (a mi entender quizás sobre alguna) pero si escribimos con elegancia e inteligencia servirán para algo.  </p>
";"07/09/2015 16";"25";"15";"10";"2";"851438491";"300"
"246";"Más baños públicos.";"<p>Las personas que viven en el centro saben bien lo molesto que es despertar con el olor característico a meada, vómito, etc. por lo general con motivo de la fiesta nocturna.</p>

<p>Es poco coherente que se impongan multas por mear en la calle cuando no hay ningún otro sitio donde hacerlo.</p>
";"07/09/2015 16";"955";"861";"94";"24";"873048172";"69150"
"247";"Propuesta de eliminación de cargos públicos";"<p>Propongo eliminar (con la inminente dismisión de todos los cargos actualmente electos) todos los puestos de concejales y incluido el puesto de alcalde de Madrid, y formar un comite a partes iguales por los cuatro primeros partidos de las elecciones municipales y que se dedique  a aprobar/rechazar lo que se proponga a debate aquí.</p>
";"07/09/2015 16";"138";"34";"104";"1";"842445588";"-1724"
"248";"Empresa Madrid Calle 30";"<p>La empresa mixta Madrid Calle 30 (Acciones:80% es del Ayuntamiento 20% de ACS y FERROVIAL) es una empresa creada para maquillar la financiación de la obra de la M30. Está compuesta por 13 personas (NO FUNCIONARIOS) cuyo gasto en personal para 2015 es de 921.923 euros (http://www.madrid.es/UnidadesDescentralizadas/Presupuestos/PresupuestosAnuales/Ppto2015/Proyecto2015/FicherosProyecto2015/tomo4_proy_2015.pdf) </p>

<p>Donde el Consejero Apoderado su sueldo es de: 109.854 euros</p>

<p>Donde el Gerente (nombrado a propuesta de ACS y FERROVIAL) su sueldo es de: 101.669 euros.</p>

<p><strong>Esta empresa no es capaz de generar beneficios ni económicos ni sociales para Madrid. Proponemos que se municipalice el servicio que presta y sean los funcionarios del Ayuntamiento de Madrid quienes los gestionen. </strong></p>

<p>Más info: http://www.mc30.es/</p>
";"07/09/2015 16";"273";"239";"34";"21";"867393587";"17946"
"249";"Mesas de pin-pong en los parques";"<p>Propongo que haya más mesas de pin-pong en los parques, incluido en el Retiro, que hoy en día apenas hay espacios para practicar dicho deporte.</p>

<p>Muchas gracias</p>
";"07/09/2015 16";"131";"102";"29";"5";"861638983";"5683"
"250";"Carril Bici";"<p>Propongo que se multe a los ciclistas que vayan por la carretera en aquellos lugares, que exista carril bici. Porque se han hecho carriles bici quitando lugares de aparcamiento, que luego no utilizan los ciclistas.</p>
";"07/09/2015 16";"158";"61";"97";"11";"841022435";"-1389"
"251";"Infraestructuras para Las Mercedes";"<p>Las Mercedes era un polígono industrial que con la burbuja inmobiliaria se convirtió en una mezcla de zona residencial (conviviendo vivienda libre con apartamentos turísticos por su cercanía a la que iba a ser villa olímpica), comercial y empresarial, manteniendo suelo industrial.</p>

<p>La parte comercial, Centro Comercial Plenilunio y Makro, va a ser incrementada con Aldi, Bahuaus y Leroy Merlin y la residencial con nuevas promociones.</p>

<p>Los accesos y el transporte público (línea 77) no son suficientes para este desarrollo y el proyecto de apeadero de Cercanías de O'Donnell para que paren los trenes CIVIS que ahora sólo pasan por el barrio, se quedó en proyecto.</p>

<p>Parte de los desplazamientos, en coche por el punto anterior, son motivados porque no hay colegio en el barrio. Se construyeron dos guarderías municipales supongo que sin pensar que los niños crecen.</p>

<p>Por todo ello, creo que es importante que el nivel de servicios esté al nivel de la demanda presente y futura.</p>
";"07/09/2015 16";"49";"39";"10";"7";"858951788";"2308"
"252";"Que la Comunidad de Madrid haga una web participativa como esta";"<p>No es competencia del ayuntamiento, pero por favor, queremos esto mismo en la Comunidad de Madrid para las competencias de transportes, sanidad, educación, etc</p>
";"07/09/2015 17";"424";"373";"51";"4";"869166335";"28326"
"253";"Apoyar a centros autogestionados y facilitacion de licencias adaptadas.";"<p>Muchas ciudadanas al arranque de la crisis y tras el 15M hemos iniciado la creacion de espacios independientes gestores de una cultura libre. Arriesgamos nuestros ahorros y pusimos en pie proyectos autogestionados a favor de nuestros barrios enfrentamos una dura lucha con una estructura poderosa institucional que boicoteo nuestra visibilidad y persiguio el cierre de salas, teatros, galerias, talleres, museos, ect. Negando nuestra existencia en el plano de la ciudad, robando proyectos y fagocitando las pequeñas iniciativas hasta su cierre o desaparicion. </p>

<p>Queremos un marco flexible que nos permita existir en igualdad de oportunidades. Solicitamos licencias logicas adaptadas al uso de nuestros espacios. No podemos competir con las fundaciones y su cultura elitista, ni somos el madrid arena para cumplir una reglamentacion de macroespectaculos. Somos red, somos espacios culturales independientes y libres, somos cultura y existimos pese a no tener apoyos. Reclamamos acompañamiento institucional a nuestra labor y reclamamos una cultura vinculada a la autogestion y sus valores.</p>

<p>Proponemos crear un mapa de espacios independientes que atiendan a una serie de valores, calidad, transformacion social, apoyo a colectivos y conexion internacional. Y que el ayuntamiento apoye de verdad con medidas de urgencia la labor que estamos desarroyando en nuestros espacios. Queremos defender la cultura, pero una cultura alejada de las barras de bar y la hosteleria, una cultura que de valor a los artistas, los creadores y que sea transformadora de la sociedad. Una cultura de resistencia que refleje las luchas sociales, que de lugar a los vulnerables y respete la diferencia y de voz a las minorias.</p>
";"07/09/2015 17";"74";"44";"30";"1";"853975773";"832"
"254";"Mediateca / Biblioteca en Montecarmelo (Fuencarral-El Pardo)";"<p>En Montecarmelo, y supongo que en los barrios nuevos, hay carencia de muchos servicios. Pero sobre todo en estos barrios nuevos donde las comunidades son grandes y cerradas en sí mismas se necesitan más puntos de encuentro para hacer cultura de barrio. Propongo la creación de una mediateca, con préstamos de libros y audivisuales, que además sirva para concentrar iniciativas para promover la lectura.</p>
";"07/09/2015 17";"47";"38";"9";"1";"858993349";"2344"
"255";"Transporte gratuito para desempleados sin prestación";"<p>Para los desempleados que cobramos la RAI o no cobramos ninguna prestación, el transporte debería ser gratuito mediante algún tipo de abono especial. Muchas veces tenemos que patearnos Madrid de arriba abajo para entregar curriculums o ir a cursos, y no podemos costear el gasto del transporte. Debería estudiarse en el caso de parados que cobran prestaciones cual es la situación familiar y subvencionar el transporte a cada uno según la situación. En cualquier caso, que sea siempre gratuito para los que perciben menos del salario mínimo interprofesional o no tienen derecho a ninguna prestación.</p>
";"07/09/2015 17";"506";"424";"82";"32";"868488959";"28657"
"256";"Bosques";"<p>Buenas tardes,</p>

<p>Mi propuesta trata de crear Bosques en Madrid, principalmente en la zona Sur-Oeste, Sur, Este y Sur-Este.</p>

<p>He vivido 26 años en Madrid y muchos de los que vinieron para hacer dinero no han dejado muchas cosas a Madrid.</p>

<p>creo que Madrid se merece comprar suelo abandonado  y recuperarlo para hacer bosques donde por un lado se crearían puestos de trabajo para mantenerlos y se crearían zonas donde la gente puede ir a pasar el día libre. Además, ello le daría a Madrid un plus en belleza como presentación al mundo exterior y evitaría su degradación paisajística.</p>

<p>No se trataría de hacer monumentos, ya que ya está todo muy recargado de mobiliario urbano, sino bosques. Si se hicieran construcciones, lo ideal sería hacer pueblos de piedra, etc. Revaloricemos la ciudad con materiales de calidad y duraderos como la piedra.</p>

<p> </p>

<p>Saludos</p>

<p> </p>
";"07/09/2015 17";"283";"261";"22";"11";"869128045";"22042"
"257";"USO PATINETE ELECTRICO";"<p>CREO QUE SE DEBERIA LEGISLAR SOBRE EL USO DEL PATINETE ELECTRICO, CREO QUE ES UNA FORMA DE DESPLAZARSE POR LA CIUDAD SIN CONTAMINACION</p>
";"07/09/2015 17";"75";"49";"26";"13";"856517223";"1502"
"258";"Retirada del genocida General Yagüe del callejero de Madrid";"<p>En el distrito de Tetuán existen varias calles de militares franquistas, pero uno de los casos más sangrantes es la calle dedicada al genocida General Yagüe, el carnicero de Badajoz, responsable de miles de asesinados. Para los vecinos de la zona es una vergüenza tener una calle dedicada a tal personaje y una apología en sí mismo del terrorismo y el asesinato.</p>

<p>Propongo cambiar el nombre de la calle a uno de una persona conocida por haber defendido las libertades civiles, mejor si es una mujer, a modo de homenaje. Se me ocurre el de Petra Cuevas, una vecina de Tetuán de esas que han sido olvidadas por las instituciones hasta este momento. Petra Cuevas fue encarcelada por coser para el Ejército republicano y pasó muchísimos años en las cárceles franquistas. Fue una persona que destacó por su lucha por los derechos de los trabajadores y las mujeres en general.</p>

<p>Aquí una reseña tras su muerte el pasado 24 de febrero de 2014: http://politica.elpais.com/politica/2014/03/28/actualidad/1395965241_500309.html</p>
";"07/09/2015 17";"290";"189";"101";"16";"860010956";"5735"
"259";"Donaciones ";"<p>Es muy complicado donar ropa y libros en la zona centro, la información al respecto es escasa, y no existen contenedores de ropa para poder depositarla rapidamente. Hay organizaciones sociales que aceptan donaciones de ropa, pero en horarios que no son compatibles con el horario laboral. En cuanto a los libros averigüé que en alguna biblioteca pública aceptaban donaciones, pero me costó localizar la información.</p>

<p> </p>
";"07/09/2015 17";"80";"69";"11";"4";"862466860";"5002"
"262";"Biblioteca en San Fermin (Usera)";"<p>Una biblioteca pormetida en 2008 y prorrogada hasta 2018. San Fermin es un distrito donde más exclusión social hay, y donde más se han destruido las asocaciones vecinales. Creo que el acceso a la cultura haría que estas cifras no fuesen tan horribles.  Pido por favor, que la cultura sea algo accesible para todas las personas y no se vea como un gasto si no como una inversión.</p>
";"07/09/2015 17";"40";"34";"6";"3";"859606443";"2380"
"263";"No al trabajo voluntario en el Ayuntamiento de Madrid";"<p>El otro dia vi con estupor el anuncio de que iban a ser voluntarios los que estaban siendo formados para trabajar en las labores de participación. </p>

<p>https://www.facebook.com/770904446353931/photos/a.774424556001920.1073741828.770904446353931/797306053713770/?type=1</p>

<p>Los servicios y prestaciones que presta el Ayuntamiento de Madrid han de ser trabajadores remunerados y elegidos conforme a un criterio profesional. No solo porque los ciudadanos paganos impuestos, sino porque la ""voluntariedad"" y ""gratuidad"" de los trabajos socaba los derechos laborales, ya suficiente mermados, produciendo un incremento de la precariedad laboral. Una ciudad que soporta más de un 20% de paro, no puede permitirse que trabajos profesionales se desempeñen de forma gratuita. Si no hay presupuesto para el personal de un servicios, pues o se aumenta el crédito o no se hace. Pero lo primero es la dignidad de las personas.</p>
";"07/09/2015 17";"122";"72";"50";"20";"855740882";"1298"
"264";"PUNTO LIMPIO ARGANZUELA";"<p>SERIA CONVENIENTE CAMBIAR DE UBICACION EL PUNTO LIMPIO DE CALLE AMALTEA, ES UN LUGAR MUY CONFLICTIVO Y DA LUGAR A MUCHAS QUEJAS VECINALES. SOLO TIENEN QUE COMPROBAR LAS LL,AMADAS A POLICIA NACIONAL Y MUNICIPAL. ¡¡¡ POR FAVOR CAMBIEN SU UBICACION!!!!</p>

<p> </p>

<p> </p>

<p> </p>

<p> </p>

<p> </p>

<p> </p>
";"07/09/2015 17";"40";"25";"15";"5";"853819904";"625"
"265";"Aparcamiento gratis para bicis en Parkings Municipales";"<p>Una medida sencilla y barata para fomenta el uso de la bici y limitar el del coche es dedicar en cada parking municipal de Madrid varias plazas para aparcar bicis de forma gratuita y segura.</p>

<p>En solo 4 plazas de coches podrían caber más de 40 bicis (hay sistemas para poder dejarlas en 1 alturas o en vertical) y estarían vigiladas contra robos, que es el principal inconveniente que existe en Madrid para ir al centro con la bici, sobre todo si es un poco buena, y es que no te dura atada ni 2 horas.</p>

<p>Muchas gracias.</p>
";"07/09/2015 17";"900";"792";"108";"26";"872223006";"60191"
"266";"ARREGLAR LOS REBAJES DE LOS BORDILLOS PARA FACILITAR EL PASO DE SILLAS DE RUEDAS";"<p>El mal estado de las calles y aceras ha hecho que en muchos casos el firme de la calzada se separe del bordillo, creando una ""hendidura"" que dificulta el paso de las sillas de ruedas al engancharse las ruedas. En otros casos, al arreglar las aceras han elevado su altura respecto a la calzada y queda un pequeño reborde que no es salvable por una silla de ruedas (aunque sí lo sea por un carrito de bebé o una bicicleta) ya que su rango de subida es muy limitado.</p>

<p>
PROPONGO mejorar el estado de las aceras y especialmente de los bordillos en las zonas de cruce, de manera que se facilite la movilidad de todas las personas, también de aquéllas con movilidad reducida.
 </p>
";"07/09/2015 17";"2023";"1977";"46";"31";"879372476";"188709"
"267";"Cambiar o quitar los bolardos de Malasaña";"<p>La mayoría de las calles de Malasaña (p. ej. la Calle la Palma) tienen <strong>aceras muy estrechas</strong>. Además estas tienen <strong>bolardos muy molestos</strong> y muchas veces la gente acaba dándose con ellos. En general, la gente suele preferir andar por el medio de la calle que ir esquivando bolardos y gente en la acera.</p>

<p>Si no se elimina la circulación rodada de estas calles, propongo que <strong>se retiren los bolardos</strong> o que se cambien por otros más visibles, o menos molestos, o con aristas más redondeadas.</p>

<p>Este mensaje lo pongo tras descubrir que además de mí, hay muchos otros que han golpeado varias veces estos elementos.</p>

<p> </p>
";"07/09/2015 17";"79";"60";"19";"9";"859724138";"3113"
"268";"Recuperar Frontón Beti-Jai";"<p>Pienso que se debería recuperar esta joya arquitectónica del distrito de Chamberí. Es increíble que esté agonizando, que un edificio tan maravilloso esté cerrado y no haya habido hasta ahora voluntad institucional de reformarlo (será por el gran valor del terreno??). Comienzo este debate porque es de recibo que en Madrid se impulse la reforma de este recinto, uno de los más significativos en España fuera del País Vasco y Navarra. Se le podrían dar todo tipo de usos además del juego de pelota originario, como edificio histórico que es.</p>

<p>Un saludo</p>
";"07/09/2015 17";"373";"342";"31";"14";"870172672";"28515"
"269";"Ciclocarriles por todo Madrid";"<p>Propongo que se adopten las medidas de fomento de la bici como alternativa al coche y de calmado del tráfico que nadie se ha atrevido a tomar:</p>

<p>1-Control de la doble fila</p>

<p>2- Control real de la velocidad de los coches</p>

<p>3- Extensión de los ciclocarriles a toda la ciudad (han provocado un gran aumento de tráfico ciclista en el centro a costa del coche. quiero disfrutar de esto también en mi barrio)</p>

<p>4- Encuentro los carrilees bici peligrosos. TODOS los de la ciudad tienen zonas muy peligrosas. No quiero gastar 300-800 /m en ese xperimento cuando se puede gastar en acoger refugiados sirios y de cualquier parte del mundo (o en servicios sociales)</p>

<p>5- No quiero medidas de sustitución caras e insuficientes como carriles bici y otras chapuzas. Si tantos ingenieros haciendo tantos en 30 años no han hecho uno bueno en Madrid, es que o son muy difícles (y mejor no intentarlo a ese precio y con esa probabilida e fracas) o no son tan buena idea.</p>

<p>Por estas 5 razones pido ciclocarriles por todo Madrid, aparcabicis, control de la doble fila y de los exceso sangrantes de velocidad.</p>
";"07/09/2015 17";"190";"156";"34";"9";"864491072";"10016"
"270";"Revisión (no retirada) del nombre de calles relacionadas con la dictadura ";"<p>Ante las actuales noticias acerca de la retirada de ciertos nombres de las calles de Madrid para la aplicación de la Ley de Memoria Histórica, desde hace tiempo vengo tratando dicho problema con asociaciones como Foro por la Memoria, elaborando un proyecto que permitía una solución que, a mi juicio, respetase la mencionada memoria. Al querer conservar el componente de memoria histórica creo que la retirada de todos esos nombres lo único que hace es vulnerarla.</p>

<p>Si es cierto que ciertas calles hacen alusión directa a genocidas como General Yagüe o Muñoz Grandes, otras calles como Cerro Garabitas o Batalla de Belchite mencionan sucesos históricos de la Guerra Civil, parte tan trágica como fundamental de nuestra historia para comprender nuestro país. Muchas de esas menciones, e incluso otras que tengan que ver con otro tipo de cuestiones, podrían servir como eje tanto de conocimeinto incluyendo una biografía, descripción y/o información del nombre o suceso mencionado en la placa de la calle, como tienen muchos ayuntamientos de España.</p>

<p>De eso trata la primera parte del mencionado proyecto: http://miguelangelrego.com/index.php/project/espacios-para-la-memoria-i/</p>

<p>Por otra parte también existe la posibilidad de elaborar e incluso usar una aplicación de realidad aumentada (de muy fácil uso) como la que  desarrollé como segunda parte del proyecto, donde a través de un dispositivo móvil cualquier ciudadano puede obtener dicha descripción a modo de información. Esta aplicación es completamente gratuita. En el enlace se puede ver una descripción gráfica: http://miguelangelrego.com/index.php/project/espacios-para-la-memoria-ii/</p>

<p>Si bien hace años optaba por la retirada de todas esas menciones, creo que la memoria no se respeta en el borrado, la eliminación o la retirada, sino en hacer presente los aspectos terribles de nuestra historia para que nunca se vuelva a repetir.</p>

<p>Existe, por tanto, la opción de eliminar ciertos nombres polémicos de las calles como General Yagüe, manteniendo las alusivas a sucesos, días históricos (a mi juicio preferible)... Por otra parte también existe la opción de mantener todos los nombres de las calles incluyendo la mencionada información (más problemática pero también viable).</p>
";"07/09/2015 17";"138";"61";"77";"18";"842288016";"-707"
"271";"Albergue para personas sin techo en calle Carvajales  y Plaza de Peñuelas";"<p>Partiendo de la base de que me parece bien que exista este albergue en mi barrio quisiera resaltar la importancia de manejar la situación de las personas sin techo en los alrededores. La calle Carvajales (en la acera contraria al albergue) está muchísimas veces muy sucia. Los alcorques de los árboles están habitualmente con latas de cerveza, cartones de vino, ropa sucia, etc. Por su condición, algunas de las personas que se ven obligadas a usar el albergue no ponen cuidado y tiran desperdicios, etc. a la calle. En la Plaza de Peñuelas se concentran también y es imposible sentarse en un banco. El olor a pis y heces es insoportable, sobre todo ahora en verano. La Plaza está descuidadísima y sucia. Creo que habría que mantener diariamente una limpieza de la calle y de la Plaza de Peñuelas. Hay personas a las que no sólo no nos molesta sino que consideramos justo acoger a estas personas pero en el barrio hay diferentes formas de pensar y se está creando una corriente de oposición que hay que procurar que no llegue a mayores.</p>
";"07/09/2015 17";"41";"28";"13";"6";"855655400";"1024"
"272";"Enterrar la M30 y prolongar Madrid Río hasta Puente de los Franceses";"<p>Deberían prolongarse 2km hacia el norte los túneles de la M30 y el parque de Madrid Rió hasta el puente de los Franceses, ya que han dejado al obrero barrio de Casa de Campo con una autovía pegada a nuestras puertas y miles de familias que compraron su casa allí antes que la M30 fuera construida llevan décadas soportando los ruidos, humos, y una barrera con la casa de campo.</p>

<p>Además de esta manera se comunicaría la ciudad con el manzanares y la casa de campo, y se uniría Madrid Río con el paseo junto al manzanares que discurre desde el puente de los franceses hasta Puerta de Hierro.</p>

<p>Estaría bien además que pusieran una pista de patinaje en la zona, a la altura calle bahía.</p>
";"07/09/2015 17";"168";"102";"66";"26";"857282250";"2185"
"273";"Hacer respetar a los usuarios de bicicletas en Madrid que respeten las normas";"<p>Y que sean sancionados si no cumplen con la normativa. </p>

<p> </p>
";"07/09/2015 17";"187";"155";"32";"25";"864848630";"10195"
"274";"Disminuir horario de carga y descarga en el centro zona La Latina";"<p>Nos acaban de cambiar el horario de carga y descarga ,antes era 10 a 13 y ahora es de 8 a 18. El problema es que hay muchisimo espacio de carga y descarga, y casi siempre vacio. Por lo que los vecinos no tenemos suficiente espacio para aparcar, ademas de que los sabados es laborable y los domingos por el rastro tenemos que dejarlo fuera de la zona , es muy complicado estacionar.</p>

<p>La gente que tenemos niños , tenemos que llevar al cole y el problema que nos tenemos que arriesgar a dejarlo aparcado en carga y descarga. Y me imagino que habra mas gente con otros problemas.</p>

<p>Sugiero quitar parte de carga y descarga zonas o disminuir horario.</p>
";"07/09/2015 17";"33";"22";"11";"1";"854314706";"733"
"275";"Ley de seguridad";"<p>Hola.</p>

<p>Propongo que ya que la ley de seguridad no permite filmar policias. deveria llevar una camara todos los agentes. Se que madrid a echo pruevas de este tema, asique seria buena idea que funcionase en toda la comunidad y obligado. Recuerdo que la seguridad es para todos.</p>
";"07/09/2015 17";"39";"26";"13";"0";"854731875";"866"
"276";"construccion de instituto publico-zona deportiva junto al museo del ferrocarril";"<p>La educación es uno de los pilares básicos de nuestra sociedad, seguramente el mas importante. Todos queremos la mejor educación para nuestros hijos, para ello, no solo tenemos que decirlo, tenemos que ofrecer los medios necesarios a nuestros profesores.</p>

<p>Propongo la construcción de un instituto situado en los terrenos situados entre el museo del ferrocarril, las calles Parroco Eusevio Cuenca y la calle de las Nebulosas. He elegido esta ubicación al estar situada en una zona tranquila sin mucho trafico en las cercanías pero situada en el centro del barrio de Delicias y que puede dar servicio a los residentes de los barrios de Legazpi, Chopera, Palos de Moguer y Atocha.</p>

<p>En esta zona del distrito de Arganzuela no existe ningún instituto publico en las proximidades y todos los colegios de las cercanías están masificados (Tirso de Molina, Miguel de Humamuno, Placio Domingo), hay que construir un instituto de gran tamaño y que disponga de aulas bilingues y aulas normales. seria básica la realización de un estudio para calcular el tamaño del mismo y tener prevista la ampliación del mismo si fuese necesario.</p>

<p>Muy interesante seria consultar a profesores el diseño del instituto para que tenga todo lo necesario para ser un centro puntero y acorde al siglo XXI y con capacidad de adaptación ante nuevas necesidades futuras.</p>

<p>Recientemente ley un informe donde indicaba que por cada euro invertido en deporte ahorras 3 euros en sanidad en el futuro. Este motivo junto a los valores de compañerismo, esfuerzo y solidaridad que favorece el deporte y que cada minuto pasado por nuestros jóvenes haciendo deporte es tiempo aprovechado en algo bueno para ellos y evita que pueda ser invertido en otras actividades no tan saludables, hacen esencial que las instalaciones deportivas sean fundamentales tan amplias y variadas como el terreno lo permita.</p>

<p>Ante la escasa cantidad de instalaciones deportivas en la zona, se podría estudiar la posibilidad de poder permitir el uso de estas instalaciones deportivas así como la biblioteca del instituto fuera del horario escolar para que el resto de habitantes del distrito pueda disfrutarlas, siempre garantizando la seguridad y el buen uso de las mismas y delimitando horarios para que no sea ninguna molestia para los vecinos.</p>

<p>un saludo </p>

<p> </p>

<p> </p>
";"07/09/2015 17";"72";"58";"14";"5";"860669181";"3544"
"277";"Eliminar SER Estacionamiento Regulado de los Barrios Obreros";"<p>Una imposición del Nefasto Gallardon a los habitantes de los barrior obreros de la Capital como El Pilar La Paz etc. cuya unica utilidad ha sido recaudar mas dinero para que se pudieran pagar los enormes sueldos de los enchufados metidos como asesores en el Ayuntamiento. Se hizo en nuestra contra. (Meses de lucha y cienmtos de kg. de pintura rosa ) Y no ha servido de nada , mas que para agobiar a los abuelos que visitan a sus nietos porque han de cambie el ticket o salir de la zona.y esquilmar a los vecinos (muchos en paro ) que han de pagar para sacar tarjeta de Residentes. Mantengase en el Centro pero dejennos a la gente obrera de sangar mas. Somos Ciudadanos Y SI SE QUIERE SE PUEDE</p>

<p> </p>
";"07/09/2015 17";"99";"55";"44";"7";"853460792";"611"
"278";"Crear soporte en centros de tercera edad para facilitar su participación aquí";"<p>Creo que la gente mayor tiene mucha experiencia a aportar y no suelen saber usar herramientas como esta donde nos enriqueceriamos mucho con su experiencia. También gente con problemas de mobilidad porque quien ha tenido dificultades grandes suele tener la sensibilidad a los problemas más desarrollada. Estaría bien que en los centros del ayuntamiento para estas personas se facilitara soporte para que participaran.</p>

<p>También podría ser interesante hacerlo en colegios para que los niños aprendiesen desde pequeños a participar.</p>

<p>Un placer de herramienta, gracias</p>
";"07/09/2015 17";"60";"50";"10";"1";"860699683";"3333"
"279";"Puesto de BiciMad en la cuesta de Av Pablo Iglesias.";"<p>Creo que sería mas que conveniente el instalar un puesto de BiciMad despues de la cuesta de Av Pablo Iglesias, Ya está señalizado el carril bici, y es una zona con una cuesta muy pronunciada donde estoy seguro que el motor electrico de estas bicis podrá superar sin problemas, es una zona residencial con muchos vecinos que estarían encantados con un puesto de bicis electricas que les permitiera acceder al centro en este transporte tan barato y cómodo.</p>
";"07/09/2015 17";"40";"26";"14";"4";"854599072";"780"
"280";"calatrava";"<p>Desde 1960 no se tocaba una baldosa en la calle calatrava, por fin se estan renovando y ensanchando las aceras para que no tengamos que circular por la calzada, espero que no sea la unica calle de esta castigado centro que se adecente. ahhh y mas bancos y menos terrazas.</p>
";"07/09/2015 17";"22";"10";"12";"1";"846153896";"-90"
"281";"Los sueldos de los Concejales";"<p>Me parece estupendamente que se haya decidido la rebaja de sueldos de los Concejales de Gobierno en el Ayuntamiento de Madrid hasta tres veces el salario mínimo interprofesional pero lo que no me gusta es que la diferencia hasta el salario que está establecido se destine al partido de turno o incluso destinarlo a las obras sociales que el concejal que corresponda estime. Creo que ese dinero sobrante se debe quedar en el Ayuntamiento como un menor gasto del presupuesto. ¿O seguimos siendo ""casta""?</p>
";"07/09/2015 17";"58";"31";"27";"7";"851327004";"213"
"282";"Polideportivos municipales a precios asequibles";"<p>Vivo justo enfrente del polideportivo de Aluche y, como a muchos amigos, nos encantaría utilizarlo. Sin embargo, mi marido tiene que ir a un gimnasio privado más lejos de casa porque la mensualidad para el uso libre (sin monitor ni nada) de las instalaciones del polideportivo es de casi 50 euros, lo que a mi entender es una barbaridad para un servicio supuestamente público. </p>

<p>Me parece totalmente desproporcionado que haya que pagar casi 600 euros anuales por persona para utilizar unas instalaciones que se supone que se sostienen con fondos públicos. A no ser que esté privatizado como casi todo y algun amigo de alguien tenga que ganar mucho dinero con esto, no se entiende.</p>

<p>Creo que es correcto abonar una cuota para que las personas que hacen uso de las instalaciones contribuyan a su mantenimiento más allá de los impuestos de todos, pero todo lo que pase de 20 ó 25 euros máximo me parece un despropósito y dudo que muchas familias de barrios obreros como éste se lo puedan permitir.</p>

<p>Salu2.</p>
";"07/09/2015 17";"356";"321";"35";"17";"869570596";"25788"
"283";"Restaurar autobuses nocturnos L";"<p>Hace unos años había unas líneas de autobuses nocturnas todos los días de la semana que hacían el recorrido de los metros pero por encima de la tierra. Creo que los ciudadanos podemos entender que abrir el metro por la noche puede ser complicado. Pero es necesario mejorar el transporte nocturno y, creo, la meor manera sería recuperar los autobuses L. Las ventajas sobre abrir el metro serían:</p>

<ul>
	<li>  Potencialmente más barato.</li>
	<li>  Mayor frecuencia al ser menor en convoy.</li>
	<li>  Más seguro, un metro vacío puede ser peligroso, mientras que un autobús siempre tiene un conductor.</li>
	<li>  Respecto a los autobuses N, las líneas L permiten no pasar por cibeles, además de que el recorrido nos es conocido por ser el mismo que el del metro. </li>
	<li>Los autobuses por la noche van muy rápido, por el poco tráfico.</li>
</ul>

<p>Un saludo,</p>

<p>Eduardo</p>
";"07/09/2015 17";"468";"424";"44";"4";"870756507";"34427"
"284";"Mejora del transporte público sureste";"<p>Mejorar el transporte público de Rivas, Arganda ...</p>
";"07/09/2015 17";"30";"20";"10";"1";"854133496";"666"
"286";">Unir VillaVerde con Madrid peatonalmente";"<p>La rotonda de la M-40 con la Avenida de Andalucía es una barrera para cruzarla peatonalmente, no hay espacio apenas para los peatones y los carriles bici se cortan ahí y sin continuidad. Debería hacerse una plaza que permita la continuidad del paseo y que peatonalmente estemos de una vez unidos al resto de Madrid, hacer una plaza más amable y accesible.</p>

<p>La M-40 es una barrera para el distrito y debería dotarse de más puentes que unan VillaVerde con el resto de Madrid, o cubrir una parte de la M-40 a su paso por VV</p>

<p> </p>

<p> </p>
";"07/09/2015 17";"84";"68";"16";"7";"861470393";"4209"
"287";"Protección contra atropellos en semáforos y pasos de cebra.";"<p>Propongo la instalacion de dos sencillos bolardos, uno a cada lado de la cera y al borde de la misma, con el fin de proteger contra atropellos por despistes de conductores. </p>

<p>Cuando esteis esperando en un paso de cebra daros cuenta de la indefension que tienen nuestros hijos y nosotros mismos frente a un atropello, ahora imaginad un bolardo portegiendo todas esas vidas.</p>

<p>El coste es muy bajo, ya que son elementos existentes en el ayuntamiento, hay miles para reparacion y nuevas instalaciones. </p>

<p>Tambien pido al ayuntamiento que cuando se tomen este tipo de medidas, no se haga solo el los barrios de alto poder adquisitivo, por que creo que en algun distrito esto esta hecho, pero en barrios como Vallecas estamos totalmente desprotegidos y nuestras vidas valen lo mismo, al menos eso dice nuestra constitucion.</p>

<p>Creo que serian los bolardos mas utiles del mundo.</p>
";"07/09/2015 17";"57";"31";"26";"9";"852085661";"271"
"288";"Campaña por barrios ""Conoce la papelera"" (y refuerzo policial para multas)";"<p>Porque Madrid lo vale. Como ciudadano me siento orgulloso de la mayoría de mis vecinos de Madrid pero hay una buena parte de mis vecinos que sufren algún trastorno educativo grave porque hacen de Madrid una ciudad guarra. Muy guarra. Cacas de perros abandonadas, papeles en el suelo, cajas de pizza en los parques, pintadas en los colegios, bolsas de basura en la acera...</p>

<p>MI PROPUESTA ES: Hacer pública una campaña ""Conoce la papelera""</p>

<p>ACTUACIÓN:</p>

<p>- Que cada barrio cuente con 15 días consecutivos de campaña</p>

<p>- Que el barrio cuente con carteles informativos reutilizables para informar de la campaña y de que habrá refuerzo policial para su cumplimiento</p>

<p>- Asignar un refuerzo policial adecuado al tamaño del barrio con la misión de vigilancia de parques, bocas de metro, entradas/salidas de institutos, zonas de copas...</p>

<p>- La policía tendrá orden de hacer cumplir la ley en cuestión de limpieza de calles.</p>

<p>- Se requerirá de un refuerzo por parte de los servicios públicos de limpieza para el vaciado de los contenedores de reciclaje y las papeleras.</p>

<p>Ruego vuestro apoyo ya que va en beneficio de todos.</p>
";"07/09/2015 17";"132";"115";"17";"3";"864828419";"8537"
"289";"Polideportivo Municipal en la Pza de la Cebada (de una vez)";"<p>Se me ha olvidado los años que hace ya desde que el Sr. Gallardón nos derribó el único polideportivo del Distrito Centro dejándonos sin la piscina climatizada de la que tanto disfrutábamos los vecinos durante todo el año, con sus puertas acristaladas móviles y su terracita y mini jardín para tomar el sol cuando hacía buen tiempo. Es hora de recuperar lo que nos pertenece y nos quitaron con tan malas artes. Polideportivo en la Pza de la Cebada ya. </p>
";"07/09/2015 17";"167";"144";"23";"8";"865494984";"10433"
"290";"Remodelación Gran Vía de Villaverde";"<p>La construción de la Gran Vía de Villaverde se suponía que era para conectar mejor los barrios de Villaverde Bajo y de San Cristóbal de los Ángeles, pero no ha sido así en ningún caso. De hecho no se han terminado de construir todas las calles que conectan dicha Gran Vía con el barrio de Villaverde Bajo (como la calle Martínez Oviol). Otra cuestión son las enormes jardineras de piedra que ocupan todas las aceras de ambos lados de la Gran Vía (estando una acera totalmente inutilizada, ya que entre la jardinera y la valla casi no entra una persona). Dichas jardineras impiden a los peatones hacer uso de las aceras, por lo que se ven obligados a invadir la acera-bici molestando a los ciclistas y ocasionando alguna que otra riña. Estas jardineras resultan ridículas ya que los árboles que había en ellas están secos o no pueden crecer en las condiciones adecuadas. Sería muy útil, tanto para peatones como para ciclistas, que se eliminaran las dichosas jardineras y que se terminaran de construir todos los accesos. Así como rehabilitar el paso subterráneo que existe entre Villaverde Bajo y San Cristóbal de los Ángeles (Parque de los Pinos), es verdad que se construyó un pequeño muro de contención de aguas ya que cuando llovía el paso se inundaba y no se podía pasar andando de un barrio a otro, aún así se debería reformar.</p>
";"07/09/2015 17";"40";"30";"10";"3";"857363860";"1500"
"291";"Recuperemos el panorama musical de la ciudad";"<p>Todos los madrileños somos conscientes del deterioro que ha sufrido el panorama musical y cultural madrileño durante estos últimos años. Los grupos de rock y otros estilos que hacen giras mundiales ya no vienen a Madrid, la escena musical electrónica madrileña ha caído en desgracia y mucha culpa la tiene una política cultural casposa y anticuada que ha privilegiado ciertos tipos de ""cultura"" frente a otros. </p>

<p><strong>Si queremos que Madrid sea una ciudad europea y cosmopolita como París, Londres o Ámsterdam, nuestro Ayuntamiento tiene que promover e incentivar espacios, eventos y actividades que vuelvan a poner a nuestra ciudad en el mapa musical europeo, siempre respetando el descanso de nuestros vecinos. </strong></p>

<p>Un buen ejemplo es la fiesta de la música de París, en la que decenas de grupos toman las calles y hacen bailar tanto a jóvenes como a familias y mayores. </p>

<p>Alcaldesa y concejales, ¡<u>os reto a volver a hacer de Madrid una ciudad musical y cosmopolita</u>!</p>
";"07/09/2015 17";"563";"502";"61";"20";"871096607";"39321"
"292";"Arreglar calle Alquitania";"<p>La calle Alquitania (de Plaza Alsacia a Av de Canillejas a Vicálvaro), de unos 2 km de largo no tiene ni 10 metros seguidos sin desperfectos en el azfalto. </p>

<p>Es un peligro circular por ella, sobretodo en motocicleta.</p>
";"07/09/2015 17";"31";"21";"10";"6";"854957395";"745"
"293";"Cierre de la Depuradora de la China";"<p>La Depuradora de la co-China es una depuradora antigua y que no cumple los mínimos establecidos. Ha sido en todas las elecciones citada como promesa para su cierre definitivo pero luego ningún político cumple sus programas. Llena los barrios de alrededor de malos olores, mosquitos, etc. está dentro de Madrid y es infame.</p>

<p>Para colmo está al lado de la Caja Mágica, lo que hace que los olores allí sean a veces nauseabundos. Debería cerrarse de una vez y aprovechar el espacio para meter allí un polo de atracción para el Sur de Madrid, y equilibrar la ciudad, una ciudad tan descompensada y desequilibrada, e injusta con el Sur.</p>

<p>Y además se podría volver a reabrir el acceso a Usera, VillaVerde y Caja Mágica de la M-40</p>

<p> </p>

<p> </p>
";"07/09/2015 17";"59";"49";"10";"12";"861015205";"3238"
"294";"Nadie sin techo";"<p>Cada año aumenta en Madrid el número de personas sin techo. Que haya una sóla persona viviendo en la calle, el nivel máximo de exclusión social y marginación a la que esta sociedad puede conducir, es un fracaso de todos y un atentado contra los derechos humanos más básicos. Es necesario un plan urgente e integral para revertir esta situación y para que nunca más se llegue a esto. Se calcula que en Madrid hay más de 3.000 personas en esta situación, una catástrofe humanitaria que como tal debería tratarse como asunto de primer orden. Y para esto hay dinero, sólo con el dinero público que ha ido a parar a paraisos fiscales se solucionaría la situación de estos ciudadanos, o dejando de pagar deuda ilegítima que enriquece injustamente a los círculos que la generaron.</p>
";"07/09/2015 17";"266";"212";"54";"10";"865083402";"12592"
"296";"Más accesibilidad en el Metro";"<p>Soy consciente de que la remodelización y obras en el metro son un gasto importante para la comunidad de Madrid, sin embargo, creo bastante necesario la mejora de la accesibilidad al metro, sobre todo en algunas estaciones. </p>

<p>Son muchas todavía las estaciones en las que si eres minusválido o te has roto una pierna no puedes acceder dado que no hay ascensores y muchas veces las escaleras mecánicas no funcionan. La estación que más sorprende por su poca accesibilidad es Avenida de América, teniendo en cuenta que es un intercambiador desde donde salen autobuses para todo el norte de España, además del autobús para el aeropuerto, y que la gente lleva unos maletones enormes intentando subir escaleras bastante empinadas. </p>

<p>Sugiero por tanto, si no lo hay ya, un programa de mejora de la accesibilidad del metro para todo, porque todos podemos tener dificultades a lo largo de nuestra vida tanto por vejez, por problemas físicos o por llevar demasiada carga (o incluso sillas de niños).</p>
";"07/09/2015 17";"185";"170";"15";"7";"867667449";"14243"
"297";"Bajar las cuotas de las guarderías públicas";"<p>Buenas... Las familias en las que ambos padres trabajamos fuera de casa en un país en el que la baja por maternidad es de 16 semanas y no tenemos familiares en condiciones de cuidar de nuestros hijos no tenemos más remedio que llevarles a la guardería. Es decir, no es un capricho sino una necesidad. Sin embargo, la guardería pública nos cuesta entre escolaridad, comedor y ampliación de horario (que casi todo el mundo necesita por sus horarios de trabajo) más de 300 euros al mes.</p>

<p>Esto en mi opinión es desproporcionado y contribuye a las bajas tasas de natalidad. Creo que la escolaridad debería ser gratuita, abonando únicamente el comedor, cuya cuota se debería también revisar. Además, se debería revisar el horario, ya que de 9 a 16 no cubre ninguna jornada laboral de 8 horas, eso sin contar con los desplazamientos al/del centro de trabajo. Y todo lo que pase de ahí se abona aparte.</p>

<p>Entiendo que el importe de la cuota lo fija la Comunidad, pero el Ayuntamiento podría dar cheques guardería por el importe de la cuota de escolaridad de las guarderías sostenidas con fondos públicos, o bien abrir centros infantiles municipales gratuitos.</p>

<p>Salu2.</p>
";"07/09/2015 18";"164";"132";"32";"9";"863708851";"8048"
"299";"Estacionamiento Regulado (SER) Inteligente.";"<p>A día de hoy para utilizar el SER se necesita introducir la matrícula del coche. Además el reconocimiento numérico permite leer matrículas perfectamente con una cámara (Lo hacen en garajes  y autpistas). Mi propuesta sería hacer del sistema SER en algo más flexible e inteligente. Equipando a los profesionales municipales con algo parecido a un smartphone capaz de leer las matrículas y que automáticamente sepan si el coche está bien estacionado se podría agilizar el SER y hacerlo más flexible. Varios puntos:</p>

<ul>
	<li>Esto facilitaría el trabajo de los agentes y evitaría que no se viese algún ticket.</li>
	<li>
<strong>Varios tipos de permisos</strong>: Este problema no me afecta, pero conozco a mucha gente que sí. Trabajas en el centro de Madrid y vas en coche. Cada dos horas tienes que cambiar el ticket y te complica la vida innecesariamente. Yo creo que, utilizando la matrícula, podría haber aparte del permiso de residente, un permiso de trabajador cerca del trabajo que permita aparcar durante el horario laboral de cada uno. Este permiso rondaría los 30 - 50 euros mensuales, dependiendo de la zona.  El agente leería la matrícula y el smartphone sabría si el coche está bien aparcado, sin más. </li>
	<li>
<strong>App de SER:</strong> Para agilizar más aún los trámites, sería útil un App ciudadana que incorporase servicios de la ciudad y, entre otros, permitiese seleccionar donde has aparcado tu coche y por cuanto tiempo. Así de fácil. Incluso aumentar el tiempo sin volver al coche.</li>
	<li>
<strong>Precio variable en función de hora, zona y dia: </strong>Dependiendo de la ocupación y otros factores los precios se podrían variar de forma inteligente, incluso atendiendo de forma dinámica a la demanda en una zona. También el tiempo máximo de estacionamiento.</li>
	<li>
<strong>Otros usos:</strong> Creo que un sistema así permitiría un aparcado totalmente inteligente para los residentes que permitiría hacerle la vida más fácil a todos. Se invita a hacer sugerencias!</li>
</ul>

<p>Un saludo,</p>

<p>Eduardo</p>
";"07/09/2015 18";"49";"33";"16";"10";"856346032";"1144"
"300";"Asfaltado viales casa de campo";"<p>Dado que son muchos los ciclistas que utilizan este parque y el numero de accidentes que allí se producen por el mal estado del asfalto me gustaría abrir este foro de debate para saber que opina la gente y cuales son los motivos por los que no se ha asfaltado todavía.</p>
";"07/09/2015 18";"54";"20";"34";"8";"843325674";"-518"
"303";"La creación de un carril bici bidireccional en el tramo sur de Bravo Murillo";"<p>En una gran avenida como es Bravo Murillo, en especial en su tramo sur de Cuatro Caminos a Quevedo, que tiene 5 carriles de circulación y es unidireccional, es palpable la falta de infraestructura ciclista, que se limita a un ciclocarril. Sugiero eliminar un carril de circulación (dejando 4, lo cual es más que suficiente ya que su alternativa de subida, Santa Engracia tiene también estos carriles) y crear de este modo un carril bici bidireccional. Es una infraestructura barata y de gran valor para la ciudad</p>

<p> </p>
";"07/09/2015 18";"106";"78";"28";"14";"860383156";"3679"
"304";"Habilitar zonas para que los jóvenes podamos beber a gusto y disfrutar sin miedo";"<p>Hola a todos.</p>

<p>Entiendo que hay gente que no respeta y tiene mala educación, pero hay muchos y muchas jovenes como yo que simplemente al vivir todavía con los padres y no tener mucho dinero no tenemos un lugar donde poder estar tranquilos con nuestros amigos tomando unas copas y no tenemos mas remedio que estar en la calle. Estoy de acuerdo en que hay gente que lo deja todo sucio y hace mucho ruido y molesta a la gente y eso esta mal y no hay que permitirlo.</p>

<p>Ahora va mi propuesta:</p>

<p>Voy a poner como ejemplo Granada que tiene un espacio público donde se pueden reunir los y las jovenes para beber y disfrutar sin miedo a multas.</p>

<p>Creo que sería una buena idea facilitar espacios públicos a los y las jovenes para que podamos beber a gusto sin molestar a nadie.</p>

<p>Ojalá esta propuesta se lleve a cabo ya que de esta forma no habría problemas y todos podriamos disfrutar de la vida, unos durmiendo y otros sin miedo a las multas.</p>

<p>Si se puede vivir todos en armonía y en paz.</p>

<p>Salud y gracias por hacer posible entre todos que el mundo cambie empezando por Madrid.</p>
";"07/09/2015 18";"120";"63";"57";"7";"852207610";"315"
"305";"Que bajen el IBI";"<p>Que bajen el IBI de las personas que tenemos una sola vivienda y malpagamos la hipoteca y se lo suban al los que tienen muchos inmuebles.</p>
";"07/09/2015 18";"279";"243";"36";"12";"867866448";"18029"
"306";"Peñagrande - Reponer calle eliminada";"<p>Fue suprimida para hacer obras de cosntrucción en la parcela, la unión viaria de la calle de Islas Aleutianas con la entonces calle de Nueva Zelanda, hoy Glorieta de Isaac Rabín, sobre la M-30.  Las obras se paralizaron y abandonaron y desde hace ya muchos años que esta parte del barrio se encuentra aislada, debiendo hacer y deshacer un largo acceso diferente. El Ayuntamiento debe tener el dinero que hubieron de poner como garantía los Promotores de la obra cuando les concedieron el permiso de construcción. Se pide reponga el Ayuntamiento la calle suprimida.</p>
";"07/09/2015 18";"30";"14";"16";"1";"846453844";"-93"
"307";"EDUCACION PUBLICA VILLA DE VALLECAS Y ENSANCHE";"<p>Urge plantear en los colegios públicos de Villa de Vallecas y Ensanche (hablo de estas zonas porque son las que conozco) un programa de educación socioemocional, es imprescindible porque es la manera de prevenir el acoso escolar, fomentar el respeto y la inclusión social. Estos programas deberían darse dentro del horario de clase y por un profesional, sería interesante que se fomentara la figura de mediador adulto en los recreos y un mediador o grupo de mediadores entre los propios alumnos (siendo responsables durante una semana cada grupo) y concienciar a los mayores de que los pequeños deben aprender de ellos, fomentar en los colegios la colaboración y no tanto la competitividad.</p>
";"07/09/2015 18";"89";"73";"16";"4";"862136524";"4675"
"308";"BONOTRANSPORTE (BONOBUS) PARA LOS PARADOS.";"<p>Facilitar el tranporte y la movilización de los parados para ir de un lugar a otro, y poder entregar curriculums...  asi mismo se contribuye a hacer mas llevadera la situación de los parados en Madrid y España. Ya no mas las largas caminatas por madrid y sus alrededores para entregar un curriculums. Ayuda por favor.</p>
";"07/09/2015 18";"123";"96";"27";"6";"862122752";"5385"
"309";"Que la red de metro de Madrid vuelva a tener empleados en todas las estaciones";"<p>Son muchas las personas mayores que no saben como utilizar las máquinas para recargar el abono transporte y muchos los jovenes que se cuelan a diario si hubiese empleados de metro y seguridad en todas las estaciones y no sólo en las principales, además de crear puestos de trabajo, se recaudaría más dinero</p>
";"07/09/2015 18";"194";"153";"41";"1";"863848020";"8832"
"311";"Baños públicos en el metro de madrid";"<p>Pagamos una cantidad excesiva por el transporte en madrid y no tenemos ni un baño en toda la red de metro,cualquier urgencia dentro t obliga a salir fuera,provocando esto muchas veces tener que pagar otro billete. si hay bibliotecas (cosa que me parece genial) podrian poner baños tambien. gracias</p>
";"07/09/2015 18";"1868";"1621";"247";"56";"874987608";"119232"
"312";"¿Y esto es lo que nos prometían? limpieza calles.";"<p>Lo primero decir que YO voté a Carmena. Era la esperanza que tenía para que las cosas cambiaran, no solo las cosas...""grandes"" sino las de barrio como ella ha dicho tantas veces.</p>

<p>Mi barrio, el barrio Lucero, está hecho un asco. Lo ha estado siempre realmente pero ahora en teoría esto debería de haber cambiado. Las calles están sucias y no es suficiente que el barrendero barra de vez en cuando, tiene que haber máquinas que limpien las aceras y calles  mecánicamente, raspando la suciedad que hay incrustada. No sé la logística ni el funcionamiento de los barrenderos, pero a veces les veo barrer una calle que no está tan sucia pero la de al lado, que está asquerosamente sucia, no la barren nunca. Esta gestión debería mejorarla la empresa encargada. Como anécdota, llevo semanas viendo un gato muerto y cada vez más descompuesto al lado de casa, y nadie se encarga de quitarlo (este servicio municipal de recogida de animales tampoco funciona). Hay muchas peleas por aquí, el charco de sangre puede estar semanas seco en el suelo. No es un sitio donde yo quisiera que creciera mi hijo, así que cuando decida tener uno espero poder irme a otro lugar.</p>

<p>La suciedad de la esquina de Huerta Castañeda con Cebreros está muy sucia y en parte es por el camión de la basura, que al recogerla vierte los líquidos a la calzada. Día tras día hay una gran costra de mierda. En el paque entre Sepúlveda y Cebreros cagan todos los perros, es la zona oficial. Está claro que hay que recoger las cacas, pero hay tantas que si mi perro se mete a hacer sus cosas me es imposible ir a recoger sus excrementos porque me haría falta un calzado especial y bien cerrado hasta la rodilla para no mancharme. La solución es fácil, que una vez a la semana alguien con un rastrillo barra toda la suciedad. Me dan ganas de hacerlo yo solo por la satisfacción que debe sentir uno al dejar todo eso limpio.</p>

<p>Pues eso, estos problemas son los problemas que se ven a pie de calle, eso que nos prometían antes de las elecciones. Mi barrio es un barrio de gente en general sin estudios, sin educación, mucha inmigración...por un lado hace falta educar a la gente, sí, pero por el otro la realidad es que hay que limpiar el doble que en otras zonas para mantenerlo limpio, y así quizá en algún momento a alguien se le remueva la conciencia cuando ensucie algo.</p>
";"07/09/2015 18";"79";"49";"30";"9";"855992115";"1178"
"313";"Teleasistencia gratuita o para personas mayores y enfermas crónicas";"<p>Escribo en nombre de mis padres, personas mayores y uno de ellos enfermo crónico, que tenían servicio de teleasistencia gratuito en casa. Desde que Botella empezó a cobrar por este servicio se dieron de baja. Con la teleasistencia estaban bien atendidos y vigilados; sabían a quién y cómo recurrir en caso de peligro o de necesidad. Hasta les pusieron un detector de humos en la cocina una vez que a mi madre se le prendió fuego la sartén accidentalmente. No puedo estar más agradecida por todo lo que este servicio hacía por ellos.</p>

<p>Ruego que el servicio de teleasistencia vuelva a ser gratuito o al menos tenga un precio que no vaya más allá de lo simbólico. Por su edad, y por su educación, incluso pudiendo pagarlo, si es de pago se dan de baja porque creen que es caro. Y no podemos dejar a los mayores y a los enfermos solos. Por favor, tengan en cuenta a los mayores. Su bienestar y su seguridad son importantes para todos.</p>
";"07/09/2015 18";"893";"840";"53";"14";"874967069";"74029"
"314";"BiciMAD en zona norte de Madrid (Hortaleza, Sanchinarro, Las Tablas, Valdebebas)";"<p>Como dicen en otro debate, sería muy buena opción BiciMAD como medio de transporte dentro del barrio y para desplazarse al centro. Al igual que se pide para los barrios del sur (Carabanchel, Aluche, etc..) a los que vivimos en la zona norte también nos vendría muy bien. Se forma mucha congestión de coches por la mañana por estas zonas y esto yo creo que lo rebajaría. También para desplazarse al centro de Madrid en bici o incluso para acercarse a los parques Felipe VI y Juan Carlos I</p>
";"07/09/2015 18";"323";"287";"36";"11";"869081345";"22302"
"315";"APP para denuncias de movilidad";"<p>Igual que hay una aplicación para incidencias, debería haber una para denuncias de movilidad. Puede sonar exagerado, pero lo que es más exagerado aún es ser peatón o ir con la bici y encontrar coches aparcados en el carril bici, en mitad de un paso de cebra, delante de una parada de autobús, haciendo que personas mayores o en silla de ruedas no puedan bajar bien, y otros ejemplos que todos conocemos.</p>

<p>Si yo hago una foto y la presento en la comisaría de Policía Municipal, mi denuncia es válida. Pero es tal el nivel de ""hago lo que me da la gana con mi coche"" de los madrileños, que tendríamos que pasarnos las tardes en comisaría. Los grupos más vulnerables (vamos, quienes no tenemos coche) nos sentimos impotentes. Muchas una parada se convierte en un estacionamiento, en zonas prohibidas, y se generan situaciones MUY peligrosas. Con esto se agilizaría la presentación de denuncias y la gente se pensaría si bloquear accesos o incumplir normas, dado que por el hecho de ""respetar a los demás"" no sirve con muchos, y además se optimizaría el trabajo y vigilancia de la policía municipal.</p>
";"07/09/2015 18";"90";"77";"13";"1";"863186449";"5475"
"316";"AYUNTAMIENTO MADRID MANEJE LIMPIEZA Y CREAR OFICINA DE CONTRATACIÓN DIRECTA.";"<p>El ayuntamiento de Madrid debe manejar directamente la limpieza de la ciudad y crear una oficina de contratación directa, donde no se manejen puestos de trabajo a dedo, asi mejora el servicio y su eficacia y tenemos mas posiblidades de un puesto de trabajo... tambien se puede crear puestos de trabajo con contratos rotativos para dar oportunidades a mas cantidad de ciudadanos que estamos parados.</p>
";"07/09/2015 18";"77";"62";"15";"3";"861264674";"3784"
"317";"BAÑOS PÚBLICOS PLAZA DE CIBELES";"<p>Hay unos baños públicos en la misma plaza de Cibeles que están hechos un desastre desde hace 10 años... Las puertas rotas, el aspecto general deplorable... todo eso en frente del Banco de España y el Ayuntamiento, por donde pasamos al día miles de ciudadanos (y turistas). Deberían hacer una reforma y acondicionarlos como es debido cuanto antes... y nada de cerrarlos como había propuesto Ana Botella... Saludos y gracias :)</p>
";"07/09/2015 18";"158";"138";"20";"4";"865876030";"10306"
"318";"Festival de Cine Internacional";"<p>¡Hola!</p>

<p>Para empezar, quisiera puntualizar que no he votado a Carmena ni probablemente lo haga por motivos de afinidad política. Pero también tengo que confesar lo mucho que me está sorprendiendo (para bien), por el sentido común que parece tener y las medidas -como la de los refugiados- que se están aprobando.</p>

<p>Creo que Madrid es una ciudad impresionante y acogedora, a la altura de las grandes capitales del mundo. Sin embargo, deberíamos plantearnos recuperar el amor por la cultura y el cine que un día definieron a nuestra ciudad, que en sus días de mayor esplendor estaba llena de cines y teatros que rebosaban de gente y espectadores. Tal vez sería conveniente convocar un Festival de Cine Internacional, como ya se hace en Berlín (la Berlinale) o Nueva York (NYCIFF). En España hay mucho talento en este aspecto y sería un buen escaparate para promocionar nuestro cine y nuestra ciudad como referente cultural y, por qué no, ¡destino de producciones de Hollywood!</p>

<p> </p>

<p>Un saludo muy afectuoso</p>
";"07/09/2015 18";"91";"76";"15";"4";"862725035";"5094"
"320";"Error/bug al visualizar tipos de debate";"<p>Hola</p>

<p>Al provar la web me he dado cuenta que no resetea el número de página lo que hace, por ejemplo, que si estás en la página 3 de más comentados y seleccionas más votados, te mantiene la página 3. No sabía donde reportar y lo hago aquí. Una vez hayáis corregido este error de javascript, podéis borrar el comentario. Quizás podríais crear algún espacio en la web para reportar o dar un email. Buen trabajo :)</p>
";"07/09/2015 18";"16";"6";"10";"5";"845786614";"-150"
"321";"Ruido nocturno de bares, discotecas y gente en la calle";"<p>Desde que se aprobó la ley que prohíbe fumar en el interior de cualquier recinto cerrado se ha incrementado el ruido que produce la gente que sale a fumar a la puerta del bar. La consecuencia es el ruido nocturno sufrido por los vecinos, además de toda la suciedad que lleva aparejada: colillas en el suelo, vasos de plastico, gente que orina en la calle, etc. Es muy complicado luchar contra esto y los vecinos se encuentran totalmente indefensos. </p>

<p>No se cual es la solución perfecta que permita a unos disfrutar por la noche y que permita a otros descansar. Quizás la solución sería no sobrecargar determinadas calles y zonas y conseguir que los bares y discotecas tengan que estar separadas por x metros. Es decir, evitar que en un mismo tramo de la calle haya 3 o mas bares/discotecas de ocio nocturno y que en el resto de la calle o zona no haya ninguno. De esta manera se evitarían las aglomeraciones de gente en una misma zona.</p>
";"07/09/2015 18";"139";"101";"38";"18";"861132274";"4577"
"322";"mantenimiento del arbolado en los parques publicos";"<p>ES NECESARIO UN PLAN DE PROTECCION DEL ARBOLADO EN LOS PARQUES DE LA CIUDAD. YA NO SE FUMIGA Y NO SE PODA DEBIDAMENTE. LOS ARBOLES ESTAN ENFERMOS Y ES PENOSO VER QUE LA SOLUCION QUE ESTAMOS VIENDO ES LA TALA PARA EVITAR MALES MAYORES Y LO PEOR, QUE NO SE REPLANTA.</p>
";"07/09/2015 18";"577";"560";"17";"9";"874320932";"52700"
"324";"LIMPIEZA CALLE ALGODONALES";"<p>Buenas tardes</p>

<p>La Calle algodonales, está muy sucia. Llena de cagadas de perros y papeles, plasticos etc etc que se salen de la basura, ya que los cubos son los antiguos.</p>

<p>Sra Carmena, la zona de Retiro o el Barrio Salamanca no están tan sucios. no hay un papel ni una cagada en las aceras.</p>

<p>TODOS SOMOS VECINOS DE MADRID Y PAGAMOS LOS MISMOS IMPUESTOS.</p>

<p>Muchas gracias por su atención, y la felicito por esta iniciativa.</p>

<p> </p>

<p>Gracias</p>

<p> </p>
";"07/09/2015 18";"26";"19";"7";"4";"855962141";"876"
"325";"MUNICIPALIZAR SERVICIOS TAN IMPORTANTES COMO LOS CAF DEL AYUNTAMIENTO DE MADRID";"<p>Los Centros de Apoyo a las Familias son servicios externalizados que dependen del ayuntamiento pero que hasta la fecha siempre han quedado en manos de empresas externas que los gestionan -como otros tantos servicios de carácter ""municipal"" o al menos así se venden a los ciudadanos. La realidad es otra. Los trabajadores que están en los CAF como en otros tantos servicios municipales carecen de sueldos dignos dadas sus responsabilidades. Es decir, este trabajo de abogados, psicólogos, trabajadores sociales debe ser reconocido como tal y estos servicios debieran ser remunicipalizados en aras de un servicio más justo. Basta de recortes y de externalizaciones. Ojalá Carmena y su equipo sean capaces de atender esta realidad y darle la vuelta al calcetín. Por una remunicipalización de los servicios ""Municipales"". </p>
";"07/09/2015 18";"194";"155";"39";"15";"864431951";"9268"
"326";"Multar a las personas que tiren residuos al suelo";"<p>Madrid es una pena como está de sucia y es una de las ciudades con más papeleras que otras ciudades. He visitado Londres carecen de muchas papeleras y está super limpio. Motivo: multan con 80 libras a quien tire algo al suelo y solo dejan fumar en los lugares donde hay papeleras y son muy escasas. Se, que es cosa de educación, pero parece que muchas personas carecen de ella y como madrileña me da vergüenza.</p>
";"07/09/2015 18";"2763";"2584";"179";"87";"879461304";"224919"
"327";"Cine y teatro subvencionados para pensionistas y desempleados";"<p>Que el ayuntamiento llegue a acuerdos y subvencione un día a la semana la asistencia a cines y teatros de mayores, pensionistas y desempleados. La entrada se podría reducir en un 50%. Con ello no sólo se favorecería el acceso a la cultura de esos tres sectores de la población con menos recursos, sino que sería un impulso importante para las salas de cine y teatro, ya de por sí penalizadas con el 21% del IVA, que repercute a su vez en los usuarios.</p>
";"07/09/2015 18";"115";"79";"36";"5";"859158741";"2953"
"328";"Vias principales, sólo peatonales en Domingo";"<p>Hola,</p>

<p>es algo que he visto en otras ciudades del mundo y que, salvo quizá para los residentes, facilitaría y ayudaría mucho al tránsito de peatones por todo el centro.</p>

<p>Mi propuesta es hacer la mañana, tarde, o todo el día las principales vías (gran vía, horaleza, etc) de uso exclusivo peatonal. Las zonas comerciales del centro lo agradecerían sin duda, no se amontonarían tanto la gente en las calles y sería mucho más agradable, ya no sólo ir a comprar, sino también dar una vuelta.</p>

<p>
Gracias!</p>
";"07/09/2015 18";"88";"64";"24";"3";"859568192";"2909"
"329";"Convertir en avenida urbana el tramo de la A6 entre C. universitaria y Moncloa";"<p>La idea es la que indica el título. Aunque no sé si el ayuntamiento tiene competencia sobre este tema. La fantasatica ciudad universitaria madrileña esta dividida por un rio de coches que hacen muy incómodo transitar y moverse por ella. una avenida mitigaría el impacto de los coches  e integraría el parque del oeste a toda la C. Universitaria poniendolo en valor.</p>
";"07/09/2015 18";"41";"19";"22";"1";"845772037";"-139"
"330";"Volver a regular los horarios comerciales";"<p>La liberación de horario ha significado la puntilla para los mercados y pequeños comercios que no tienen capacidad para poder estar abiertos todo el día, fines de semana, festivos, etc.</p>

<p>Si queremos barrios con redes vecinales, tejido económico, empleo de calidad en el comercio, diversidad, etc. hay que regular horarios y licencias para que las grandes superficies no acaparen todo el sector.</p>
";"07/09/2015 18";"165";"107";"58";"11";"859026230";"3177"
"331";"No a la invasión de bares y terrazas en las calles de Retiro ";"<p>Vivo en el Barrio de Retiro y veo el deterioro tan grande que está sufriendo el Barrio en bulevares que eran agradables para pasear, calle Ibiza, Sainz de Baranda y Narváez. Con las terrazas en la calle, todo vale, carteles con cadenas atados a las farolas, señales de trafico e incluso bancos. Barras de los bares dando a la acera montandose corrillos que impiden el paso. Terrazas ocupando partes techadas y no techadas con todas las mesas que quieran y mas sin ningun control dejando apenas paso a los peatones, gente en silla de ruedas, etc. Cada uno campa a sus anchas, sin ningún control, poniendo mesas, sillas, carteles, cierres en pleno bulevar, mostradores para dejar platos, etc, cables electricos por todos los sitios. Se pueden poner terrazas pero con un orden y un criterio y no la jungla que han permitido ahora. Hay incluso mesas con sillas en aceras mínimas en las que hay que bajar a la calle para poder pasar. Por favor un poco de respeto, el negocio está bien y la diversion pero parece que aquí todo vale y no se piensa que las aceras han sido pensadas para los peatones y no para hacer un cortijo para unos cuantos que hacen su negocio. Señora Alcaldesa, revise las normativas y no estaría de mas que hubiese una patrulla municipal recorriendo cada barrio y viendo como realmente se invade espacio publico en beneficio propio. Creo que podría haber medidas como por ejemplo poner claramente el número de mesas permitidas en cada terraza. Poner una hilera solo de mesas para que pueda haber espacio para caminar, ya que con dos mesas cuando la gente se empieza a relajar y amover las sillas ya ocupan toda la acera.</p>
";"07/09/2015 18";"109";"81";"28";"5";"860778573";"3938"
"333";"Registro real para que voten madrileños";"<p>Deberían poder votar solo usuarios registrados con una identificación comprobada de que se vive en Madrid, de tal manera que no haya gente con múltiples identidades o gente que no reside en la ciudad. De esta manera no se alteran votaciones por colectivos de páginas web y los votos se acercan más a la realidad de los deseos de los habitantes de madrid. </p>
";"07/09/2015 18";"278";"229";"49";"24";"866640047";"14827"
"334";"Cámaras de grabación continua para la policia. ";"<p>Las <em>BodyCam </em>son cámaras que llevan los agentes en el cuerpo que permiten grabar su jornada laboral. Esta medida ha permitido reducir el uso de la fuerza por parte de los agentes un 59% y las protestas de los ciudadanos un 89% en Estados Unidos.</p>

<p>Ver: http://www.computerworld.com/article/2979627/cloud-storage/as-police-move-to-adopt-body-cams-storage-costs-set-to-skyrocket.html</p>

<p>Ver: http://www.enriquedans.com/2015/09/un-curioso-caso-de-dimensionamiento-tecnologico-las-camaras-de-la-policia.html</p>

<p> </p>
";"07/09/2015 19";"211";"166";"45";"8";"864391429";"9519"
"335";"Menos plazas de cemento y más arboladas, con sombra y bancos";"<p>Es una vergüenza que no haya en todo el centro una plaza con árboles y bancos para sentarse. Nos toman por idiotas, quieren que consumamos sí o sí en bares y terrazas.</p>
";"07/09/2015 19";"1953";"1861";"92";"15";"878894242";"168566"
"336";"Restauración de Principe Pio";"<p>Es lamentable ver la penosa reforma de Principe Pio. Arreglaron la estación a medias, dejando bonita la parte que se ve mientras la trasera se cae literalmente a cachos!</p>

<p>Es curioso! Ya que justo la ""trasera"" es la entrada PRINCIPAL de la antigua estacion del norte!</p>

<p>Que vergüenza dejar que nuestra infraestructura se caiga a cachos de esa manera... Una estación tan bonita como lo es la de Principe Pio!</p>

<p><strong>Donde estan los ascensores de LATÓN de los que me hablan tanto los mayores de esta ciudad??? </strong>Que han hecho con ellos? Los han fundido y se los han metido en forma de billetes al bolsillo? Devuelvanlos a la estación y restauren el edificio! Devuelvanle a Principe Pio el esplendor que le corresponde.</p>

<p> </p>
";"07/09/2015 19";"251";"229";"22";"5";"869115655";"18885"
"337";"Contaminación acústica polideportivo Pepu Hernandez, Las Rosas";"<p>Es inaguantable el nivel de ruido continuo que producen las máquinas de aire acondicionado y calefacción. Si bien aparentemente no  lo parece, cuando las desconectan por la noche te das cuenta de lo que durante todo el día ha estado contaminando el ambiente. Imprescindible un aislamiento acústico ya, es muy contaminante!</p>

<p> </p>
";"07/09/2015 19";"18";"12";"6";"1";"853274580";"400"
"338";"Perros sueltos en los parques";"<p>Parece ser que los parques en Madrid están diseñados para los perros y no para las personas. Pero también me pongo en el ""pellejo"" de los dueños de los perros y veo que no tienen parques específicos para ellos. Propongo agentes que vigilen parques como los Bobis de los coches. Así también se crean puestos de trabajo. Y un canon por perro.</p>
";"07/09/2015 19";"153";"70";"83";"22";"843547884";"-594"
"339";"Eliminar el cambio de tren en tres olivos";"<p>Al ser la línea 10 una de las más transitadas cada mañana, se generan auténticos embotellamientos humanos en este tramo. Mi propuesta es eliminar el final de la vía para que siga hasta hospital infanta Sofía. </p>
";"07/09/2015 19";"88";"79";"9";"3";"864578516";"6284"
"340";"Completar el anillo verde ciclista y señalizarlo correctamente.";"<p>El anillo verde ciclista es el <strong>carril bici que rodea Madrid</strong>. Tiene una longitud de 64 kilómetros y es muy utilizado, tanto para ocio como para transporte. Para llevarlo a cabo se realizaron una serie de puentes, extensiones de carriles bici preexistentes y nuevos carriles, además de una considerable plantación de árboles que acompañan el carril.</p>

<p>Sin embargo, casi una década después de su construcción, <strong>el anillo sigue sin estar completo</strong>. <strong>Algunos puentes construidos están sin utilizar</strong> (como el que cruza la m-201), en muchas partes el carril-bici se convierte en acera (y ya sabemos que ir por la acera con la bicicleta está prohibido), y en otras <strong>el carril desaparece</strong>, sin más. Además de todo esto, es muy complicado enlazar el anillo completo sin perderse, debido a la <strong>falta de señalización</strong>.</p>

<p>De manera urgente, creo que se debe colocar la señalización pertinente (p. ej. en Casa de Campo). En segundo lugar, intentaría aprovechar la infraestructura construida y que no se utiliza (¡los puentes!). Por último, habría que terminar de cerrar el anillo, añadiendo los tramos de carriles bici que faltan.</p>
";"07/09/2015 19";"819";"769";"50";"24";"874852169";"67510"
"341";"Parque canino en Madrid Rio";"<p>Hola a todos.</p>

<p>Vivo muy cerca del parque Madrid Río, que está reconocida como la zona con más perros censados y que, sin embargo, no cuenta con un recinto acotado y adaptado para ellos.</p>

<p> </p>

<p>Soy propietaria de un perrito desde hace menos de un año. Estoy intentando enseñarle a convivir de manera cívica con todo el mundo (animales y personas), me gusta poder pasear con él suelto en el parque porque así tiene oportunidad de acostumbrarse a corredores, patinadores, personas y otros perritos. Respetamos los horarios en los que la normativa marca que puede pasear suelto e intento siempre ir por donde menos molestamos. El problema es que no hay un sitio donde los perros puedan jugar sin preocuparse de molestar a otras personas. Para tener una mascota equilibrada y bien socializada debe convivir con cuantas más situaciones y personas diferentes como sea posible pero también jugar como lo hacen los perros. Además, a pesar de tener un horario de ""paseo libre"" mucho más generoso que en otros municipios, hay veces que no es posible hacer el paseo en ese horario y no hay alternativa para que jueguen. Y la verdad es que me canso de explicar a los enemigos de los perros que pueden pasear sueltos y sin bozal de 20 de la tarde a 10 de la mañana... Además en verano el parque está lleno de gente haciendo picnic y botellón y está todo lleno de porquería y es imposible pasear sin molestar a nadie.</p>

<p>No creo que costase a penas dinero, sólo sería necesario acotar un par de praderas con una extensión suficiente (ya digo que hay una afluencia de perros muy abundante) poner una fuente con bebedero abajo, una zona con sombra y algunas papeleras para depositar las bolsitas con los excrementos. Si fuera posible añadir algún elemento de agility sería genial.</p>

<p>No creo que sea tanto pedir para un parque como este donde va tantísima gente y que tanta promoción recibe. Este tema y el carril compartido para peatones y bicis son los puntos negros de este espacio tan agradable en medio de la ciudad.</p>

<p> </p>

<p> </p>

<p> </p>

<p> </p>

<p> </p>

<p> </p>
";"07/09/2015 19";"130";"89";"41";"10";"859708050";"3286"
"342";"Multas del APR justas (y todas en general)";"<p>Por unas multas justas que busquen como objetivo el cumplimiento de la norma y no sólo el ser recaudativas y desorbitadas.</p>

<p>Ahora, si a un residente de un barrio de Madrid se le olvida renovar el acceso a la zona de acceso restringido de su barrio que ya tenía (el APR), se le multa como no residente cada vez que pasa, y se le informa de la primera multa al mes de la sanción. Esto lleva consigo un total de unos 1000 en multas. No existe la manera de recurrirlas aunque se demuestre que uno en ese periodo era residente.</p>

<p>Debería haber una forma de demostrar que uno no es residente y solo se le ha olvidado renovar el acceso, un y multarle una sola vez por olvidar dicha renovación, no 20 veces.</p>

<p>Si en teoría se busca que los no residentes no accedan, poner 20 multas a un residente a 90 multa (45 con la rebaja), no parece que se esté consiguiendo lo que se busca.</p>

<p>Seguro que hay otros muchos casos donde la sanciones no son proporcionales y bebería existir un mecanismo de ajuste y replanteo de la sanciones, aunque no sea retroactivo.</p>
";"07/09/2015 19";"58";"49";"9";"5";"861672314";"3379"
"343";"¿Cuándo van a limpiar las calles de Madrid?";"<p>De hace diez años hasta hoy, la ciudad de Madrid ha sufrido un claro deterioro en cuánto a limpieza y salubridad, no sólo de sus calles y plazas, sino en el metro, parques y carreteras etc., y en general de todo el mobiliario público.</p>

<p>Entiendo que este problema no viene sólo del desgobierno de la señora Carmena y su equipo, sino de tiempo atrás, ya con los inefables Gallardón y Botella (amén).</p>

<p>Lejos de solucionarse este problema, y en las últimas fechas, ""podemos"" sin lugar a dudas afirmar que ""ahora Madrid"" si da asco, y que la limpieza e imagen de esta gran ciudad está llegando a cuotas no conocidas (al menos para mi).</p>

<p>Ya pasados los 100 famosos días de gracia, ¿qué solución se le va a dar al problema? Más cuando éste se va a agravar con el deshoje de los árboles (muchos de los cuáles por cierto han sido descuajados y desraizados sin esperanza de replantarse).</p>

<p>¿Y ""Ahora"" qué?</p>
";"07/09/2015 19";"282";"262";"20";"13";"870211304";"22483"
"344";"Fuentes de Madrid";"<p>Hace mucho que Madrid ya no es una ciudad para sus ciudadanos!</p>

<p>Si tienes sed: CONSUME!</p>

<p>Poco a poco nos han ido privando de nuestras fuentes. Primero cerrándolas y finalmente quitándolas.</p>

<p>Hablo de todas las fuentes...de las pequeñas en los parques, en las calles...de las grandes como la de callao y como la de plaza castilla.</p>

<p>Somos de las ciudadea mas calurosas que hay! Como es posible! Quitar nuestras fuentes!</p>

<p>Estoy de acuerdo con un debate que acaba de empezar: menos plazas de cemento y mas arboladas!</p>

<p>Opera se ha convertido en una plaza inhabitable en verano!</p>

<p>Devuelvan las fuentes que tanto caracterizaban la ciudad!</p>

<p>No queremos plazas de cemento que el ayuntamiento pueda alquilar por mucho dinero para montar estaribeles! Queremos poder vivir en el centro!</p>

<p>El centro no es un parque tematico. Es un barrio con vecinos y necesidades. Las fuentes son infraestructura, no nos olvidemos!</p>
";"07/09/2015 19";"545";"502";"43";"14";"872572416";"42278"
"345";"El autobús exprés del aeropuerto-Atocha, que llegue a Mendez-Alvaro";"<p>El autobús amarillo exprés que une el aeropuerto con Atocha, acaba ahí. Atocha y Méndez-Alvaro están muy cerca. Debería continuar hasta Méndez Alvaro y mucha gente beneficiarse de la conexión con autobuses y no sólo con trenes.</p>
";"07/09/2015 19";"112";"95";"17";"6";"864156430";"6616"
"346";"No + IBI";"<p>El IBI es un impuesto completamente inaceptable, regresivo e inmoral, ningún ciudadano debería ser fiscalmente persegido por tener un techo donde vivir.</p>

<p>Por la abolición inmediata del IBI.</p>

<p> </p>

<p> </p>
";"07/09/2015 19";"86";"57";"29";"4";"857755427";"1855"
"347";"Aviso a usuarios de SER por limitaciones temporales de estacionamiento";"<p>Hace poco me llevé un buen susto con mi coche: lo aparqué en la zona SER que me corresponde, y como voy a trabajar en transporte público, pasé tres días sin cogerlo. Al tercero pasé por donde había aparcado y ví que estaba aparcado en un espacio que a partir del día siguiente estaba reservado para una mudanza. Pude moverlo, pero si no lo llego a ver, al día siguiente la grúa se lo lleva y yo tengo que pagar la retirada más los días que haya pasado ahí hasta que yo me entere. </p>

<p>Por lo que he visto, la solución que ponen para esta ""desatención"" del coche, algo muy normal si, por ejemplo, sales de viaje sin coche, es que a alguien encargado de vigilarlo. Y eso no es fácil, yo por ejemplo no sabría a quién decírselo. </p>

<p>La solución la veo fácil: ahora mismo el sistema de multas está automatizado, los revisores tienen registradas las matrículas y al autorizarte como usuario del SER dejas tus datos al ayuntamiento. Un simple correo electrónico automático, o un sms, serviría para saber que tienes que mover el coche sin necesidad de ir a verlo todos los días. </p>
";"07/09/2015 19";"87";"82";"5";"7";"865912952";"7257"
"348";"Madrid sin toros";"<p>Pues eso, Madrid sin toros.</p>

<p>En pleno siglo XXI deberíamos dejar de realizar espectáculos basados en el maltrato animal y, por tanto, dejar de celebrar espectáculos de tauromaquia en la capital.</p>

<p> </p>
";"07/09/2015 19";"1600";"1073";"527";"129";"866684501";"36616"
"349";"Pasear por la calle";"<p>La gente que vivimos en el centro estamos muy familiarizados con este tema. Calles enanas llenas de terrazas que imposibilitan la fluidez de los viandantes.</p>

<p>En concreto una calle horrible que sufrimos TODOS los que ahi vivimos es la cava de San Miguel. Convertida en un parque tematico, todas sus tiendas fueron paulatinamente sustituidas por bares. Mas adelante para colmo se permitio sacar terrazas a un ancho de calles que antes estaba prohibido! Es normal que haya terrazas en plazas, pero no en calles de 2,5m (con el ruido que ello conlleva).</p>

<p>Los coches pasan al lado...no entiendo como la gente quiere comer ahi. Por supuesto todo son pobres turistas facilmente engatusables.</p>

<p>Los vecinos estamos hartos...hay que regular el comercio en el centro!</p>
";"07/09/2015 19";"267";"232";"35";"22";"868173600";"17117"
"350";"Reurbanización de la Gran Vía de Villaverde.";"<p>Esta vía es una autentica autopista urbana, homenaje al cemento contra el peatón, que anda acorralado en muchos tramos entre la valla y la aceraBici, también fuente de peligro y conflictividad. Propongo ciclocarril30 el derecho, con badenes proBici y eliminación de aceraBici, al menos en las partes más estrechas.</p>
";"07/09/2015 19";"41";"36";"5";"2";"861302899";"2721"
"351";"Prohibir las pegatinas de cerrajeros o similares";"<p>Es muy difícil imaginar la cerrajería de las calles de Madrid sin publicidad de cerrajeros, que compiten por ver quien pone más pegatinas en las farolas o puertas de los edificios.  Creo que es algo que se debería regular, al menos la que se pega en elementos privados.</p>
";"07/09/2015 19";"403";"359";"44";"4";"870435787";"28060"
"352";"Ascensores en el viaducto de la calle Bailén";"<p>El viaducto sobre la calle de Segovia se diseñó originalmente con ascensores que permitían salvar cómodamente el desnivel entre esta calle y la calle Bailén. Recuperarlos sería una medida sencilla y económica de mejorar enormemente la movilidad peatonal entre los barrios próximos al río y el centro histórico. Debería, de paso, aprovecharse la reforma para sustituir las mamparas ""antisuicidios"" actuales por otra solución menos agresiva con la estética del viaducto. La supuesta transparencia de las mamparas instaladas queda anulada cuando se convierten en soporte de graffitis y suciedad.</p>
";"07/09/2015 19";"108";"84";"24";"11";"862204798";"4666"
"353";"Empleo";"<p>La rehabilitación de edificios y la energía limpia y sostenible. Cono motor económico,  el porque no se se invierte directamente desde el Ayutamiento. Daría muchos puestos de trabajo.</p>
";"07/09/2015 19";"139";"126";"13";"0";"866790941";"10243"
"354";"Cundas Embajadores";"<p>Llevan mas de 12 años en la Gta de Embajadores y alrededores ( Labrador, Laurel, Ercilla, Martín de Vargas...)cada vez va a peor y por mucho q salgan noticias hay tantas que no las controlan, miccionan, defecan, insultan, roban, se pinchan y se esconden en los portales, todos los días hay peleas y nadie hace nada, jeringuillas por la calle, bancos ocupados por ellos...tienen que erradicar este tema, no puede ser que en una zona céntrica de Madrid pase esto y que nadie haga nada cuando han pasado más de 12 años! Se necesita más seguridad, mas patrullas de distrito y que hagan algo en la Cañada Real. Ya esta bien</p>
";"07/09/2015 19";"428";"415";"13";"22";"873485506";"38978"
"355";"Agentes de intervención rápida en la M30";"<p>Llevo 15 años conducidendo a diario por la M-30. Buena parte en moto. He observado que un gran número de retenciones de tráfico se producen por pequeños golpes entre dos coches, o por averías sin importancia que obligan al conductor a orillarse en la cuneta. </p>

<p>Esos pequeños alcances o averías (que en ocasiones se producen en la calzada central, y en su carril izquierdo o central, dificultando más el tráfico), podrían tener una respuesta rápida por parte de la Policía Municipal o de los Agentes de Movilidad.</p>

<p>Si hubiera unas patrullas de intervención rápida en la M30, que se desplazasen en moto hasta el lugar donde se han producido estos pequeños siniestros, podrían obligar a los conductores de los vehículos implicados a retirarse hasta un arcén amplio, o incluso salirse de la M30. Si tuvieran la suficiente agilidad, se evitaría que se produjeran grandes embotellamientos que perjudican a miles de conductores.</p>
";"07/09/2015 19";"74";"69";"5";"2";"865059390";"5967"
"356";"Municipalizar el servicio de Información Turística de Madrid ";"<p>Madrid, ciudad turística por excelencia que recibe al año millones de turistas, tiene subcontratado a través de Madrid Destino (empresa encargada de la gestión cultural, turística y de espacios destinados a la celebración de congresos, ferias, reuniones, espectáculos, eventos deportivos y encuentros empresariales) el servicio de Información Turística en las Oficinas de Turismo con una empresa de externalización de servicios. El antiguo gobierno del PP, firmó un contrato de dos años con ADECCO para que gestionaran las Oficinas de Turismo de la manera más barata posible ofreciendo unas condiciones precarias, denigrantes y ridículas a los profesionales que contrataron,<u> profesionales a los que se les exigió tener una formación turística universitaria, experiencia en el sector y dos idiomas extranjeros nivel B2.</u> En contraposición, ADECCO, Madrid Destino y el Ayuntamiento de Madrid ofrecía <strong>un sueldo de 4´70 bruto/hora y las siguientes condiciones laborales: contrato fin de obra, turnos y días libres rotativos, pagas prorrateadas, sin derecho a pluses/extras, no cobran más las horas extras, trabajan los 365 días del año sin excepción, no tienen festivos, sin derecho a asuntos propios, realización de examen mensual excluyente. </strong></p>

<p>Actualmente, ésta situación afecta muy negativamente al servicio, ya sea por la poca motivación que genera en sus trabajadores, o por las continuas bajas y reincorporaciones a la plantilla debido a las malas condiciones laborales ofrecidas; pero ésta modalidad no permite la especialización y la mejora continua de un servicio tan imprescindible en una ciudad como Madrid.  </p>

<p>Exigimos que el servicio de Información Turística de Madrid sea municipalizado para que se pueda prestar un servicio de calidad y para que los trabajadores puedan disfrutar de unas condicines laborales dignas y ajustadas a la legalidad. También confiamos en que el nuevo gobierno del Ayuntamiento de Madrid sepa volver a poner en su lugar a todos aquellos trabajadores y servicios municipales que fueron privatizados para el regocijo y lucramiento de unos pocos.  </p>
";"07/09/2015 19";"317";"276";"41";"8";"868885266";"20460"
"357";"Paso peatonal sobre el acueducto de Pablo Iglesias";"<p>La avenida de Pablo Iglesias presenta una cuesta muy pronunciada en la zona del acueducto que separa Moncloa de Tetuán. Siempre he pensado que sería bastante sencillo y barato hacer una intervención sobre el acueducto para habilitar el paso de los peatones (e incluso ciclistas). Esto supondría una ventaja muy grande por varios motivos:</p>

<ol>
	<li>En primer lugar porque la cuesta es tan pronunciada que supone una barrera arquitectónica importante para personas con movilidad reducida.</li>
	<li>Supondría un aumento de confort para cualquier peatón o ciclista.</li>
	<li>Podría hacer más vistoso el acueducto y aprovechar una obra que ya está ejecutada para  ofrecer a los ciudadanos una zona de paseo con unas vistas atractivas hacia Ciudad Universitaria.</li>
</ol>
";"07/09/2015 19";"79";"69";"10";"8";"863813913";"5153"
"358";"Remunicipalizar los servicios deportivos privatizados";"<p>Durante los gobiernos anteriores hemos vivido la privatización de Instalaciones Deportivas, que deberían revertir al Ayuntamiento con gestión directa: las mismas condiciones de servicio para los madrileños y las mismas condiciones laborales para los trabajadores.</p>

<p>Al margen de la gestión total de algunas Instalaciones también se ha privatizado el mantenimiento de las de gestión directa, siendo un rotundo fracaso el servicio que se hace por parte de las contratas a las que se les adjudica. También debe revisarse esta forma de privatización velada, puesto que la propia plantilla municipal de las Instalaciones puede atender el manenimiento si se le dan recursos.</p>

<p> </p>
";"07/09/2015 19";"434";"359";"75";"30";"868630409";"23492"
"359";"Extension del radio de efecto de BICIMad, a núcleos residenciales circundantes.";"<p>Como usuario de BiciMad, usaría mucho mas el servicio y dejaría en ocasiones de ir al centro en vehiculo propio si estuviesen habilitadas estaciones en la zona residencial donde vivo. Como tal, supongo que se da el caso para muchas otras personas que tienen su residencia, en los nucleos residenciales de los alredores de Madrid. No es necesaria una instalación tan densa como la que se da en el centro, sino puntos independientes que la población de la zona identifique como lugar de disposición de bicicletas públicas, organizados cubriendo areas de máxima densidad residencial.</p>

<p>Veamos si hay gente en la misma situación. </p>

<p>Un saludo.</p>

<p> </p>
";"07/09/2015 19";"285";"251";"34";"7";"868830613";"19111"
"360";"Cambio o destrucción del Arco de la Victoria ";"<p>Desde la entrada en vigor de la Ley de Memoria Histórica, el Arco de la Victoria, situado en Moncloa,  debería de ser ilegal. (https://www.google.es/maps/place/Arco+de+la+Victoria/@40.4359895,-3.7201922,17z/data=!3m1!4b1!4m2!3m1!1s0xd4228411b02c727:0x526611984966c05a). Pero, además, desde la entrada en vigor de la Constitución de 1978, este vergonozoso símbolo, que conmemora la victoria del bando franquista en la Guerra Civil y su entrada en la capital en 1939, debería sino haber sido demolido, o al menos cambiado su nombre. </p>

<p>En 2004, este polémico monumento que se levanta en la entrada noroeste del centro de la ciudad, fue objeto de noticia, ya que el entonces rector de la Universidad Complutense, Carlos Berzosa, el entonces alclade de Madrid, Alberto Ruiz-Gallardón, y la expresidenta de la Comunidad de Madrid, acordaron cambiarle el nombre a Arco de la Concordia, así como cambiar su frontal, haciendo una referencia explícita a la comunidad universitaria. El cambio no se llevó a cabo finalmente por la negativa de la Comunidad de Madrid, presidida por Esperanza Aguirre. </p>

<p>http://elpais.com/diario/2004/11/25/madrid/1101385461_850215.html</p>

<p>http://www.abc.es/hemeroteca/historico-02-12-2004/abc/Madrid/la-comunidad-decidira-si-se-levanta-un-monumento-a-la-concordia-en-la-universitaria_963743921488.html </p>

<p>Hoy, en 2015, sigue con el mismo significado revanchista y franquista como cuando se construyó en 1950. Ha llegado la hora o de cambiarle el nombre, o de destruirlo. Símbolos así no merecen cabida en un espacio de convivencia como la ciudad de Madrid. </p>
";"07/09/2015 19";"235";"78";"157";"29";"841731164";"-2622"
"361";"Multar a quienes publicitan sus servicios a través de altavoz en la vía pública";"<p>Identificar y multar a aquellos chatarreros, tapiceros, etc que molestan a los vecinos circulando semanalmente con sus vehículos por zonas residenciales ofertando sus servicios a voz en grito mediante un altavoz.</p>

<p> </p>
";"07/09/2015 19";"84";"58";"26";"3";"858705106";"2209"
"362";"Precio polideportivos";"<p>Deberían bajar el precio del acceso a las instalaciones deportivas municipales ya que no puedo entender como me sale mas barato asisitir a un centro privado que a uno público.</p>
";"07/09/2015 19";"582";"535";"47";"22";"873019159";"44859"
"364";"ATASCO Vicálvaro: rotonda M40-Av Canillejas a Vicálvaro NO SEÑALIZADA           ";"<p>Todos los días laborales, hay retenciones en la M40 (sentido norte) entre San Blas y Vicálvaro, por lo que es normal que se formen pequeños atascos en <strong>ambos distritos, </strong>al acceder a la <strong>M40 norte, por la rotonda de la Av Canillejas a Vicálvaro</strong>. Sin embargo, como los <strong>ACCESOS</strong> a esta rotonda <strong>NO ESTÁN SEÑALIZADOS</strong> (ni señales en el pavimento, nI verticales, ni semáforos, que faciliten el acceso desde Vicálvaro), los vehículos que provienen de <strong>San Blas, abusan de su prioridad, </strong>y se suelen <strong>parar en las zonas de intersección de la rotonda,</strong> originando <strong>ATASCOS enormes SÓLO EN VICÁLVARO (a veces hasta la Pza. Vicálvarada)</strong>, mientras que en la zona de San Blas apenas hay atasco.</p>

<p>Solicito implementen la <strong>regulación por SEMÁFOROS</strong> o, al menos, <strong>SEÑALIZACION EN EL PAVIMENTO</strong> (<strong>líneas de carriles específicos de acceso</strong> y señalización de <strong>prohibido parar en las zonas de intersección</strong>), similar a la que hay en los accesos a la rotonda de la M40-Ctra. San Blas a Coslada, para que el <strong>atasco</strong> matutino de acceso a la M40 norte,  <strong>se distribuya equitativamente en ambos distritos (</strong><strong>Vicálvaro y San Blas)</strong>.</p>
";"07/09/2015 19";"56";"52";"4";"18";"864256748";"4457"
"365";"Eliminación de cualquier anuncio sexista de las marquesinas de los autobuses ";"<p>Eliminación de cualquier anuncio sexista de las marquesinas de los autobuses y de los propios autobuses</p>
";"07/09/2015 19";"169";"116";"53";"6";"860734664";"4324"
"366";"Evaluación de las políticas políticas públicas madrileñas";"<p>El Ayuntamiento debería contar con una Política de Evaluación propia y realizar evaluaciones periódicas de sus proyectos, planes y programas, además de implementar una estrategia de gestión del conocmiento.</p>

<p>La publicación de los resultados de las evaluaciones favorecería la transparencia y la rendición de cuentas pública.</p>

<p>La aplicación de las recomendaciones de las evaluaciones promovería el aprendizaje para la mejora de las políticas públicas madrileñas. </p>

<p>Aprender y mejorar para transformar.</p>
";"07/09/2015 19";"64";"55";"9";"2";"862639522";"3953"
"367";"Que los taxis tengan que hacer un número de horas en bici ";"<p>En Madrid últimamente hay mucho debate en torno a las bicis y se ve una falta clara de concienciación. Normalmente los debates y las escenas desagradables que se ven en la carretera, se dan por parte de personas que claramente nunca han cogido una bici en la ciudad (muchas veces por miedo). Muchas de estas personas que se enfadan tantísimo con las bicis, han usado la bici en el campo y en el pueblo, pero es que compartir espacio vial con vehiculos motorizados a diario es muy diferente. Hay coches, autobuses y en especial taxis que hacen pirulas a las bicis muy muy peligrosas, y no son conscientes del daño que hacen. No saben lo que supone estar en una bici mientras a tu alrededor pasan coches y camiones a 50km/h. No es justo que su estrés ""de la carretera"" lo pagemos el resto y menos con miedo o a costa de tener un accidente.</p>

<p>Al menos los taxistas (que muchos se creen legitimos dueños) y los autobuses, antes de tener la licencia para conducir por el centro de la ciudad deberían pasar un número determinado de horas subidos en la bici y conduciendo por el centro de Madrid. Solo así, van a ser conscientes de lo que supone la vulnerabilidad de la bicicleta y van a aprender, por ejemplo, por qué es necesario adelantar con 1'5 m o dejar 5m de distancia de seguridad. Mis padres y mi hermano entraban dentro de esa categoria de personas, desde que se dan cuenta de que la bici que va delante podría ser su hija o su hermana han cambiado la forma en que conducen y respetan a las bicis.</p>
";"07/09/2015 20";"161";"30";"131";"24";"844172527";"-1881"
"369";"Aceras invadidas por las terrazas";"<p>¿Cómo es posible que en una ciudad que se busca la movilidad peatonal haya aceras en las que literalmente te tienes que bajar a la calzada con el peligro que conlleva para poder pasear?</p>

<p>No quiero imaginar como lo harán las personas con movilidad reducida.</p>

<p>Deberían limitar el espacio aunque eso conlleve menos recaudación por licencia.</p>
";"07/09/2015 20";"277";"233";"44";"34";"867700954";"15897"
"370";"Ampliación puente calle embajadores con av. santa catalina";"<p>Hace unos años prometieron al barrio de entrevías la retirada de chabolas en la avenida de santa catalina y ampliación del puente que cruza hacía la caja mágica, ya que es de un carril.</p>

<p>Dichas chabolas desaparecieron (ahora es un solar que podría usarse para ampliar el parque forestal de entrevías) y que de momento solo sirve para acumular suciedad y escombros.</p>

<p>Solo limpian esta zona cuando se celebra un acontecimiento en la caja mágica...</p>

<p>La ampliación nunca llego y parece que no llegará, ni siquiera hay mantenimiento de dicho puente, ya que no dispone de ninguna iluminación (cuando pasa por dicho puente el carril bici, siendo un peligro al pasar en la oscuridad) La iluminación de la vía de hecho acaba según pasas la caja mágica, desde allí hacia la calle embajadores dirección carretera de Villaverde a Vallecas hay iluminación nula.</p>

<p>Espero que nos tengan encuentra ya que por este puente y por esta vía pasan a diario muchos coches, autobuses, peatones y deportistas. </p>

<p>Imagino que hasta que no ocurra una desgracia en el puente, nadie tomara medidas como suele ocurrir con todo en esta ciudad.</p>
";"07/09/2015 20";"34";"25";"9";"0";"857191472";"1176"
"371";"no al circo con animales n Madrid";"<p>Es retrógrado y cruel seguir en este siglo contemplando como entretenimiento un espectáculo consistente en, animales robados de su habitar y su familia, y forzados con métodos todos sabemos como de crueles (quitar comida, látigos, clavos,grilletes,,, acercar fuego etc) todo lo q sirva,siendo aún crías, para someter y hacer obedecer. Ya el circo del sol da ejemplo de como buenos cirqueses no necesitan explotar y encerrar animales q sólo quieren su libertad.(la cual es inexistente ya que,después del espectáculo pasan la vida en jaulas, trasportados en camerinos de aquí allá.</p>

<p>Respeto ya por la. naturaleza y las dmas especies con quien compartimos este planeta, q creemos nuestro.hay una recogida d firmas sobre esto en change.org, dirigida a Carmena,lleva 200.000 y pico</p>
";"07/09/2015 20";"525";"422";"103";"7";"868505064";"25641"
"372";"Cambio de la pintura Túnel Doctor Esquerdo ";"<p>El túnel de la calle Doctor Esquerdo justo para llegar a la plaza de Manuel Becerra, está muy viejo y su pintura esta deshecha. Una capa de pintura no estaría nada mal</p>
";"07/09/2015 20";"39";"35";"4";"0";"861768336";"2782"
"374";"Cambio de las baldosas de las calles secundarias (no solo de las principales";"<p>Recuerdo que hace un par de años, el Ayuntamiento de Madrid cambió las antiguas baldosasde rombo grisis por unas más modernas y cuyo impacto visiual era mejor. Hasta ahí todo bien, pero tiempo después me enteré de que no todas las calles iban a ser remodeladas, solo las principales. Por favor, cambien las baldosas feas de las calles secundarias (todo esto si hay dinero claro).</p>
";"07/09/2015 20";"45";"37";"8";"2";"860530423";"2384"
"375";"Fuencarral El Pardo";"<p>He visto con horror como en una de las glorietas del nuevo barrio de Montecamerlo (en concreto a la que se accede desde la M-607 en dirección Madrid), como adorno, en medio, en lugar de un arbol u otro tipo de monumento, ¡han colocado una máquina de matar!, una ametralladora....¿es que eso nos parece adecuado para decorar la ciudad???</p>

<p> </p>

<p> </p>
";"07/09/2015 20";"23";"14";"9";"3";"853070486";"304"
"376";"ÁRBOLES CON LAS GUÍAS DE HIERRO.";"<p>HAY ÁRBOLES QUE YA NO LAS NECESITAN PORQUE YA TIENEN UN BUEN TAMAÑO Y EN CAMBIO HAY OTROS PEQUEÑOS QUE CRECEN TORCIDOS PORQUE ESTÁN MAL PUESTAS. POR FAVOR, CUIDEN Y RIEGUEN LOS ÁRBOLES Y ARBUSTOS EN EL DISTRITO DE SALAMANCA.</p>
";"07/09/2015 20";"48";"45";"3";"0";"863674548";"3937"
"378";"Multas recaudatorias";"<p>El Ayuntamiento de Madrid sigue enviando a la policía municipal a los parques a poner multas recaudatorias bajo la ley 'antibotellón'.</p>

<p>Tres chavales en un banco tomándose una lata de cerveza no es BOTELLÓN. Un trabajador en la calle Goya comiendose un bocadillo con una cerveza tampoco. La multa en cambio sí es profesional : 600 EUROS, casi el salario mínimo de un mes.</p>

<p>Dos reflexiones ;</p>

<p>1. ¿Van los agentes a poner esas multas a sitios conflictivos o se limitan a ponerlas a los pacíficos transeuntes de los parques? Sospecho que se limitan a recaudar su cupo mensual con el menor esfuerzo.</p>

<p>2. Empiezo a pensar que sale más barato okupar un edificio y tomarse la cerveza dento. Parece que el ayuntamiento simpatiza más con estas cuestiones</p>

<p> </p>
";"07/09/2015 20";"94";"65";"29";"23";"859823306";"2489"
"379";"Distrito C - Las Tablas - Polígono Industrial La Moraleja";"<p>Buenas tardes</p>

<p>Quería proponer que se estudie la posibilidad de potenciar el transporte público en las zonas indicadas para evitar el colapso de las vías de entrada y salida desde o hacia éstas áreas en horas punta, ya que, son muchas las empresas que se han instalado, y se siguen instalando allí, y escasos los medios de transporte, desde autobuses interurbanos cuya frecuencia es de 20 minutos y en verano de 30 minutos, metro insuficiente para las largas distancias en estas zonas, y la gran mayoría de trabajadores, procedemos de Madrid, y de otros puntos alejados, y tenemos que recurrir al cercanías. Propongo que la línea T61 desde la estación de cercanías de Fuencarral, amplíe su recorrido hacia Avda de Europa en el Polígono Industrial de la Moraleja u otras zonas alejadas de su recorrido actual, o si no, una línea similar que haga un recorrido alternativo. De esta forma, habría muchas más personas que podrían dejar el coche en casa y conciliar la vida familiar y laboral. Gracias por brindar la oportunidad de participar en éste foro.</p>
";"07/09/2015 20";"37";"32";"5";"0";"860855165";"2335"
"380";"Comercio de barrio, proximidad y economía social";"<p>Principalmente un plan de fomento e inversión en la economía social, cooperativa y solidaria, para poder transitar hacia modelos de ciudades comunes y cooperativas.</p>

<p>Igualmente, un plan para favorecer estas iniciativas, así como el pequeño comercio frente a los grandes almacenes y grandes compañias multinacionales.</p>

<p>Algunas de las ideas, además de un plan de fomento del cooperativismo social (por ejemplo en BCN se va a hacer http://ccaa.elpais.com/ccaa/2015/04/12/catalunya/1428853670_634408.html ), así como ayudas y facilidades para tirar adelante éstos proyectos frente al resto de modelos.</p>

<p>De igual modo, medidas tanto para la economía social como el pequeño comercio para fomentar y publicitar su consumo -acceso a listado de estos tipos de comercio, incentivos, regulación de horarios, ceder publicidad de forma gratuita a este tipo de comercios que no pueden acceder, etc.)</p>
";"07/09/2015 20";"98";"85";"13";"2";"864616594";"6244"
"381";"Limpieza Manzares";"<p>El impresentable que un río en pleno centro de España esté tan sucio y con tan poca agua. Es que el río da una imagen desoladora cuando paseas por Madrid Río.</p>
";"07/09/2015 20";"305";"295";"10";"5";"872238564";"27565"
"382";"Revisión concesión placas minusválidos en las vías públicas. ";"<p>Con los anteriores gobiernos del Ayuntamiento han concedido plazas de minusválidos a todo el que la ha solicitado sin revisar si existe alguna cercana. Concretamente en Vallecas conocemos lugares donde hay concesiones antiguas y que el minusválido que la solicitó ya no vive en la zona o ha fallecido.</p>

<p>Sería conveniente revisar si todas las placas corresponden con la realidad actual de las solicitudes realizadas en un cierto período de tiempo.     </p>
";"07/09/2015 20";"162";"151";"11";"3";"868514236";"13049"
"383";"Red pública de puntos de recarga para vehículos eléctricos";"<p>Para incentivar el uso de vehículos no contaminantes se debería desarrollar una buena red de puntos de recarga. Yo personalmente, que no tengo garaje, no me planteo la compra de un coche eléctrico por la escasez de puntos de recarga.</p>

<p>Se podrían aprovechar infraestructuras ya creadas, como por ejemplo las estaciones de bicimad (ampliando su tamaño para poder albergar otros vehículos) o modificar otras como las paradas de autobús, haciendo que las plazas de aparcamiento colindantes sean puntos de recarga.</p>
";"07/09/2015 20";"254";"224";"30";"2";"868689157";"17108"
"384";"PUBLICIDAD PROSTITUCION.";"<p>LA PROSTITUCION DEBERIA ESTAR PERMITIDA Y REGULADA Y SE EVITARÍA TODA ESTA PUBLICIDAD A LA QUE ESTAMOS SOMETIDOS EN DIFERENTES BARRIOS DE MADRID, CONCRETAMENTE EN EL DISTRITO DE SALAMANCA.ESTE TIPO DE PUBLICIDAD TIENEN TELEFONOS Y DIRECCIONES WEB. ¿PORQUÉ NO SE INVESTIGA Y SE ELIMINA ESTA LACRA EN LA CIUDAD DE MADRID.</p>

<p>EN EL DISTRITO DE SALAMANCA, LOS QUE REPARTEN ESTE TIPO DE PUBLICIDAD SON CHINOS.</p>
";"07/09/2015 20";"67";"35";"32";"7";"851925652";"156"
"385";"Recuperar el barrio de las letras";"<p>Recuperar el barrio de las letras para la literatura y las artes escénicas. No puede ser que Madrid sea una de las ciudades con mayor historia literaria del mundo, y tanto sus ciudadanos como los turistas desconozcan su historia, las calles que pisan y las autoras y autores que la han habitado..</p>

<p>Es necesario reconvertir el barrio, y que sea un centro neurálgico de la producción literaria, librerías y artes escénicas. De igual modo, recuperar su historia -carteles explicativos, murales, etc-, así como fomentar el turismo desde éste aspecto y la historia en los centros educativos-.</p>

<p> </p>

<p> </p>
";"07/09/2015 20";"299";"276";"23";"14";"870751858";"23353"
"386";"LIMPIEZA EN TETUÁN";"<p>Sé que se está implementando un plan de limpieza integral, pero es que en tetuán las calles huelen y rodeas la basura por las aceras para ir al metro, A parte de limpiar profundamente con que pasaran la escoba yo ya me conformaba. CAlles como san felipe o general margallo dan mucha pena.</p>
";"07/09/2015 20";"68";"64";"4";"12";"865455234";"5647"
"388";"Habilitar zonas para que los perros orinen y prohibir hacerlo en la via pública";"<p>Algunos dueños ya han aprendido a recoger las heces de sus mascotas, pero los orines de los perros también ensucian, huelen, son antihigiénicos e insalubres. Muchos dueños de perros se creen con derecho a que sus canes orinen en medio de la calle, en la puerta de tu portal, en la acera, en las esquinas, en las ruedas de los coches, en los ciclomotores aparcados, es decir, en cualquier sitio. Esto, aparte de un asco, es algo que luego se limpia con los impuestos de todos o peor, no se limpia y lo tenemos que sufrir los demás. Propongo acotar zonas adecuadas y prohibir este comportamiento incivico de los dueños de los perros que les dejan orinar en cualquier sitio.</p>
";"07/09/2015 20";"121";"74";"47";"15";"857718937";"1651"
"389";"Optimizar el horario de recogida de basuras en Fuencarral-El Pardo";"<p>Muchos habitantes de Fuencarral-El Pardo estamos sometidos a un horario infernal de recogida de basuras. Tenemos que dejar los cubos fuera por las mañanas, sólo de lunes a sábado, entre las 7 y las 10 de la mañana.</p>

<p>Aunque, como no podía ser de otra manera, el camión viene más o menos cuando se le antoja, de manera que no es tan raro bajar en pijama a las 9.30 y salir persiguiendo como alma que lleva el diablo al dichoso camión. O quedarte con la basura durante todo el fin de semana. </p>

<p>Como no puedes dejar las basuras en la calle por la noche, ni dejar el cubo pernoctando, los vecinos sólo tenemos una alternativa: madrugar todos los días, sábados incluidos. Es un agravio comparativo con la mayor parte de barrios de Madrid y esperamos que haya cambios en este sentido. </p>
";"07/09/2015 20";"33";"27";"6";"3";"859509675";"1718"
"390";"Promoción de la música";"<p>Que se cree un evento musical a nivel internacional, que esté a la altura de una capital europea como es Madrid</p>
";"07/09/2015 20";"133";"116";"17";"1";"865968440";"8634"
"391";"parque del casino de la reina";"<p>Quisiera proponer como mantener el parque de nuestro barrio, me imagino que habra muchas ideas, a ver si nos leen y entre tod@s hacemos algo.</p>

<p>Lo primero es decir que se sabe que la cafeteria del parque paga al ayuntamiento una cantidad, que no se si seria suficiente , pero con ese dinero se podria dar al menos un puesto de trabajo para el mantenimiento permanente, dado que la dejadez lleva al deterioro y por lo tanto a mayor gasto.</p>

<p>Con esto quiero decir, que si solo tenemos un parque en el barrio, donde son casi 50000 vecinos censados, creo que es justo tener un parque digno para tod@s</p>
";"07/09/2015 20";"18";"13";"5";"0";"855074861";"577"
"392";"Plan Estratégico de la Ciudad de Madrid";"<p>Madrid necesita urgentemente un Plan Estratégico que, liderado por el gobierno municipal, y con la participación de la sociedad civil madrileña (organizaciones sociales, económicas, culturales, etc.) diseñe un modelo de ciudad a largo plazo en el que se contemple un desarrollo sostenible que genere valor para los ciudadanos. Este plan debería identificar unas líneas estratégicas en las que se enmarcarían proyectos, programas y actuaciones concretas que tendrían que estar vinculadas al Presupuesto Municipal.</p>
";"07/09/2015 20";"39";"31";"8";"4";"859554274";"1828"
"393";"Observatorio contra la intolerancia";"<p>Hacer de Madrid una ciudad que abandere iniciativas contra cualquier tipo de actitud intolerante, alejándonos de respuestas puntuales y generando mecanismos automatizados de respuesta, consiguiendo hacer de ello un sello de distinción que desde siempre se encuentra en el código genético de los ciudadanos madrileños. </p>

<p>Se deben incluir políticas de re orientación del gasto del presupuesto munical que permita poner en marcha iniciativas cada vez mas ambiciosas.</p>

<p>Madrid por la capitalizad de los derechos humanos.</p>
";"07/09/2015 20";"67";"43";"24";"0";"856770009";"1219"
"394";"Urna más accesible";"<p>Sugiero que en el salón de plenos , la urna se colque en un sitio donde los concejales (incluso los más bajitos ) puedan llegar para emitir su voto.</p>
";"07/09/2015 20";"31";"13";"18";"2";"845737418";"-209"
"395";"DEPORTE, ENTRETENIMIENTO Y SOCIEDAD: Ciclistas en la Vía Pública.";"<p>Existen muchas protestas sobre la realización de actos deportivos, sobre todo individuales, que se realizan en la via pública y que la ciudadanía en general pone en entredicho por los comportamientos antisociales de deportistas y de viandantes.</p>

<p>Claro esta que existen normativas, comportamientos e influencias educacionales, asi como el total desarraigo del principio de solidaridad y buenas formas de convivencia.</p>

<p>Podriamos proponer enseñanzas que nos llevarian generaciones poner en marcha, aztuar con rigidez en el cumplimiento de la normativa que nos llevaria a enemistarnos con quien ejerce de autoridad, etc.</p>

<p>Yo creo que lo esencial pasa por intentar reconocer que es necesario el buen entendimiento, la solidadridad y el respeto.</p>

<ol>
	<li><strong>Por ello propongo en primer lugar, debatir sobre los Ciclistas en la Viá Pública, aficionados y no aficionados.</strong></li>
</ol>

<ul>
	<li>Reglas para tratar de resolver en primer lugar, la visibilidad de los Ciclistas por los peatones y por los conductores</li>
	<li>Reglas para que los Ciclistas tengan a punto si vehiculo (la bici)</li>
	<li>Reglas para que se delimiten, visualmente, todas las fronteras de comportamiento entre Ciclistas y otros.</li>
	<li>Reglas para que Ciclistas, petaones y conductores respeten, se solidaricen, sepan ceder de sus derechos en ocasiones comprometidas, etc. que en definitiva socialicen la via pública, !como que es de todos¡</li>
</ul>

<p>... y mucho mas si se nos va ocurriendo... yo continuaré proximamente en otro ratito de iluminación</p>

<p>Saludos</p>
";"07/09/2015 20";"35";"17";"18";"5";"848576156";"-48"
"396";"PERROS SUELTOS";"<p>TENGO UN PERRO PEQUEÑO Y NO PUEDO DISFRUTAR DE UN PASEO POR EL PARQUE CON ÉL PORQUE HAY CIUDADANOS QUE SE CREEN CON EL DERECHO DE SOLTAR A SUS GRANDES CANES, CON EL CONSIGUIENTE PELIGRO DE QUE ALGUNO ATAQUE AL MÍO Y QUE ESTOS HAGAN SUS NECESIDADES DONDE LES APETEZCA. POR FAVOR, HAGAN CUMPLIR LA NORMATIVA DE QUE LOS PERROS DEBEN IR CON CORREA SIEMPRE Y LOS QUE PESEN MAS DE 20 KILOS CON BOZAL Y CORREAS PROPORCIONADAS A SU PESO Y NO ESAS DE JUGUETE EXTENSIBLES.</p>

<p>MULTAS PARA TODOS A VER SI DE UNA VEZ POR TODAS NOS CONVERTIMOS EN UNA CIUDAD EUROPEA DE VERDAD Y NO LA FARSA QUE SOMOS.</p>

<p>CARMENA, PONGA A LA POLICIA A PASEAR POR LAS CALLES Y NO EN SUS CÓMODOS COCHES POR QUE NO SIRVEN PARA NADA LA MAYORIA DE LAS VECES.</p>

<p>UN VOTANTE.</p>
";"07/09/2015 20";"128";"71";"57";"17";"855603462";"776"
"397";"Más Psicólogos en Servicios Sociales ";"<p>En los tiempos que vivimos es más necesaria que nunca la figura del psicólogo, sin embargo, la mayoría de recursos sociales carecen de él. Ayudas a domicilio, muchas residencias de mayores,  centros de servicios sociales, n algunos centros de día de personas con Alzheimer solo están cinco horas para más de 50 abuelos, en las que hay que hacer multitud de burocracia. Los abuelos que teniendo problemas múltiples, si no tienen Alzheimer, no son tratados. Parados, personas desahuciadas,   Etc., etc. </p>

<p>Por todo ello propongo que se aumente el número de estos profesionales en todos los ámbitos sociales.</p>
";"07/09/2015 20";"111";"90";"21";"11";"863678226";"5594"
"398";"Eliminar el tráfico de automóviles privados de tracción mecánica del centro ";"<p>El fomento del transporte público así como la movilidad en bicicleta pueden ser incrementados notablemente si se limitara el acceso al centro de Madrid únicamente a vehículos comerciales, taxis y autobuses de la EMT. Esto no sólo mejoraría la imagen y la calidad del tránsito sino que reduciría ampliamente la contaminación de la ciudad. Para ello se podría invertir en aparcamientos disuasorios PÚBLICOS en las entradas principales de la ciudad, como por ejemplo el de Ciudad Universitaria, así como aumentar el número de líneas y frecuencia de la EMT.</p>
";"07/09/2015 20";"121";"76";"45";"6";"858135847";"1947"
"399";"Contenedores SÓLO para residuos ORGÁNICOS, menos vertederos e incineradoras.";"<p>Si hubiere <strong>contenedores específicos para residuos orgánicos</strong>, <strong>sólo éstos deberían recorge a diario, </strong>mientras los actuales contenedores indicados para el <strong>resto de residuos, </strong>podrían ser recogidos cada 2 o más días. Realizando esta separación, los <strong>residuos orgánicos podrían compostarse más fácilmente, </strong>y el <strong>resto de residuos (al estar limpios de materia orgánica)</strong>, podrían <strong>reciclarse en mejores condiciones de higiene laborales</strong>, a la vez que se <strong>aumentarían los niveles de reciclado</strong>, y se <strong>reducirían</strong> drásticamente los residuos destinadas a <strong>incineradoras o vertederos</strong>.</p>
";"07/09/2015 20";"72";"63";"9";"4";"863848935";"4725"
"400";"Bajar el 21 % de iva en cine, teatro, lectura, musica y cualquier acto cultural.";"<p>Me gustaría que en la ciudad en la ciudad de Madrid se rebajase el 21% de IVA tanto, en cine, teatro, literatura, música, es decir cualquier acto cultural, además de poner dar más las ayudas en proyectos cinematográficos y de cualquier índole cultura, no sé qué opinareis el resto de la población, pero me parece fundamental que en esta vuestra ciudad se vuelva a fomentar la cultura tal como es debido, sin recortes, sin limites</p>
";"07/09/2015 20";"816";"677";"139";"21";"871341224";"44635"
"401";"Introducción de arbolado autóctono y menos alérgenico";"<p>Introducir paulatinamente en las nuevas zonas verdes, y si se pudiera en las presentes, especies autóctonas de arbolado, más adapatadas al clima y que sean menos alergénicas.</p>

<p>En especie, aunque sean seres vivos, estudiar un modo de sustituir o paliar los efectos negativos de especies como plataneros y mimosas.</p>
";"07/09/2015 20";"603";"575";"28";"16";"874785429";"52160"
"402";"Instalar máquinas de reciclado";"<p>En otros paises existen máquinas como las exprendedoras, en las que depositar latas y a cambio devuelven céntimos. Todo el mundo las usaría. </p>
";"07/09/2015 20";"767";"731";"36";"14";"875761227";"66237"
"403";"Reabrir la Biblioteca de la Caja (Barrio del Pilar - Fuencarral)";"<p>En el distrito Fuencarral - El Pardo, sólo tenemos dos bibliotecas: una gestionada por el Ayuntamiento y otra por la Comunidad de Madrid.</p>

<p>Hace tiempo teníamos una más, la <strong>Biblioteca de la Caja</strong> (también en el Barrio del Pilar) pero como muestra de la corrupción absoluta, ésta fue cerrada y cedida a la Fundación Valcárcel, relacionada con el escándalo de las <em>tarjetas black</em> de Bankia.</p>

<p>Desde hace un tiempo, los vecinos y vecinas del distrito, especialmente del Barrio del Pilar, venimos reclamando la reapertura de la biblioteca, como centro de cultura y de estudio, ya que escasean en nuestro distrito.</p>

<p> </p>
";"07/09/2015 20";"58";"51";"7";"2";"863160407";"3868"
"404";"Establecer un peaje de acceso de vehículos a Madrid";"<p>Uno de los motivos por los que el tráfico de la Ciudad de Madrid, sus carreteras de acceso y circunvalación están permanentemente colapsados es por la cantidad de residentes en otros municipios que utilizan su coche particular para acudir a trabajar o a hacer sus compras a Madrid.</p>

<p>Al igual que en otras ciudades de Europa, podría establecerse un peaje disuasorio de entrada a la ciudad a los vehículos que no estuvieran registrados en Madrid mediante una red de cámaras con reconocimiento de matrículas en las carreteras / calles de entrada y en las vias principales de la ciudad.</p>

<p>La medida permitiría disminuir drásticamente el tráfico rodado y la contaminación, haciendo más segura la circulación en bicicleta por toda la ciudad.</p>
";"07/09/2015 20";"117";"64";"53";"6";"854661517";"601"
"405";"Bicicletas del Ayuntamiento, 30 primeros minutos gratuitos";"<p>Creo que el problema de la contaminación en Madrid esta ligeramente por encima del problema de la deuda. Por ello es terriblemente importante acostumbrar o concienciar a los madrileños de que usen medios de transportes alternativos al coche. La bicicleta es el mejor, en unos 20 minutos puedes ir de Moncloa hasta Piramides sin demasiado problemas, sin las esperas que supone coger el Metro o los atascos que puede tener un coche. </p>

<p>El servicio actualmente funciona fatal, es una chapuza que en algunos casos a amigos mios les han quitado 10 euros por tener la bici 20 minutos, pero creo que esto sería recibido con los brazos abiertos para muchos, y necesario para otros. </p>
";"07/09/2015 20";"165";"120";"45";"7";"862411643";"5454"
"406";"Eliminar el S.E.R.";"<p>Eliminar el cobro por aparcar en la calle, zona azul y zona verde. Ya pagamos un impuesto sobre vehículos de tracción mecánica. </p>
";"07/09/2015 20";"141";"66";"75";"10";"844669151";"-421"
"407";"Mejorar el transporte público, una tarea fundamental para la ciudad.";"<p>El transporte público en la ciudad de Madrid, año atrás, orgullo de la ciudad, como muchas cosas ha perdiendo calidad en el servicio, los autobuses y metros ha disminuido las frecuencias de paso por los recortes, el Metro por ejemplo tiene deficiencias en el mantenimiento, seguridad..etc, debería haber siempre personal y contratar  gente donde hace falta en las estaciones de Metro, yo propongo que se hablase con el Consorcio de Transportes para recuperar la calidad del servicio del transporte público de la ciudad, volver a dar la calidad de servicio de hace unos años, por supuesto que los autobuses y metros tarden menos.</p>

<p> </p>

<p>En el caso de Metro renovar los trenes de las líneas 1,6 y 9 que tienen los trenes mas antiguos y ya toca renovar la flota, los autobuses de la EMT nuevo que sean ecologicos, coches confortables para los ciudadanos, un transporte público de primera para una ciudad como Madrid en definitiva.</p>

<p>También incluso en la propuesta a ver si sería posible quitar el nombre de Vodafone en la línea 2 y en Sol, se que nuestra alcaldesa tenía intención de hacerlo, yo espero que esto sea posible y se llegue a un acuerdo con el Consorcio.</p>
";"07/09/2015 20";"126";"116";"10";"2";"867354719";"9758"
"408";"Introducir Car2go en Madrid para reducir contaminación";"<p>En Madrid se debería introducir el Car2go que ya se utiliza en muchas ciudades europeas y americanas como New York y Roma y que permitiría reducir la contaminación de la ciudad. Funciona en parte como el BiciMAD y consiste en alquilar un coche cada vez que se necesita (una app señala los coches mas cercanos a ti) y luego dejarlo aparacado en cualquier aparcamiento publico (el coche se activa con tarjeta). Esto permite moverse sin preocuparse de aparcamientos, gasolina etc. y reduciría el número de coches en circulacion. </p>

<p>Más información aquí:</p>

<p>https://es.wikipedia.org/wiki/Car2go</p>

<p>https://www.car2go.com/</p>
";"07/09/2015 20";"82";"64";"18";"3";"861743980";"3590"
"409";"Legalización y regularización de la prostitución";"<p>Ya que la prostitución es una realidad ya va siendo hora que Madrid lleve la iniciativa y se sume a muchas de las capitales europeas que han regularizado la prostitución y han transformado un problema incómodo en nuevos ingresos para sus ciudades. Regularizar la prostitución acabaría con gran parte del proxenetismo, con la prostitución en las calles y explotación de menores e inmigrantes. Experiencias como en Francia, Alemania, Suiza y desde hace decadas en Holanda han confirmado que existen alternativas a la persecución de clientes y trabajadores.</p>
";"07/09/2015 20";"484";"368";"116";"43";"867168907";"19160"
"410";"Ayudas a madres jóvenes ";"<p>Creo que sería útil y bueno para la ciudad ayudar a las madres jóvenes ya que cada vez es más complicado tener hijos y eso q la larga afecta a la ciudad</p>

<p>Son problemas y medidas de largo plazo y por eso no suelen tomarlas los políticos pero deberíamos crear una sociedad que permita y ayude a ser madre pensando en el Madrid del futuro</p>

<p>Entre otras iniciativas se debería ayudar fiscal mente a quienes contraten a mujeres con hijos que busquen un trabajo con horario reducido para compatibilizar trabajo y familia</p>
";"07/09/2015 20";"129";"78";"51";"9";"857604067";"1632"
"412";"Cambiar los respiraderos de metro, ¡son un peligro para las bicicletas!";"<p>Es muy peligroso ir por la carretera con la bicicleta y de repente ver que tu rueda va directamente hacia un agujero de un respiradero de metro (ej. en la calle Espiritu Santo en Malasaña). Creo que sería muy importante cambiar este tipo de respiraderos por otros (con forma de cuadrado y no de línea) dónde las bicicletas puedan pasar sin peligro de caer entre sus rejillas. </p>

<p> </p>

<p> </p>
";"07/09/2015 20";"100";"79";"21";"1";"862674587";"4582"
"413";"Substituir las APRs, por zonas de prohibición de aparcamiento para no residentes";"<p>Creo que es exagerado impedir el acceso con el vehículo privado a ciertas zonas de la ciudad APRs, ni para recoger algo o a alguien, para reducir el tránsito de vehículos en estas zonas, ya que bastaría con prohibir el aparcamiento a los vehículos de los no residentes, para obtener un efecto similar, sin tener que sancionar a los que van de paso.</p>
";"07/09/2015 20";"49";"28";"21";"6";"854049644";"400"
"414";"Gatos";"<p>Me encantaría que está ciudad comenzará a tener conciencia con los animales y en concreto con los gatos que nos aportan un gran servicio a la ciudad ya que limpian las calles de ratas, ratones e insectos.</p>

<p>Los gatos en la ciudad de Roma, uno de los muchos símbolos de la capital de Italia, están protegidos por ley, y puedes ver como el ayuntamiento se encarga de controlar las colonias esterilizándolos y manteniendo un mínimo de vacunas, paseando por la ciudad ves como  muchas comunidades de vecinos mantienen sus propios gatos.</p>

<p>Un Juzgado de lo Contencioso-Administrativo número 5 de Madrid ha avalado la labor de una comunidad de vecinos de alimentar y esterilizar a una colonia de gatos callejeros, condenando al Ayuntamiento de Madrid a pagar hasta 350 euros en costas y devolver la sanción de 900 euros impuesta, esto sucedió el año pasado y no puede repetirse.</p>

<p> </p>

<p> </p>
";"07/09/2015 20";"82";"63";"19";"10";"861608693";"3380"
"415";"Sustitución de asesores por catedraticos universitarios";"<p>Si se necesita ser asesorado, que sean los catedráticos universitarios quien lo haga (los hay expertos en todas las materias y de todas las ideologías). El dinero debería repercutir en el catedrático y en la universidad.</p>

<p>Es la mejor manera de estar bien asesorado y asegurarte que no enchufan a nadie.</p>

<p>Por supuesto que los catedráticos tendrían que presentarse voluntariamente, no obligarles.</p>

<p> </p>
";"07/09/2015 20";"81";"59";"22";"7";"860359367";"2695"
"416";"Ampliación de las aceras de la calle Infantas.";"<p>La calle Infantas es una de las pocas que queda sin ampliar en el barrio de Justicia. Las personas mayores, los ciegos, los minusválidos -y cualquier persona que no sea joven, agil y con las suficientes fuerzas para saltar, esquivar y soportar empujones de los transeuntes con los que se cruza en dicha calle-, no pueden transitar por una de las calles más concurridas del barrio. Eso sin hablar de los usuarios de  bicicletas, que cuando les viene en gana y por un egoísmo incívico descorazonador ( ya que ellos saben lo que es abusar de la fuerza, puesto que los automóviles lo hacen con ellos), expulsan a los peatones sin ningún miramiento -¡ y diles algo!.-</p>

<p>Solicito por tanto una iniciativa para facilitar el tránsito de los viandantes por dicha zona.</p>
";"07/09/2015 21";"45";"35";"10";"3";"859758031";"1944"
"417";"El solar de Metro en Pacífico deber volver a uso público y equipamientos";"<p>Quería que se vovlviera a replantear el uso del solar de Pacífico (c/ Valderribas y C/ Granada). El tema lleva muchos años coleando desde que el cuartel de automovilismo del Ejercito cerró y ahora, la compañía Metro de Madrid se ha dado mucha prisa en venderlo al finalizar la pasada legislatura. Recuerdo que se llegó a plantear que como el Polideportivo de Daoíz y Velarde se vió que quedó pequeño, podrían ir allí la piscina de verano, porque aunque parezca mentira, Retiro es de los distritos que está dentro de la lista de carecer de este equipamiento público.</p>
";"07/09/2015 21";"82";"72";"10";"4";"864580131";"5443"
"418";"Aparcamientos Bicicletas Madrid Centro";"<p>Me parece genial que el <strong>ayudantamiento</strong> ponga estaciones satelite con <strong>bicicletas</strong> de <strong>pago</strong> por todas las esquinas para que la gente pueda moverse facilmente pero a los que ya tenemos bicicletas nos vendría bien que pusieseis al lado de las ya mencionadas estaciones satelite unos <strong>aparcamientos</strong> para las nuestras. </p>
";"07/09/2015 21";"156";"136";"20";"0";"866791024";"10112"
"419";"Semáforos en ámbar por la noche";"<p>A determinadas horas de la noche los cruces en la ciudad están infrautilizados por los coches y por los peatones. Propongo que aquellos en los que se pueda (calles pequeñas y medianas), se pongan en ámbar para los coches, pues agilizaría los movimientos en coche cuando no hay nada de tráfico. Sobre todo cuando los semáforos no regulan el tráfico, sino que lo paran. Por supuesto no en calles grandes, pues al peatón también hay que protegerlo.</p>
";"07/09/2015 21";"86";"44";"42";"7";"851567119";"102"
"420";"Abrir la estación de metro de arroyo del fresno";"<p>Se trata de una estación contraída y no abierta. Debido a la reactivation de la zona y el aumento de vecinos debería ser abierta</p>

<p> </p>
";"07/09/2015 21";"40";"31";"9";"0";"859213534";"1705"
"421";"No a la propaganda electoral";"<p>Es un despilfarro (de dinero y recursos) empapelar la ciudad con propaganda electoral antes de las elecciones. Si la gente quiere informarse hay otras formas de hacerlo. ademas los carteles no informan absolutamente de nada.</p>
";"07/09/2015 21";"381";"344";"37";"11";"871334228";"27718"
"422";"Peaje para los no empadronados en Madrid por usar nuestras calles";"<p>Los principales problemas de congestión del tráfico en Madrid son debidos a aquellos que viven fuera de Madrid y vienen a trabajar entre semana. Saturan la ciudad y no contribuyen al mantenimiento de las infraestructuras de movilidad. Propongo cobrar un pequeño peaje como hacen otras grandes ciudades como Londres por entrar </p>
";"07/09/2015 21";"255";"58";"197";"15";"843796512";"-3161"
"423";"Consulta municipal sobre inmigración / refugiados";"<p><strong>Desde la Troika nos vuelven a imponer sus políticas</strong> mediante un ejecutivo que los ciudadanos no hemos elegido. Los MassMedia (en su poder) <strong>están trabajando a toda máquina estos días para tratar de lavar la cara a esta nueva oleada migratoria, pero una vez más (y al igual que con los sucesivos gobiernos del PPSOE), los ciudadanos no tenemos voto.</strong></p>

<p> </p>

<p>Esto YA está pasando en otras ciudades europeas y no aparece en la televisión </p>

<p>http://www.20minutos.es/noticia/2548201/0/policia-griega/impide-lesbos/afganos-refugiados-ferri-trasbordador/</p>

<p> </p>

<p> </p>

<p>Como siempre, los obreros sufriremos las consecuencias, ya que<strong> en los barrios donde viven los políticos, banqueros, ciertos periodistas y demás colaboradores de la élite global, nunca verán a un ""refugiado"".</strong> Por ello insto al gobierno de Madrid que inicie un <u><strong>proceso democrático donde los ciudadanos decidan</strong></u> si aceptan estas medidas migratorias de la troika o no.</p>
";"07/09/2015 21";"115";"75";"40";"8";"859127265";"2282"
"424";"Reglamentación del ruido por aparatos en los patios";"<p>Ya sean los aparatos del aire acondicionado o, como nos pasa en casa, los aparatos de un dentista, se debería de regular en pequeños patios cerrados que concentran aún más el ruido lo que se permite poner. Y más, teniendo un patio abierto disponible para poner los aparatos. El ruido que se genera no deja vivir, y los límites de ruido actuales no tienen en cuenta lo nefasto que es para la salud oír ruido todos los días en cualquier estancia de la casa.</p>
";"07/09/2015 21";"59";"50";"9";"9";"862775379";"3474"
"426";"Que el Ayuntamiento promocione la investigación con becas y proyectos";"<p>Inversión de nuestros impuestos en futuro: promoción de la investigación con becas predoctorales y postdoctorales, así como de proyectos de investigación.</p>
";"07/09/2015 21";"125";"107";"18";"2";"865613728";"7618"
"427";"Que las personas con discapacidades puedan trabajar";"<p>Somos muchas las personas que tenemos algún tipo de discapacidad que podemos trabajar, pero no se nos acepta o bien no se tiene en cuenta los problemas para acceder a cualquier trabajo.</p>
";"07/09/2015 21";"69";"60";"9";"5";"863856678";"4434"
"428";"Prohibir y castigar de forma ejemplar grafitis";"<p>Muchas veces aparecen graffitis en la fachada de la vivienda donde vivo llamas para que lo limpien y es cierto que lo quitan en pocas horas pero a los pocos días vuelve a estar el graffiti en el mismo sitio y así una y otra vez debería de haber cámaras de vigilancia o polías y multas ejemplar</p>

<p>es para que los grafitis se acabe esto se hizo en Londres dónde hacer un graffiti se convirtió en un delito penal y se acabaron a los pocos años</p>
";"07/09/2015 21";"133";"98";"35";"18";"862479726";"4642"
"429";"Apertura de más puntos de encuentro familiar";"<p>Para facilitar y hacer cumplir el régimen de visitas de los padres a los menores. La falta de estos Centros, ha impedido que muchos padres puedan ejercer su derecho y deber de ver a sus hijos. Los hijos salen también perdiendo</p>
";"07/09/2015 21";"32";"18";"14";"0";"852323609";"225"
"430";"Agilizar la construcción del gimnasio en Barrio del Pilar Av.Monforte de Lemos";"<p>el solar que ya está vallado para la construcción del gimnasio y equipamientos deportivos se encuentra paralizado por la concesión a la empresa GO Fit, solicito al ayuntamiento que agilice el proceso de revisión de la concesión para que no seamos los vecinos los afectados por la paralización de la obra.</p>
";"07/09/2015 21";"60";"40";"20";"6";"857879039";"1333"
"431";"Apertura de más guarderías públicas";"<p>Faltan guarderías públicas. En mi opinión, mejores que las privadas: se repetan cuotas de espacio y cuidadores por niño. Las cuotas (el coste) se pueden poner en función de la renta.</p>
";"07/09/2015 21";"87";"74";"13";"2";"864177510";"5188"
"432";"Parque en el solar de calle Tiziano y mejora de la calle para el colegio infatil";"<p>En la calle Tiziano existe actualmente una escuela pública infantil y el estado de la calle no es el mejor:</p>

<ul>
	<li>
<strong>El tamaño de las aceras es insuficiente</strong>: los padres deben llevar a los niños agarrados y deben ir por la calzada porque no caben por la acera.(Además hasta hace pocas semanas había elementos antiparking oxiadados en las aceras que podían provocar tétanos y de todo a los chavales. Yo mismo casi sufro un incidente con uno).</li>
	<li>
<strong>Olor a orín insoportable</strong>: la puerta del colegio está enfrente de la puerta trasera de la iglesia de San Antonio y huele mal.</li>
	<li>
<strong>Zona-descampado</strong> ""Instalaciones provisionales en el barrio de Tetuán"": Un espacio que podría contar con zonas verdes, columpios, bancos y que daría mucha más vida al barrio.</li>
</ul>

<p>Teniendo en cuenta que circulan decenas de niños todos los días creo que es vital para la mejora del barrio y la salubridad de los chavales y vecinos.</p>
";"07/09/2015 21";"28";"17";"11";"1";"853795936";"364"
"434";"Contratos de luz públicos con comercializadoras de energía 100% renovable";"<p>Propongo que los contratos de luz pertenecientes al ayuntamiento de Madrid sean con una comercializadora verde para dar ejemplo de ciudad comprometida en la lucha contra el cambio climático y la contaminación, Hospitales, Institutos, Centros deportivos Bibliotecas, centros culturales, colegios, centros de salud, alumbrado público...</p>

<p>Existen numerosas comercializadoras y cooperativas que ofrecen estos servicios y el precio suele ser más bajo.</p>

<p>En mi vivienda tengo contratado el servicio eléctrico con Gesternova que es una comercializadora madrileña y estoy muy contento.</p>

<p>http://www.gesternova.com/</p>
";"07/09/2015 21";"362";"333";"29";"8";"871863340";"27964"
"435";"Educar, concienciar y por último amonestar a que no se tire basura o colillas en";"<p>Madrid esta muy sucia, llena de basura en las calles, por un lado si que es verdad que la calidad de la limpieza a bajado mucho los últimos años, a causa de la privatización, los recortes y los baremos de los contratos firmados antaño, pero la basura y colillas la generamos los ciudadanos. </p>

<p>Muchas otras ciudades del mundo no tienen apenas basura o colillas en sus calles, muchas de ellas incluso sin apenas papeleras públicas, podria parecer una útopia darse esto en Madrid, años atras pensabamos eso de fumar en sitios cerrados o incluso de la necesidad de cinturon de seguridad.</p>

<p>Se necesita una campaña de concienciación ciudadana para que la gente se guarde la basura hasta la papelera más cercana, no tirar las colillas al suelo como si fuese lo más normal, tras la concienciación sino deberia de realizarse amonestaciones por parte de la policia municipal.</p>
";"07/09/2015 21";"258";"246";"12";"7";"871627596";"22311"
"436";"Limpieza alrededores de colegios";"<p>La limpieza de calles es importante pero ahora que comienzan los colegios deberían de prestar más atención a las calles en las que se encuentran ubicados. Hoy al ir al colegio situado en la calle vieja de pinto en villaverde alto el hedor era insoportable. Desde aquí pido limpieza y mano dura con las personas que orinan en las calles. </p>
";"07/09/2015 21";"47";"35";"12";"1";"859199276";"1712"
"437";"Accesibilidad viviendas";"<p>Propuesta para promover la instalación de ascensores en edificios de más de dos alturas que no dispongan de ellos. Para ello sería necesaria una línea de subvenciones en función de la renta de los vecinos y de la altura de los edificios, que permitan realizar la mejora a aquellos que tengan más necesidad y/o menos recursos. Además de facilitar el espacio público vial si fuera necesario para la realizacion del proyecto arquitectónico.</p>
";"07/09/2015 21";"61";"43";"18";"9";"859213072";"1762"
"438";"Instituto del varón.";"<p>El 80% de las víctimas de homicidio son varones. A pesar de eso su presencia en los medios de comunicación es mínima. No se analizan las causas de los asesinatos, no se atiende a la familia de las víctimas ni hay programas de prevención,</p>

<p>Los varones tienen una esperanza de vida inferior a las mujeres, en cinco años. Es necesario revertir esta situación desviando atención sanitaria hacia la prevención y cura de enfermendades propias de hombres.</p>

<p>El fracaso escolar afecta de manera desproporcionada a los hombres, que ya son solo el 40% de los universitarios. Hay que establecer sistemas de cuotas y favorecer a los hombres son becas específicas masculinas.</p>

<p>La represión social y policial se ceba con el género masculino, que puebla las cárceles del Estado en un 87%. </p>

<p>Los medios de comunicación y la publicidad transmiten una imagen del hombre como un ser violento,irreflexivo, insensible e inmaduro. Hay que establecer observatorio para la aprobación y catalogación previa de contenidos audiovisuales.</p>

<p>Ante esta situación no es extraño que los hombres ejecuten el 66% de los suicidios.</p>

<p>Propongo que se constituya en Madrid el Instituto Madrileño del Varón, para implementar programas integrales y transversales destinados a lograr la igualdad del hombre en estos ámbitos sociales.</p>

<p> </p>
";"07/09/2015 21";"252";"161";"91";"52";"861493733";"4472"
"440";"Ayudas emprendedores";"<p>Nos falta creatividad y espíritu emprendedor para salir de la dificil situación en la que estamos. ( como sociedad, por que al fin y alcabo, Madrid somos todos).</p>

<p>La generación actual de jóvenes, es la que tiene mayores niveles de estudios completados de nuestra historia.( en mi caso tengo carrera, master, y hablo 3 idiomas). Pero al mismo tiempo se enfrenta a un futuro laboral, más incierto y difícil que nunca.</p>

<p>Se sabe, que el marco de referencia en el que se desarrollaron en su día nuestros mayores, ya no es válido, y se necesita referentes más próximos. Jóvenes, con perfiles y procedencias diversas, pero con el mismo afán por compartir y adaptar esta sociedad con nuevas capacidades, ideas, y proyectos.</p>

<p>La creatividad no es un privilegio de algunos. Todos los seres humanos nacemos con ese potencial.</p>

<p>Por lo que, ¿<u>porque no fomentar proyectos y acciones innovadores, para crear a Madrid, un referente mundial de la innovación y desarrollo, de tal manera que podamos ser un referente de emprendedores que generan empleo, en lugar de referente de busca de empleo</u>?</p>

<p>Muchas gracias por su atención.</p>

<p>Saludos</p>
";"07/09/2015 21";"53";"41";"12";"2";"860449442";"2243"
"441";"Ampliar los horarios de las piscinas climatizadas";"<p>Hoy me disponia a empezar una nueva temporada en la piscina climatizada de Vicalvaro, pero me he encontrado la sorpresa de que han cambiado los horarios,cierran unos dias a los ocho y otros a las ocho y media. Yo llego de trabajar casi a las ocho. Ahora los que trabajamos durante todo el dia tenemos un derecho menos. En vez de ampliar, recortar, eso era lo que hacia el pp, pero ahora no esta el pp, quien a tomado tan penosa decision?. Seguro que alguien que no piensa en la clase trabajadora, pero esos eran los del pp no?....que alguien se lo aclare a este trabajador progresista por favor.....</p>
";"07/09/2015 21";"60";"48";"12";"10";"861806769";"2880"
"443";"Volver más peatonal el eje de Paseo de las Delicias (autopista urbana)";"<p>El Paseo de las Delicias parece una autopista en medio de la ciudad, genera ruido, malestar, humo y contaminación. </p>

<p>Propongo eliminar carriles,bajar la velocidad de la circulación, ampliar aceras, ademas de instalar una linea sustitutoria de autobuses o tranvias de alta capacidad.</p>

<p>Los comercios y vecinos mejorarían su situación, ademas de bajar la contaminación de uno de los puntos negros de la capital.</p>

<p>Ya existen propuestas similares a esto para todo el eje Delicias-Prado-Recoletos-Castellana facilmente tranviable. Más peaton, más transporte publico combinado, lease lanzaderas y transportes de diferente capacidad/velocidad/frecuencia (bus, metro, tranvia)</p>
";"07/09/2015 21";"100";"80";"20";"7";"863437548";"4800"
"444";"Ayudas emprendedores";"<p>Nos falta creatividad y espíritu emprendedor para salir de la dificil situación en la que estamos. ( como sociedad, por que al fin y alcabo la Madrid somos todos, o eso nos dice la publicidad, ""Madrid la suma de todos""). jeje</p>

<p>La generación actual de jóvenes, es la que tiene mayores niveles de estudios completados de nuestra historia.( en mi caso tengo carrera, master, hablo 3 idiomas). Pero al mismo tiempo se enfrenta a un futuro laboral, más incierto y difícil que nunca.</p>

<p>Sabe que el marco de referencia en el que se desarrollaron sus mayores ya no es válido, y necesita referentes más próximos. Jóvenes de edades, perfiles y procedencias diversas, pero con el mismo afán por compartir y adaptar a esta sociedad nuevas capacidades, ideas, proyectos y sus recursos.</p>

<p>La creatividad no es un privilegio de algunos. Todos los seres humanos nacemos con ese potencial.</p>

<p>Por lo que, ¿porque no fomentar proyectos y acciones innovadores, para crear a Madrid un referente mundial de la innovación y desarrollo, de tal manera que podamos ser un referente de emprendedores que generan empleo, en lugar de referente de busca de empleo?</p>

<p>Gracias por considerar mi mensaje</p>

<p>Saludos</p>
";"07/09/2015 21";"68";"52";"16";"0";"861001664";"2752"
"445";"Intensidad lumínica en semáforos LED por la noche";"<p>No se si nadie mas lo ha notado pero los semaforos Led por la noche emiten demasiada luz y molestan bastante, algo que durante el dia esta muy bien por la noche puede suponer todo un problema para conductores y peatones. Propongo que no esten todos los leds encendidos a la vez y asi de paso sea tambien se ahorrara en energia electrica.</p>

<p>Gracias. </p>

<p> </p>
";"07/09/2015 21";"54";"39";"15";"6";"859317108";"1733"
"446";"Aceras para resicentes en el centro YA!";"<p>Los que vivimos en el centro tenemos que soportar día tras día la invasión de las aceras por gente que no son del barrio y que van a distinto ritmo... Un sábado por la tarde tenemos que soportar a la gente paseando! haciendo compras! turismo! y logicamente nos incomodan cuando vamos a la compra o al gym.</p>

<p>Como es posible que exitan estacionamientos para los coches residentes del barrio, y los peatones que somos muchos más no tengamos un espacio propio... que locura es esta! Los residentes del centro deberíamos llevar una identificación bien grande colgada del cuello que nos permitiera ir por una de las dos aceras de la calle que debería estar restringida para nosotros y separada físicamente del resto de viandantes.</p>

<p> </p>
";"07/09/2015 21";"120";"24";"96";"4";"845319765";"-1440"
"447";"Soterramiento M-30 Norte";"<p>La avenida de la ilustracion (M30 a su paso por la zona norte) divide en dos esta zona de Madrid, es una zona permanente de atascos y un foco de ruido y contaminacion enrome. Mediante su soterramiento se liberarian gran cantidad de espacios para uso y disfrute de todos los que vivimos en esa zona, al igual que ha ocurrido con la zona de Madrid Rio. Permitiria abrir carriles bici que conectaran con el actual, zonas de juego infantiles y peatonales. Ademas solucionaria los problemas de trafico en el acceso al nudo de manoteras y desde y hacia la carretera de colmenar, eliminando el ""excalextric"" mas propio de los años 70 que del siglo XXI.</p>
";"07/09/2015 21";"88";"60";"28";"4";"859501955";"2181"
"448";"Pintar los Pasos de Cebra¡";"<p>Últimamente hay muchso pasos de cebra que no se ven ya que la pintura se va y muchos cosas no lo ven.</p>
";"07/09/2015 21";"112";"96";"16";"6";"865534580";"6857"
"450";"App para smartphones de MADRID DECIDE y poder ver tus debates abiertos.";"<p>Lo dicho anteriormente</p>
";"07/09/2015 21";"209";"174";"35";"9";"867076196";"11572"
"451";"Abono deportivo y de uso libre anual";"<p>A principios de este año se eliminaron los abonos anuales deportivos, me imagino que porque no le saldrian rentables a los anteriores inquilinos del Ayuntamiento, pido desde aqui que vuelvan ya que es mucho mas comodo y mas rentable este tipo de abonos que el mensual.</p>

<p>Gracias. </p>

<p> </p>
";"07/09/2015 21";"58";"53";"5";"1";"864543199";"4386"
"453";"Contaminación atmosférica y contaminación sonora en las calles lazo.";"<p>Las calles de libre circulación del área de prioridad residencial del barrio de Embajadores se convirtieron en carreteras urbanas, Colegiata, Conde de Romanones, Doctor Cortezo, Magdalena...Son calles angostas, nunca fueron diseñadas como vías de paso, el Ayuntamiento las llama eufemisticamente calles lazo, se saturan de tráfico y ruido durante el día y también de ruido durante la noche por la inadecuada gestión de los servicios de limpieza y recogida de basura. Se baldean de madrugada, supongo que para evitar que las partículas depositadas acaben en suspensión empeorando la calidad del aire; en algunos tramos los camiones baldean las calzadas invadiendo la aceras, esto produce contaminación sonora aerea y estructural en las viviendas de los edificios colindantes durante la madrugada, destrozos en el pavimento, hundimiento de arquetas y registros. El modelo de áreas de prioridad residencial somete a los vecinos de las calles excluidas a altos niveles de contaminación atmosférica y sonora. Es imposible prrotegerse de la contaminación sonora estructural.</p>
";"07/09/2015 22";"56";"46";"10";"5";"862103116";"2957"
"454";"Gravar pisos vacios ";"<p>Primero exponer que esta propuesta no debería ir dirigida a pequeños propietarios, es decir, aquellos que posean una vivienda habitual y una segunda e incluso tercera residencia, esta es una materia que obviamente se deberia legislar cuidadosamente.</p>

<p>Esta medida sería util para bajar los precios de alquiler abusivos que sufre a menudo nuestra ciudad, provocando que  la compra de un piso se presente como la única decisión acertada, cuando en numerosos paises de Europa, el alquiler es una opción vital realmente extendida.</p>

<p>En capitales como Paris, creo recordar, esta medida fiscal o similar ya se aplica, su funcionamiento consistiría en gravar aquellos inmuebles, propiedad de una misma persona o empresa (bancos, inmobiliarias...), que después de un tiempo razonable, que debería estudiarse rigurosamente, continuaran vacios sin utilidad demostrada. Esto obligaría al propietario a sacarlo al mercado de alquiler o de venta, provocando una bajada de precios de los bienes inmueble, de la cual se beneficiarian todos los ciudadanos con necesidad de una solución habitacional, y adecuando su precio a su condicion de derecho constitucional.</p>
";"07/09/2015 22";"108";"70";"38";"8";"859146418";"2074"
"455";"Poner placas en los espacios infantiles para que se respete el descanso ";"<p>Pues se podian poner placas en los espacios infantiles para que los padres de los niños que los disfrutan se conciencien de que cerca hay vecinos descansando  y eduquen a sus hijos para que no den gritos a ciertas horas, en verano se pueden encontrar grupos de niños hasta la 1 0 2 de la madrugada dando gritos y los padres sin llamarles la atención. LOS NIÑOS TIENEN QUE JUGAR SI, PERO LOS VECINOS TAMBIEN TANEMOS QUE DESCANSAR.</p>
";"07/09/2015 22";"48";"28";"20";"1";"854530986";"466"
"457";"Fomentar el I+D+I";"<p>Se debería fomentar el I+D+I desde el ayuntamiento como medida para combatir el desempleo y como fuente de ingresos a largo plazo.</p>
";"07/09/2015 22";"580";"558";"22";"13";"875480025";"51566"
"458";"Ronda de Toledo";"<p>Esta calle, en pleno centro, cuenta con exceso de carriles lo que provoca excesos de velocidad, aceras estrechas y ausencia total de pasos de peatones. No es admisible esta especie de autopista en medio de la ciudad. Como medida urgente deberían crear un paso de peatones en la zona intermedia, a la altura de la entrada al Parque del Casino amser posible regulada con semáfor. Como medida más costosa y menos probable, convertir esta avenida en un bulevar agradable al peatón, al menos pueden estudiarlo. Gracias</p>
";"07/09/2015 22";"52";"35";"17";"0";"857650455";"1211"
"460";"Desmantelamiento del tramo de la A6 en la Ciudad Universitaria";"<p>La Ciudad Universitaria es un símbolo de la ciudad de Madrid. Es un espacio de gran calidad urbana, ecológica, paisajística y arquitectónica en el que se ubican gran parte de las dos universidades más importantes de Madrid, de la región y del país: la Universidad Complutense y la Universidad Politécnica de Madrid; además de muchas dependencias de la Universidas Nacional de Educación a Distancia; e incluso instituciones nacionales tan importantes como el Palacio de la Moncloa.</p>

<p>Sin embargo, la Ciudad Universitaria se encuentra partida por la mitad por una autovía de gran velocidad, desde el cruce del río Manzanares hasta el final en la plaza de la Moncloa, tramo que depende del Ayuntamiento de Madrid. Aún así, es un espacio que mayoritariamente se utiliza de modo peatonal por estudiantes, profesores e investigadores, y se pierde el disfrute de una parte importante del espacio público de gran importancia, además de complicar en gran manera la comunicación entre las dos zonas que separa la vía.</p>

<p>Por ello, propongo abrir un debate entre ciudadanos y expertos, para poder decidir sobre el futuro de este espacio. En el cual se pueda decidir si aportar más espacio a los peatones, desmantelanto la autovía completamente, creando una calle de menor tráfico rodado, pero con transporte público y mayor calidad urbana, con aparcamientos disuasorios que compensen la pérdida de una entrada a Madrid. O más aún, con una mayor complejidad técnica y económica, soterrar el tramo de la A6, para mantener el tráfico de vehículos, mientras se reconquista la superficie para la ciudad, y poder dar carácter al espacio ahora perdido.</p>
";"07/09/2015 22";"64";"35";"29";"7";"854058494";"328"
"461";"Derogar Ordenanzas ""civismo"" y replanteamiento de ésta";"<p>Hay numerosas leyes, que tratan de ""ordenar"" y ajustar las conductas sociales de la ciudadanía.</p>

<p>Si bien algunas de ellas pueden ser ""útiles"" -aunque incluso habría que dudar de ello-, hay una gran mayoría que son inútiles, absurdas, abusivas, discriminatorias, y que criminalizan la acción social. Por cierto, ¿qué es ser cívico?. Habría que cambiar hasta el propio concepto en sí mismo.</p>

<p>Es necesario abrir un debate y replantear todas las medidas -muchas ya señaladas en esta web-. No puede ser que haya multas y se persiga  a personas que estén sin hogar o que cojan alimentos de los contenedores y encima no haya recursos suficientes o se gaste más dinero en luces de navidad que en asistencia a éstos; que se multe por orinar y no haya wc públicos -y los bares te obliguen a consumir para usar el wc-, que se criminalice y persiga el Graffity y luego se expongan y comercialicen en ARCO; que se multe la música en la calle -cuando no está molestando a nadie- y te decomisen los instrumentos y te multen; que se multen con 600e a alguien que beba unas cervezas en la calle mientras que si lo haces en una terraza todo está bien; que te multen por patinar y no haya skateparks en tu barrio; poner todas las facilidades del mundo al asociacionismo y los colectivos sociales de Madrid para desarrollar propuestas y actividades, etc...</p>

<p> </p>

<p> </p>

<p> </p>

<p> </p>
";"07/09/2015 22";"44";"19";"25";"4";"846057518";"-259"
"465";"Revitalización de las Juntas de Distrito";"<p>Si se trata de acercar la Administración local a l@s madrileñ@s es imprescindible revitalizar los distritos para: 1) Que sean instrumentos de gestión para resolver los problemas concretos y singulares que afectan a los ciudadanos de cada barrio; 2) Que sean escuelas de democracia donde, debatiendo acerca de los problemas concretos en cada barrio, los ciudadanos se ejerciten en argumentar sus propuestas y confrontarlas democraticamente con las de otros ciudadanos que sean distintas a las suyas.</p>
";"07/09/2015 22";"48";"37";"11";"4";"860349431";"2004"
"466";"Enterar el tráfico de las calles Cea Bermúdez y José Abascal";"<p>El tráfico en esta arteria de Madrid es enorme al unir la carretera la La Coruña con la de Zaragoza. Provoca una contaminación ambiental y acústica tremenda en el centro de Madrid desde las 5:30 de la mañana a las 24:00 de la noche. Si se hiciera quedaría enterrado todo el trayecto señalado, dejando una zona arbolada para paseantes, carril bici y transporte público. Todos ganaríamos.</p>
";"07/09/2015 22";"58";"27";"31";"9";"847643590";"-186"
"467";"Carril bici en calles paralelas a avenidas principales";"<p>Realizar un estudio para ver la viabilidad de mejora después de convertir calles de sentido unico paralelas a Ejes terciarios a carriles bici de doble sentido. En muchas grandes avenidas, como puede ser en La albufera, Alcalám y Bravo Murillo entre otras, podría ser una mejora de la seguridad ciclista el separarlos de los vehiculos y una mejora de movilidad para todos los vehiculos.</p>

<p> </p>
";"07/09/2015 22";"103";"77";"26";"6";"862195503";"3812"
"468";"Promoción de cooperativas y residencias municipales de mayores autogestionadas  ";"<p>Me gustaría que desde el Ayuntamiento de Madrid se diera a conocer, se promoviera e impulsara la creación de cooperativas residenciales de mayores o de residencias municipales de envejecimiento activo y colaborativo en régimen de alquiler que supusieran un modelo alternativo a las residencias de ancianos actuales. He estado leendo sobre el senior co-housing y creo que a cualquiera le gustaría aspirar a una vejez no solo digna sino llena de posibilidades en un modelo diferente. La vivienda joven es importante, pero en una sociedad que envejece, los modelos de vivienda y de atención a la vejez necesitan una revisión de principio a fin.</p>

<p>Con el apoyo municipal será posible, de otra forma seguirá siendo accesible a muy pocas personas.</p>

<p>Os dejo este enlace para que lo conozcáis mejor http://satt.es/visita-trabensol-un-senior-cohousing/ </p>

<p> </p>
";"07/09/2015 22";"73";"62";"11";"0";"863817698";"4331"
"469";"Apertura de más guarderías públicas";"<p>Faltan guarderías públicas. En mi opinión, mejores que las privadas: se repetan cuotas de espacio y cuidadores por niño. Las cuotas (el coste) se pueden poner en función de la renta.</p>
";"07/09/2015 22";"426";"383";"43";"8";"872103278";"30568"
"470";"Gravar el IBI de los locales vacíos a partir del primer año sin actividad";"<p>Hay numerosos locales en Madrid, y en particular en el barrio de Chamberí, vacíos, sin actividad, abandonados y sucios que afean las calles. Suele pasar que estos locales pertenecen a empresas o particulares que acumulan propiedades y viven de las rentas sin generar mayor beneficio a la sociedad, y prefieren mantener vacío un local antes que bajar su precio para adecuarlo a las condiciones actuales. Por tanto parece lógico que si no es un perjuicio para ellos tenerlos vacíos, ya que siempre se puede alquilar bajando el precio, proponemos que se grave el IBI de estos locales a parir del primer año vacio sin actividad comercial o de cualquier otro tipo, progresivamoente cada año, favoreciendo así que se pongan en alquiler y dinamizar la economía y a los emprendedores al descender el precio de los alquileres. Los que generan trabajo y actividad se verán beneficiados y las calles recuperarán su vida con nuevos negocios. Si estás de acuerdo con esta medida no dejes de votar a favor,</p>
";"07/09/2015 22";"101";"69";"32";"6";"860187252";"2527"
"471";"Peatonalizar la calle de Hortaleza";"<p><strong>Hortaleza</strong> es una calle estrecha. Es difícil cruzarse con otros peatones en la acera y los coches siempre pasan rozando. Propongo que se peatonalice la calle y se deje 'abierta' únicamente para residentes, camiones de reparto hasta las 11 de la mañana y emergencias.</p>

<p>Antes de peatonalizar una calle mucha gente piensa que será un caos porque no habrá por dónde pasar o dónde aparcar. Bueno, eso siempre ocurre. Ahora a nadie se le ocurre que Arenal pueda estar llena de coches o se pueda aparcar en la calle de Preciados enfrente del Fnac. Peatonalizar las calles es positivo para los vecinos y bueno también para el turismo. El centro tiene que ser peatonal.</p>

<p>Carmena, puedes hacer grandes cosas por esta ciudad, no pierdas la oportunidad.</p>
";"07/09/2015 22";"112";"90";"22";"9";"864196779";"5464"
"472";"Transformar en habitables los locales comerciales cerrados";"<p>Me preocupan los cientos de locales comerciales que dia a dia van cerrando en nuestra ciudad sin casi opcion de continuidad debido al cambio de sistema de compras de los ciudadanos, cientos de locales vacios dejan una imagen tristey deapuperada de Madrid, podrian reciclarse en pequeños estudios o apartamentos para gente mayor, minusvalidos, jovenes....</p>
";"07/09/2015 22";"42";"27";"15";"1";"856326627";"771"
"474";"Apertura de más puntos de encuentro familiar";"<p>Para facilitar y hacer cumplir el régimen de visitas de los padres a los menores. La falta de estos Centros, ha impedido que muchos padres puedan ejercer su derecho y deber de ver a sus hijos. Los hijos salen también perdiendo</p>
";"07/09/2015 22";"36";"24";"12";"0";"856534137";"800"
"475";"Cursos subvencionados de movilidad en bici";"<p>Mucha gente se ha dado cuenta que  la bici es un metodo barato y ecologico para moverse, pero tiene miedo, ya que muchos no han cogido la bici desde que eran pequeños, y su respuesta al miedo es crear carriles bici, peligrosos tambien, ademas de muy costosos, cuando lo que se trata es de compartir espacios, respetar las normas, osea se, educación y sentido comun...entonces habra mas bicis y menos coches, no les demos el gustazo a los que contaminan, compartir convivir...</p>
";"07/09/2015 22";"43";"25";"18";"1";"854449370";"406"
"478";"No permitir edificios ruinosos ni solares vacios en el centro de Madrid";"<p>Deberian estudiar una ley  por la que se destruyesen edificios insalubres en un plazo estipulado por el ayuntamiento, si el propietario no lo derriba, que lo ejecute el Ayuntamiento, la propiedad se mantendria, solo que, una vez propuesto un proyecto de edificacionen regla, los propietarios tendrian que abonar los gastos del desescombro, esos solares mientras no tuviesen un proyecto serio podrian ser utilizados como plazas de parking o mejor, plantando unos arboles autoctonos, sin barreras que los aislasen,serian pequeños respiraderos de los vecinos.</p>
";"07/09/2015 22";"95";"80";"15";"6";"864775602";"5473"
"479";"Las cosas claras sobre el precio de la vivienda";"<p><strong>Desearía que el ayuntamiento de Madrid tomara una posición clara y rotunda respecto al tema del precio de la vivienda.</strong></p>

<p>El precio de la vivienda es un tema polémico que afecta a gran parte de la población y en el que no hay salidas fáciles que no perjudiquen a nadie. Una bajada generalizada del precio representa reducir la valoración del patrimonio de muchísimas personas de todos los estamentos sociales. Mantener o subir el precio representa volver a  endurecer el acceso a la vivienda de enormes capas de la población que, en general, están menos favorecidas.</p>

<p>Pero los datos son tozudos. Tradicionalmente, basándose en las medias históricas, los expertos recomiendan que la vivienda media tenga un valor entre <strong>3,5 y 4 años de sueldo</strong> medio (ver: http://www.idealista.com/news/inmobiliario/vivienda/2013/05/14/617545-la-banca-comprar-un-piso-deberia-costar-solo-cuatro-anos-de-salario-frente-a-los).</p>

<p>En Madrid, según datos de 2014, el precio de la vivienda tras su desplome aún supera los <strong>9 años de sueldo</strong> (ver http://ccaa.elpais.com/ccaa/2014/12/28/madrid/1419773295_023353.html).</p>

<p>Mucha gente no entiende las consecuencias del encarecimiento de la vivienda. En propiedad o en alquiler, es el mayor gasto en toda la vida de una persona: duplicar su precio significa que el pagador tiene muchísimo menos dinero para cualquier otro gasto, pagar por productos cuya producción genera empleo, o afrontar el gran gasto que representan los hijos. Ese dinero, en lugar de eso, se redistribuye a los vendedores de vivienda (constructores, promotores, y también ciudadanos comunes), a los bancos (más precio, más hipoteca) y al Estado (más precio, más impuestos).</p>

<p><strong>La redistribución negativa de la renta causada por la burbuja inmobiliaria es la principal causa del paro, del derrumbe bancario y su rescate, y de la deuda pública. Estamos en crisis por el precio de los pisos.</strong></p>

<p>Y precisamente ahora, empiezan a sonar noticias de una ""incipiente recuperación"" del mercado inmobiliario porque los precios repuntan un poco. Medios y políticos jalean esas noticias como si fueran positivas. Y muchísima gente lo cree, y piensa que el incremento de precios de la vivienda es una vuelta a la normalidad positiva.</p>

<p>Esta ambigüedad es mortífera.</p>

<p><u><strong>Quiero que el Ayuntamiento se pronuncie claramente sobre si desea unos precios de la vivienda en ascenso o en descenso.</strong> </u></p>

<p>Y, a partir de ahí, que sepamos a qué atenernos respecto de las medidas de vivienda que se adopten.</p>

<p>La mejor política de vivienda es que los precios en el mercado sean asequibles, y sean muy pocas las personas que necesitan ayuda por no poder permitirse nada.</p>

<p>Muchas gracias.</p>
";"07/09/2015 22";"49";"40";"9";"4";"861717415";"2530"
"481";"Parque para perros en el Barrio de Barajas Distrito 21";"<p>Son muchos los vecinos que tienen mascotas fundamentalmente perros, sin embargo no existe un parque específico para ello en el barrio, el único que existe en el distrito se encuentra en el Parque Juan Carlos I el cual es insuficiente y además queda alejado de varias zonas del distrito.</p>

<p>Los vecinos han ido ocupando algunos parques como el situado entre las calles Trópico y Acuario o solares como el de la calle Playa del Sardinero con Playa de Fomentor por ello es sin duda un equipamiento necesario para los vecinos del distrito. </p>
";"07/09/2015 22";"46";"28";"18";"2";"855645409";"608"
"483";"¿Qué cuesta cada acción?";"<p>Sería interesante saber lo que cuestan las cosas que se hacen desde el ayuntamiento de una manera que sea entendible para cualquiera. Idealmente que incluya trazabilidad.</p>

<ul>
	<li>¿Cuánto cuesta el dispositivo de seguridad del evento X?, ¿y la limpieza?.</li>
	<li>¿Cuánto cuesta esta herramienta?</li>
</ul>

<p> </p>
";"07/09/2015 22";"55";"50";"5";"0";"864465731";"4090"
"487";"Que abran el metro toda la noche";"<p>Pues eso gente, que la apertura del metro toda la noche nos va a arreglar la vida a mas de uno.</p>
";"07/09/2015 22";"92";"66";"26";"4";"861049603";"2869"
"488";"Eliminar papeleras";"<p>Creo necesario dejar de barrer la suciedad provocada por el ""paternalismo"" que provoca el que existen múltiples papeleras. Creo que no pasaría nada si elimináramos la mitad por ejemplo. Así mismo se deberían incrementar las multas o trabajos sociales para los  que tiran una colilla o un chicle al suelo.  No será necesario limpiar aquello que no se ensucia.....Es cuestión de educación.</p>
";"07/09/2015 22";"119";"23";"96";"9";"845659399";"-1410"
"489";"Estacionamiento regulado en el Distrito 21";"<p>Sin duda la movilidad y aparcamiento en el Distrito son problemas graves a abordar, el estacionamiento regulado es imprescindible en puntos muy concretos del Distrito 21, aunque para los vecinos en general se trataría de una medida impopular.</p>

<p>Imprescindible en la Avenida de Logroño parcialmente desde el metro de Barajas hasta calle Gonzalo de Céspedes o Planeta, en la plaza de Barajas y en la Plaza del Navío.</p>
";"07/09/2015 22";"36";"11";"25";"3";"845894163";"-427"
"490";"Pago de Ibi";"<p>¿pagar el ibi la iglesia católica?</p>
";"07/09/2015 22";"114";"89";"25";"10";"863748493";"4996"
"494";"Problemas de movilidad en Ensanche de Barajas: calles sin aparcamientos";"<p>El planeamiento del Ensanche de Barajas tiene numerosos errores de planteamiento uno de ellos en la existencia de calles sin aparcamiento alguno lo que provoca que los vecinos aparquen ocupando un carril con lo que queda un solo carril para ambos sentidos lo que ha provocado accidentes de tráfico y seguirá provocándolos.</p>

<p>calles: Mistral, Monzón, Tornado (nueva) </p>
";"07/09/2015 22";"25";"15";"10";"0";"853699041";"300"
"496";"Limpieza ";"<p>Propongo mas limpieza en las calles..estan sucias..con pintadas...basura ...y eso da imagen de dejadez total por parte del Ayuntamiento..todo el mundo merece las calles limpias </p>
";"07/09/2015 22";"89";"81";"8";"3";"866509679";"6643"
"498";"USO DE BICICLETAS EN MADRID RIO";"<p>Hola</p>

<p>A pesar de ser un espacio de prioridad peatonal, está no se respeta y en vez de compartir y respetar, se convierte en un invasor.</p>

<p>Cuando no debería ser así, las actitudes faltas de civismo de muchos compañeros del pedal, hace que la gente mire mal al resto y eso no puede ser.</p>

<p>Es necesario, regulación vigilancia y sanción a las personas que no sepan convivir, si necesitamos correr hay espacios para ellos sin acosar a las personas que están paseando.</p>

<p>O cambiamos el chip, o no nos permitirán disfrutar de un sitio tan singular.</p>

<p>Gracias.</p>
";"07/09/2015 22";"64";"55";"9";"7";"863964064";"3953"
"501";"Bicicletas/aceras/ordenanzas";"<p>¿Hasta cuando debemos los peatones soportar la invasión de bicicletas en todas las aceras de madrid?</p>

<p>Por no hablar de la velocidad con la que circulan en parques como madrid río. Indiferentes a niños, ancianos, tullidos (yo soy una), peatones y/o animales.</p>

<p>Si un ciclomotor tiene matrícula...por qué no las bicis tambien. Si el civismo no nace por sentido común tal vez haya que darle su correspondiente ordenanza.</p>

<p> </p>
";"07/09/2015 22";"94";"64";"30";"21";"860522062";"2314"
"503";"Oferta cultural ";"<p>Hablo desde el barrio de Ciudad Lineal... y propongo que haya mucha mas oferta cultural..apenas hay ocio cultural en este barrio....apenas un cine...ni  teatros..ni conciertos.. ni acciones al aire libre....es obvio que en el centro de Madrid encuentras todo el ocio que quieras,..pero seria buena idea impulsar la creatividad desde los barrios mas humildes ..o habilitar espacios culturales para dar rienda suelta a los proyectos creativos</p>
";"07/09/2015 22";"43";"35";"8";"1";"861231879";"2197"
"506";"Rotonda necesaria en cruce de Playa de Barlovento, Sardinero, Caleta y Valhondo";"<p>Un grave problema de movilidad y de seguridad vial en el Ensanche de Barajas es el cruce de estas cuatro calles en un mismo cruce por lo que la posibilidad de una rotonda pudiera ser una solución que mejoré la seguridad vial en este punto, donde se han producido algunos accidente de tráfico. </p>
";"07/09/2015 22";"24";"11";"13";"0";"848173034";"-91"
"508";"Metro de Madrid ";"<p>Las frecuencias de Metro son vergonzosas..las condiciones de limpieza dan verguenza ajena..nos merecemos mejores servicios ..ya que no se corresponde el precio elevado de los billetes y abonos con el servicio prestado</p>
";"07/09/2015 22";"205";"189";"16";"10";"870252569";"15949"
"510";"Profesionalización y replanteamiento del  modelo para el Samur.";"<p>Desde hace varios años, tanto muchos ciudadanos de Madrid, como muchos de los profesionales sanitarios de nuestra ciudad, creemos que la figura del Voluntario dentro de Samur Protección-Civil ha sido explotada hasta la extenuación por los anteriores equipos de gobierno del Ayuntamiento de Madrid, considerándolos como mano de obra gratuita para crear un sistema de emergencias de gran impacto mediático pero con bajos costes laborales.</p>

<p>Si analizamos la última memoria publicada de Samur Protección-Civil para el periodo 2012-2013, este servicio contó con 657 (27%) profesionales funcionarios y 1770 (73%) voluntarios.</p>

<p>Aunque creo que tanto la formación como la actividad de los voluntarios de Samur-Protección Civil es la correcta, es intolerable que una Administración Pública (como es Samur Protección-Civil) funcione a base de la buena voluntad de las personas y abuse del tiempo ofrecido desinteresadamente por vecinos de Madrid, como si fuese una Organización no Gubernamental</p>

<p>Entiendo que cualquier organización, y si es pública con mayor razón, busca la excelencia dedicando suficientes recursos para seleccionar a los mejores profesionales, reconociendo su trayectoria y dedicación.</p>

<p>Precisamente este aspecto queda muy claro en la recientemente aprobada Ley 1/2015, de 24 de febrero, del Voluntariado en la Comunidad de Madrid en su artículo 13.2 El voluntario y las organizaciones de voluntariado no llevarán a cabo actividades que sean realizadas por el personal al servicio de las Administraciones Públicas, no tendrán la consideración de personal al servicio de las Administraciones Públicas, ni asumirán el ejercicio de funciones públicas ni obligaciones propias de la Administración""</p>

<p>Por ello, y aprovechando el reciente cambio del equipo de gobierno de nuestro Ayuntamiento, creo que es hora de el Ayuntamiento de Madrid se plantee cual es el modelo que quieren los ciudadanos de Madrid para el Samur Protección-Civil. </p>

<p>Queremos continuar con un sistema de emergencias que deforma el concepto de la Protección Civil con un interés economicista, basado en la voluntariedad y la explotación de personas, muchas de ellas profesionales sanitarios obligados a someterse a largos periodos de trabajo gratuito para poder tener en un futuro oportunidad de encontrar un puesto como funcionario dentro del Samur Protección-Civil.</p>

<p>O queremos un sistema de emergencias profesionalizado (Samur), con equipos reconocidos y que desarrollen su labor de manera digna y estable, que ofrezcan una atención de máxima calidad a nuestros vecinos y que cuente con un pequeño grupo de voluntarios (Protección Civil), preparados para actuar en situaciones que excedan los recursos propios del Samur.</p>

<p>Por el bien de todos los madrileños esperemos que su equipo escoja la segunda opción.</p>

<p>Espero su respuesta.</p>

<p>un saludo</p>

<p> </p>
";"07/09/2015 22";"88";"75";"13";"33";"865397508";"5284"
"511";"Cubos amarillos en cada portal de Lavapies para reciclado de envases.";"<p>Actualmente todos los portales tienen sus cubos naranjas, en algunas comunidades incluso tenemos dos, pero no hay amarillos, por lo cual mucha gente no separa los envases en origen. En distritos como Latina hay cubos amarillos pequeños para las comunidades de vecinos me gustaría proponer que esta iniciativa se aplique también en Lavapiés.</p>
";"07/09/2015 22";"51";"38";"13";"4";"860133109";"1862"
"513";"Implementar software libre en todo el ayuntamiento y organismos dependientes";"<p>Es bien conocido que anualmente se despilfarran millones en licencias de <em>software</em> que seria claramente reemplazable por <em>software</em> libre y abierto, que incluso dicho software es, en bastantes casos, muy superior al que se está empleando en estos momentos por la adeministración. Demás, es habitual que la vida últil de los equipos y sus componentes sea mayor si se utiliza determinado <em>software</em>, como por ejemplo: los equipos de escritorio con alguna distribución GNU/Linux adaptada a las necesidades.</p>

<p>Además, sería un buen punto de partida para concienciar a los trabajadores de la privacidad asociada a las ""nuevas tecnologías"" y de determinados riesgos tecnológicos así como una manera ""sencilla"" de minimizar dichos riesgos.</p>

<p>Todo esto se debería hace de manera gradual, es decir, con dos dedos de frente, sin ir a lo loco y teniendo siempre en mente al usuario de dicho <em>software</em>. Un punto de partida podríaser el ejemplo de la ciudad de Munich (Alemania) donde llevan ya unos años con esta política y aparentemente con buenos resultados.</p>

<p>Desde mi humilde punto de vista, se podría dividir en 3 grandes bloques:</p>

<ul>
	<li>Planificaicón y estudio de las ""alternativas"" necesarias para cubrir los requisitos de <em>software</em> y hardware del Ayuntamientos en la parte de servicios. Ejemplo: servidores, servicios externalizados (mantenimiento). De este modo, aunque se necesite introducir mayir plantilla para adaptar o crear software específico, estoy prácticmante seguro que no supondría ni la 1/4 parte de la inversión en licencias y además se estarían creando puestos de trabajo totalmente localizados.</li>
	<li>Planificaicón y estudio de las ""alternativas"" necesarias para cubrir los requisitos de software de los equipos del personal del ayuntamientos y otros organismos asociados. Consistiria en trees partes:
	<ol>
		<li>obtener requistos, sugerencias y quejas por parte de los empleados de manera localizada con el fin de homogeneizar las herramientas y buscar soluciones que cobran todas o prácticamente todas las neceidades básicas. Al mismo tiempo implementar alternativas de menera gradual al teimpo que se van impartiendo formación especídica para usar dichas herrameintas. Esto último es de especial importancia.</li>
		<li>Iniciar una sustitución más profunda de los sitstemas, implementando distribuciones adaptadas a cada área de aplicación al mismo tiempo que se imparten charlas o cursos relativas a la seguridad informática y posibles riesgos tecnológicos derivados del uso de los istemas.</li>
		<li>Adaptar las interfaces para que coexistan ciertas plataformas heterolgéneas que vayan acerándose a la eficiencia que pudieran ofrecer ciertas plataformas móviles al tiempo que se adaptan los canales para que la ciudadanía pueda interacturar, llegado el caso, con dichos sitemas. </li>
	</ol>
	</li>
	<li>Acercar y explicar a la ciudadanía la razón de dichos cambios, y pasado un tiempo, realizar una evaluación. Aplicar posibles cambios y corregir defectos de aplicación. Del mismo modo acercar y enseñar los principios que sustentan estos cambios a todos los niveles, desde los más jóvenes a los más mayores con menos experiencia.</li>
</ul>

<p>Sé que muchos detractores dirán que estos podría cabar con muchos puestos de trabajo, yo digo que sencillamente no es cierto, simplemente cambiarían o incluso aumentarían en ciertos casos. No se trata úincamente en un ahorro económico a largo o corto plazo,  s tratería más bien de una inversión a futuro con el fin de demostrar que se puede ser independientes tecnológicamente a la vez que sostenibles y que Madrid puede aportar si granito de arena en la investigación y el desarrollo, es decir, valor añadido.</p>

<p> </p>

<p> </p>
";"07/09/2015 22";"340";"284";"56";"40";"869488274";"19044"
"515";"Soterrar vías de tren en el Parque de la Bombilla";"<p>Buenas.</p>

<p>Las vías del tren que van de la estación de Príncipe Pio al Puente de los Franceses dividen el distrito de Moncloa en dos haciendo que los recursos como bibliotecas o guarderías queden muy a desmano. Creo que sería adecuado soterrarlas, aunque no fuera completamente al menos un tramo para comunicar mejor ambas zonas.</p>
";"07/09/2015 22";"52";"35";"17";"3";"858174042";"1211"
"517";"Pintura menos deslizante en la carretera - Es un peligro para las motos";"<p>La inciativa de poner los pasos de cebras regulados por semáforo con menos pintura (marcando sólo comienzo y final ) es buena, pero debe extenderse. No puede ser tan difícil una pintura no deslizante. Y lo mismo con las rejillas que quedan en medio de la calzada. Ambas cosas son un peligro para las motos, especialmente en invierno y con el suelo húmero.</p>
";"07/09/2015 23";"271";"248";"23";"4";"871135167";"20590"
"519";"Más iluminación en el Paseo del Zurrón ";"<p>En el paseo del Zurrón una vez caída la noche debido a que se trata de una calle arbolada la luz de las farolas queda anulada por los mismos árboles, por lo que se instalaron farolas a una altura más baja que ilumen la calle y acera pero sin embargo estas son insuficientes ya que sigue estando poco iluminada lo que conlleva problemas de seguridad ciudadana. </p>
";"07/09/2015 23";"21";"15";"6";"0";"856425096";"642"
"521";"Cubos Amarillos cada Día";"<p>Desde hace tiempo, al menos en Tetuán, sólo se sacan los cubos amarillos los Martes,  Jueves y Sábados.  Si un Sábado estas fuera se te acumulan los embases para reciclar 5 días en casa.</p>

<p>Queremos reciclar y lo hacemos. Pero pónganlo fácil. </p>
";"07/09/2015 23";"75";"55";"20";"2";"860995102";"2566"
"522";"Licencias definitivas para los locales de restauración";"<p>Los negocios de restauración sufren la inestabilidad de no conseguir las licencias de funcionamiento definitivas en casi ningún caso. Hay una Mafia funcionando en ese área del Ayuntamiento que salvaguarda sus intereses negando y demorando las licencias indefinidamente para tener a los propietarios dóciles y a la defensiva en casos de inspecciones y multas arbitrarias.</p>

<p>Existen diferentes criterios a la hora de controlar los locales y el amiguísimo el impera por doquier.</p>

<p>Es una pena.</p>

<p>propongo que se desbloqueen las licencias sin mas tardanza a los que cumplan con las normas.</p>
";"07/09/2015 23";"35";"24";"11";"0";"857254404";"891"
"523";"Plaza de Toros de las Ventas ";"<p>Se que es una utopia.. y enfadaria a mucha gente..pero seria una buena idea hablitar la Plaza de Toros de las Ventas solo para conciertos y actividades culturales.....y acabar de una vez por todas con la tortura animal que dia tras dia ocurre en esa plazaa</p>
";"07/09/2015 23";"136";"89";"47";"5";"860354368";"2748"
"524";"Introducción del lenguaje de la programacion en las aulas";"<p>Esta proposición no es la primera vez que se presenta, pero tenemos una gran oportunidad con esta herramienta para debatirla y llegar a un consenso de pros y contras y lo que conllevaria esto...</p>

<p>Esta propuesta esta basada en que la programación va a ser el inglés del futuro, ya uqe se considerará un lenguaje más, ya que los trabajos y profesiones que estan surgiendo cada vez estan virando mas al uso de dicho lenguaje en su uso laboral...</p>

<p>Además estas clases podrían ser de lo más divertidas para los niños ya que la programación va ligada a a robótica, apps y programas interactivos...</p>

<p>Sinceramente lo que me gustaria es uqe alguien en los comentarios diera motivos firmes y con buenas fuentes no como yo que estoy generalizando demasiado, y que tambien se sugieran posibles contras de esta medida.</p>

<p>Muchas gracias</p>
";"07/09/2015 23";"71";"52";"19";"9";"861016191";"2416"
"526";"Día sobre ruedas (sensibilización con los discapacitados motores)";"<p>Declarar un día al año <em><strong>Día sobre Ruedas</strong></em> para dar a conocer la problemática que sufren los desplazados mecánicos en su día a día y que el resto de la gente ignora simplemente por tener el privilegio de poder usar sus dos piernas</p>

<p>Consistiría en algo parecido al día del clima. Si en éste el reto es apagar tus electrodomésticos, en el <em><strong>Día sobre ruedas</strong></em> se trataría de hacer tu vida a bordo de una silla</p>

<p>Seguramente el capo Echenique me comprendería</p>
";"07/09/2015 23";"47";"37";"10";"3";"861023664";"2125"
"528";"Reapertura total de las Urgencias de Barajas ";"<p>Aunque se trata de una competencia de la Comunidad Autónoma instamos al impulso de la reapertura total de las Urgencias de Barajas, tras su cierre parcial. Actualmente abre únicamente de viernes a domingo y permanece cerrado de lunes a jueves de 20:30 a 8:30.</p>
";"07/09/2015 23";"57";"49";"8";"0";"863507907";"3524"
"530";"Auditoría ciudadana de las multas e impuestos";"<p>Los gobiernos anteriores han expoliado a los ciudadanos madrileños para pagar a la Púnica y construir ediicios fastuosos.</p>

<p>Han pagado todo esto con impuestos y multas injusta e injustiicadas, que han sangrado a la ciudadanía. Yo soy estudiante y me pusieron 600 euros de multa por salir de un bar con un cubata en la mano. </p>

<p>Propongo una auditoría pública y retroactiva de los impuestos y multas municipales para determinar cuáles son justos, y cuáles son odiosos.</p>

<p>Un referendum podrá decidir cómo deben ser los impuestos en el futuro.</p>
";"07/09/2015 23";"65";"38";"27";"2";"855855030";"643"
"531";"Soterramiento vías del tren, A-4 y M-40 a su paso por Villaverde";"<p>El distrito de Villaverde ha sido, históricamente, un distrito profundamente desfavorecido por los poderes públicos, que han hecho de este un lugar aislado del resto de distritos y con unas enormes dificultades de movilidad, incluso utilizando medio de transporte privado, dándose casos en los que es completamente imposible pasar de un barrio a otro sin jugarse la vida (por ejemplo, desde la Avenida de los Rosales a San Fermín) o la obligación de hacer un recorrido de varios kilómetros para pasar de un barrio a otro que visualmente esta a 50 metros (desde San Cristóbal de los Ángeles a Butarque, ambos en Villaverde).</p>

<p>Es completamente imprescindible el soterramiento de estas infraestructuras con el objetivo de hacer de este distrito un lugar más habitable que converja, aunque sea solo en aspectos de movilidad, con el resto de barrios y distritos del norte de Madrid.</p>

<p>La eliminación de estas barreras arquitectónicas redundaría, además, en una lógica prolongación sin barreras de uno de los parques forestales más grandes de Madrid: el Parque Lineal del Manzanares en su tramo II, el cual es ahora poco más que un estercolero, a diferencia de su ""hermano mayor"" del norte, y de otros como el parque urbano de la Dehesa del Boyal.</p>

<p>Por la convergencia de los barrios y distritos de Madrid es absolutamente imprescindible.</p>
";"07/09/2015 23";"85";"65";"20";"11";"862550323";"3441"
"539";"Más zonas de aparcamiento en el Centro, distrito Palacio";"<p>En los últimos años, año a año, se han ido disminuyendo las plazas de aparcamiento (más las verdes que las azules) por diversos motivos: ensanches de aceras innecesarios, alargamiento excesivo de las paradas de bus, colocación de contenedores,... </p>

<p>Hay muy poco sitio para aparcar y cada vez nos quedamos con menos. Sería importante encontrar espacio para que los residentes (y también los no residentes, pero priorizando a los primeros) podamos aparcar sin tener que estar 30 o 60 minutos dando vueltas algunos días. Otra opción sería la creación de algún parking municipal, con un coste similar al SER, que permita a los vecinos poder aparcar (lo que ayudaría a que haya sitio para los que vienen de fuera que a veces es imposible aparcar</p>
";"07/09/2015 23";"56";"34";"22";"5";"856520350";"728"
"540";"Instituto Público en Barajas Distrito 21";"<p>El distrito de Barajas necesita de un instituto público. </p>
";"07/09/2015 23";"45";"34";"11";"9";"860351911";"1737"
"545";"Ampliar los horarios de apertura Parque Capricho y Castillo Alameda ";"<p>Actualmente el parque del Capricho y el Castillo de los Osuna o Zapata abren únicamente los fines de semana y algunos días festivos, creemos que horarios reducidos e insuficientes.</p>
";"07/09/2015 23";"72";"59";"13";"0";"863343733";"3769"
"546";"Centros Culturales: más cursos, más económicos y sin subcontratas.";"<p>La oferta de los Centros Culturales,  no siendo mala, se queda corta y muchos quisiéramos una mayor variedad de oferta formativa.  ¿No sería posible consultar a los vecinos y que estos decidan qué cursos y talleres deben darse en sus centros?</p>

<p>Encontré un centro que ofrecía clases de guitarra eléctrica. 1 hora a la semana, 15 alumnos y más de 60 euros al mes... Un profesor particular de Guitarra va a tu casa a enseñarte a ti sólo por 15  la hora. ¿No creen que para ser un servicio municipal es un poco caro? Tampoco he visto cursos de Grabado en los centros de Madrid.</p>

<p>Por último no entiendo por qué hay empresas que malpagan a los profesores de edtos Centros, (véase Tritoma por ejemplo). ¿A qué se debe tanto intermediario en los servicios públicos?  ¿De verdad es necesario? </p>
";"07/09/2015 23";"87";"73";"14";"5";"864671633";"4950"
"547";"Prohibir las pegatinas de cerrajeros y otra publicidad ilegal.";"<p>&lt;div&gt;Las farolas, canalones, buzones, señales de tráfico, registros  o en los cierres habrás visto multitud de pegatinas que inundan Madrid. Si aún no te has hecho una idea una búsqueda de ""pegatinas cerrajeros"" en google images te recordará una imagen familiar. Los cerrajeros, representados por la Unión de Cerrajeros de Seguridad están a favor de prohibirlas llegando a afirmar que van desde la competencia desleal llegando a existir mafias. Algunos ayuntamientos como Tarragona y Barcelona ya lo han prohibido &lt;/div&gt;

Las pegatinas están diseñadas para ser especialmente difíciles de quitar lo que las hace más dañinas. No pagan por uso ni respetan las fachadas. Una vez que el barrio está feo empieza a degenarar. Uno pinta con boli en las pegatinas, luego típico niñato del edding, pintadas... no hay presupuesto para limpieza. Por si fuera poco, los encargados de pegarlas lo realizan de madrugada conscientes de que no son bienvenidos. Y apostaría a que la mayoría no están dados de alta en la seguridad social. Propongo crear una sanción para el que se anuncie con cualquier sistema que deje una marca difícil de eliminar. Los típicos carteles de asistenta se colocan con celo... o si no se podrían colocar con cinta de carrocero. También propongo que la sanción sea proporcional a los carteles colocados de forma que aquellos que lo organizan de forma masiva sean penalizados proporcionalmente. Hay empresas, no sólo de cerrajería que han empapelado todo los reveses de las señales de ciudad universitaria. Es eso... o sólo nos quedará llamar al cerrajero a las cinco de la mañana del sábado en un barrio periférico de madrid &gt;:-)  </p>
";"07/09/2015 23";"141";"122";"19";"4";"867187785";"8912"
"549";"poner carril bici en Madrid Rio";"Ya hemos comprobado que las bicis y los peatones no pueden ir por el mismo espacio, por favor s
dividan los paseos de Madrid Rio en carril bici y carril para peatones nos ahorraremos muchos disgustos";"07/09/2015 23";"110";"92";"18";"30";"865815688";"6189"
"550";"Parque skate / dirt Moratalaz";"<p>Muchos chavales desde hace ya tiempo han estado trabajando en caminos y saltos en el parque de moratalaz que recorre toda la M-23 (prolongacion de o´donnel) por la parte sur. La propuesta consiste en que se acondicione la iluminacion y se delimiten caminos para que los jovenes puedan practicar dirt y skate tambien aqui en Moratalaz, creo que se hizo algo muy parecido cerca de la caja mágica en legazpi solo que aqui tenemos mucho mas espacio y un entorno perfecto para que el parque se llene de entusiastas!</p>
";"07/09/2015 23";"61";"43";"18";"0";"859597201";"1762"
"552";"Fomentar el uso del transporte público de superficie";"<p>Renovación de la flota de autobuses de la EMT e incentivacion del uso del autobús con el aumento del servicio que año tras año se ha ido deteriorando tanto en retirada de vehículos de las lineas como en la No renovación de flotas y lineas para cubrir las necesidades de una ciudad que sigue creciendo día a dia.</p>
";"07/09/2015 23";"54";"43";"11";"0";"861738040";"2548"
"557";"Impulso de Barajas D21 como destino turístico y cultural";"<p>El distrito de Barajas tiene un Patrimonio Histórico único con numerosos recursos como la Plaza de Barajas y su casco histórico, plaza de Nuestra Señora de Loreto, Parque Juan Carlos I y el eje Castillo de los Osuna y Parque del Capricho así como otros iglesias y ermitas, un legado desconocido por muchos de los vecinos y que es necesario potenciar.</p>
";"07/09/2015 23";"37";"22";"15";"1";"854887019";"416"
"558";"Personas sin techo";"<p>Vuelvo a hablar desde el barrio de  Ciudad Lineal-..es realmente triste observar que hay personas que viven en plena calle .gente que no tiene un techo donde refugiarse..pasan la noche y el dia a la intemperie..y algunos llevan años en el barrio... sinceramente..esas personas necesitan una solucion digna.. no es justo que en un ningun barrio haya gente excluida de tener casa comida y techo </p>
";"07/09/2015 23";"51";"28";"23";"2";"853820032";"274"
"560";"Controlar el ruido excesivo de las motos.";"<p>Controlar el ruido excesivo de las motos.</p>
";"07/09/2015 23";"805";"749";"56";"22";"876263432";"64479"
"562";"Hacer visible el paso de peatones de calle Atocha";"<p>En la calle Atocha 49 existe un paso de peatones que casi ningún conductor respeta. Quiero creer que es porque no tiene buena visibilidad e imagino que con una mejor señalización podríamos mejorar su visibilidad para cumplir con la normativa.</p>
";"07/09/2015 23";"72";"66";"6";"0";"866098689";"5500"
"563";"Intercambiadores  ---->  pantallas de ""información"" SIN anuncios.";"<p>Al contrario que las pantallas -actualizadas- de otras Estaciones subterráneas (p.e. en moncloa) las situadas sobre cada dársena de embarque bajo ""Plaza de Castilla"" todavía siguen castigando la paciencia de aquellos pasajeros más ANGUSTIADOS mientras buscan líneas y trayectos, al entorpecer abusivamente su <strong>visión del horario</strong> -y tiempo remanente, hasta la salida programada- mediante interminables promociones comerciales  (ajenas a los <em>servicios operativos</em> de la plataforma)  que acaban por ocultarles la tan necesitada expectativa URGENTE de datos esenciales, a los cuales sin duda <u>tienen derecho</u> innegociable como clientes y (sobre todo) ciudadanos.  Si las ""rutinas"" de visualización  -que controlan dichos paneles-  no van a ser actualizadas, mejor que retiren definitivamente dichas pantallas: ya estamos HARTOS de los grandes almacenes que invaden <strong>espacios reservados</strong> a la información del pasajero.</p>
";"07/09/2015 23";"57";"44";"13";"3";"861412912";"2392"
"568";"Instalacion de urinarios en la Plaza de Tirso de Molina/de la orina";"<p>Se trataría de estudiar la posibilidad de instalar algún tipo de urinario en los alrededores de la Plaza o bien de recuperar los originarios de obra existentes en este espacio público hasta fechas no muy lejanas en el tiempo. La prestación de este servicio es una necesidad en si misma, además evitaría los desagradables e insoportables olores que padece esta plaza en el corazón de la ciudad.</p>
";"07/09/2015 23";"76";"66";"10";"5";"865100354";"4863"
"571";"Ampliar horarios polideportivos municipales";"<p>Hasta ahora los polideportivos municipales abren de lunes a viernes hasta las 21.00 hrs, y los sabados y domingos hasta las 15.00 hrs. Estos horarios dificultan a gente con trabajos con jornadas hasta las 19.00 o las 20.00 hrs. En especial, me gustaria hablar de las piscinas cubiertas, pidiendo que abran hasta las 22.00 y los fines de semana por la tarde... y preguntar por qué en verano cierran las cubiertas para que tengamos que nadar en las de fuera al aire libre con todo lleno de gente... hay gente que asiste a natacion porque lo necesita, no creo que sea un lujo dejar las cubiertas abiertas tambien en verano, para así, el que necesite nadar o simplemente lo practique como deporte, pueda realizarlo sin las masificaciones de las piscinas de exterior. muchas gracias! </p>
";"07/09/2015 23";"122";"113";"9";"7";"868580765";"9632"
"576";"Vivienda Social en el Distrito de Barajas";"<p>Uno de los mayores problemas a lo que se enfrentan los jóvenes del Distrito 21 es al acceso de la vivienda, muchos de ellos de no pueden asumir el coste de las viviendas que hay en el mercado ya que Barajas se ha convertido en una zona residencial y los precios de alquiler y venta son demasiado elevados. En el ensanche de Barajas esa vivienda social no tiene tales precios social y es claramente insuficiente en número.</p>

<p> </p>
";"07/09/2015 23";"48";"21";"27";"0";"846448481";"-262"
"587";"Crear una escuela obligatoria para los políticos";"<p>Elevaría mucho el nivel de nuestros gobiernos el que se creara una Escuela Pública de Formación de Políticos en la que los profesores serían ciudadanos corrientes. Las materias serían tanto políticas como de cultura general y se prestaría especial atención a las normas de moralidad y honradez personal. El titulo dispensado sería obligatorio para presentarse a cualquier elección popular.</p>
";"07/09/2015 23";"53";"27";"26";"0";"849893896";"50"
"588";"Bajar precio del servicio de bicicleta del ayuntamiento";"<p>Me gustaría que el servicio de bicicletas del ayuntamiento bajara si precio para los madrileños, al menos para los usuarios activos del abono transporte. El uso de la bici es sustitutivo del transporte público (si voy en bici, no voy en bus).</p>

<p>Este servicio podría estar dentro den Consorcio de Transportes.</p>

<p>Pido al ayuntamiento un compromiso serio con la bicicleta y el transporte público, única solución real a la contaminación y los problemas de movilidad.</p>

<p>Es bueno mirar a otras ciudades; por ejemplo en Las Palmas el uso de las bicis es gratuito.</p>

<p> </p>
";"07/09/2015 23";"82";"58";"24";"3";"860817248";"2404"
"590";"Bibliotecas/Salas de Estudio para todos";"<p>Ha de haber en Madrid suficientes Bibliotecas y Salas de Estudio para que ningún madrileñ@ tenga que esperar para su uso. Es una vergüenza que un estudiante en época de éxamenes esté una hora esperando por un sitio. </p>
";"07/09/2015 23";"79";"69";"10";"3";"865433646";"5153"
"599";"Más bancos";"<p>Os ruego que no entréis en pánico, no me refiero a los bancos que hemos rescatado todos con nuestro dinero ;-). Hablo de más bancos para sentarse. Como bien sabéis, en Madrid se ha producido una disminución sistemática e intencionada del número de bancos llevada a cabo por los anteriores ayuntamientos del PP que odiaban que la gente estuviera sentada sin pagar nada. Poco a poco han ido desapareciendo, especialmente en la zona centro, y han sido sustituidos por terrazas de locales. Pero el número y tamaño de terrazas no es la cuestión sobre la que quiero plantear el debate, ya que otros usuarios han iniciado ya discusiones sobre dicha cuestión. Aquí lo único que pido son más bancos. Muchos más. Muchísimos más. Que Madrid se llene de bancos, bancos donde poder sentarse a descansar o a tomar ese refresco que te has comprado en la tienda que te ha dado la real gana. Bancos para que no tengas que comer de pie por haber cometido el pecado de no consumir en una terraza. Bancos para tomar el sol. Bancos para ver pasar a la gente. Bancos para leer. Bancos cómodos, con respaldo como los de toda la vida, y no bloques de hormigón para evitar que pases demasiado tiempo sentado. Bancos grandes, para que se sienten varios amigos para charlar, y no antisociales, solitarias y enormes sillas. Bancos sin separadores porque las personas sin hogar también son seres humanos. Bancos en plazas, calles y parques. Bancos bonitos. Bancos para disfrutar de Madrid. Bancos para todos.</p>
";"07/09/2015 23";"141";"126";"15";"5";"868268713";"9919"
"601";"Reasfaltado calles Valdeacederas";"<p>Las calles del barrio de Valdeacederas se encuentran en un estado deplorable, multitud de baches, socavones y alcantarillas hundidas. Urge un reasfaltado en casi todas las calles, en especial las de mayor tráfico: Veza, Plátano, Arroyo, Capitán Blanco Argibay, Pinos Alta, etc.</p>

<p>Es un problema para la mecánica de los automóviles, pero también de seguridad para conductores y peatones, ya que se pueden producir pinchazos, salidas de vía y atropellos.</p>

<p> </p>
";"07/09/2015 23";"27";"16";"11";"1";"854209361";"296"
"603";"Implementar el uso del NFC";"<p>Al igual que en algunas paradas de bus, en las que acercas tu movil con el chip NFC (No es una frikada, es lo que llean los nuevos DNI 3.0) y al instante obtienes el lugar donde estas, la linea el horario...Pues lo mismo implementarlo bien en todas las paradas, en la oficina de turismo en sitios publicos que al fin y al cabo tengan que proporciionarte una información con un folleto, asi ahorrariamos muchisimo, y eso si seguir con el metodo tradicional para las personas que no tienen la posiilidad claro...</p>

<p>Invito a proponer mas beneficios de esta tecnologia y posrupuesto debatir sus posibles contras</p>
";"07/09/2015 23";"28";"21";"7";"2";"858683736";"1050"
"604";"Eliminar Madrid Destino como empresa gestora de la cultura de Madrid.";"<p>Recuperar para la cultura el dinero que supone mantener Madrid Destino Cultura Turismo y Negocio como empresa gestora de la cultura de nuestra ciudad, además  del porcentaje de beneficio que se llevan de las actuaciones de artistas y compañias a las que someten a  medidas que atacan al sentido común, viendose perjudicados directamente la económia y la cultura de los ciudadanos y visitantes de Madrid.</p>

<p>Por favor.</p>
";"07/09/2015 23";"43";"27";"16";"1";"856563672";"690"
"605";"Reasfaltado calles Valdeacederas";"<p>Las calles del barrio de Valdeacederas se encuentran en un estado deplorable, multitud de baches, socavones y alcantarillas hundidas. Urge un reasfaltado en casi todas las calles, en especial las de mayor tráfico: Veza, Plátano, Arroyo, Capitán Blanco Argibay, Pinos Alta, etc.</p>

<p>Es un problema para la mecánica de los automóviles, pero también de seguridad para conductores y peatones, ya que se pueden producir pinchazos, salidas de vía y atropellos.</p>

<p> </p>
";"07/09/2015 23";"33";"26";"7";"2";"860138135";"1496"
"612";"Eliminar Madrid Destino como empresa gestora de la cultura de Madrid.";"<p>Recuperar para la cultura el dinero que supone mantener Madrid Destino Cultura Turismo y Negocio como empresa gestora de la cultura de nuestra ciudad, además  del porcentaje de beneficio que se llevan de las actuaciones de artistas y compañias a las que someten a  medidas que atacan al sentido común, viendose perjudicados directamente la económia y la cultura de los ciudadanos y visitantes de Madrid.</p>

<p>Por favor.</p>
";"07/09/2015 23";"92";"76";"16";"3";"864720757";"4956"
"622";"VIH y ser taxista en Madrid";"<p>Es increible que en estos tiempos, pueda haber una discriminación de este tipo. Si consideramos que el vih es solo contagiable por semen, sangre o fluido vaginal, ¿por qué está prohibidos er taxista en Madrid y tener vih?</p>

<p>Que alguien me lo explique.</p>

<p>Adjunto, proposición de cahange.org para que se cambie esto.</p>

<p>https://www.change.org/p/ayuntamiento-y-comunidad-de-madrid-las-personas-con-vih-sida-tambi%C3%A9n-pueden-ser-taxistas</p>
";"08/09/2015 00";"19";"8";"11";"1";"848102362";"-126"
"632";"Ocupación de aceras por terrazas";"<p>Me gustaría que hubiera un teléfono, buzón, correo electrónico donde denunciar la ocupación de aceras por las terrazas de los bares, ya que a veces no dejan sitio para pasar. Una solucón sería marcar en rojo el límite que pueden ocupar. y si lo superan como denunciamos facilmente?</p>
";"08/09/2015 00";"37";"26";"11";"2";"858415440";"1054"
"634";"URGENTE Botón ""denunciar"" para malos usos de la plataforma";"<p>Estamos viendo como hay trolls que no paran de boicotear la plataforma con debates estúpidos. Pienso que lo único que tratan es hacer fracasar la iniciativa.  Como en muchos otros foros como meneame o reddit, donde se pueden denunciar los hilos, creo que esta plataforma necesita con urgencia un botón para ello. </p>

<p>Además de un botón de ""Denunciar""  o ""Ofensivo"" creo que no estaría mal una búsqueda de debates, no sólo de los últimos, sino de los más activos.</p>

<p>Esta es una iniciativa maravillosa, debemos sentirnos muy agradecidos de tenerla y, como las calles o los parques, los ciudadanos podemos tener un rol importante a la hora de mantenerla limpia. Podemos ayudar con nuestros votos y nuestras denuncias para que ciertos debates se oculten hasta que los moderadores comprueben si debe o no debe ser borrado. </p>

<p> </p>

<p>Gracias.</p>
";"08/09/2015 00";"202";"121";"81";"22";"860046740";"2396"
"637";"MENORES EN MADRID";"<p>Me gustaria tratar el tema de que desde la Comunidad de Madrid han hecho desaparecer el Instituto Madrileño de la Familia y el Menor haciendo que pasen los centros de proteccion a depender de Bienestar Social metiendo todo en un mismo lote y comparandolo con las Residencias de Ancianos. Quiero denunciarlo publicamente ya que me parece un total retroceso en el campo de los menores, los Centros de proteccion son de menores y tambien de de las familias y tendriamos que estar en Direccion General de la Familia ademas no hacer desaparecer el Instituto Madrileño del Menor y la Familia, en Madrid vamos para atras en politica del menor claramente y me gustaria saber desde el Ayuntamiento, que la propia Alcadesa dijera que piensa y si podria hacer algo para que entrara en razon la gente de la Comunidad de Madrid, yo soy trabajadora de un centro de proteccion y les puedo dar toda la informacion que precisen.</p>
";"08/09/2015 00";"32";"19";"13";"1";"854771468";"356"
"638";"PLAZAS CON ENCANTO EN MADRID";"<p>Da pena ver como en Madrid, ciudad preciosa, llena de plazas con mucho encanto e infinidad de posibilidades, en los últimos años se las han Ido cargando una a una en las sucesivas reformas. Faltan zonas con árboles y plantas para dar sombra en verano del sol aplastante y zonas de bancos para poderse sentarse y descansar o simplemente ver la vida pasar. Da envidia ver plazas con muchísimo encanto en otras ciudades como Lisboa o Roma pero no aquí en Madrid. TRANSFORMEMOS ENTRE TODOS ESAS PLAZAS GRISES E INHÓSPITAS EN PLAZAS ENVIADIABLES Y VIVIBLES!!!</p>
";"08/09/2015 00";"162";"153";"9";"6";"870480042";"13600"
"641";"Falsos autónomos. Economía de subsistencia";"<p>Cada vez son más. A sus obligaciones fiscales se añade un plus (recargo en equivalencia), sin contrapartida. Se publicitan ""ayudas a emprendedores"". La gran mentira. Somos emprendedores a la fuerza. Menos derechos que el resto y más pagos. Equiparación con las condiciones del resto de Europa.</p>
";"08/09/2015 00";"39";"32";"7";"4";"861690190";"2051"
"642";"Recuperar el tranvía en las avenidas que lo permitan.";"<p>Hay que recuperar el tranvía eléctrico en las grandes avenidas para sacar los contaminantes autobuses de todos los sitios donde no sean necesarios. Eso sí, con billete que permita el transbordo al autobús.</p>
";"08/09/2015 00";"118";"55";"63";"6";"846134971";"-372"
"646";"web accesible";"<p>Hacer la web de Madri verdaderamente accesible a los ciudadanos y que sea de todos y para todos</p>
";"08/09/2015 00";"42";"31";"11";"4";"859875918";"1476"
"653";"Aprovechamiento de parqings en edificios municipales en pro de evitar molestias ";"<p>Pongo de ejemplo el centro cultural sanchinarro. Por las tardes, en horario de actividades, los aledaños del edificio se colapsan de coches que traen y llevan a los niños y niñas al centro. Esto provoca ocupación masiva de plazas de aparcamiento, incluso de aceras, medianas, dobles filas, etc. El centro dispone de un parqings exterior evidentemente insuficiente para estos momentos, pero también dispone de un aparcamiento subterráneo que, si no me equivocó, es para uso del personal del centro. </p>

<p>Mi propuesta se refiere a la revisión de la gestión de este parquing, o la creación de alternativas que alivien los momentos de máxima afluencia de coches, ya que los residentes vemos imposible aparcar en los zona en estos horarios, que coinciden con la vuelta del trabajo.</p>

<p>Añado además que actualmente, en este centro, se esta instalando la oficina de atención al ciudadano de sanchinarro, con lo que el movimiento de coches y personas se incrementará aún más</p>
";"08/09/2015 00";"37";"20";"17";"0";"852677625";"162"
"659";"Por un foro serio";"<p>Resulta lamentable, que siendo el primer ayuntamiento dispuesto a escuchar las inquietudes y propuestas de la ciudadanía, algunos personajes lo utilizen para hacerse los graciosos con debates estúpidos. Su actitud da lugar a que muchos piensen que no merezcamos ser consultados, ni siquiera respetados. El ayuntamiento debería empezar por establecer un filtro que elimine las propuestas estúpidas y pretendidamente graciosas...</p>

<p> </p>
";"08/09/2015 00";"99";"61";"38";"8";"858779832";"1417"
"666";"Aparcamientos disuasorios y en zonas empresariales";"<p>Fomento de aparcamientos disuasorios en las entradas a Madrid para reducir el tráfico. Mejorar las conexiones en transporte público a zonas empresariales, y habilitar aparcamientos regulador (y no por ello de pago) en estas mismas zonas, evitando que la afluencia de coches perjudique a residentes ni peatones. Pongo de ejemplo la zona empresarial de la avenida de manoteras, distrito c....</p>
";"08/09/2015 00";"70";"53";"17";"4";"862051209";"2725"
"688";"Referendum para la gestión adecuada del dinero de los madrileños";"<p>El dinero que gestiona el Ayuntamiento de Madrid es de los madrileños, y su gasto debe retribuir única y exclusivamente a los madrileños.</p>

<p>Todo gasto que los políticos pretendan hacer, y que se aparte de este objetivo, debería ser aprobado en referendum popular.</p>

<p>Propongo que se decida en referendum si aprobar o no el gastos de dinero de los madrileños en personas extranjeras.</p>

<p>Igualmente propongo que de ahora en adelante, cada subida de cualquier impuesto o tasa deba ser aprobada previamente en referendum por los ciudadanos de Madrid.</p>
";"08/09/2015 00";"133";"95";"38";"18";"863078242";"4071"
"689";"Reapertira del palacete del parque del capricho ";"<p>Buenas noches me dirigo a todos ustedes para recuperacion del palacete de los duques de osuna de un gran valor historico y su reapertura nos enseñaria como se vivia y las costumbres que tenian en pleno siglo XVIII muchas gracias </p>
";"08/09/2015 00";"98";"87";"11";"0";"866910897";"6746"
"694";"Transformar los buses en buses temáticos y ecologizarlos";"<p>Inspirado en los buses que vi en Brighton,Reino Unido, pintar y decorar los buses tanto interior como exteriormente de forma temática como vi alli, por ejemplo uno como un bosque, otro ecologista, otro LGBT, otro heladeria, otro playero</p>

<p>Jugando con el exterior del bus las barras y asientos de dentro el techo.Esto seria una atracción turistica mas que añade mucho juego ala ciudad, ademas de dar color y algo uevo a la vista que te sorprenda un dia que otro</p>

<p>Y otra idea(que se pueden fusionar) es la de ecologizarlos añadir paneles solares que atuabastezcan las luces interiores, cambiar estas por unas de bajo consumo o LED...Y incluir los famosos jardines urbanos en el techo de los buses con plants adecuadas para comobatir la contaminación...</p>

<p>y si porsupuesto es una idea que hay que pulir y que tiene puntos muertos por eso la planteo aqui para debatirla</p>
";"08/09/2015 00";"63";"35";"28";"8";"855514413";"388"
"701";"competencia desleal hosteleria / inseguridad jurídica/ Nepotismo";"<p>En todo Madrid están surgiendo restaurantes que no cumplen la normativa del catalogo de espectáculos públicos : restaurantes con DJ , restaurantes que desde las 00:00 ejercen cómo discotecas, cierran tarde, no cumplen sus aforos, restaurantes que se saltan las zonas ZAPE... ha proliferado la competencia desleal y sobretodo en la zona de barrio salamaca donde al parecer si eres el restaurante de relubron , de hijos de o donde van los poderosos  etc pueden hacer lo que les da la gana sin que nadie les pare y al final es al pequeño bar/restaurante al que le prohiben la musica, al que desalojan y al que no se defienden sus derechos dejando que estos sitios invadan su espacio horario o sus venjas por licencia, al final son los restaurantes pequeños los que no pueden poner musica porque enseguida tienen su multa correspondiente... para cuando un sistema igual para todos grandes y pequeños, poderosos o ciudadanos corrientes ? para cuando una regulacion coherente: puede un restaurante tener musica y entonces un bar especial o discoteca  terraza o vender comida ?...mientras en madrid triunfa quien no respeta la norma y el que se ciñe a la misma reduce sus posibilidades de exito al mínimo, aquí nadie se preocupa de garantizar la igualdad de condiciones ?  hagamos un sistema coherente  donde todos cumplamos seas poderoso o no y por fin seremos competitivos , lo contrario solo sirve para que la parte poderosa siga manejando la ciudad a su antojo .</p>
";"08/09/2015 00";"41";"23";"18";"2";"854377794";"280"
"704";"Museos gratuitos para los madrileños";"<p>Los museos de Madrid deberian ser de acceso público para sus ciudadan@s. Debiesen crearse más tallares que acerquen a la ciudadanía la cultura.</p>
";"08/09/2015 00";"293";"245";"48";"12";"869507223";"16472"
"705";"Eliminar la prohibición en IFEMA del uso de patinetes y bicicletas";"<p>IFEMA es el único recinto ferial que PROHIBE el uso de patinetes o bicicletas en la totalidad del recinto. Como profesional del montaje ferial y como visitante habitual de este tipo de recintos a nivel europeo, IFEMA es el único recinto que reduce a los vehículos de motor los medios de transporte dentro del recinto. No solo se prohibe en el interior de pabellones o avenida central, sino que incluye las vias de circulación para vehículos o incluso el aparcamento, por lo que usar un patinete o bicicleta como vehículo alternativo al coche también inflinge normas. Como ejemplo cercano tenemos Barcelona, con menos pabellones en sus recintos fomentan el uso de estos medios de transporte para facilitar, tanto el trabajo de los profesionales que nos movemos en los montajes como la experiencia de acceso a los visitantes. Espero que se imponga el sentido común y ecológico por encima del afán recaudatório de IFEMA respecto a los parkings, algo mas que revisable que afecta a miles de visitantes y profesionales.</p>

<p>Gracias y si compartes mi opinióin haz un voto a favor de esta propuesta.</p>
";"08/09/2015 00";"94";"66";"28";"2";"861392026";"2668"
"725";"Restauracion de la iglesia de san anton o de las escuelas pias";"<p>Buenas noches tras haber pasado esta noche por la iglesia de san anton o de las antiguas escuelas pias necesita su interior una reforma muy grande ya que las grietas cada dia van a mas y seria una verdadera pena que se perdiera un trozo de historia del centro de madrid que se concedio a los escolapias en el siglo XVIII por su majestad el rey don Carlos IV </p>

<p> </p>
";"08/09/2015 00";"96";"48";"48";"9";"851586980";"0"
"729";"Más aparcamientos en Aravaca";"<p>En Aravaca zona de la estación de cercanías, aparca mucha gente para poder coger el Cercanias para ir al centro de Madrid a trabajar y la zona se quedad colapsada de aparcamiento para los vecinos. Algunas calles son de doble sentido y no tienen líneas de aparcamiento. Propongo que se estudie poner esas calles con un único sentido y poder agregar una línea de aparcamiento. Aravaca es un barrio del distrito Moncloa/Aravaca aunque esto último lo desconoce mucha gente. Aravaca existe y es un barrio de Madrid!!!. En fin esperó que este debate se tenga en cuenta.</p>
";"08/09/2015 00";"52";"28";"24";"6";"854221041";"215"
"743";"Ayudas a divorciados en materia de vivienda y otras.";"<p>Soy trajador autónomo desde hace 11 años, hace seis me divorcié y tengo tres hijos,  ( Con 11,  7  y 3 años) dos con mi anterior mujer y el pequeño con mi actual pareja . En la misma situación que estoy yo sé que hay muchos mas hombres, y me refiero a todos los pagos que tenemos que hacer frente cada mes  (Pensión de los niños, alquiler del local donde trabajo, S. Social mia y la del empleado, impuestos, teléfono,luz agua, hipoteca del piso donde vive mi ex con mis dos primeros hijos y alquiler de la casa donde vivo yo y sus gastos correspondientes)   Hace tres años solicité una ayuda a la EMV sin contestación a fecha de hoy .  Creo que sería bueno que se destinara algun tipo de ayuda para este colectivo al que creo que no se le tiene mucho en consideración. Muchas gracias</p>
";"08/09/2015 00";"103";"59";"44";"13";"857598930";"859"
"746";"Necesidad de poder utilizar aseos sin pagar y tener lavabos públicos.";"<p>No soy ciudadano de Madrid, pero las veces que voy de visita me sorprendo por lo difícil que es ir a un baño en el centro de la ciudad. Los baños públicos brillan por su ausencia, y en un momento de urgencia o necesidad te sorprendes al ver que hosteleros y comerciantes no permiten el uso de los aseos a personas que no realicen ninguna consumición. </p>

<p>Por lo tanto, propongo dos medidas:</p>

<ol>
	<li>Creación y ampliación de una red de lavabos públicos, de acceso gratuito (basta de pagar por mear en Atocha),buena localización y en buen estado de mantenimiento.</li>
	<li>Instar, mediante advertencias y luego sanciones, a que los negocios dejen utilizar los servicios a la gente de la calle sin necesidad de realizar una consumición. </li>
</ol>
";"08/09/2015 00";"121";"99";"22";"10";"865923495";"6300"
"753";"Restauracion del interior de la parroquia de los dantos niños justo y pastor nue";"<p>Buenas noches tras el plan de restauracion del exterior de dicha iglesia , se necesitaria la restauracion entera interior del templo , con el cambio de la instalacion electrica entera , cambio de suelo y picado y pintado y tapado de gruetas del mismo , no podemos dejar de lado este tema ya de que se trata de un enclave muy historico para madrid y es unas de las iglesias de madrid que data de 1212 del primer plano que se conoce de esta maravillosa villa que es madrid </p>
";"08/09/2015 00";"79";"35";"44";"6";"846332158";"-398"
"756";"Ajuste de las tarifas de BiciMad y unificación con la tarjeta de transportes.";"<p>Me gustaría proponer un ajuste en las tarifas del serivicio BiciMad, basado en mi experiencia utilizando el serivicio <em>Velib</em> de la ciudad de París durante un año. Paso a enumerar las principales ventajas del servicio <em>Velib</em>:</p>

<ul>
	<li>Primeros 30 minutos gratuitos.</li>
	<li>Tarifas especiales para jóvenes (primeros 45 minutos gratuitos).</li>
	<li>Estaciones cada 200 metros.</li>
	<li>Bonificaciones acumulables en caso de aparcar bicicletas en puntos poco frecuentados. <em>Ciertas estaciones de la red otorgan un bonus de 15 minutos en caso de aparcar una bicicleta en ella.</em>
</li>
</ul>

<p>Propongo por lo tanto que se realice un estudio del precio de las bicicletas públicas en otras ciudades dónde funcionan a la perfección para llegar a un mejor sistema para los madrileños. Además quiero hacer especial hincapié en lo siguiente:</p>

<p><em>En Madrid, una persona que esté pagando el abono transporte mensual, en caso de querer utilizar las bicletas públicas, tiene que pagar un segundo abono anual BiciMad, además de cada trayecto de bicicleta. Considero que esto supone una diferenciación entre el transporte público y las bicicletas.</em></p>

<p>Espero que la accidentada puesta en marcha del servicio, se quede en una anecdota y acabemos teniendo un servicio de bicicletas de calidad.</p>
";"08/09/2015 00";"183";"156";"27";"19";"868534152";"10996"
"757";"Debatamos sobre la utilidad de esta página[tema serio]";"<p>Que os parece esta página?</p>

<p> </p>

<p>Yo creo que el concepto en sí es positivo, pero parece que la ha hecho un niño de 6 años, en serio ha costado dinero hacer esto? cualquiera puede abrir un debate (mirame a mi) y escribir lo que se le antoje, votar todas las veces que quiera creandose las cuentas que quiera?</p>

<p> </p>

<p>Esto no es sirio.</p>
";"08/09/2015 00";"37";"18";"19";"6";"850372894";"-48"
"831";"Increíble como se divierte la derecha cuando les dejas participar en un debate a";"<p>Pobres, es la falta de costumbre. Alguno conseguirá ver la utilidad de hacer propuestas para su distrito, les daremos tiempo a acostumbrarse a la democracia.</p>
";"08/09/2015 01";"31";"6";"25";"18";"847245353";"-367"
"867";"Sobre la calle dedicada a Ramón Gómez de la Serna";"<p>Agradezco, en primer lugar, muchísimo esta oportunidad de poder dirigirme al Ayuntamiento de Madrid para poder expresar un sentimiento y una preocupación. Se trata de la posibilidad que algunos medios han anunciado, de que se vaya a quitar del callejero la calle dedicada a D. Ramón Gómez de la Serna. Esto sería una grave injusticia.  D. Ramón es, no solamente uno de los más grandes escritores madrileños que han existido, sino que jamás fué franquista como algunos están diciendo. Fué un autor víctima de muchas envidias y esa solo es una mas de las muchas que sufrió en su vida. Es verdad que colaboró ( muy poco tiempo), desde el exilio en Argentina, en el diario Arriba pero sólo con greguerías. Jamáas escribió un artículo de fondo en semejante diario. Vivió 36 años en el exilio a pesar de una tremenda añoranza de España y de su Madrid. Solo viajó una vez, en un viaje que fué una encerrona del franquismo que no quería renunciar a contar con su aprobación, pero nunca la consiguieron. Visitó a Franco con un frac alquilado y se reunió sólo una vez con él, pero sin disfrutar de ninguna prebenda ni beneficio retornó a la Argentina en la que murió. Firmó el manifiesto a favor de la República y abandonó España cuando comenzó la guerra porque no quería matar a nadie ni ser muerto. Se declaró siempre Azañista y republicano. Antes de decidir quitarle su calle, tienen Vds. que hacer un estudio serio y honesto sobre su verdadera vida, no sobre las opiniones que enemigos literarios como Pla y otros emitieron en su día. Confío en el buen criterio de Doña Manuela Carmena, a quien con gusto he votado, de que sea seria y firme en este punto tan importante de la cultura española y madrileña.</p>
";"08/09/2015 01";"9";"7";"2";"1";"856262638";"388"
"871";"Sobre la calle dedicada a Ramón Gómez de la Serna";"<p>Agradezco, en primer lugar, muchísimo esta oportunidad de poder dirigirme al Ayuntamiento de Madrid para poder expresar un sentimiento y una preocupación. Se trata de la posibilidad que algunos medios han anunciado, de que se vaya a quitar del callejero la calle dedicada a D. Ramón Gómez de la Serna. Esto sería una grave injusticia.  D. Ramón es, no solamente uno de los más grandes escritores madrileños que han existido, sino que jamás fué franquista como algunos están diciendo. Fué un autor víctima de muchas envidias y esa solo es una mas de las muchas que sufrió en su vida. Es verdad que colaboró ( muy poco tiempo), desde el exilio en Argentina, en el diario Arriba pero sólo con greguerías. Jamáas escribió un artículo de fondo en semejante diario. Vivió 36 años en el exilio a pesar de una tremenda añoranza de España y de su Madrid. Solo viajó una vez, en un viaje que fué una encerrona del franquismo que no quería renunciar a contar con su aprobación, pero nunca la consiguieron. Visitó a Franco con un frac alquilado y se reunió sólo una vez con él, pero sin disfrutar de ninguna prebenda ni beneficio retornó a la Argentina en la que murió. Firmó el manifiesto a favor de la República y abandonó España cuando comenzó la guerra porque no quería matar a nadie ni ser muerto. Se declaró siempre Azañista y republicano. Antes de decidir quitarle su calle, tienen Vds. que hacer un estudio serio y honesto sobre su verdadera vida, no sobre las opiniones que enemigos literarios como Pla y otros emitieron en su día. Confío en el buen criterio de Doña Manuela Carmena, a quien con gusto he votado, de que sea seria y firme en este punto tan importante de la cultura española y madrileña.</p>
";"08/09/2015 01";"9";"6";"3";"2";"854286512";"200"
"986";"Prohibir al tráfico el acceso al centro de forma libre.";"<p>Pues lo que pasa en Londres. Si no vas en transporte público, Taxi, vas a cargar o descargar mercancias a tiendas o vives en la zona o pagas para entrar con el coche al centro o te jodes y te piras. Hasta Botella lo intentó, así que como Carmena le está copiando bastantes propuestas según he visto (Bunker del capricho, Beti Jai etc) coño, pues que tenga huevos (U ovarios) y saque esta medida adelante por el bien de la salud de muchos madrileños y por la limpieza también del centro, que lo llenan de mierda la polución que echan los coches. 
Como mucho que se deje abierta entre las dos zonas cerradas al tráfico del centro la Gran Vía, y que se haga de nuevo el bulevar con el que se concibió esta quitando un carril por sentido a los coches. 
Además esta medida iría en parelelo con la operación prdo recoletos y la reforma de plaza de España, sobre la que tengo una propuesta que cuesta poco y que escribiré en cualquier momento que se me antoje.</p>
";"08/09/2015 02";"17";"15";"2";"2";"860858213";"1147"
"1088";"Remodelación parte de Cercanías de la Estación de Atocha.";"<p>A ver si nos dejamos de tocar los huevos y hacemos algo por esta ciudad. ADIF tiene hechos cacota las estaciones de la capital. Coño Manuela, que eres la abuelita amable pero también la que tiene que dar sopapos con la zapatilla. Pegales una chufla para que lo reformen. Lo que no puede ser es que nos gastemos un pastizal en la restauración de la parte antigua para que luego vayamos a la nueva y lo primero que vemos en una torre feisima con un reloj que está descolocado. En vez de en el centro está en un lado. Y eso, la torre parece la picha de Falete. Es que más feo no puede ser. Solo la torre de Valencia se le puede comparar. Luego todas las instalaciones antiguas. Entras en la estación y hay 4 plantas que no sabes realmente para que sirven. Si están por postureo o para qué.Que se remodele y haga accesible para todos y con un sentido medianamente lógico del espacio. Y luego la zona de los andenes que la limpien y la adecenten. Yo ni siquiera pido que se reofrme para que se parezca a la estación antigua, aunque sería lo deseable. Solo con que todo estuviera más hecho con cabeza. Si intentase minimizar el impacto de la horrible estación con su entorno antiguo añadiendo elementos más amables a la vista y por favor, reformando al torre esa, me bastaría. No os estoy pidiendo convertir el cercanías en la Estación de Francia de Barcelona. Os pido algo muuucho más simple.Ya hablaré más tarde de la PPio que también tiene tema porque vamos...</p>
";"08/09/2015 02";"12";"7";"5";"0";"852825759";"116"
"1130";"Democracia directa como única forma de acabar con la Oligarquía";"<p>Es necesario que las acciones de los políticos estén sometidas a un escrutinio continuo y, sobre todo, A REFRENDOS CONTINUOS.</p>

<p>Por ello propongo que se apruebe lo siguiente:</p>

<p>Obligar legalmente al ayuntamiento de Madrid a que:</p>

<ol>
	<li>Todas las leyes/disposiciones/decretos/ordenanzas deben ser aprobadas en referendum popular.</li>
	<li>No se puede aumentar la deuda pública sin que se apruebe en referendum popular.</li>
	<li>No se pueden subir los impuestos sin que se apruebe en referendum popular.</li>
	<li>No se pueden aprobar nuevos gastos, inversiones, obra pública, rescates a empresas insolventes, ni ninguna otra ayuda pública a los amigotes/votantes del político de turno sin que se apruebe en referendum popular.</li>
</ol>

<p>Estamos gobernados por una Oligarquía y la única forma de huir de ella y de aproximarnos a la democracia es mediante la obligación legal de los políticos de someter a referendo popular practicamente la totalidad de las decisiones.</p>

<p>Mientras esto no se apruebe, estaremos viviendo en una Oligarquía.</p>

<p>Como ya explicó Robert Michels al enunciar la Ley de Hierro de la Oligarquía, toda organización que crece se apoya en los especialistas para crecer más rápido y más fácilmente.</p>

<p>Conforme una religión, un sindicato, un partido o un estado crecen, es necesario tomar decisiones más complejas o en poco tiempo; muchas veces surgen oportunidades que requieren el manejo de muchos medios de forma autónoma y fuera del control de las bases, etc. Esto hace que los especialistas vayan ocupando los puestos importantes dentro de la organización.</p>

<p>Cuando ha pasado suficiente tiempo los especialistas ya ocupan los puestos importantes. Más y más decisiones son tomadas por los especialistas, quienes poco a poco anulan la capacidad de decisión de las bases hasta convertirla en testimonial.</p>

<p>Finalmente son los líderes los que deciden por las bases, y el ""flujo de decisión"" se invierte. La organización deja de dedicar sus esfuerzos a ejecutar las decisiones de las bases, y empieza a emplear su energía en convencer a todos (tanto al resto de la población como a las mismas bases) de la conveniencia/necesidad de las decisiones de los líderes.</p>

<p>Resumiendo, la organización termina siendo controlada por unos pocos, los líderes, quienes toman todas las decisiones importantes, y que usan los medios de la organización para su beneficio personal: completa su evolución cuando se convierte en una Oligarquía.</p>

<p>Esto ocurre en todas las organizaciones creadas por el hombre: empresas, religiones, maquinaria estatal, partidos políticos, sindicatos... Por eso, porque estamos gobernados a través de partidos oligárquicos (controlados por sus líderes), que se pelean por controlar un aparato del estado que a su vez también es oligárquico, es imposible vivir en democracia. Los líderes de todos y cada uno de los partidos/sindicatos/estados/aparatos-religiosos/asociaciones/sectas/etc que han existido y existirán utilizan esas organizaciones para tomar el control del presupuesto y repartírselo entre sus amiguitos.</p>

<p>Y en el caso de los partidos y el aparato del estado, lo hacen con el presupuesto público. Somos nosotros, el pueblo, los que les pagamos la fiesta a los nuevos señoritos. Ya está bien de sanguijuelas. La única forma de conseguir democracia verdadera es obligando al aparato político a someterse a la voluntad popular mediante referendums continuos vinculantes. Que seamos los ciudadanos, mediante la única democracia que existe (referendums populares vinculantes para todo) los que decidamos nuestro futuro.</p>

<p>PD: Por supuesto, esto se extiende a toda España y a toda la Unión Europea. Pero debemos empezar por nuestra ciudad.</p>
";"08/09/2015 02";"33";"19";"14";"1";"855279640";"287"
"1556";"Han tardado nada y menos los tóxicos en hacer acto de presencia.";"<p>Abrir y asombrarse es todo uno .Moderador ,moderando por favor.Gracias.</p>
";"08/09/2015 07";"22";"13";"9";"0";"856703083";"236"
"1560";"Wellcome Refugees";"<p>¿Qué pasa con los negros subsaharianos que están entre nosotros? ¿acaso muchos de ellos no llegaron huyendo de otras guerras? ¿y los gitanos rumanos y otros como los exmilitares albano-cosovares? ¿ellos no tienen derecho a nuestro cariño y a nuestros impuestos?</p>

<p> </p>

<p> </p>
";"08/09/2015 07";"21";"2";"19";"1";"851978902";"-161"
"1564";"Excrementos caninos";"<p>A nadie escapa la gran cantidad de perros que habitan en nuestra ciudad. El civismo de los dueños es incompleto, cuando no inexistente. Muchas cacas, y todos los orines, quedan en las calles, haciendo desagradable y a veces intransitable el simple caminar. Un problema de higiene, que recuerda mucho a lo que ocurría en el medievo. Creo que es lógico, y de justicia que los propietarios de perros subvencionen con un impuesto especial, la especial limpieza que requieren las calles debido a sus mascotas.</p>
";"08/09/2015 08";"32";"23";"9";"2";"861709141";"1006"
"1569";"Aparcarmiento en vados de actividades por la noche";"Hay infinidad de vados de vehiculos que no se usan en festivos, de noche o a ultimas horas del día por pertenecer a un comercio o industria. Que exista dos tipos de vado, a elegir por el dueño del uso del vado, uno limitado a ciertas horas y otro como el que está 24h 265 dias. Se ganarian plazas de aparcamiento. Si se limita las horas de aparcamiento debería redundar en un abaratamiento de la tasa.";"08/09/2015 08";"62";"45";"17";"0";"864010770";"2032"
"1570";"mas policias municipales?";"<p>creeis que son necesarios? en algunas zonas no hay casi</p>
";"08/09/2015 08";"87";"40";"47";"3";"849777528";"-321"
"1571";"Madrid en globo";"<p>Sería una buena forma de incentivar el turismo.</p>
";"08/09/2015 08";"71";"24";"47";"3";"848883329";"-777"
"1572";"Reconsiderar las normas de aforo para eventos culturales";"<p>Soy asiduo a eventos culturales de todo tipo, en especial del mundo del cómic y estoy viendo cómo debido a un aforo que en muchos casos es excesivamente conservador, la entrada está muy limitada.</p>

<p> </p>

<p>Aún recordando el triste caso del Madrid Arena, es cierto que a veces el aforo permitido en estos eventos es limitado, quedándose en que debe haber 2 metros cuadrados por persona, una cantidad que deja a muchos visitantes de estos enventos en la calle y que además impide la venta de entradas que permite a los eventos seguir adelante.</p>

<p> </p>

<p>Solicito pues que se reconsidere para los eventos culturales un aforo un poco más laxo sin que se comprometa la segurida que permita tanto mantener la seguridad del recinto, en los que aunque hubiese concentraciones bastante altas de gente todavía no se ha producido un incidente que dabamos lamentar en demsasía, y que a la vez permita a más gente entrar en los recintos y permitir así que los eventos culturales no se vean abocados a morir de éxito.</p>
";"08/09/2015 08";"29";"18";"11";"2";"858972357";"434"
"1574";"Control a vehiculos que contaminan demasiado aquellos que solo echan humo negro";"Muchos días me cruzo con vehiculos que echan un humo negro que debería ser controlado por la Policia Municipal. He visto como pasa delante y ni les para. Quizá sería bueno que se les parase a todos esos vehiculos para darles un primer aviso y al segundo aviso, obrar como manda la Ordenanza General de Protección del Medio Ambiente Urbano en la parte del control de emisión en los vehiculos a motor, está de sobra legislado pero ni se persigue ni mucho menos se vigila.";"08/09/2015 08";"138";"122";"16";"4";"871519764";"9371"
"1575";"Creación de una bolsa de trabajo gestionada por los servicios publicos";"<p>Para mejorar la situacion de las personas y que las entidades publicas trabajen para los ciudadanos. Se deberia de crear una oficina que sirva para ayudar a las personas a buscar trabajo. Arbitrara para que estas empresas no comentan abusos ofreciendo salarios irrisorios o condiciones fuerad e la legalidad. Para motivar a las empresas para que entren en esta bolsa y comprometiendose a ofrecer unos salarios acordes a los minimos pactados, podrian ofrecer los organismos publicos condiciones y rebajas en los impuestos que se les cobra, de esta forma fomentaremos la creacion de empleo sostenible.</p>

<p> </p>
";"08/09/2015 08";"106";"84";"22";"5";"867867055";"4913"
"1576";"Salvemos el Palacio de la Música de la Gran Vía";"<p>El Palacio de la Música tiene un valor incalculable. No debemos permitir que otra tienda de ropa invada la Gran Vía. El Palacio de la Música es patrimonio de Madrid y debe respetarse su grado máximo de protección. Debemos apostar por la música y la cultura en esta ciudad.</p>
";"08/09/2015 08";"181";"162";"19";"6";"872940156";"12798"
"1577";"Podar los árboles ";"<p>Los árboles de Madrid tienen un tamaño descomunal.  Eso es peligroso y mucho más cada vez que hace viento o hay tormentas.  Debería hacerse una poda masiva por seguridad y para mantener nuestros árboles en buenas condiciones. </p>
";"08/09/2015 08";"106";"82";"24";"8";"867395824";"4486"
"1580";"Mejorar las lineas de cercanias";"<p>¿Cómo es posible, que apenas 60 km tarde hora y media? llegar desde alcala hasta tres cantos es un suplicio en transporte publico, obligando a coger el vehiculo particular porque no compensa en tiempos ni dinero coger el transporte publico.</p>
";"08/09/2015 08";"50";"45";"5";"2";"868127973";"3600"
"1581";"Un barrio.-Mínimo una librería";"<p>Incentivar la continuidad de las librerías madrileñas. Un Barrio, mínimo UNA LIBRERÍA.-</p>

<p>Actualmente el Ayuntamiento de Madrid adquiere sus fondos editoriales a empresas no especializadas y de fuera de Madrid. Sugiero que estos fondos y libros que se adquieren fuera sean adquiridos a través de librerías madrileñas y que se fomenten actividades en éstas patrocinadas por el Ayuntamiento con el lema: UNA LIBRERíA HACE UN BARRiO.</p>
";"08/09/2015 08";"53";"31";"22";"2";"859390680";"526"
"1582";"Peatón - ciclista - automóvil ";"<p>Me da mucha pena comprobar cada día que peatón, ciclista y automóviles no se respetan unos a otros. </p>

<p> </p>

<p>Sobre todo en el tema de las bicicletas, ya que estas circulan a gran velocidad por la acera y no respetan ninguna norma de tráfico. Es triste generalizar, pero viviendo en el centro es una guerra constante. </p>

<p> </p>

<p>Quizás debería ponerse una especie de permiso en el que demuestren que conocen las normas de tráfico, ya que muchos no deben saber para que sirven los semáforos. </p>

<p> </p>

<p>La bicicleta es importante en la ciudad. Yo la usaría si hubiese una habilitación real el las calles y no fuéramos jugándonos la vida entre los coches. </p>
";"08/09/2015 08";"50";"41";"9";"3";"866117118";"2624"
"1585";"Obligar a compañias de redes telefónicas a soterrar los cables";"<p>Cada nueva compañia que da acceso a internet tiende el cableado e instala sus registro grandes de forma aérea adosandose a las fachadas de los edificios. En la mayoría de los casos es un pegote, que afea la ciudad y a veces es peligroso cuando vuela por encima de las calles de un edicifio a otro a no mucha altura. Se debería exigir a estas compañias el soterramiento de dichas lineas. Está regulado en normativa municipal, ""quedando expresamente prohibida su instalación aérea"".</p>
";"08/09/2015 08";"149";"132";"17";"3";"872016222";"10187"
"1586";"¿Por que no se amplían los carriles a 4 metros para una mayor fluidez?";"<p>Hola, depues de hacer obras durante todo este verano en muchas calzadas para cambiar tuberias por las calles de Usera, Rafael Ibarra, Antonio Leyva, Paaseo de las Delicias, Sant. Mª de la cabeza, embajadores... llega el momento de reasfaltarlas.</p>

<p>Yo propongo que en calles como el Paseo de las Delicias que hay 4 carriles y estan siempre colapsados bloqueando el paso a todo bicho viviente bicicletas, autobuses, motos... yo suprimiria un carril de coches privados y ampliaria el resto para que por lo menos los que van en moto y en bici puedan moverse por la calzada y no tengan que subir a la acera.</p>

<p>Tambien, en los ciclocarriles en cuesta hacia arriba, bajaria la velocidad a 20 km/h, no somos Contador, ni purito... y los coches se pegan demasiado a la rueda de atras de la bici.</p>

<p>El cambio seria barato, y dentro de la M30 Madrid sería de otra forma... hay muchas calzadas en Madrid con un tamaño justo para que 2 atobuses urbano quepan.. eso son 2,5m + 2,5m justos justos... bloqueando la fluided de cualquier otro tipo de vehiculo.</p>

<p>UN saludo.</p>
";"08/09/2015 09";"78";"16";"62";"2";"850279918";"-943"
"1587";"Asfaltado San Blás";"<p>Para todos aquellos que vivan en el distrito de San Blás - Canillejas sabrán de lo que hablo.</p>

<p>Tenemos muchas calles con un asfalto hecho polvo y con muchos socavones que ya han producido pinchazos en numerosos coches incluso tropiezos en las aceras ya uqe las aceras también están en un estado un poco lamentable.</p>

<p>Nuestro barrio no es el barrio de Salamanca pero los que vivimos aqui nos merecemos calles mejores.</p>

<p> </p>

<p>¡Un saludo!</p>
";"08/09/2015 09";"31";"21";"10";"1";"860942411";"745"
"1589";"Campaña para concienciar contra el ruido";"<p>Madrid es una de las ciudades más ruidosas del mundo. Una buena campaña concienciando de que el silencio es calidad de vida, recordando límites horarios, instituciones dando ejemplo y finalmente sancionando severamente a quienes incumplan... no estaría nada mal.</p>
";"08/09/2015 09";"119";"112";"7";"12";"872964457";"9882"
"1590";"Suciedad en la calle (Lavapiés)";"<p>Vivo en Lavapiés desde hace unos 5 años, vengo de vivir toda mi vida en un pueblo de la sierra en el que a decir verdad los servicios eran bastante buenos en general.</p>

<p>Vivir en pleno centro implica tener que acostumbrarse a ciertas cosas y creo que más o menos lo he llegado a conseguir, pero lo que no logro resistir es la suciedad que hay constantemente en las calles. </p>

<p>Entiendo que uno de los problemas es la posible escasez de servicios de limpieza (facilmente solucionable), pero en mi opinión, la principal cuestión a tratar en este problema es la educación ciudadana. En general la gente de Madrid es bastante dejada a la hora de tirar los desperdicios a las papeleras y/o cubos de basura, aunque bien es cierto que he llegado a ver en el barrio papeleras llenas durante 2-3 días sin que hayan sido vaciadas, sin ir más lejos el pasado fin de semana.</p>

<p>Me gustaría que se llevasen a cabo campañas de concienciación/educación ciudadana y que hubiese sanciones para los que incumplan las condiciones básicas de higiene que al final nos afectan a todos, de lo cual podría ocuparse una unidad de la policía municipal.</p>

<p>Lavapiés es un barrio encantador y me encanta vivir en él pero el tema de la suciedad  lo veo como un grave problema que afecta gravemente a los vecinos del barrio y que no deja en muy buen lugar a la ciudad respecto a los muchos turistas que patean diariamente  las calles del barrio.</p>

<p>Un saludo y espero que mi comentario sirva de algo.</p>

<p> </p>
";"08/09/2015 09";"129";"117";"12";"15";"872314166";"9523"
"1591";"Limpieza real en los barrios, no para salir en la foto.";"<p>Tras el triunfo en las elecciones de mayo se anunció una serie de limpiezas de refuerzo en los distintos barrios y fui observando como, aparentemente, se producían dichas acciones de higiene según las noticias y fotos que ibáis subiendo a la página de Facebook.</p>

<p>Hace unas semanas me enteré de que le tocaba el turno a mi barrio, Carabanchel. Carabanchel es el barrio más poblado de Madrid y tan solo se ha dedicado 3 días de limpieza en la zona de Abrantes, olvidándose de calles como Camino Viejo de Leganés, General Ricardos, Avenida de Oporto, Valle de Oro, Antonio López y tantas zonas del barrio que siguen igual de sucias y llenas de mierda como con el gobierno de Ana Botella.</p>

<p>Carabanchel, Vallecas o Usera no son barrios que salen en las fotos, ni los barrios que van a contar los japoneses cuando vuelvan a su país. Tampoco salen en películas ni pasa el bus turístico por ellos. Solo son los barrios más poblados de la capital, donde vive la gran mayoría de la población trabajadora y obrera de Madrid que luego debe de ir a los barrios que habéis limpiado a dar servicio a esos turistas. ¿Realmente solo merecen 3 días de limpieza, cuando son los más castigados por la pobreza y la desigualdad?</p>

<p>Limpieza real y no para salir en la foto, por favor. Os lo pide un votante.</p>
";"08/09/2015 09";"520";"509";"11";"20";"880328668";"48746"
"1592";"Aparcacoches en Ibiza";"<p>Se ruega la vigilancia y multa a los aparca coches en Ibiza, sobre todo en la calle Narváez, donde sus maravillosas practicas hacen que los autobuses tengan que invadir el sentido contrario mientras al policía se lo pasa pipa hablando con ellos.</p>
";"08/09/2015 09";"98";"88";"10";"3";"870924656";"7004"
"1593";"¿Quien nos ha robado las estrellas?";"<p>Es sabido que la contaminación luminica de Madrid es una de las más altas del mundo, con las dos consecuencias enormes, de perder la posibilidad de ver las estrellas y el coste economico y medio ambiental que supone tal derroche de energía. Esta contaminación proviene a multitud de edificios públicos y privados en que la mejor forma de iluminarles creen que es de abajo arriba, en otros casos es a focos de anuncios de carteles que estan dirigidos directamente hacía arriba, y en otros por usar alumbrado público abierto hacia el cielo o lamparas de vapor de mercurio. En normativa municipal prohibe de manera tajante ese tipo de iluminación hacía el cielo. Propongo que se inste a todos esos edificios y anuncios que cambien la forma de iluminar.</p>
";"08/09/2015 09";"102";"86";"16";"12";"869645470";"5901"
"1594";"BiciMAD en Cuidad Universitaria";"<p>Hace unos años se inició un proyecto llamado BiciUCM (o parecido) para fomentar el uso de las bicis dentro de Ciudad Universitaria. De este proyecto sólo quedan las verdes marquesinas y se puede considerar un fracaso. Quién quiere alquilar una bici para ir desde la parada Ciudad Universitaria hasta su facultad? Poca gente.</p>

<p>Ahora bien, si lo que se está proponiendo es poder coger la bici en el barrio donde vives e ir hasta tu facultad directamente pedaleando, eso es otra historia. Por eso, propongo que se habiliten tótems en el Campus de Ciudad Universitaria. Hay mucho flujo de gente y hay carriles bici ya hechos. Qué puede fallar? </p>
";"08/09/2015 09";"116";"107";"9";"12";"872404749";"9039"
"1595";"Ajardinar la Ctra de Boadilla del Monte Col Jardiin";"<p>Como vecinos de la zona sur de Madrid vivimos en un entorno llenos de solares y espacios yermos. La carretera de B. del Monte que une l la N-V hacia la ciudad de la imagen y la M502 transcurre paralela a la Casa de Campo y en su margen derecho ha quedado una franja de terreno de la que se echaron los habitantes de las casas bajas que alli existian. Quedan los restos de higueras y otros arboles dispersos, pero desde que se derribaron las casas, estos antiguos huertos, donde incluso hay una antigua fuente abandonada, son conquistados de forma constante por coches y basura abandonada. Solicito que se urbanice esa zona de tierra, recuperando la vegetación, haciendo zonas verdes que unan con la casa de campo, un espacio para huertos vecinales y canchas deportivas. Todos estas instalaciones serian de un gran utilidad publica y nuestros vecinos merecen vivir en un entorno agradable.   </p>
";"08/09/2015 09";"40";"28";"12";"2";"862470646";"1120"
"1597";"No al Cruising en la Casa de Campo";"<p>Es bochornoso salir a pasear con tu familia y encontrarte escenas desagradables. No tengo nada en contra de cualquier tipo de orientación sexual, pero desde luego este tipo de actividades no deberían permitirse en un parque de acceso público.</p>

<p>Por favor, más policia en la Casa de Campo.</p>

<p>https://www.google.com/maps/d/u/0/viewer?mid=zrcKvRwPHDrw.kXOWbqzDrSxo&amp;hl=es</p>

<p> </p>
";"08/09/2015 09";"86";"46";"40";"9";"858821602";"320"
"1599";"Habilitar carriles para aparcar de 21.00-7.00 fomentará el consumo";"<p>En Madrid hay calles con hasta más de tres carriles para el tráfico. Son muy útiles a hora punta y evitan muchos atascos. Pero a partir de determinada hora tanto carril resulta inútil. Por eso propongo que a partir de una determinada hora, alguno de estos múltiples carriles se habilite para poder aparcar en ellos. Los días cuando más ocio puede haber en Madrid, por ejemplo: de viernes a domingo, y entre las 21.00 y las 7.00 por ejemplo.</p>

<p>En otras ciudades, como Valencia, hacen algo parecido con el carril bus a partir de las 22.00.</p>

<p>Muchas veces voy a Madrid, intento aparcar y me acabo volviendo o marchando a otro sitio debido al hartazgo de no encontrar aparcamiento. La gente que venimos del extra radio y que no tenemos tan accesible el transporte público de la capital venimos en coche. Y nos gustaría poder venir más y disfrutar del ocio que ofrece la capital. </p>
";"08/09/2015 09";"51";"23";"28";"6";"851284912";"-225"
"1600";"Ubicar nuevas estaciones de biciMAD en Paseo Virgen del Puerto y Ronda Segovia";"<p>Me gustaría que se fuera ampliando el radio de las estaciones del servicio de biciMAD por todo Madrid.</p>

<p>Para esta ampliación propongo ubicar estaciones en la parte baja de la Ronda de Segovia y en el cruce del Paseo de Virgen del Puerto con la calle Segovia, en ambos lugares hay espacio mas que suficiente para instalar las estaciones de aparcamiento de bicis y ademas es zona colindante con el área en el que ya las hay instaladas.</p>
";"08/09/2015 09";"135";"120";"15";"24";"872195266";"9333"
"1601";"Control ético  para la reducir a población de palomas urbanas ";"<p>En  otros paises    ya se esta usando el pienso anticonceptivo para las palomas reduciendo la población de palomas un 80% en un par de años siendo más eficaz y  una forma más etica que la captura con sacrificio de los mismos . Ya que los que no  hayan sido capturados no tienen tantan competividad en recursos  y fomentas su reprodución</p>

<p> Sin ir  más lejos en Cataluña ya se esta haciendo .</p>

<p>Organizaciones por los derechos de los animales como "" Mis amigas las palomas "" se ofrecen al asesoramiento de estos metodos   eticos y efectivos.</p>

<p> </p>
";"08/09/2015 09";"319";"297";"22";"39";"876910311";"25603"
"1602";"Cambiar la forma de registro o algo";"<p><strong>Esto es un cachondeo, el registro es super fácil y esto se llena de trolls. Esta plataforma podría servir para mucho, sin embargo y debido al garrulismo de algunos, esto no va a servir para nada. Así que mas control!!!!</strong></p>
";"08/09/2015 09";"104";"75";"29";"12";"866343132";"3317"
"1605";"Cuesta de san Vicente (semi)peatonal Sábados y Domingos ";"<p>La Cuesta de San Vicente conecta Madrid Río/Casa de Campo con el centro, plaza de España/Gran Vía. La Cuesta de San Vicente es una de las calles más privilegiadas, rodeada de parques como Debod y Campo del Moro, y a la vez más contaminadas de la capital. Es la Nacional 5 básicamente.   Ya que no se puede soterrar y unir Madrid Río a plaza de España, lo cual sería costosísimo, propongo reducir sus 6 carriles a 4 en fin de semana, subida y bajada, y dejar dos carriles para que la gente pueda bajar al río caminando, patinando o en bicicleta de forma segura. </p>
";"08/09/2015 09";"64";"44";"20";"18";"864266666";"1650"
"1606";"empleo";"<p>Invertir en reformas, instalaciones de energía renovables,limpias y sostenibles, crearía mucho empleo</p>
";"08/09/2015 09";"51";"43";"8";"0";"867159093";"2950"
"1609";"BICIMAD - Esos primeros 30 minutos, gratis para propietarios de abono transporte";"<p>Propuesta sencilla, que Carmona llevaba en su programa. Con esta sencilla propuesta, los vecinos de Madrid, tendrían una opción rápida de desplazarse por la ciudad sin depender de otros servicios públicos como el metro o el autobús. Manera ecológica y rápida, sin tener largas esperas e ir en metros abarrotados.</p>

<p>Esta gratuicidad, la incluiría a los poseedores del abono transporte de Madrid, como manera de controlar el servicio.</p>

<p>Al sacar la tarjeta Bicimad, tienes que dar tú número de abono transporte, con lo que este control, no debería ser complicado.</p>
";"08/09/2015 10";"222";"176";"46";"5";"870972096";"10306"
"1610";"Clausura de Valdemingomez";"<p>Clausura del Centro Tecnológico de Vañdemingomez debido al riesgo que supone a las personas, desplazamiento a un lugar que se encuentre a bastante más distancia de las zonas urbanas. Su funcionamiento se ha ido prorrogando más allá de la planeado en un primer momento,  la zona sureste lleva más de 30 años siendo solidarios y ahora que Madrid  ha crecido hay que revisar su excesiva cercanía a las viviendas.</p>
";"08/09/2015 10";"76";"55";"21";"4";"865377481";"2460"
"1614";"Baños públicos. ¿Y si la respuesta estuviese en el Metro?";"<p>De todos es sabido que los baños públicos escasean en Madrid. Y cuando hay necesidad, hay necesidad.</p>

<p>Sin embargo, Metro hay en todos lados. O al menos, en un intervalo corto de distancias. Y en ellos, hay baños.</p>

<p>Y si estos baños se hiciesen públicos? Aunque fuese pagando el ticket de Metro (ya que quizás están pasados los tornos). O, que se pida la llave en la ventanilla. Pero al menos, que la existencia de estos baños sea visible de cara al exterior y que puedan ser usados por el público. </p>
";"08/09/2015 10";"75";"59";"16";"3";"867138264";"3382"
"1616";"Madrid limpio es capital";"<p>Vuelvo a referirme a este tema que estuvo de moda hace unos cuantos años. Hoy dia, por le que leemos o oimos, la limpieza de Madrid esta en entredicho.</p>

<p>La limpieza siempre empieza por uno mismo y partiendo de este punto, diria que la limpieza es parte de todos los cuidadanos de Madrid o de cualquier cuidad o pueblo.</p>

<p>Es verdad que si no se ponen papeleras, la gente tirara lo que sea al suelo, pongamos mas papeleras o digamos al ayuntamiento de poner mas papeleras.</p>

<p>Pasa lo mismo con los baños en Madrid, hace poco lei un articulo que decia que habia solamente 29 baños publicos en Madrid.</p>

<p>Es mas, si tienes una urgencia fisiologica y no encuentras un bar cerca ( en el cual tendras que consumir para utilizar el baño) y decides vaciar tu vejiga en la via publica, este te puede costar entre 750 y 1500 euros.</p>

<p>Intenten buscar un baño (publico o puesto por el ayuntamiento) en el rastro, siganlo buscando porque no hay ninguno, toda la gente que quiera satisfacer sus necesidades esta, obligada de meterse en un bar y consumir.</p>

<p>Hechamos las campanas al vuelo diciendo que nos visitan 65 milliones de turistas, pero que imagen se llevan de nuestras cuidades, playas o pueblos ? Nos gastamos cantidades enormes de dinero en la marca España, pero no hay dinero para poner baños en los parques o en las playas (benidorm).</p>

<p>Volvamos a empezar por lo basico, si ponen una papelera........y si ponen baños tambien.</p>

<p> </p>
";"08/09/2015 10";"154";"148";"6";"5";"874949985";"13646"
"1618";"Acciones contra la contaminación";"<p>El nivel de contaminación a todos los niveles en Madrid la hace invivible, por lo que urge una actuación radical que ponga solución a este problema. Siendo el tráfico de vehículos privados el principal media de contaminación en esta ciudad, debería prohibirse su circulación al menos por el centro o restringirse de alguna manera. Esto, evidentemente, debería ir acompañado de un aumento del servicio del transporte público, así como de su calidad y una bajada de su precio, también insostenible.</p>

<p>Como ya se ha comentado en otros debates, habría también que impulsar el uso de la bici haciendo carriles para ellas, pues de otra forma parece una broma, tal y como se conduce en esta ciudad. Imprescindible recuperar las fuentes públicas, las plazas para uso público y no privado (es decir, fuera las terrazas de los bares), los bancos para poder sentarse, lugares con sombra y árboles, que siempre son pocos.</p>

<p>Creo que solo he apuntado aspectos esenciales para poder empezar a hablar de una ciudad en la que merezca la pena vivir, pero seguro que hay muchas más. A ver si este sitio sirve para algo.</p>
";"08/09/2015 10";"424";"401";"23";"19";"878674572";"35749"
"1620";"Botellón o no botellón.";"<p>Hola.</p>

<p>Quisiera proponer un tema que desde mucho tiempo siempre ha creado polémica. El botellón. Considero que la situación actual que hay es bastante inviable tanto para la gente que bebe, que lo normal son gente que no tiene recursos o estudiantes, como para los vecinos que muchas veces se levantan y desesperan por los ruidos y basuras producidas.</p>

<p>Por ello quisiera proponer lo que se hace en ciudades como Granada, la construcción de botellodromos, sitios delimitados en las ciudades donde no se moleste a los vecinos y a su vez tenga un servicio de seguridad y ambulancias. Con ello creo que sería un buen método de que al ayuntamiento:</p>

<p>- Le resultará más fácil la limpieza ya que los botellones se producirían en puntos concretos y habilitados para ello.</p>

<p>- No se producirían quejas por parte de los vecinos.</p>

<p>- En caso de incidentes estarían localizados.</p>

<p>Al final se trata de una situación que esta presnete en las calles de nuestro Madrid, y considero que la convivencia es fundamental para todos.</p>

<p>A su vez, considero que en temas como tomarte una lata de cerveza en la calle, o cualquier otra bebida de baja graduación debería no estar penados en los casos que no se observe una embriaguez en la persona o acumulación de residuos </p>
";"08/09/2015 10";"64";"28";"36";"8";"850637668";"-350"
"1622";"Plan urgente de carriles bici";"<p>Madrid es la única ciudad que conozco que ha desplegado un servicio de bicicletas municipales, el Bicimad, sin haber hecho ni un solo mero de carril-bici adicional. </p>

<p>Este caso único, que se suma a los varios años de retraso con que se ha comenzado el servicio respecto a todas las demás capitales, dificulta un mayor uso de las bicis y una mejora consiguiente del tráfico rodado y de los elevados niveles de contaminación. Además, eleva el riesgo de accidentes e incomoda a peatones y otros vehículos.</p>

<p>Este caso inaudito de promover las bicis sin carriles para ellas refleja el cochecentrismo del anterior ayuntamiento y su miopia e inutilidad, algo que espero no quieran continuar los actuales gestores. </p>

<p> </p>
";"08/09/2015 10";"163";"129";"34";"27";"870272748";"7518"
"1625";"Quitar vallas y furgones policia en la plaza de las cortes";"<p>Parece que vivimos en un estado de sitio, hay que quitar vallas, cemento y poner verde y bancos para sentarse, con lo bonita que era esa plaza hace años</p>
";"08/09/2015 10";"89";"60";"29";"2";"864424569";"2089"
"1626";"¿¿Cuando se le devolverá su campo de futbol al C.D. AVIACION ??";"<p>En Noviembre del año pasado, a mitad de temporada, mas de 150 chavales de todas las edades fueron desalojados por el anterior concejal de Latina de manera caprichosa, autoritaria y despótica del campo de futbol en el que hacían deporte, amigos y soñaban con llegar a ser algún día estrellas del futbol, con el único fin de construir viviendas. Tras un montón de promesas inclumplidas el Avi sigue sin tener campo de futbol propio y se ven obligados a entrenar y jugar en campos que no cumplen con las mínimas condiciones.</p>

<p>¿¿ Cuando se le devolverá su campo al Avi?? dado que no se ha construido aún nada y lo único que se hizo fue demoler las oficinas y el vestuario o si no es posible cuando se va a acondicionar el campo de Saliquet en el que ahora entrenan como pueden los equipos. Gracias. </p>
";"08/09/2015 10";"57";"45";"12";"2";"866376736";"2605"
"1628";"Inspecciones sanitarias de todos los restaurantes, con resultado público";"<p>Hola,</p>

<p>Los que hayáis estado en Nueva York, habréis visto que todos los restaurantes y lugares de comida, tienen en la puerta o la fachada un documento con una calificación <strong>(A, B, C)</strong> bien grande, expedida por el ayuntamiento tras inspección sanitaria periódica. De esta manera, a la hora de elegir un lugar, nosotros y los turistas, podemos estar seguros de al menos entrar en un sitio que ha cumplido unas <strong>normas mínimas de higiene</strong>, sobre todo en la cocina, que es donde no podemos entrar.</p>

<p>Además, el resultado de las inspecciones debería estar publicado en un repositorio abierto, actualizado, histórico, y en un formato que permita la consulta e interacción con aplicaciones (API pública) que puedan crearse con él, por ejemplo, un mapa con los restaurantes con buena calificación, o mala calificación, y qué deficiencias tiene cada uno.</p>

<p>Dcoumentos:</p>

<ul>
	<li>
<strong>Mapa de NYC con los restaurantes y sus deficiencias sanitarias:</strong> http://www.nytimes.com/interactive/dining/new-york-health-department-restaurant-ratings-map.html?_r=0</li>
	<li>
<strong>Explicación del sistema de calificación en español:</strong> http://www.guiadenuevayork.com/calificacion-de-los-restaurantes-en-nueva-york</li>
</ul>

<p>Saludos</p>
";"08/09/2015 10";"1432";"1399";"33";"69";"885037147";"133452"
"1630";"Eliminar las sopladoras de gasolina en la limpieza de Madrid";"<p>Las mañanas de otoño se transforman en un infierno de ruido, sobre todo en los parques. Ya tenemos una ciudad demasiado ruidosa. ¿No sería posible mejorar ese detalle?</p>
";"08/09/2015 10";"143";"124";"19";"11";"872005835";"9104"
"1631";"Rehabilitar con la máxima calidad la Plaza Mayor de Madrid";"<p>Los tejados de la Plaza Mayor de Madrid están siendo invadidos por terrazas ilegales, antenas, maceteros abandonados, etc. Los comercios carecen de un mínimo de estética y respeto por el pasado. Resulta decepcionante y triste pasear y constatar el poco respeto que se le tiene, a pesar de estar en pleno proceso de restauración. Patrimonio parece estar ""ausente"". </p>

<p>Propongo que la rehabilitación tenga las máximas garantías y calidad, similar a la plaza vieja de Praga o la plaza San Marcos de Venecia, exigiendo además a los comercios guardar una estética adecuada, historicista y elegante. Nuestra Plaza Mayor y entorno debería ser Patrimonio Cultural de la Humanidad. </p>
";"08/09/2015 10";"165";"149";"16";"4";"873577635";"12010"
"1632";"¿es necesario cerrar el Paseo de Camoens los fines de semana?";"<p>Gallardon cerro el Paseo de Camoens y el transito de coches por el parque del Oeste los fines de semana, sin tener en cuenta los trastornos que nos producia a los vecinos del oeste para entrar en Madrid. No recuerdo que razon dio, pero creo que hoy no se sostiene y creo que ya no esta justificada.</p>

<p>solicito que no se cierre al trafico los fines de semana ese zona.</p>
";"08/09/2015 10";"40";"23";"17";"3";"859140219";"345"
"1633";"Integración Agentes de Movilidad en el cuerpo de Policía Municipal";"<p>Propongo que el Cuerpo de Agentes de Movilidad se integre en Policía Municipal mediante un sistema de Promoción Interna Horizontal o de Turno Libre Restringido (similar al que actualmente existe para militares profesionales tal y como establece la Ley de Coordinación de Policías Locales de la Comunidad de Madrid).</p>

<p>Se trata de una medida absolutamente legal (recogida en el Estatuto Básico del Empleado Público) y que permitiría rejuvenecer y ampliar la plantilla de Policía Municipal sin apenas coste (desde luego mucho menor que incrementar los efectivos de policía municipal con una oposición de ingreso libre).</p>

<p>Además es una propuesta recogida en el programa de Ciudadanos, no digo que este sea un motivo para dar más credibilidad a mi propuesta. Antaño también era apoyada por el Grupo Municipal de UPyD.</p>

<p>Por cierto, los agentes de movilidad son funcionarios de carrera que entraron por oposición, y no tienen nada que ver con los controladores de la Zona SER, que son personal de una empresa privada. Fue un cuerpo creado específicamente por Gallardón y que existe en otras ciudades como Toledo o Guadalajara.</p>

<p> </p>
";"08/09/2015 10";"184";"122";"62";"48";"866906683";"3978"
"1635";"Que no sea sancionable el skateboard en la Plaza de Felipe II y Colón";"<p>El skateboard, al igual que el resto de deportes urbanos (bici bmx, rollers, scooters, etc) no son un delito, son deportes con más de 20 años de historia en la capital, y en especial en estas dos céntricas plazas, Felipe II (en Goya) y Colón, de donde han salido profesionales de estos deportes que viven de ello.</p>

<p>Hasta ahora para poder practicar estos deportes se nos obliga a salir a otros municipios con parques especializados, con el consecuente gasto de dinero en transporte, medios y tiempo, pudiendo tener espacios en el centro de Madrid, sin tener que realizar obras costosas ni habilitaciones de ningún tipo.</p>

<p>Los deportes urbanos no dañan a nadie, no destruyen el mobiliario urbano a corto plazo, lejos de lo que se cree. El ruido de las ruedas de los patines no sobrepasa el límite permitido de ruido, y no son una escusa para multarnos o criminalizarnos, que es lo que realiza la policía municipal, con sanciones de hasta 300 por practicar un deporte.</p>

<p> </p>

<p> </p>
";"08/09/2015 10";"94";"43";"51";"5";"850483341";"-365"
"1636";"Posibilidad de unificar dos temas similares";"<p>Sería bueno proponer que dos temas que son muy parecidos entre sí, o que se refieren a lo mismo se puedan fusionar y unir los votos diferentes. Ya sé que cada uno aporta matices, pero sería una forma de que los debates no se dispersaran.</p>
";"08/09/2015 10";"123";"117";"6";"3";"873891378";"10558"
"1637";"Teléfono 010 Gratuito";"<p>Que el teléfono de información del Ayuntamiento de Madrid sea gratuito y no de tarifación adicional, ya que no entiendo como se puede cobrar por facilitar información administrativa de carácter general.</p>

<p>De todas formas se puede evitar marcando el teléfono  915 298 210 que equivale al 010.</p>

<p>Y que el Ayuntamiento haga una Declaración Institucional pidiendo a la Comunidad de Madrid haga lo mismo con el 012, que se note la orientación hacia los ciudadanos y las personas que tiene Ahora el Ayuntamiento de la Ciudad de Madrid.</p>
";"08/09/2015 10";"1121";"1086";"35";"19";"883710860";"101818"
"1638";"Acceso a menores de edad a salas de conciertos acompañados por un adulto";"<p>La normativa autonómica actual impide a los menores el acceso a la música en directo que no sea en grandes recintos como el palacio de los deportes, Santiago Bernabéu etc, estando prohibido el acceso a salas pequeñas bajo el pretexto de que se vende alcohol. </p>

<p>Esta ley es del todo contradictoria ya que en estos grandes recintos también se vende alcohol y por la misma se debería entonces prohibir el acceso a los bares.</p>

<p>Esta ley lo que hace es impedir a los menores el acceso a una parte importante de la cultura como es disfrutar de conciertos en todo tipo de salas en directo, ni siquiera existe la opción de ir acompañado por un adulto que se haga responsable.</p>

<p>En otros países como Estados Unidos se soluciona con algo tan simple como poner una pulsera a los mayores de 18 años.</p>
";"08/09/2015 10";"82";"59";"23";"0";"865637870";"2590"
"1640";"Gobierno abierto .";"<p>Junto a iniciativas como esta , que sirven para tomar el pulso de los Ciudaddnos ,creo que seria fiunadamental modificar  y/o suprimir los mecanismos oficiales existentes en el Ayuntamiento.me refiero en concreto a la <strong>ventanilla de entrada ofimatica </strong></p>

<p>https://www-s.munimadrid.es/SYR_003_WACiudadanos/iniciar.do?procedimiento=200</p>

<p> </p>

<p>LLevo años usandola y sirve de poco ,por cada consulta/sugerencia/felicitacion  se te asigna un numero automaticamente y tienen que pasar meses /años para volver a tener alguna nueva informacion o a veces ninguna.</p>

<p>En la mayorai de las ocasiones la respuesta es del tipo "" se lo hemos pasado a tal organo interno   de la organizacion ""     ¡ y  a mi que ¡</p>

<p>No habiamos quedado que esta ventanilla es mi acceso para  TODO el Excelentisimo  Ayuntamiento......  ¿ NO deberian ser ellos mismos quienes me contestes y al poder ser con rapidez y eficacia ?</p>

<p> </p>
";"08/09/2015 10";"34";"27";"7";"1";"864827350";"1588"
"1642";"Transformar la calle de Segovia en peatonal. El actual acerado es intrasitable.";"<p>En algunos tramos de la calle Segovia, su acerado es intransitable, con una anchura que ni siquiera alcanza un metro de ancho, los peatones nos vemos obligados a hacer literalemnte malabares cuando nos cruzamos con otros viandantes porque no hay espacio para ceder el paso a nadie. A esto hay que añadir que con tanta limitación de espacio, viene siendo muy habitual que autobuses y camiones golpeen las cabezas de los paseantes con los espejos retrovisores, he sido testigo de varias situaciones de pánico. He vivido situaciones realmente peligrosas cuando los que intentan andar por esa calle lo hacen acompañados de carros de la compra, carros con bebés, o animales de compañía. Debería hacerse peatonal desde el puente de Segovia en dirección Sol para evitar un grave accidente.</p>
";"08/09/2015 10";"75";"53";"22";"3";"865101884";"2190"
"1645";"Pintadas en Madrid";"<p>Es una pena que una ciudad como Madrid este tan sucia en general, queremos parecernos a otros países europeos pero en este tema como en muchos otros retrocedemos...como puede ser que se tenga que contratar a un grafitero para que me pinte el cierre de mi establecimiento para que otros no lo hagan? Xq tenemos que ver los parques y todas las calles pintadas? La pintura que están poniendo en otros países ( la que rebota)es buena idea pero será costosa. Como es que no se castiga a este gente, si tienen firma?Que pinten en zonas habilitadas pero que dejen de ensuciar Madrid. </p>

<p>Muchos madrileños han llamado para que vuelvan a pintar las fachadas y así se ha hecho, pero al día siguiente ya vuelve a estar todo pintado. ¿Xq las comunidades de vecinos se tienen que gastar un dinero en pintar los cierres de sus garajes o sus entradas si lo han hecho otros? </p>

<p>La cuestión es que los madrileños se quejan y el ayuntamiento sea del partido que sea solo pone parches pero nunca arreglan el problema, por favor queremos pasear por Madrid, disfrutar de Madrid, de una ciudad limpia! Ya que quieren mirar tanto por los madrileños vamos a ver si es verdad y empiezan a tomar medidas en relación a la suciedad y a la seguridad de los madrileños, mi ciudad está cada vez mas sucia y todos los años pagamos más impuestos, donde va nuestro dinero? Ya esta bien tanto unos como otros.</p>
";"08/09/2015 10";"114";"104";"10";"7";"872580194";"8575"
"1646";"Abrir a concurso público los puestos del Ayuntamiento";"<p>Como era esperable, Carmena se ha apuntado a la fea costumbre establecida por sus antecesores, de dudosa honrabilidad, tales como el nepotismo y la endogamia ideológica, siendo ya varios los dedazos puestos en práctica.</p>

<p>Ante está situación, y puesto que una ciudad como Madrid se merece en sus altos cargos a los mejores, deberían establecerse oposiciones para estos puestos de responsabilidad, y que todos los madrileños pudiesen optar a ejercer y servir a todos los ciudadanos, sin deber favores, y sin ser esbirros y familiares de sus superiores en última instancia.</p>

<p>¡Concursos públicos para el Ayuntamiento YA!</p>
";"08/09/2015 10";"100";"76";"24";"10";"867752397";"3952"
"1650";"Cambiar el nombre a la Calle Caídos de la División Azul.";"<p>Es indignante que Madrid aun mantenga una calle a soldados que combatieron junto con las tropas nazis. Por ello deberíamos cambiar el nombre a la Calle Caídos de la División Azul para dedicarla a las víctimas del holocausto. Esto no solo servirá para mejorar y la imagen internacional de la ciudad, también servirá como justo homenaje. </p>
";"08/09/2015 10";"169";"81";"88";"9";"851082468";"-335"
"1651";"Carril-bici en el Bulevar José Prat en Vicálvaro";"<p>Desde el año 2008, año el que se desarrolló el <em>Plan Director de Movilidad Ciclista de Madrid</em>, está planificada la construcción de una vía para ciclistas que recorra el Bulevar José Prat. Dicha vía tiene el objetivo de conectar el Anillo Verde Ciclista con la vía ciclista de la Avenida de la Democracia y con las zonas verdes del distrito: Parque de Valdebernardo, Faunia y Cerro Almodovar.</p>

<p>Mi propuesta es una solución de bajo coste basada en la creación de un carril-bici en cada sentido siguiendo el modelo usado en la Avenida del Mayorazgo que tan buenos resultado ha dado. Esta solución implicaría la supresión de 1 de los 3 carriles del bulevar en cada sentido para convertirlo en carril-bici. Este cambio no afectaría al tráfico, ya que en esta calle el tráfico no es tan intenso como para no poder ser absorbido con 2 carriles por sentido. Además, esta medida eliminaría el problema de estacionamiento en doble fila que actualmente sufre el bulevar.</p>

<p>Los carriles quedarían configurados de la siguiente manera. A la izquierda quedarían los carriles para vehículos, a la derecha un carril exclusivo para bicicletas, a continuación la zona de aparcamiento y la acera. Como se puede ver la creación del carril bici tan solo implica el uso de un poco de pintura blanca y la señalización por lo que su realización resulta bastante barata.</p>

<p>Este tipo de carril bici tiene varias ventajas sobre la acera-bici (lo que la comúnmente llamamos carril-bici y que consiste en un tramo de acera pintado en rojo):</p>

<ul>
	<li>Su coste es bastante más bajo que el de una acera bici ya que sólo implica pintar líneas blancas y un poco de señalización.</li>
	<li>El riesgo de accidente es menor, ya que la mayoría de accidentes en donde se ven involucrados ciclistas se producen entre ciclistas y peatones.</li>
	<li>La velocidad a la que pueden ir los ciclistas es mayor que usando la acera bici por lo que se fomenta el uso de la bicicleta como medio de transporte.</li>
</ul>
";"08/09/2015 10";"54";"33";"21";"1";"861217586";"733"
"1652";"CREACIÓN DE RED DE ""COMPOSTERAS"" DE BARRIO PARA RECICLAR DE RESIDUOS ORGÁNICOS ";"<p>Se trataría de ubicar dentro de los barrios (y en espacios bien estudiados y acondicionados) contenedores para el vertido y procesamiento de todo lo que pueda clasificarse como residuo organico reciclable para generar abono etc. El objetivo de la propuesta sería principalmente la reducción del volumen de residuos que acaban siendo transportados a los grandes vertederos, para reducir también los impactos de mobilidad y de paso aprobechar localmente el recurso de lo organico en jardinería o horticultura. La red debería apoyarse a la vez en espacios verdes existentes, donde se puedan ubicar los composter (depositos para el procesamiento de los residuos organicos) e involucrar en su gestión sujetos varios. Si bien la dirección debería probablemene estar a cargo de personal cualificado de los servicios de limpieza del ayuntamiento, este debería poder trabajar con la colaboración voluntaria de otras realidades, como las varias huertas comunitarias de la ciudad, o los estudiantes de primaria y secundaria, que podrían así ser concienciados activamente con el problema de la gestión de los residuos. La cuestión sería intentar cazar varios pájaros de un tiro: reducir el tráfico de camiones de vasura y por tanto de emisiones, generar localmente nuevas ocasiones de empleo, aprobechar el material orgánico y finalmente, hacer pedagogía y fomentar nuevas redes de colaboración entre lo público y el asociacionismo.    </p>
";"08/09/2015 10";"76";"56";"20";"4";"866161587";"2652"
"1657";"Corralas ";"<p>Conversión de las corralas en propiedad del Ayuntamiento en mercados tradicionales o modernos como el de Sán Miguel, pequeñas tiendas, centros de tiendas de antigúedades e incluso guarderías donde los niños cuenten con un patio interior donde jugar.</p>
";"08/09/2015 11";"39";"20";"19";"2";"855399512";"51"
"1659";"Limpieza calles";"<p>¿Sería muy costoso recuperar la limpieza de calles con agua de riego como antaño? Creo que hace años el riego era diario. ¿Podría realizarse una vez por semana?</p>
";"08/09/2015 11";"109";"107";"2";"1";"874510922";"10307"
"1664";"OLA VERDE: que los que corran no salgan ganando, sincronización de semáforos ya!";"<p>Estimada Alcaldesa:</p>

<p>En la circulación rodada en Madrid se asiste al espectáculo de coches y motos de listillos y seguidores espontáneos que arrancan a toda velocidad cuando se pone un semáforo en verde sabiendo que serán recompensados pasando el siguiente aún en verde o amarillo, a pesar de haber superado con mucho la velocidad límite, mientras que los conductores que van a velocidad legal deben conformarse con otro semáforo en rojo, aumentando los tiempos, las emisiones, y el ruido de arrancadas innecesarias a los vecinos.</p>

<p>La tecnología hace mucho que permite que los semáforos vayan sincronizados, premiando al que circula a 40 o máximo 50 km/h encuentre a su paso todo en verde. Incluso hay paises en los que desde hace mucho hay una señalización intermedia recomendando la velocidad a seguir para encontrar el siguiente semáforo en verde.</p>

<p>Estoy seguro que que el sistema semafórico de Madrid permite establecer la sincronización en grandes ejes con una ""ola verde"" que beneficie a la movilidad en general, aumente la seguridad y minimice los impactos negativos del tráfico rodado.</p>

<p>Por favor, Sra. Alcaldesa, implante una OLA VERDE en los grandes ejes de toda la ciudad, la ciudadanía y la naturaleza se lo agradecerán de por vida.</p>
";"08/09/2015 11";"217";"199";"18";"12";"875488450";"16598"
"1665";"Madrid: Ciudad libre de Ramoncín";"<p>Porque es muy desagradable encontrártelo de golpe al doblar una esquina. Pidiendo dinerico por la piratería cuando nadie, ABSOLUTAMENTE NADIE se descarga su M de ¿música?</p>

<p> Deshagámonos de los transgénicos, de la castaTM y después de Ramoncín.</p>
";"08/09/2015 11";"10";"7";"3";"0";"858942590";"280"
"1669";"Metro sin tornos pero con vigilantes/revisores";"<p>En ciudades como Berlín, Múnich, Hamburgo, Oporto...el metro no tiene tornos, con lo que se facilita mucho la entrada, no hay aglomeraciones, no hay dificultades para bicicletas, sillas de ruedas o cochecitos de bebés, y es posible el acceso con un solo ascensor desde la superficie sin pasar por un vestíbulo intermedio.</p>

<p>Con un buen sistema de revisores y multas (por desgracia) podríamos concienciarnos de que hay que viajar con un billete válido. Esto a su vez podria dar trabajo a mucha gente. </p>

<p> </p>
";"08/09/2015 11";"76";"24";"52";"6";"850082681";"-884"
"1674";"Aparcacoches";"<p>Hola,</p>

<p>no puede hacer nada el Ayuntamiento con los aparcacoches que hay en la zona de Reina Victoria, San Francisco de Sales y Guzmán El Bueno? Creo que los residentes tenemos derecho a soluciones ya que pagamos nuestros impuestos y la tarjeta de residente del SER para poder aparcar sin tener que estar acosados cada vez que intentamos encontrar un parking.</p>

<p>Saludos.</p>
";"08/09/2015 11";"73";"69";"4";"1";"871910912";"6143"
"1678";"No es más limpio el que más limpia...";"<p>Creo que todos los ciudadanos de Madrid estamos de acuerdo en el deplorable estado de limpieza en el que se encuentra la ciudad: las aceras están llenas de basura, los contenedores quedan a rebosar, algunos ciudadanos pasean a sus perros y no recogen lo que el animal deja en la acera, las calles no se baldean, muchos piensan que la ciudad es su basurero y dejan electrodomésticos, ropa y muebles en las aceras, etc.</p>

<p>Es necesario que el ayuntamiento se comprometa a dejar Madrid más limpio pero es más necesario que los ciudadanos hagamos un Madrid más limpio porque en la mayoría de ocasiones la limpieza empieza por nosotros mismos y por no ensuciar.</p>

<p>Muchos ciudadanos, estoy seguro de que no la mayoría están arruinando el esfuerzo por el civismo que hacemos el resto y malgastando los recursos que invertimos en limpieza que no se harían necesario en caso de que ellos no ensuciasen a sabiendas.</p>

<p>Es necesario proscribir, penalizar y sancionar algunos comportamientos que vemos a diario: dueños de perros que no recogen los excrementos, vecinos que dejan en la calle basura que no puede ser recogida por el camión en lugar de llevarla al punto limpio o acordar una recogida contralada en el 010, comunidades de vecinos que sacan  la basura sin el cubo que da gratis el ayuntamiento, etc.</p>

<p>No basta con limpiar más si no se elimina la causa de la suciedad estando ésta en nuestras manos: a los ciudadanos también hay que educarlos y parece ser que tiene que ser con sanciones.</p>
";"08/09/2015 11";"105";"100";"5";"7";"873688507";"9047"
"1679";"Carril bici en Paseo de las Delicias (eje ciclista Norte Sur)";"<p>Propongo la creación de un carril bici segregado del tráfico motorizado en el Paseo de las Delicias. </p>

<p>La medida podría ir acompañada de la creación de una nueva estación de BiciMad en la Plaza de Legazpi. Debido a que las bicis son eléctricas, la cuesta se haría mucho más llevadera y se fomentaría el uso de la bicicleta, lo cual redundaría en un mayor beneficio medioambiental para el distrito de Arganzuela.</p>

<p>Los potenciales beneficios de la medida serían:</p>

<p>- Reducción de la contaminación el el Paseo de las Delicias y alrededores: esta calle parece una autopista urbana y los niveles de contaminación son cada vez más alarmantes. Hay carriles de sobra para crear uno específico para bicis, lo cual fomentaría la movilidad sostenible y la circulación de bicis con total seguridad. </p>

<p>- Conexión Eje Norte-Sur: desde Madrid Río, el carril bici iría desde la calle Maestro Arbós conectando con Madrid Río, pasando por el Paseo Delicias hasta conectar con Atocha, uniéndose al eje ciclista que subiría por el Paseo del Prado - Castellana. De esta forma se crearía una arteria principal de Norte a Sur, fomentando la movilidad ciclista por toda la capital.</p>

<p>Muchas gracias.</p>
";"08/09/2015 11";"156";"130";"26";"9";"871693149";"8666"
"1681";"Juan Ramón Rallo próximo pregonero de las fiestas del Carmen de Vallecas";"<p>Porque la diversidad, la tolerancia, el diálogo y la democracia son nuestras señas de identidad.</p>
";"08/09/2015 11";"62";"40";"22";"0";"862890215";"1161"
"1685";"REPONER A LA ESTACION DE METRO DE SOL SU NOMBRE";"<p>Me indigna enormemente al entrar en el metro ver lo de la estación VODAFONE. Yo no la llamaré así jamás. Hasta cuando tendremos que ver esta patochada? Volverá a tener su nombre original?</p>
";"08/09/2015 11";"328";"268";"60";"7";"873795015";"16995"
"1686";"Limpieza urgente y mantenida de las calles";"<p>Es urgente y necesario que se proceda a limpiar las calles de Madrid. Un plan de choque es prioritario, pero el servicio habrá de mantenerse para que Madrid vuelva a ser una ciudad limpia y agradable para sus ciudadanos</p>
";"08/09/2015 11";"270";"263";"7";"4";"878286458";"24936"
"1688";"Recuperación real de los bulevares Sagasta - Alberto Aguilera";"<p>Recuperar el fantástico bulevar que existió en las calles Sagasta - Carranza - Alberto Aguilera. </p>

<p>Anteriores corporaciones municipales tomaron el pelo a los vecinos anunciando su recuperación cuando lo que hicieron fue plantar una fila de árboles en la mediana de la calzada. </p>

<p>La propuesta es reducir el espacio destinado a la circulación, limitándolo a un carril por dirección, y devolver los metros perdidos a los bulevares que mejorarán la calidad de vida de los vecinos y rehabilitará la zona para el ocio y el comercio de lo que hoy es sólo una autopista intra urbana de seis carriles. </p>
";"08/09/2015 11";"83";"75";"8";"5";"871402192";"6054"
"1692";"BICIMAD y CARRILES BICI";"<p>Hay que ampliar y mejorar el servicio de BICIMAD. Faltan bicicletas y estaciones. No basta con una estación por cada distrito. La zona de Pacífico/Retiro precisa muchas más bicicletas y estaciones. Se ha de ampliar el carril bici por todo el centro de Madrid (separado del resto de la circulación de vehículos). Se ha de limitar el número de vehículos privados que circulan por el centro de Madrid.</p>
";"08/09/2015 11";"135";"118";"17";"6";"872437535";"8828"
"1697";"Sistema de reciclaje de envases y botellas al estilo alemán (""Pfand"")";"<p>El sistema de reciclaje de envases de Madrid (los cubos amarillos) es genial, pero podemos mejorar en este sentido.</p>

<p>Por ejemplo en Alemania cuando pides una bebida en un bar, normalmente te cobran unos céntimos de más como tasa de reciclaje (se llama ""Pfand""), lo que te devuelven cuando retornas el envase en el mismo establecimiento (o en otros lugares especializados).</p>

<p>Esto hace que sea mucho más difícil ver calles ensuciadas con botellas de plástico y demás residuos, porque si no son los propios compradores los que las recojen, lo harán los transeúntes para sacarse unos centimillos después.</p>

<p>Más información sobre este sistema: http://www.berlinfree.com/reciclaje-botellas-alemania/</p>
";"08/09/2015 11";"440";"420";"20";"12";"879752606";"38181"
"1699";"Ocio y Convivencia";"<p>El Centro de Madrid es el distrito que mas visitantes recibe, pero no solo hay comercios, bares, teatros y otros lugares de ocio, tambien hay residentes que viven y duermen (o mal duermen en sus casas). El ruido nocturno y las suciedad que se genera (orines incluidos) es el que considero prioritario para regularizar una normativa que respete los derechos de los vecinos de Centro al descanso (salud e higiene).</p>
";"08/09/2015 11";"44";"38";"6";"6";"868079502";"2763"
"1705";"Suprimir alumbrado navideño y cabalgata";"<p>Propongo suprimir el alumbrado navideño y todas los actos en los que participa el Ayuntamiento con motivo de las fiestas cristianas, incluyendo la Cabalgata de Reyes.</p>

<p>Supone un gran gasto y lo único que hace es fomentar el consumismo.</p>

<p>Además tener tantas luces es antiecológico y aumenta la contaminación lumínica</p>

<p>Propongo destinar el ahorro que se genere a mejorar las condiciones de los refugiados sirios que vamos a acoger.</p>

<p>Un saludo</p>
";"08/09/2015 11";"194";"59";"135";"11";"849102747";"-2311"
"1706";"Informar a los inmigrantes de las normas locales para que se amolden";"<p>Buenos días.</p>

<p>Como vecino del barrio de Usera me veo afectado por la falta de información de la normativa local a los inmigrantes, sufriendo las consiguientes consecuencias que hacen de la cida en este barrio un infierno.</p>

<p>Por ejemplo, si han viajado a China sabrán que allí es costumbre escupir en el suelo, además, de manera vehemente. Otro ejemplo sería el ruido a deshora.</p>

<p>Propongo que se comunique la normativa a las personas que vengan de fuera, ya que muchas veces no se cumple por desconocimiento, y que se exija el cumplimiento de la misma, para que la convivencia sea armoniosa entre todos y para promover el civismo.</p>

<p>Muchas gracias</p>

<p>Saludos</p>
";"08/09/2015 11";"173";"147";"26";"19";"872816144";"10281"
"1707";"Convertir los puntos limpios en espacios de reciclado y recuperación";"<p>Cada vez que voy al punto limpio a llevar objetos que ya no utilizo pero están en buen uso pienso en que podrían aprovecharlos otras personas, pero el sistema está organizado para tirar con lo que supone de gasto energético, aparte del beneficio social que podría significar. La opción de entregarlos a ong es complicada, porque en muchas no admiten todos los objetos -ropa sí, pero no juguetes, o no artefactos electrónicos- y pienso que disponiendo de almacenes donde las personas necesitadas pudieran acudir como si se tratase de un banco de alimentos se haría una doble función al eliminar residuos que no son tales y resolver las demandas de personas con pocos recursos.</p>
";"08/09/2015 11";"79";"77";"2";"6";"873293208";"7310"
"1709";"Mini-tasa a las gasolineras, para sufragar el servicio de Metro 24horas";"<p>Creo que la mayoría de los madrileños estaríamos de acuerdo en que tener el metro abierto las 24horas del día sería bastante cómodo.</p>

<p>En lo que solemos chocar es a la hora de decidir ""¿de dónde sale el dinero para sufragarlo?"". Quizás el ayuntamiento tenga suficiente presupuesto ya para poder asumirlo, pero la pregunta es si es de verdad prioritario este tema.</p>

<p>Bueno, entonces lo que yo propongo es un doble sistema: penalizar el uso del coche en Madrid mediante una mini-tasa a las gasolineras (las cuales supongo que repercutirán el coste a sus usuarios), y con esa recaudación sufragar el sobrecoste que suponga tener el metro abierto desde las 2AM hasta las 6AM.</p>

<p>Sería un sistema win-win, porque tendríamos menos problemas de transporte (¿cuántas veces hemos tenido que pedir a un familiar que nos venga a buscar al aeropuerto por llegar el vuelo super tarde?) y menos contaminación en la ciudad (mirad Pekín, que ha tenido que prohibir los coches durante 2 semanas para que hubiera cielo azul en su desfile conmemorativo de la Segunda Guerra Mundial).</p>
";"08/09/2015 11";"73";"21";"52";"12";"850443940";"-891"
"1710";"Manifestaciones silenciosas ";"<p>Yo, como ciudadano de Madrid, estoy ya cansado de tanto silbato y tanta bocina dentro de las manifestaciones, el derecho a la manifestación de unos termina donde empieza el respeto al resto de los habitantes de esta ciudad. Con la cantidad enorme de manifestaciones que abundan por nuestras calles, el ruido de los coches, ya de por sí molesto, es sustituido por el de una masa de sonidos muy por encima del nivel permitido de contaminación acústica. </p>

<p> </p>

<p>Por estas razones, la policía local, encargada del mantenimiento del orden público, debería tener la capacidad de sancionar de alguna manera a los que excedan los límites que deberían respetar todas las personas por igual.</p>

<p> </p>
";"08/09/2015 11";"96";"35";"61";"4";"849789953";"-947"
"1712";"CARRIL BICI EN LA CALLE BAMBÚ DEL DISTRITO DE CHAMARTÍN";"<p>Al final de la Calle Arturo Soria hay gran densidad de población por viviendas en altura. Se congestionan las vias de acceso. La calle Bambú es peligrosa para las bicicletas, ya que conviven con coches y autobuses interurbanos que conectan con la estación de Chamartín.</p>

<p>La acera es estrecha porque esta la tapia de la estación pero detrás de la tapia hay una zona de descampado. Se podría realizar un carril de bicicletas.</p>

<p> </p>

<p> </p>
";"08/09/2015 11";"54";"42";"12";"3";"866570358";"2333"
"1713";"Villaverde-Río Manzanares";"<p>Hacer realidad que el río Manzanares a su paso por Villaverde sea un parque similar a Madrid Río y Parque lineal del Manzanares. Que el río tenga un tratamiento igual que en el resto de distritos.</p>

<p>Que madrid río llegue hasta villaverde.</p>
";"08/09/2015 11";"62";"58";"4";"6";"871313113";"5051"
"1714";"Skatepark indoor en la ciudad de Madrid. ";"<p>Creo que seria bueno para la ciudad construir un Skatepark indoor en la ciudad de Madrid para fomentar este tipo de deportes (Skate, roller, BMX etc). </p>

<p>Un lugar idoneo seria el Mercado de la fruta de legazpi, ademas tambien se podria unir al proyecto un Hostel. </p>

<p>Esto se puede ver por ejemplo en el Skatepark indoor de Eindhoven, a lado del cual se encuentra el Blue Collar Hotel. </p>

<p>De esta manera se fomentaria el deporte y el turismo y se le daria vida a toda esa zona.</p>
";"08/09/2015 12";"41";"28";"13";"0";"863043148";"1024"
"1717";"Auditoría de los puestos de trabajo del Ayuntamiento.";"<p>Publicar los puestos de trabajo del Ayuntamiento y su sueldo correspondiente.</p>
";"08/09/2015 12";"311";"302";"9";"14";"879029474";"28452"
"1718";"URINARIOS PARA TAXISTAS Y VIANDANTES";"<p>Estoy harto de que meen en el portal de mi casa y que la policía municipal no haga nada. Hay calles por las que no se puede pasar por el pestazo.</p>
";"08/09/2015 12";"91";"80";"11";"4";"871279210";"6065"
"1719";"Derroche luz  en la parcela del antiguo cuartel de ingenieros en Villaverde Alto";"<p>En la pacela  urbanizada del antiguo cuartel de ingenieros en Villaverde Alto, mantienen encendidas durante toda la noche las luces sin motivo aparente ya que en dicho lugar solo hay farolas y bancos. Por otro lado la carretera adyacente de Educardo Barreiros esta insuficientemente iluminada.</p>
";"08/09/2015 12";"20";"13";"7";"5";"860685058";"390"
"1720";"Pádel municipal - Tarifas rígidas e instalaciones obsoletas";"<p>El Ayuntamiento tiene las mismas tarifas para jugar al pádel (y para practicar otros deportes) a las doce de un mediodía de julio con 40 grados que a las ocho de una tibia tarde de abril. No se distingue entre horas de mínima/nula ocupación y entre horas de máxima afluencia.</p>

<p>Actualmente, jugar dos horas en una pista al aire libre cuesta 6,90 / hora, más un suplemento de luz en horario nocturno 3,70 / hora; total: 21,20 con luz, 13,80 sin ella (15,9 la hora y media con luz; 10,35 sin ella).</p>

<p>En cambio, en clubes de pádel privados cubiertos la tarifa durante el horario de menor afluencia (por la mañana y por la tarde generalmente hasta las 18h de lunes a viernes) es, según centros deportivos, de entre 10-15 con luz. Por las tardes y fines de semana el alquiler sube a entre 20-26. Es una flexibilidad de precios acorde con la demanda. La diferencia fundamental es que en estos clubes, a diferencia de la instalación municipal, por el mismo dinero o un poco más tienes:</p>

<p>- Pista cubierta (sin reflejos del sol, sin lluvia, sin viento, a una temperatura constante y con iluminación homogénea, en muchos casos de LED, sin pérdida de bolas por tratarse de un recinto cerrado, etc.).</p>

<p>- Reja dura (sin alambres sueltos o mallas deformadas en la parte lateral de la pista).</p>

<p>- Pared de cristal (sin irregularidades en el rebote y mucho menos lesiva en los choques; algunas pistas del Ayuntamiento son de cristal, pero la mayoría, más antiguas, son de muro).</p>

<p>- Suelo de moqueta de mejor calidad y más cuidado (sin humedad, protegido de los elementos y con buen mantenimiento).</p>

<p>- Facilidad para alquilar pista por internet o por teléfono sin pago previo o mediante bono monedero, aplicaciones de móvil, etc.</p>

<p>En definitiva: 1) creo que es anacrónico no tener tarifas por franjas horarias, 2) el servicio deportivo resulta carísimo respecto a lo que actualmente ofrece el mercado, especialmente teniendo en cuenta la calidad de las instalaciones municipales, 3) no hay incentivo en el precio, 4) no hay facilidades para el alquiler por teléfono o internet, 5) de cómo se gestionan las escuelas formativas hablamos otro día.</p>

<p>Resultado: se desaprovecha la magnífica oportunidad de enganchar a los ciudadanos a un deporte en alza, en unas pistas cuyo mantenimiento no podría ser más agradecido e interesante en relación inversión/beneficio.</p>
";"08/09/2015 12";"30";"23";"7";"2";"864407332";"1226"
"1724";"Reducir vía de 7 carriles (calle Segovia desde Madrid Río)";"<p>Hay una vía de acceso al centro de Madrid desde el puente de Segovia que me parece una exageración: ¿es una autopista? Hay 3 carriles por sentido, y un carril extra de vía de servicio. ¡En total 7 carriles! (Calle Segovia, al final pegando a Madrid Río.)</p>

<p>Esto no sólo es una fuente de ruido enorme (lo que hace que disfrutar del colindante Parque Atenas sea imposible) sino que es bastante peligroso porque los vehículos circulan muy rápido (con lo que se ven pocas bicicletas por esta zona).</p>

<p>Propondría convertir 2 de estos carriles en carril-exclusivo bicicleta (no simplemente poner un símbolo de 30Km/h, sino que se pinte de otro color), o bien reducir esta mini-autopista a 4+1 carriles (en lugar de 6+1).</p>
";"08/09/2015 12";"44";"31";"13";"0";"863913738";"1268"
"1725";"Mejorar la imagen de los que nos representan";"<p>Sugiero a los señores concejales y a la alcaldesa de Madrid que por favor mejoren su imagen pública cuidando su aseo personal y su vestimenta, por lo menos en los actos públicos. Da vergüenza ver cómo estas personas acuden a actos con otras autoridades internacionales y nacionales y su imagen no está a la altura. Si nos representan, por favor, tómense en serio esta actitud, porque nos gusta ver a nuestros representantes bien vestidos, aseados y peinados. Es una cuestión de respeto a la ciudadanía y a las personas con las que se reunen.</p>

<p>Personalmente me dio vergüenza ajena ver cómo iba vestida y mal peinada la alcaldesa en su primera reunión con el Rey de España.</p>

<p>No se acercan más al ""pueblo"" por ir inadecuadamente. Al contrario, rebajan su nivel.</p>

<p>Muchas gracias</p>
";"08/09/2015 12";"73";"29";"44";"9";"850455682";"-595"
"1726";"Las aceras de Madrid son imposibles para los peatones.";"Desde hace unos años los alcaldes de Madrid utilizan las aceras para resolver problemas que no saben solucionar.
- Dejan aparcar las motocicletas, ya de paso circulan por las aceras. Deberían aparcar en la calzada como antes de la llegada a la  alcaldía  del Sr. Gallardón conocido motorista.
- No controlan las terrazas de los lugares de ocio de tal forma que ocupan casi  toda la acera de forma abusiva.
- Las aceras están llenas de carteles de negocios que hacen publicidad, tropiezas con el cartel y consideran que es buena publicidad.
- A falta de carril bici y en otros casos por que les viene bien, los ciclistas circulan por las aceras sin respectar al peatón.
Todo esto más el espacio que ocupan buzones de correo, kioscos de todo tipo etc.
Qué espacio queda en la acera para los peatones.
";"08/09/2015 12";"96";"88";"8";"4";"872569820";"7333"
"1727";"Arbolado en Madrid";"<p>Me gustaría que se valorase un progresivo cambio del arbolado presente en Madrid. Ya no es únicamente un problema de que muchos árboles se encuentran enfermos y frágiles, lo que conlleva que cada vez que hay una tormenta moderada nos encontremos con ramas caídas o incluso troncos volcados. Además tenemos unos árboles que crean bastante suciedad, los plátanos orientales: https://es.wikipedia.org/wiki/Platanus_orientalis, que además generan una cantidad de polén enorme</p>

<p>Sin ser botánico ni nada parecido, quiero pensar que habrá mejores alternativas. Mi zona, Puente Vallecas, está llena y a mí, entre la contaminación y el polén de estos árboles, las primaveras y veranos me dejan para el arrastre.</p>
";"08/09/2015 12";"49";"42";"7";"1";"868341315";"3000"
"1730";"2.	Plan de cubiertas verdes en edificios  ajardinamiento de azoteas";"<p>La propuesta consiste en estudiar la posibilidad de ajardinar progresivamente la cubierta de los edificios de la ciudad que por tipología y condiciones estructurales permitan esta opción. El objetivo sería contribuir a mejorar la eficiencia térmica/energética de los mismos, aumentar las superficies vegetadas de la ciudad y poner también las condiciones para el aprovechamiento público o privado-comunitario de estos nuevos espacios verdes para actividades de ocio o productivas (huertas en altura).</p>

<p>La iniciativa debería plantarse para un escenario de largo plazo, pudiéndose implementar inicialmente en los edificios públicos, por las menores dificultades de gestión que supuestamente  puede conllevar. Sucesivamente se podría extender (sobre base voluntaria) a los edificios de titularidad  privada, activando también una línea de financiación/apoyo u ofreciendo descuentos fiscales relacionados con la mejora de la eficiencia energética de los inmuebles.</p>
";"08/09/2015 12";"142";"130";"12";"7";"874135337";"10802"
"1731";"Por que hay que acoger inmigrantes por que alemania lo diga??";"<p>España ha ""sufrido"" durante los buenos años de la burbuja del ladrillo oleadas de inmigrantes a los que se les ha permitido la entrada sin que ningun pais europeo se preocupara lo mas minimo sobre esta gente, ni que tendria para comer,la forma inhumana de llegar hasta la peninsula o si era sostenible para la economia del pais.</p>

<p>ahora que la zona sur de europa esta mal economicamente hablando,(españa, italia y grecia) y que ningun inmigrante se plantea venir a quedarse y solo es zona de paso hasta paises ""desarrollados"" como alemania o londres, tenemos que tragar por que no quieran responsabilizarse de ""acoger"" a esta gente por que les van a perjudicar economicamente.</p>

<p>no estoy diciendo que se niege la entrada al pais a quien quiera venir, pero si el deseo de la mayoria es ir a alemania que se ocupen ellos y no deriven gente a los demas paises para quitarse el problema de encima. </p>

<p>O somos europeos todos cuando nos interesa?</p>
";"08/09/2015 12";"152";"43";"109";"18";"849730278";"-1867"
"1732";"Abrir jardines de Canal en Chamberí";"<p>Abrir al público los jardines del Canal de Isabel II en Chamberí.</p>
";"08/09/2015 12";"108";"100";"8";"0";"873291126";"8518"
"1733";"SACAR LA BEBIDA FUERA DE LOS BARES";"<p>Hubo un tiempo en que Madrid era una ciudad espontánea y vital, un espíritu que poco a poco fueron apagando. Con la excusa de controlar el ""botellón"" se implantó una ley que impide comprar alcohol a partir de las 10 de la noche y que nos obliga a permanecer en el interior del bar mientras estemos consumiendo. Ni el botellón ha desaparecido ni los jóvenes han dejado de beber alcohol. Lo que sí ha conseguido esta ley es que los madrileños ya nunca podamos tomar el aperitivo al sol, una de esas pequeñas cosas que te alegran la vida.</p>

<p>Por otro lado las terrazas ha crecido de forma incontrolable. Las posibles molestias a los vecinos se han multiplicado, eso sí, previo pago de la necesaria licencia: la recaudación como objetivo. Bebe pero sentado, un control absurdo y orwelliano de nuestra vida más cotidiana.</p>

<p>En muchas ciudades de España esta ley no existe, en otras sí, y no parece que eso altere la convivencia en absoluto. En Londres, por ejemplo, se puede beber en la calle hasta una hora determinada. Creo que una medida de esas características sería la más adecuada para devolver a las calles de Madrid su espontaneidad perdida.</p>

<p>Déjennos vivir. Tan sencillo como eso.</p>

<p> </p>
";"08/09/2015 12";"72";"51";"21";"3";"865668460";"2125"
"1734";"Mantenimiento aceras y limpieza Tetuán vs Arturo Soria";"<p>Durante muchos años he sido vecina del barrio de Tetuán y desde hace unos años resido en Ciudad Lineal alrededor de la calle Arturo Soria a diferentes alturas.</p>

<p>Como mi madre sigue residiendo en Tetuan, visito con regularidad este barrio y me indigna enormemente ver la diferencia tan grande en la limpieza y mantenimiento de las aceras.</p>

<p>Teniendo en cuenta que la densidad de población en una zona y otra no tiene nada que ver, al final se trata de que unos pocos disfrutan de mejores equipamientos y mayor limpieza que una mayoría con menor poder adquisitivo. ¿Por qué? no puedo entenderlo porque la diferencia es avergonzante. Me gustaría tener la posibilidad de subir imágenes, porque no puedo describir con palabras  el estado de las aceras de las calles Berruguete, Mariano Fernandez, Lope de haro, Villamil.... he visto caerse a muchas personas mayores, mi hijo de 2 años tropieza constantemente, mi madre también se ha caído y en cuanto a la limpieza es penosa, no hay espacio reservado para los cubos de basura, la basura se acumula en las esquinas, porque no se recoge lo que está fuera de los cubos y la verdad me cuesta ver un barrendero por las calles adyacentes a Bravo Murillo. Botellas rotas, cacas de perro, papeles, comida, absolutamente de todo te puedes encontrar en estas calles. </p>

<p>En definitiva, me gustaría ver que se preocupan por el estado de estas calles y se empiezan a remodelar aceras y a incrementar los servicios de limpieza, así como campañas de concieciación para los vecinos, tanto en Tetuan como otros barrios que se encuentran abandonados. </p>

<p>Aprovecho la ocasión para agradecer la oportunidad de compartir nuestras reflexiones sobre la ciudad, espero que no caigan en saco roto. </p>
";"08/09/2015 12";"44";"43";"1";"9";"871167025";"4104"
"1735";"Cambio en la estructura organizativa del tráfico de Madrid";"<p>La idea es quitar semáforos que nos hacen perder tiempo, a la vez que se hacen vías preferenciales para peatones, bicis y transporte público. Los vehículos privados a motor, no importa si explosión o eléctricos, deberían de no poder hacer rectas superiores a 150m, es decir que su vía como mucho cada 150m tenga una curva pronunciada, así por ejemplo en calles como la Calle de Álcala tras cruzar el puente de Ventas, no se podría seguir recto con el coche privado, si no dar la vuelta a toda la plaza e incluso haciendo que todos los coches se tengan que meter en calles de un solo carril, así se desincentivaria el uso del coche por ser mucho menos comodo. Esto habría que discutirlo largo y tendido y viendo como se puede hacer lo mejor posibles con expertos en movilidad, pero en conclusión es hacer que el coche no pueda correr por impedimentos físicos.</p>
";"08/09/2015 12";"56";"28";"28";"2";"855112173";"0"
"1737";"Mantenimiento nombre de la plaza Vazquez de Mella";"<p>Sin menospreciar la labor del concejal Zerolo creo que es un poco excesivo el quitar el nombre de una plaza que lleva años en la memoria colectiva.</p>

<p>No quita que se le haga algun tipo de homenaje en plan busto o placa conmemorativa</p>
";"08/09/2015 12";"98";"45";"53";"1";"851013094";"-367"
"1742";"Publicar los ""enchufes"" que hay en el ayuntamiento";"<p>Tras haber conocido en estos últimos meses la facilidad para obtener empleos si pertences al árbol genealógico de Carmena y demás componentes de Ahora Madrid propongo se haga pública una recopilación de todos los ""enchufados"" para que los ciudadanos madrileños podamos identificar a estos individuos con un formato dinámico y sencillo al mismo tiempo.</p>
";"08/09/2015 12";"166";"125";"41";"22";"869907887";"6325"
"1743";"Carril bus para bicis";"<p>Pienso q por ley las bicicletas deberían poder circular por los carriles bus. Dado q están situados más a la derecha y fuera de las aceras, y dado q es un carril donde los vehículos (buses, taxis y motos) deberían ir mas lentos, es el lugar perfecto. </p>
";"08/09/2015 12";"64";"37";"27";"4";"861155320";"578"
"1748";"Más control de fumadores en paradas de Cercanías";"<p>A pesar de estar prohibido en todo el recinto, la gente sigue fumando en las paradas de Cercanías ""al aire libre"" como Atocha. Más control para asegurar el cumplimiento de la ley y evitar molestias a los no fumadores, no basta con poner anuncios de megafonía de vez en cuando.</p>
";"08/09/2015 12";"51";"32";"19";"4";"862352016";"815"
"1751";"Cumplimiento de las Ordenanzas del Ayuntamiento de Madrid";"<p>Según leo, muchos de los problemas que comentan los ciudadanos ya están regulados por el Ayuntamiento de Madrid. Algunas por otros organismo. Con teclear en un buscador dichas Ordenanzas y Leyes, pueden informarse de qué gestione el Ayuntamiento y qué medidas se tomas. Le incluyo tres Ordenanzas muy útiles para atajar tres problemas: ruidos, suciedad y convivencia. </p>

<p>Ordenanza Municipal de la Policía Municipal y Gobierno de la VIlla: regula problemas de suciedad, ruido y convivencia. Es una Ordenanza extensa pero muy útil. </p>

<p>Ordenanza contra la Contaminación Acústica y Térmica: regula - obviamente, problemas generados por el ruido pero también por vibraciones de aparatos de aire acondicionado, motores de máquinas, etc.</p>

<p>Ordenanza Reguladora de la Publicidad Exterior: regula, desde los problemas generados por las octavillas en los coches hasta la colocación de cartelería por parte de los locales y negocios. </p>

<p>Ordenanza Municipal de Carga y Descarga: también hay horarios para la carga y descarga. </p>

<p> </p>

<p>Ley de Propiedad Horizontal: para los problemas de ruidos en las Comunidades de Vecinos. </p>
";"08/09/2015 12";"50";"49";"1";"5";"871709174";"4704"
"1753";"No retiren el nombre de Calle Álvaro Cunqueiro. ";"<p>En el conjunto de nombres de calles y plazas que van a ser retirados, y muy justamente dado que no es posible mantener nombres como ""Caídos de la División Azul"", ""General Yague"", etc. figura también el del escritor Álvaro Cunqueiro.</p>

<p>Solicito que no se retire ese nombre dado que este escritor, primero afiliado al partido Galleguista, estuvo afiliado a la Falange pero se salió en 1943. Es un caso semejante al de Dionisio Ridruejo. Desde ese  momento fue un escritor que no tenía nada que ver con el régimen, Si hasta se le retiró el carné de periodista...!!!</p>

<p>No es un caso como el de esos militares y próceres franquistas a los que justamente se les va retirar el nombre a las calles.</p>

<p>Reflexionen, por favor.</p>

<p> </p>

<p>José Vicente Serrano</p>
";"08/09/2015 12";"42";"34";"8";"5";"866790950";"2104"
"1754";"Votación sobre Mercado de Frutas y Verduras";"<p>El espacio del mercado de Frutas y Verduras, abandonado desde hace 10 años debería ser objeto de decisión por parte de los madrileños. Faltan instalaciones deportivas en la zona, como una piscina, canchas de baloncesto que no estén tomadas por la inmigración reconvertidas en pistas de voley. Decidir una biblioteca, que también es necesaria y espacio vecinal que es muy progre pero poco práctico en mi opinión debería ser sometida a votación.</p>
";"08/09/2015 12";"47";"39";"8";"5";"867684706";"2572"
"1755";"a ""trolear"" a otro lado";"<p>Me parece mal que haya tanta gente que proponga debates de broma o tonterías en general.</p>

<p>Nos brindan una oportunidad de participación estupenda y ¿así la usamos?</p>

<p>Luego nos quejamos de los políticos corruptos pero parece que es lo que merecemos.</p>

<p>Espero que sepamos aprovechar las buenas iniciativas del ayto y dejar de ""trolear"" en esta web</p>
";"08/09/2015 12";"67";"34";"33";"4";"856456822";"50"
"1756";"Ventajas para los madrileños";"<p>Me gustaría proponer un carnet o algún tipo de ventaja por el cual los madrileños que por cualquier motivo nos hemos visto a no residir en la capital seamos tratados de igual manera que el resto de habitantes y no seamos tratados como meros turistas con algunas tarifas como en el metro o los parquímetros.</p>
";"08/09/2015 12";"49";"16";"33";"1";"851114203";"-555"
"1757";"cuidador@s y ""cangur@s"" a domicilio con patrocinio municipal";"<p>hola, soy padre de dos niños pequeños. mi mujer y yo, por fortuna, trabajamos y nos cuesta trabajo conciliar como suele ser habitual. uno de los problemas no es ya buscar a alguien que se quede con los crios cuando trabajamos, el problema mayor es encontrar a alguien de confianza y si no lo encuentras, te fastidias y o cambias turnos, o usas dias libres o, como mi caso, te llevas los niños a tu trabajo......¿seria buena idea que desde un ayuntamiento, que debe estar cerca de los problemas de su poblacion, se crease un grupo de personas que realizasen esta tarea? el salario estaria pagado por el usuario (pagaria por servicios o una cuota) y los gastos de contratacion como alta en la seg social.....lo podia asumir la administracion o compartirlo con el precio pactado con el usuario. seria interesante ya que generaria empleo, a un coste bajo ya que lo pagaria quien lo necesita (que lo va a pagar de tdas formas y en negro) y daria seguridad ya que la administracion te puede asegurar un curriculo en la persona que va a tu casa a quedarse con tus crios. gracias.</p>
";"08/09/2015 12";"70";"31";"39";"12";"851705567";"-354"
"1759";"Cooperativas de aparcamiento";"<p>Creo que el Ayuntamiento debería ofrecer apoyo administrativo, que no dinero, para aquellos que quisieran formar cooperativas para construir aparcamientos soterrados en sus barrios. Hasta ahora, la gestión es privada o del propio Ayto y debería estimular la creación de grupos de vecinos que se agruparan para construir y gestionar aparcamientos que liberaran la vía pública de tráfico.</p>
";"08/09/2015 12";"46";"36";"10";"1";"866274507";"2034"
"1760";"Peatonalizar la calle Carretas";"<p>La calle Carretas, en pleno corazón de nuestra villa y corte, es un espacio casi sin tráfico e invadida por miles de turistas y madrileños. Sin entrar en lo deteriorada y sucia que está, es preciso que se peatonalice y se convierta en una calle similar a sus cercanas Preciados, Arenal o Montera. </p>
";"08/09/2015 12";"261";"224";"37";"5";"874693764";"16049"
"1761";"Cacas de perros";"<p>En Madrid pasear por las aceras es imposible si quieres mantener tus zapatos limpios. Hay zonas (distrito Latina) que están llenas de excrementos de perros. Es un problema para para todos, pero especialmente para los ciegos que se comen literalmente y para los niños que si te descuidas las cogen. </p>

<p>Propongo mayor vigilancia y multas. Es como cuando la gente fumaba en el metro, no se dejó de hacer hasta que se empezaron a poner multas.</p>
";"08/09/2015 12";"207";"193";"14";"20";"876296143";"16689"
"1762";"Adelantar el horario de limpieza de calles en Lavapiés";"<p>Todos conocemos los problemas de limpieza en el barrio y en el distrito. También es cierto que muchos vecinos percibimos ya mayores esfuerzos municipales y algunas leves mejoras en el tema de la limpieza. Sin embargo, aunque se ven más barrenderos, éstos empiezan a limpiar a media mañana, cuando muchos vecinos ya llevamos horas recorriendo las calles sucias. Mi propuesta es adelantar la hora de paso de los trabajadores de limpieza viaria en Lavapiés, barrio que por sus caracterísiticas sufre mucha afluencia de gente y botellón por las noches, para evitar en la medida de lo posible la estampa deprimente con que muchos nos encontramos cada mañana temprano al ir al trabajo y para evitar que nuestros niños tengan que hacer el recorrido diario hacia al cole caminando entre la suciedad, los orines y la basura de la noche anterior, lo que es del todo intolerable. </p>
";"08/09/2015 12";"33";"25";"8";"1";"864559204";"1287"
"1763";"ELIMINEN LA ZONA AZUL Y VERDE";"<p>Pagar por aparcar en la calle es la mayor estafa conocida desde un hombre vendió la Torre Eiffel en Nueva York.</p>
";"08/09/2015 12";"110";"45";"65";"7";"849895014";"-818"
"1764";"Metro 24 horas el sábado";"<p>Si en Barcelona funciona, ¿por qué no en la capital? Mucha gente lo usa y sería de gran ayuda para esa gente que renuncia a no salir un sábado por la noche/domingo de madrugada, por no esperar a que a las 6:00/15 abra el suburbano.</p>
";"08/09/2015 12";"350";"307";"43";"8";"876461792";"23156"
"1765";"Alumbrado público y arbolado";"<p>Es frecuente que las luces de la vía pública se encuentren entre el ramaje de árboles, con lo que se pierde efectividad y gasto inútil de energía eléctrica, ya que la luz no llega al lugar proyectado.  Sería conveniente tenerlo en cuenta en nuevas instalaciones y en lo existente, proceder al recorte de ramas y a acortar la altura de luminarias para separarlos</p>
";"08/09/2015 12";"54";"52";"2";"1";"871577968";"4814"
"1766";"Conectar carril bici con el sur";"<p>Me gustaría que se llegara a un acuerdo con el resto de ayuntamientos colindantes, en especial los del sur para unir el carril bici entre todos los municipios y que tengamos una red decente y conectada para movernos entre las distintas ciudades.</p>
";"08/09/2015 12";"101";"90";"11";"3";"872151321";"7039"
"1768";"ESPACIOS MUNICIPALES GRATUITOS PARA EMPRENDEDORES";"<p>El Ayuntamiento de Madrid,   de cara a poder ayudar a 'emprender',  cosa que ya de por sí es bastante difícil en este país;  pues simplemente por tener que hacerse Autónomo obligatoriamente tienes que pagar al año más de 4.000;  no como en países tan cercanos como Portugal o Francia,  que es gratuito hasta que no se llega a una facturación mínima;  podía poner tantísimos espacios como tiene en todos los distritos,  pequeños espacios de trabajo,  una simple mesa con su silla,  y unos servicios mínimos como Internet,  donde pudiéramos estar al menos los 2 primeros años de intentar iniciar una actividad,  sobre todo,  y siendo egoista,  acordándose de gente que como yo tenemos 50 años,  y es totalmente imposible intentar siquiera buscar un trabajo,   con familia normalmente,  y que nos es imposible sacar adelante simplemente el pago de los Autónomos.  Esos espacios,  que no quiero usar el término anglosajón,  podían ser de 'silla caliente' es decir,  que si en un centro caben 200 personas,   con total probabilidad se podría dar espacio para 400 personas;  con alguna sala común más grande para poder dar conferencias o charlas;  o simplemente reuniones.</p>
";"08/09/2015 12";"73";"60";"13";"1";"868978128";"3863"
"1769";"Parada BUS Centro Proteccion Animal (CPA) Ayuntamiento Madrid";"<p>Solicito parada de BUS para el Centro de Proteccion de Animales del Ayuntamiento de Madrid sito en la Crrtra. Barrio de La Fortuna. </p>

<p>Necesario para voluntarios, trabajadores, visitantes, adoptantes y....ciudadanos en definitiva. </p>

<p>Actualmente la parada más cercana obliga a andar durante 5 minutos por el arcen de la carretera o cruzar rotonda de salida a M-40.</p>

<p>Gracias por apoyarlo!!</p>
";"08/09/2015 12";"96";"93";"3";"5";"874221948";"8718"
"1770";"Billete compartido de bus, metro y tren";"<p>Madrid es la única capital europea que no tiene aún un billete compartido de transporte público. Es decir, si alguien quiere viajar de San Blas a Villaverde tiene que pagar una vez por el metro y otra por el bus. Dos billetes separados o consumir dos opciones en el caso de los de 10 viajes, lo que supone entre ida y vuelta casi 6 por persona. Pero si fuera compartido, no llegaría a 3. El modelo actual desalienta el uso del transporte público porque sale más caro que ir en coche.</p>

<p>Con un billete compartido se paga por tiempo, normalmente dos horas, y permite usar todo el transporte público (bus, metro y cercanías).</p>

<p>Billete compartido YA.</p>
";"08/09/2015 12";"368";"361";"7";"1";"880246323";"34726"
"1771";"Apertura de colegios públicos para ser utilizados como salas de estudio.";"<p>¿Sería posible utilizar como salas de estudio los colegios públicos una vez que se acabe la jornada escolar? En el Centro Integral de Arganzuela existe una sala de estudio utilizada por universitarios pero también por niños de Primaria que hacen sus deberes en dicha sala. En aquellos barrios donde no existe biblioteca (a las bibliotecas ya se puede hacer por internet y leer los libros de la biblioteca en el propio ordenador) se podría acondicionar unas salas en los colegios de primaria para que los universitarios de la zona pudiesen estudiar allí. Unicamente, salas dedicadas al estudio. Y por supuesto, también permitir la entrada a los estudiantes de Primaria que quieran completar sus deberes allí. El colegio Menéndez Pelayo en la calle Méndez Alvaro sería una buena opción para esa zona. </p>
";"08/09/2015 12";"121";"104";"17";"2";"871936909";"7477"
"1772";"Billete compartido de bus, metro y tren";"<p>Madrid es la única capital europea que no tiene aún un billete compartido de transporte público. Es decir, si alguien quiere viajar de San Blas a Villaverde tiene que pagar una vez por el metro y otra por el bus. Dos billetes separados o consumir dos opciones en el caso de los de 10 viajes, lo que supone entre ida y vuelta casi 6 por persona. Pero si fuera compartido, no llegaría a 3. El modelo actual desalienta el uso del transporte público porque sale más caro que ir en coche.</p>

<p>Con un billete compartido se paga por tiempo, normalmente dos horas, y permite usar todo el transporte público (bus, metro y cercanías).</p>

<p>Billete compartido YA.</p>
";"08/09/2015 12";"3471";"3423";"48";"69";"890055275";"332832"
"1776";"Prohibición vehiculos diesel dentro del anillo M30";"<p>El titulo lo dice todo, incluyendo taxistas, repartidores y demas. O todos o ninguno.</p>

<p>Los gasolina limitaria a los posteriores a Euro3. Hibridos, bifuel y demás que sean bienvenidos.</p>
";"08/09/2015 12";"116";"31";"85";"6";"850543565";"-1443"
"1777";"Volumen de las sirenas";"<p>En Madrid el volumen de las sirenas de los coches de policía, ambulancias y bomberos es muy superior al necesario para ser efectivo, y esto produce una molestia a los ciudadanos que en algunos casos se convierte en un grave problema cuando sus casas están en un lugar cercano al paso de estos vehículos.</p>

<p>El problema es especialmente grave por las noches de verano, cuando no hay casi tráfico y se despierta a miles de personas que duermen con las ventanas abiertas. Influyendo negativamente en su productividad laboral al día siguiente.</p>

<p>La solución es tan simple como efectiva, bajar el volumen de las sirenas, como en muchas otras ciudades en Europa. ¿Por qué no hacerlo?</p>
";"08/09/2015 12";"63";"44";"19";"9";"865373510";"1746"
"1779";"Aparcamiento gratuito para coches eléctricos";"<p>Creo que hay fomentar el uso de coches eléctricos así que podría legislarse que las zonas azul y verde fueran completamente gratuitas para este tipo de coches (o incluso para los híbridos enchufables, ""plug-in hybrid"", que también pueden prescindir de la gasolina completamente).</p>

<p>Son coches caros, pero con esta medida, la gente puede empezar a pensar que se pueden amortizar o que empiece a merecer la pena.</p>
";"08/09/2015 12";"89";"64";"25";"5";"866864940";"2804"
"1782";"Multar por uso indebido de aceras-bici";"<p>Debería empezar a sancionarse a todos los comercios y bares que sitúan cubos de basura, terrazas, etc en las aceras bici. Asimismo una campaña de concienciación del tipo ""no es un carril para carros de la compra"" no vendría mal. Asimismo debe mirarse también las sanciones que comenten los ciclistas en dichas aceras.</p>
";"08/09/2015 12";"129";"115";"14";"4";"873216633";"9003"
"1783";"Contenedores de Basura Rotativos";"<p>Creo que se debería replantear la actual ubicación de los contenedores de basuras, ya que durante decadas han estado en la misma ubicación con los incovenientes de ruidos, olores, riesgo bandalismo, etc  que ello conlleva. Se debería establecer un cierto periodo de tiempo (1 año, 2 años, 4 años, ...)  tras el cuál se reubicarian o desplazarian para que no seamos siempre los mismos los que sufrimos los inconvenientes. Espero replanteen el sistema y de paso a uno más justo.</p>
";"08/09/2015 12";"36";"22";"14";"4";"861165711";"488"
"1784";"Disminución efectivos policiales";"<p>No es normal que si un anciano sufre un mareo en una plaza, acudan a estas dos monovolumenes de la policia nacional, 2 motos de la municipal y otros tres monovolumenes de la policia municipal. Se formó un circo muy curioso.</p>

<p>Sobran efectivos, sin más.</p>

<p>Con ello se ahorraria en impuestos y tendría que pagar menos a final de mes.</p>
";"08/09/2015 12";"61";"26";"35";"8";"851487887";"-383"
"1785";"Uso edificios públicos";"<p>¿por qué alquilar edificios si hay edificios municipales vacios?</p>
";"08/09/2015 12";"103";"97";"6";"3";"873804993";"8569"
"1788";"Contenedores de aceite en la vía pública";"Reciclar el aceite doméstico no es nada fácil ni cómodo en Madrid. Es claramente insuficiente los 16 puntos limpios fijos y los 21 puntos limpios móviles. Para los que vivimos en la capital, que el ayuntamiento nos mande a las afueras a un punto limpio si uno no tiene coche o no se va a molestar en llevarlo y los puntos limpios móviles, están muy bien pero para 2 horas que están a la semana en cada distrito y a horas que no siempre se está en casa puede hacer que el reciclaje de este aceite sea imposible. Lo que no se entiende como a estas alturas Madrid no tiene contenedores para facilitar el reciclaje de aceite a los vecinos como tienen muchos de los grandes municipios de la zona.

Cada litro tirado contamina 1000 litros de agua. También tiene otras consecuencias, como el coste de 2,5 reciclar cada litro que se tira por el desagüe que llega a las depuradoras según varios estudios que he visto. También se reduciría el coste del ayuntamiento en mantener limpio el sistema de alcantarillado y los ciudadanos podrían evitar gastarse un dineral en mantener o desatascar sus tuberías cuando las bolas de aceite se forman en sus casas y edificios aumentando los malos olores.

Si todo ese aceite se reciclara, se podría reducir un porcentaje el concepto de depuración en las facturas de agua que pagamos todos los madrileños. Por lo que la factura del agua no saldría más barata tanto a los que somos de Madrid capital como al resto de ciudadanos de la región.

Para que se haga una recogida óptima desde el primer momento del aceite doméstico y mucha gente más pueda empezar a reciclar se necesitarían unos 10 contenedores mínimo por cada distrito para ponerlo fácil y cómodo, por que esto es lo que necesita la gente si se pretende que se recicle el aceite doméstico de forma masiva, ponerlo fácil, cómodo y sencillo. contenedores que permitan llevar el aceite con disponibilidad 24 horas al día y poder acceder a cualquiera de ellos a menos de 10 minutos andando desde cualquier vivienda del municipio (y evitando usar el coche solo para llevar el aceite).

Llevo años pidiéndole al ayuntamiento que pongan estos contenedores obteniendo siempre excusas.";"08/09/2015 12";"1141";"1075";"66";"30";"883665913";"95063"
"1789";"licencia perros";"<p>Considerando el gran número de perros que hay en Madrid, se podría establecer una licencia para los dueños de perros, que incluiría el pago anual de un cuota por posesión y un número municipal por cada mascota, así como la firma de una Carta de Buenas Prácticas para los Dueños de Perros (como por ejemplo, recoger las cacas, siempre ir con correa en los parques y jardines infantiles en los horarios especificados, etc....) </p>
";"08/09/2015 12";"106";"53";"53";"17";"858077853";"0"
"1790";"por una fruta y verdura de calidad para enfermos ,niños,abuelos y todos.";"<p>propongo un programa del ayuntamiento par crear mercadillos,itinerantes,algun dia a la semana etc.tambien locales,como sucede en algunos pueblos,donde se puedan tener productos de calidad traidos al dia a a la capital,fruta y verdura de calidad y que sana.mas tarde hariamos un programa mas amplio.en principio dejariamos que trajeran productos de este tipo cualquier productor.se le haria un carnet ,y asi sabriamos quien lo trae y de donde.el caso es que comamos salud y ayudar a muchos que estan deseando producir este tipo de alimentos,y que no pase como ahora,que solo pueden comerlo,por su precio ,gente con dinero.cuando uno come estos productos ,se da cuenta de lo bien que sientan.ya esta bien de comer verdura mala por ser pobres.salud.</p>
";"08/09/2015 12";"26";"14";"12";"0";"856960018";"107"
"1791";"Legalización del consumo público de alcohol o drogas";"<p>Llegó la hora de demostrar que somos progres de verdad. Se acabaron las convenciones pequeñoburguesas y el absurdo respeto al descanso de los vecinos o el uso exclusivo de los parques por los infantes.</p>

<p>Legalicemos desde ya el consumo de alcohol y drogas (blandas?) en los espacios públicos madrileños, e incluso pongamos paneles informativos de cómo hacer correctamente un porro o reciclar los vidrios usados.</p>

<p>Gracias.</p>
";"08/09/2015 12";"129";"37";"92";"0";"850347411";"-1577"
"1792";"COORDINACION PARA APOYAR A CHAVALES DE 16 AÑOS";"<p>Me sorprende que los servicios sociales de ayuda al menor no puedan conseguir el apoyo de los centros deportivos del ayuntamiento para matricular preferentemente a los menores que estan en guardia o custodia o tutelados. El deporte les seria de mucha ayuda y a los 16 años estan en una edad en que es necesario todo el apoyo y aun es posible que recuperen el tiempo perdido sin echarse a perder.</p>

<p>Se que es lo que llevan intentando hace tiempo los servicios sociales, pero no parece que lo hayan conseguido.</p>

<p>Lo mismo para el resto de servicios que ofrece el Ayuntamiento o la CAM.</p>
";"08/09/2015 12";"37";"23";"14";"1";"861355565";"559"
"1793";"Actitud policial";"<p>Ruego enseñen a conducir mejor a la policia pagada por todos nosotros. Estoy harto de ver como omiten la ley y circulan y estaciones como y cuando quieren. Sobretodo hay dos que todas las noches dejan su bonito monovolumen rotulado de policia municipal en la esquina de ortega y gasset con diaz porlier entre el paso de cebra y el cruze. Por no hablar de los que aparcan en alcala con rufino blanco dificultando el giro o los policias de la secreta que todas las tardes se quedan de chachara en un rincon de la plaza de manuel becerra.</p>

<p> </p>
";"08/09/2015 12";"47";"35";"12";"2";"865572559";"1712"
"1801";"limpieza de graffitis";"<p>Buenos dias, Llevamos mas de año demostrando como las nuevas tecnologias sirven para algo. En este caso, hemos presentado a todas las empresas responsables de la limpieza viaria un nuevo revestimiento antigraffi no tóxico, no contaminante y donde la eliminación reiterada de graffitis se realiza solo con agua. Aplicado sobre cualquier elemento lo protege de los rayos UV, del agua, corrosión, etc. Estamos convencidos que mediante el uso de esta nueva tecnologia junto con una iniciativa para realizar un censo de espacios públicos para poder realizar graffitis se puede conseguir mejorar de forma notable la imagen de la ciudad y de forma complementaria, conseguir ahorrar del orden del 80% en las partidas correspondientes a la limpieza de graffitis. El problema: parece que no interesa. Que es preferible adoptar soluciones que esta claro que no funcionan (como el repintado) y que generan unos costes anuales muy importantes a todos los madrileños.</p>

<p>Acepto sugerencias porque es desesperante. </p>

<p>Muchas gracias</p>
";"08/09/2015 12";"155";"136";"19";"8";"873623330";"10265"
"1802";"Despilfarro y molestias camiones de agua (Medio ambiente)";"<p>Hola,</p>

<p> </p>

<p>En primer lugar queria comentar que mandé un mensaje via Facebook al perfil de la nueva alcaldesa y parece que el tema mejoro, pero no duro más de un mes. Imagino que se les comunicaria algo a los operarios pero despues de un tiempo hacen lo que quieren.</p>

<p>En segundo lugar gracias por dejarnos expresar por este medio, espero que sea más de utilidad que otros que tiene la administración. He rellenado en más de tres ocasiones quejas en esta página y siento que se rien de uno porque dicen mentiras y no arreglan nada:.www-s.munimadrid.es/</p>

<p>Quería plantear una queja que llevo años planteando. Se trata de un punto enfrente de mi casa donde viene a cargar agua los camiones cisterna.</p>

<p>Me quería quejar de que acuden en masa a cualquiera hora de la madrugada para cargar agua dejando los motores encendidos, a veces hasta 7 camiones en fila en una zona residencia con la consecuente molestia, que si dejas la ventana abierta no puedes ni dormir el escandalo que arman. El punto se encuentra en la calle Isabel Clara Eugenia esquina con Alcalde Conde de Mayalde.</p>

<p>Creo que esta no es una zona donde estos camiones deben estar, justo enfrente de viviendas y entre dos parques públicos...</p>

<p>Por otro lado los camiones dicen que no tiene agua potable, claro que es agua potable y si no que se la trate como al resto y lo sería. Me parece un despilfarro ir regando calles que a veces lo que causan es una molestia para ciudadanos.No solo por el agua sino por el tráfico, ruido... Además del coste que tiene para el ciudadano, veo estos camiones con tres operarios cada uno. </p>

<p>Quiza hay zonas en el centro que si lo necesitan, pero la mayoria de barrios lo dudo.. Entiendo que estos contratos son muy buenos para las empresas FCC y compañia que hacen el mantenimiento pero no creo que sean necesarios.</p>

<p>Por favor podría eliminar este punto de carga de agua y recapacitar del uso que hacen del agua potable como los recursos ecónomicos que tiene el ayuntamiento gracias a los impuestos de todos los ciudadanos?</p>

<p> </p>

<p>Muchas gracias,</p>

<p> </p>

<p> </p>
";"08/09/2015 12";"18";"9";"9";"1";"855408757";"0"
"1803";"Zona verde en la Ventilla";"<p>No entendemos que exista zona de estacionamiento vigilado en la Ventilla. Es una zona muy alejada del centro de Madrid donde no existen problemas de aparacamiento y donde sabemos que el servicio es deficitario pues no hay practicamente coches. Toda la zona es verde por lo que las pocas empresas de la zona no tienen espacios para aparcar.</p>
";"08/09/2015 13";"19";"12";"7";"1";"859967242";"315"
"1804";"Camas insuficientes en los hospitales de Madrid";"<p>Estamos en urgencias de maternidad de La Paz. Las mamás se tienen que ir a casa porque no hay camas suficientes. Soluciones a la sanidad publica ya!!</p>

<p> </p>
";"08/09/2015 13";"27";"21";"6";"1";"864636279";"1166"
"1806";"Camas insuficientes en los hospitales de Madrid";"<p>Estamos en urgencias de maternidad de La Paz. Las mamás se tienen que ir a casa porque no hay camas suficientes. Soluciones a la sanidad publica ya!!</p>

<p> </p>
";"08/09/2015 13";"60";"52";"8";"4";"869768505";"3813"
"1807";" PROBLEMAS PARA APARCAR EN VALDEZARZA";"<p>VALDEZARZA DISTRITO DE MONCLOA-ARAVACA NO SE PUEDE APARCAR.</p>

<p>EL PROBLEMA VIENE QUE LOS BARRIOS DE ALREDEDOR TIENEN ZONA AZUL O VERDE</p>

<p>POR FAVOR QUITEN LAS ZONAS AZULES-VERDES Y SI NO ES POSIBLE  ADAPTEN EL DISTRITO DE VALDEZARZA A ZONA AZUL-VERDE </p>
";"08/09/2015 13";"23";"9";"14";"1";"852729313";"-195"
"1809";"Arreglar fuentes de parques o cerrarlas";"<p>Es habitual que las fuentes de los parques incluso en parques infantiles esten inoperativas y cerradas, si la media es para ahorrar agua, mantenimiento, etc. sería mejor cerrarlas, cosa que no comparto.</p>

<p>¿No se pueden poner grifos anti-vandalos y realizar un mantenimiento adecuado?</p>

<p>Se necesitan fuentes operativas y funcionales especialmente en los parques</p>

<p>Gracias</p>
";"08/09/2015 13";"38";"33";"5";"0";"868004400";"2431"
"1810";"Levantar la prohibición de jugar deportes en los jardines de MadridRío";"<p>Hace unas semanas me dió por llevar una red de badminton a MadridRio y jugar un poco allí con mis amigos.</p>

<p>Me quedé anonadado cuando, ni corta ni perezosa, la policía municipal viene y nos obliga a dejar de jugar, con la excusa de ""la ordenanza"".</p>

<p>Para empezar, ¿dónde están estas normas de ""la ordenanza"" publicadas? Por más que busco, no las encuentro.</p>

<p>Y para terminar, ¿qué tipo de ciudad es esta que no fomenta el deporte entre sus ciudadanos? Lo que quieren es lo de siempre, que pasemos por caja, usando los polideportivos que nos cobran mínimo 30 euros la hora. Si a mí me apetece disfrutar del sol en lugar de encajonarme en una pista cubierta como un ratón, debería estar permitido.</p>
";"08/09/2015 13";"61";"24";"37";"8";"851115467";"-511"
"1812";"Estaciones de BiciMad vacías y falta de información.";"<p>BiciMad ha sido un gran avance en la movilidad sostenible de nuestra ciudad. Todos deberíamos estar de acuerdo en esto.</p>

<p>No sé si se trata de un problema de exceso de usuarios, falta de bicis, vandalismo, o todo ello combinado; pero desde comienzos del mes de septiembre, observo buena parte de las estaciones de la zona centro prácticamente vacías, o con las pocas bicis ancladas en ellas bloqueadas.</p>

<p>Asimismo, los perfiles de BiciMad en las redes sociales no dan información suficiente sobre qué es lo que está pasando. La aplicación para smartphones no muestra información útil sobre las bicis disponibles en cada estación, puesto que únicamente informa sobre las bicis ancladas en ellas, estén bloqueadas o no. Además no permite reservar bicicletas.</p>

<p>Quiero entender que el precio que pagamos por el abono de BiciMad (15 anuales) debería garantizarnos un correcto funcionamiento del servicio, puesto que ya pagamos por cada viaje que realizamos. </p>

<p>Estos problemas reducen drásticamente la eficacia de un sistema relativamente nuevo que espero continúe en expansión.</p>

<p>Saludos.</p>
";"08/09/2015 13";"84";"75";"9";"8";"871815804";"5892"
"1813";"Proteger el paisaje urbano: Ordenanza reguladora de publicidad exterior";"<p>Reducir la contaminación visual de Madrid haciendo cumplir la ordenanza reguladora de publicidad exterior, prohibiendo las pantallas de led en la calle y exigiendo a las compañías telefónicas una correcta instalación del cableado.</p>
";"08/09/2015 13";"63";"54";"9";"0";"869614844";"3857"
"1814";"No diferenciar por sexos en bares y locales nocturnos";"<p>Muchos establecimientos de ocio nocturno cobran entrada a un sexo y no al otro. Es denigrante utilizar a un sexo como reclamo del otro con fines exclusivamente comerciales por parte del establecimiento. Genera una situación de injusticia para una de las partes y de objetivización para la otra.</p>

<p>Propongo que se impida cobrar entrada creando diferencias por sexos, pues así Madrid será una ciudad más justa y que avanza hacia la equidad y se aleja de diferenciar por género. </p>
";"08/09/2015 13";"260";"222";"38";"20";"874917156";"15710"
"1815";"Proteger el paisaje urbano: Ordenanza reguladora de publicidad exterior";"<p>Reducir la contaminación visual de Madrid haciendo cumplir la ordenanza reguladora de publicidad exterior, prohibiendo las pantallas de led en la calle y exigiendo a las compañías telefónicas una correcta instalación del cableado.</p>
";"08/09/2015 13";"77";"70";"7";"0";"871806799";"5727"
"1818";"guetto en carracedo, latina. 28024-madrid.";"<p>Mientras brillantes funcionarios, llenos de Oposiciones ""ganadas"" a dedo, ocupan sus sillones en la alcaldía, -generalmente con sueldos de escándalo, comparativamente, respecto de los sueldos y horarios de trabajo actuales del mercado de trabajo,-una calle de esa alcaldía, ""virtual"", Carracedo, Carracedo 21, 23, y 25, carece de Accesos a los Servicios Públicos de ambulancias, bomberos, coches mortuorios, policía, ...¿ queda alguien más por ahí? </p>

<p>Después de haber sido aprobada una resolución del Ayuntamiento de Madrid, de fechas de Diciembre de 2011, en la que la Corporación acordó estudiar una solución al problema, un rosario de ¿""Informes""? departamentales, a los que nunca se me dió acceso, han coronado como resultado, que la calle, como tal, solo exista a efectos tributarios, y solo sirva para que los aquí residentes paguemos: impuestos de personas físicas, pago de IBIS, pago de impuestos por otros servicios públicos, como agua, luz, teléfono, ...etc, etc, es decir, para pagar de nóminas de brillantes funcionarios, que se dedican más a la ""industria del partido"" que a su verdadero Trabajo( si es que, como tal existiera?)</p>

<p>Y es que, los problemas sencillos requieren soluciones sencillas, ajenos a brillantes ""informes"" de unos y de otros, que, a la postre, no solo dilatan la solución al problema planteado, sino que interfieren los pasos a cualquier posible solución, y convierten a los ciudadanos en víctimas, y paganos, de un rosario de de decisiones que se bloquean unas a otras ( sobran departamentos, llenos de empleados de partidos( partitocracia) y funcionarios, cuyas decisiones bloquean unas a otras, y al final, ...la casa por barrer, o sea, para la legislatura siguiente).</p>

<p>El caso que nos ocupa trata de una comunidad de Propietarios que tiene un jardinito en la calle de Carracedo 27, que impide el acceso a Servicios rodados de Emergencia y Protección Civil, y convierte ese espacio de terreno en un espacio ""privado"", lleno de árboles, al resto de la calle ( ¿dónde está el Departamento de Patrimonio Verde, y a qué se dedica, para tolerar esto?, dónde estan la Policia, que no lo ve, donde los Bomberos, que tampoco? ... quién manda aquí??? qué desgobierno es este???</p>

<p>Pero el guetto en Carracedo lo corona otra Comunidad, que disponiendo de una servidumbre de paso para un rosario de bloques, desde el nº 7 al nº 19, impide el paso a los bloques de carracedo 21, 23, 25, convirtiendo esa servidumbre de paso,( se trata de una calle de jardines), en otra ""propiedad privada"", con lo que esta desdichada ""calle"" se convierte en un botón de muestra del desgobierno municipal de los hasta ahora gobiernos( desgobiernos) de Botella, Gallardón, etc, tan brillantes y tan adelantados, para llegar a fabricar una deeeeeuda descomunal de miles y miles de millones de euros ( deuda perpetua) que pesa sobre nuestras espaldas municipales.</p>

<p>El tema municipal es muy sencillo de resolver. Solo hay que poner manos a la obra y con el ordenamiento jurídico vigente en nuestras manos resolver estas ilegalidades, cargadas de ""derechos históricos"", en 24 Horas, de un plumazo.</p>

<p>Con ello se acabaría la necesidad de hacer ""Informes, para resolver este problema"", y se podría prescindir de estos brillantes funcionarios,- locuaces empleados de partido- que tanto dinero nos cuesta a nuestros bolsillos, a todos los ciudadanos, a todos los votantes y a todos los no votantes.</p>

<p>Gracias por esta Ventana de Aire Fresco a toda la Ciudadanía. Ojalá se traduzca en Resultados Operativos.</p>

<p>Ojo, no confundamos la democracia con la industria del voto, y no llenemos de funcionarios, carentes de operatividad, los departamentos de nuestras instituciones.</p>

<p>Saludos   </p>

<p> </p>

<p> </p>
";"08/09/2015 13";"20";"7";"13";"0";"852736746";"-209"
"1820";"Unión peatonal y ciclista de Villaverde y Leganés bajo A42 ";"<p>Son muchos los vecinos del barrio de San Andrés, en Villaverde, que acuden al centro comercial Parque Sur a pie. Para ello deben pasar bajo la A42 con el riesgo que implicada para la seguridad personal. </p>
";"08/09/2015 13";"30";"23";"7";"3";"864875385";"1226"
"1822";"Un madrileño, un ave";"<p>Propongo que a cada madrileño se le entregue un huevo de ave cuando cumpla 18 años. Deberá responsabilizarse de cuidarlo hasta que se haga adulto. De esta manera, haremos que los jóvenes se responsabilicen y den un paso adelante en su madurez a la vez que aumentamos la fauna de nuestra región.

La elección del ave que se entregaría queda a disposición de un Comité Ciudadano que de manera asamblearia decidiría cuales son las especies óptimas.</p>
";"08/09/2015 13";"92";"22";"70";"10";"851230372";"-1147"
"1829";"Pueden los policias de madrid aparcar mal?";"<p>¿Pues eso las normas no deberían ser para todos especialmente si la urgencia es tomarse unos cafes todos los días en el mismo sitio?</p>
";"08/09/2015 13";"65";"54";"11";"2";"869108557";"3572"
"1830";"Referendum para acoger inmigrantes";"<p>Ya que cuando me cobran impuestos por todo nadie me pregunta y no recibo paga ni piso gratis me gustaria que al menos me preguntaran mi opinion acerca de acoger a los inmigrantes con mis impuestos, ahora que estan tan de moda los referendums.</p>

<p> </p>
";"08/09/2015 13";"167";"102";"65";"35";"865787163";"2259"
"1833";"Santiago Bernabeu";"<p>Los madridistas a votar a favor y los No madridistas en contra. Que os parece si damos permiso para la ampliación del Bernabeu?</p>

<p> </p>
";"08/09/2015 13";"93";"43";"50";"2";"851685198";"-323"
"1836";"Gastar menos = más renta para el ciudadano";"<p>Propongo que el <u>Ayuntamiento de Madrid disminuya los impuestos para que nosotros seamos los decisores de cómo gastar nuestro dinero </u>. <strong>Si el Ayuntamiento</strong> <strong>disminuyera anualmente un 5% su presupuesto / gasto</strong>, significaría que bajarían los impuestos un 5%, por ende, <strong>los contribuyentes tendría un 5% más de renta disponible</strong> para gastarlo (o ahorralo) en lo que cada ciudadano estime conveniente, según su criterio y necesidad. </p>
";"08/09/2015 13";"55";"32";"23";"0";"861047751";"523"
"1837";"dotaciones en la travesía de Santoña";"<p>Esta plaza (aunque se llama travesía) estuvo engalanada con setos y otras ornamentaciones hasta que de la noche a la mañana los arrancaron los jardineros y hasta hoy. Ahora estos espacios vacios son unos cagaderos de perros que además pasan días sin ser limpiados. Además existe todavía una torre de baja tensión que aprovechan los vecinos para dejar las basuras. Cosa que se tenía que vigilar y penalizar.</p>
";"08/09/2015 13";"12";"7";"5";"0";"857251934";"116"
"1842";"Devolver la fiesta de percusión al Retiro que fue prohibida por Gallardón";"<p>Creo que no sería mucho pedir que se pudiera celebrar la tradicional quedada de tambores y percusión en el estanque del Retiro como se venía haciendo si mayores consecuencias que un pacífico intercambio cultural/musical entre todos los amantes de la música.</p>

<p>Por favor que se derogue la normativa que prohibe tocar percusión en los parques, creo que el sentido común deberia ser el límite a la percusíon no una normativa municipal.</p>

<p>Gracias por vuestro apoyo.</p>
";"08/09/2015 13";"123";"67";"56";"21";"862124834";"599"
"1847";"Mejora de las instalaciones y dotación para los centros educativos públicos";"<p>Las competencias en educación las tiene la Comunidad de Madrid pero dado el estado de abandono en que la Comunidad tiene sumidos a muchos colegios e insitutos públicos no estaría de más que el Ayuntamiento de Madrid colabore con los centros educativos públicos de nuestra ciudad y les ayude a mejorar sus instalaciones y su dotación de recursos materiales (bibliotecas, ordenadores, equipamiento deportivo, oferta de actividades extraescolares, talleres, escuelas de padres etc.) Tenemos que ayudar a que la oferta educativa pública y de proximidad sea la mejor posible y la más atractiva y toda la ciudad se beneficiará, ya que así se reducirá la movilidad de los escolares en rutas y en vehículo privado lo que genera atascos y contaminación.</p>
";"08/09/2015 13";"60";"53";"7";"1";"870234544";"4063"
"1848";"Eliminar los nombres de las calles de los republicanos de la Guerra Civil";"<p>Un asesino es siempre un asesino tenga la motivación que tenga y sus actos no deben ser tolerados. El derecho a la vida y la no violencia son básicos en una sociedad democrática. Por ello creo que un Ayuntamiento tan importante como el de Madrid debe tomar partido para que no se les homenajee como si fueran héroes. Pero estoy hablando de TODOS los asesinos. Incluidos aquellos de la República que se cobraron muchas vidas. Eso es un hecho. Veo al ayuntamiento muy centrado en eliminar las calles de aquellos afines al franquismo y en general en la población estamos de acuerdo con esto. Pero que terminen el trabajo y que no sustituyan a unos asesinos por otros.</p>

<p>Por ello pido que el excelentísimo Ayuntamiento de Madrid termine la tarea que comenzó o me veré obligado a pensar que apoyan o al menos no condenan estos actos según la ideología que tenga la mano ejecutora. Su actuación hasta ahora no solo no se basa en principios democráticos sino que carece de toda ética al dar reconocimiento a asesinos como Santiago Carrillo.</p>

<p> </p>

<p>Acabemos con esto de una vez!!</p>
";"08/09/2015 13";"225";"130";"95";"40";"865199372";"2022"
"1850";"Que vuelvan las ayudas de alquiler para jóvenes";"<p>La mayoría de jóvenes que encontramos trabajo son de un salario mínimo e irrisorio, porfavor es necesario tener una ayuda en el alquiler para poder vivir dignamente, yo pienso que al fomentar la emancipación da más pie a que la gente consuma más ,se paguen mas impuestos(luz,agua,tasa basuras...) por mas que busco algo negativo a esta ayuda no logro encontrar ninguna, pero es mi humilde opinión.</p>

<p>Gracias por leerme.</p>
";"08/09/2015 13";"96";"73";"23";"15";"868765995";"3802"
"1852";"Reforzar la seguridad del nucleo de cercanias";"<p>Propongo instalar arcos de seguridad para evitar otros atentados, como los de atocha o los de el tren belga, asícomo poner mas personal de seguridad dentro de los trenes. Tambien propongo para financiar esta propuesta rebajar el personal interventor, pues todo el mundo pagaria su billete al pasar por los arcos sin escapatoria alguna.</p>
";"08/09/2015 13";"39";"22";"17";"0";"859476697";"282"
"1854";"Limpieza Centro de Madrid";"<p>Llevo toda la vida viviendo en Madrid en pleno centro y trabajo en la zona de Chueca. Desde el mes de julio he notado que el nivel de basura es insoportable. Entre las 8:00 y las 9:00 de la mañana era habitual ver regar las calles y a barrenderos pero en estos últimos dos meses no hay ninguno y la cantidad de bolsas, botellas de refrescos, colillas, papeles...que se ve en todo el trayecto desde mi casa al trabajo es increíble. Algo ha pasado de junio hasta ahora para que la suciedad haya aumentado tanto. En el último año las cosas habían empeorado pero en solo dos meses esto es insufrible.</p>
";"08/09/2015 13";"118";"108";"10";"5";"873821893";"8969"
"1856";"Carmena: CES + BienestarColoniasFelinas AHORA MADRID!!";"<p>Madrid necesita una gestión ética de sus colonias felinas, una gestión que pasa por la aplicación del CES (Captura, Esterilización y Suelta) y la autorización y establecimiento de colonias controladas para la garantía de buena alimentación y salud de los gatos callejeros. </p>

<p>Basta ya de este maltrato tanto a las personas como a los gatos. Basta de una educación de tan poca base ética que como resultado obtiene abandono de animales por sus ciudadanos y maltrato animal. </p>

<p>No se trata de una utopía, en nuestro país se hace en numerosos pueblos y ciudades.</p>

<p>Los ejemplos más imponentes son las ciudades de Barcelona y Zaragoza que han implantado la gestión ética de colonias felinas CES + BienestarColonias (BC) con éxito probado. Se trata de una gestión de las colonias felinas a través del Ayuntamiento, Voluntariado, Protectoras o Asociaciones Animalistas, y el Centro de Protección Animal (CPA). </p>

<p>Ni que decir tiene que atender y esterilizar a los gatos de la calle no infringe ninguna normativa, como se demuestra en la sentencia que condenó al Ayto. de Madrid por imponer sanción injusta a cuidadores de gatos en noviembre de 2014.</p>

<p>Esta tarea que corresponde al Ayto. y no a particulares, y que dichos particulares realizan de manera altruista, supone una medida eficaz para el control de la población de los gatos  y disminución de las molestias que puedan ocasionar.</p>

<p>La medida del exterminio de los gatos, que aplican algunos servicios municipales, además de ser cruel e impropia de una sociedad civilizada, no soluciona nada, puesto que retirar y matar a una colonia de felinos no hace sino crear lo que se llama el efecto vacío en la zona, propiciando que otros gatos repueblen el lugar y comiencen a reproducirse sin control.</p>

<p>El Ayuntamiento de Madrid debe incorporar esta práctica. Debemos ser una ciudad modelo, amiga de los animales, donde los animales urbanos estén sanos y compartamos el espacio de manera positiva, donde las personas que tanto cuidan y respetan a los animales y se preocupan por la alimentación y salud de los gatos, no sean perseguidas, sino que se les reconozca su labor, labor que debería realizar el Ayto pero que realizan particulares de manera altruista.</p>

<p>Formemos una alianza Ciudadanos-Ayto, ya sea como voluntarios o mediante convenios de colaboración con ONGs animalistas o protectoras, instaurando las figuras de 'ciudadano-alimentador' y 'ciudadano-CES'. </p>

<p>Todo ello pasa por modificar la ordenanza municipal y crear nuevas figuras administrativas de protección animal. </p>

<p>Los gatos y los ciudadanos de Madrid estamos cansados del maltrato que se nos da, un trato injusto y poco ético.</p>

<p>Por eso lanzamos esta petición, para reclarmarle a usted, Alcaldesa Manuela Carmena, que es posible una gestión ética de colonias urbanas, que debe existir un CES público + BC, y que sabemos que de esta manera dejarán de malvivir los gatos por nuestras calles, podrá disfrutarse y valorarse la fauna urbana, y por fin habrá entendimiento felino entre ciudadanos afines a los gatos y el Ayuntamiento. </p>

<p>Si quieres firmar para unirte a la petición change para CES + BienestarColoniasFelinas AHORA MADRID, aquí dejamos el enlace, ya van más de 3.100 firmantes:</p>

<p>https://www.change.org/p/alcaldesa-manuela-le-pedimos-una-gesti%C3%B3n-%C3%A9tica-de-las-colonias-felinas-en-madrid-ahora</p>

<p> </p>

<p> </p>

<p> </p>

<p> </p>
";"08/09/2015 13";"112";"89";"23";"15";"870255659";"5244"
"1860";"Queremos una consulta a la ciudadania para la acogida de inmigrantes y refugiado";"<p>Como ciudadano y no soy el unico, nos gustaria que en MADRID hubiese un referendum sobre este tema tan importantisimo como es la acogida de refugiados sirios ¿Es lo que el pueblo quiere? Adelante, pero un gobierno no se puede llamar democratico cuando permite la entrada de foraneos sin una simple consulta, ademas de darle ayudas y una vivienda teniendo a españoles en la calle.</p>

<p> </p>

<p>¡Queremos una consulta democratica sobre la acogida de foraneos!</p>
";"08/09/2015 13";"215";"139";"76";"58";"868001303";"4073"
"1864";"Regular guías turísticos en Madrid";"<p>Desde hace unos años el tema de guías turísticos está liberelizado en la comunidad de Madrid, lo que ha llevado a una situación insostenible en la ciudad de Madrid. Cualquier persona puede hacer de guía sin ninguna formación específica y sobre todo sin pertenecer a ningún organismo. Han proliferado pseudoguías que se aprenden un discurso sacado de blogs sobre la ciudad y ofrecen sus servicios a cambio de propinas al final de sus visitas. La calidad de las visitas es pésima ya que no hay un control o una seguridad de que estas personas tengan un mínimo de formación y a parte se trata de competencia desleal a todos los que pagamos impuestos con nuestras actividades turísticas. Mi pregunta es, por qué no se prohiben estas visitas a base de propinas?, ya que las propinas no se controlan y es una forma de defraudar.</p>

<p>Madrid se ha llemado de free Tours que dan una imagen penosa del sector turístico en la ciudad, casi llegando a pelearse por llevarse a los clientes en lugares como la plaza Mayor o la plaza de Oriente. Es lamentable que una ciudad como Madrid no tenga regulado el tema del turismo y dejq que cualquiera sea guía dejando en los turistas la impresión de un turismo muy lejos de la calidad que se merece Madrid.</p>

<p>Por ello espero que se regule esta situación, por los profesionales que nos dedicamos a ello y por la imagen que se llevan los turistas de esta maravillosa ciudad llena de cultura y patrimonio. </p>
";"08/09/2015 13";"33";"25";"8";"4";"865111635";"1287"
"1866";"Eliminar el REGISTRO obligatorio, poder hablar en persona con un organismo";"<p>Cada vez que quieres preguntar, aportar, reunirte con alguien del Ayuntamiento o de la Comunidad de Madrid, te encuentras con el muro del REGISTRO, donde muchas veces no he obtenido ni respuesta. Otras veces mi sugerencia o comentario iba a un departamento no adecuado o se perdía. ¿Tan dificil es que te den un teléfono o una cita presencial?</p>
";"08/09/2015 13";"39";"35";"4";"2";"869032583";"2782"
"1867";"Regular guías turísticos en Madrid";"<p>Desde hace unos años el tema de guías turísticos está liberelizado en la comunidad de Madrid, lo que ha llevado a una situación insostenible en la ciudad de Madrid. Cualquier persona puede hacer de guía sin ninguna formación específica y sobre todo sin pertenecer a ningún organismo. Han proliferado pseudoguías que se aprenden un discurso sacado de blogs sobre la ciudad y ofrecen sus servicios a cambio de propinas al final de sus visitas. La calidad de las visitas es pésima ya que no hay un control o una seguridad de que estas personas tengan un mínimo de formación y a parte se trata de competencia desleal a todos los que pagamos impuestos con nuestras actividades turísticas. Mi pregunta es, por qué no se prohiben estas visitas a base de propinas?, ya que las propinas no se controlan y es una forma de defraudar.</p>

<p>Madrid se ha llenado de free Tours que dan una imagen penosa y deplorable del sector turístico en la ciudad, casi llegando a pelearse por llevarse a los clientes en lugares como la plaza Mayor o la plaza de Oriente. Es lamentable que una ciudad como Madrid no tenga regulado el tema del turismo y dejq que cualquiera sea guía dejando en los turistas la impresión de un turismo muy lejos de la calidad que se merece Madrid.</p>

<p>Por ello espero que se regule esta situación, por los profesionales que nos dedicamos a ello y por la imagen que se llevan los turistas de esta maravillosa ciudad llena de cultura y patrimonio. </p>
";"08/09/2015 13";"55";"37";"18";"17";"864925818";"1278"
"1868";"Mantenimiento de parques y jardines";"<p>Madrid tiene un parque, El Retiro, que a pesar de no hallarse en sus mejores momentos, es envidia de cualquier ciudad. Es sin embargo un parque pequeño para una gran ciudad. Cuenta por eso también, para su oxigenación, con la Casa de Campo y una multitud de pequeños y no tan pequeños parques periféricos, como los de Valdebernardo, donde vivo.</p>

<p>Sin embargo esos parques periféricos distan mucho de tener los cuidados apropiados: árboles desaparecidos y no replantados, árboles mustios, raquíticos, secos, con el tronco abierto; masas de arbustos desaparecidas, zonas de cesped esquilmadas convertidas en eriales. Y la omnipresente basura.</p>

<p>Se planifican parques, pero se plantan pimpollos demasiado pequeños que no llegan a término y no se dota el presupuesto de mantenimiento necesario. Si a ello añadimos la crisis actual, el vandalismo de algunos jóvenes y la indiferencia por el entorno de muchos otros no tan jóvens, el resultado son parques de película de terror.</p>

<p>Esa es la realidad actual que necesita un gran esfuerzo de planificación e inversión (educación y policía ciudadana incluidos) para mejorar esos parques que tanto necesitamos. Espero que las promesas de este gobierno de redistribución de las inversiones en barrios, para disminuir las desigualdades, se conviertan en realidad y con el esfuerzo de todos cambiemos la situación.</p>
";"08/09/2015 13";"83";"79";"4";"0";"873440962";"7138"
"1874";"Sobre quitar la calle a D. Ramón Gómez de la Serna";"<p>Agradeciendo, en primer lugar, ésta oportunidad de comunicar con el Ayuntamiento de Madrid, yo deseo expresar un sentimiento y una preocupación que me inquieta mucho. He leído en los medios de prensa que el Ayuntamiento se propone quitar del callejero de Madrid una serie de calles dedicadas a personajes que se consideran vinculados con el franquismo. Entre esas calles estaría la dedicada a Ramón Gómez de la Serna. Si eso se produjese y se le retirase su calle a este insigne escritor madrileño se estaría cometiendo una flagrante injusticia. Ello por muchísimas razones y paso a exponer algunas.
En algún medio de prensa se ha publicado la siguiente información tendenciosa y falsa:</p>

<p>«""Ramón Gómez de la Serna desde Argentina se decantó por el Bando Nacional, manifestando su apoyo al Movimiento y haciendo entrega de una cuantiosa suma de dinero para financiar a los sublevados contra la República. En 1944 comenzó a colaborar en el diario falangista Arriba. En 1949 regresó a Madrid, donde tuvo una recepción con el Caudillo de España Generalísimo Francisco Franco, del que era gran admirador. Su hijo, Víctor de la Serna, también cuenta con su propia calle. Militante falangista, durante la guerra apoyó a la causa franquista mediante su participación en las tareas de propaganda. Suya fue la célebre frase ""Camarada Miguel de Unamuno: ¡Presente!"" durante el entierro del escritor. Al terminar la contienda fue director del diario madrileño Informaciones, desde donde defendió a Hitler y su régimen.</p>

<p>Es falso que Ramón se decantase por el Bando Nacional desde Argentina. Es más, cuando llegó alli se definió como «Azañista» y republicano. No pudo hacer ninguna donación económica porque fue un hombre que vivió sus 36 años de auto-exilio en la precariedad mas absoluta no contando para vivir con más medios que sus mal pagadas colaboraciones en periódicos. En el diario Arriba escribió cuando el diario se lo ofrecióente pagándole espléndidamente, pero exclusivamente greguerías y cosas intrascendentes. Cuando el periódico le exigió la redacción de artículos «de fondo» cesó su colaboración con él. Es verdad que regresó en un viaje «encerrona» a España en 1949, pero estuvo pocos días porque le asfixiaba la opresión política en España. Acudió a la recepción de Franco con un «Frac» alquilado pero rehusó su solicitud de quedarse en España y retornó a los pocos días a la Argentina en la que murió. Ya, la información, cuando habla de su hijo, pasa a ser deleznable pues Ramón Gómez de la Serna nunca tuvo ningún hijo y menos falangista.</p>

<p>Ruego encarecidamente al Ayuntamiento de Madrid que tenga presente que muchas informaciones sobre Ramón son falsas y muchas motivadas por la envidia que suscitaba siempre entre otros literatos. Algunos le detestaron siempre y plagaron de infundios sobre su persona. Un exiliado que se marchó de España cuando la guerra «Porque los españoles solo pensaban en matarse» y porque «Se iban a cerrar todas las librerías» y que mantuvo siempre íntegra su independencia, nunca pudo ser un franquista. La prueba está en que jamás recibió honores ni prebendas de aquel régimen. Al final de su vida recibió del gobierno argentino una pensión para poder sobrevivir.
Es uno de los mas grandes escritores madrileños de todos los tiempos, con 100 libros geniales editados y fué siempre honesto e independiente. Se merece su calle actual y  merecería mucho más. Confío en que el ayuntamiento no cometa la torpeza de quitársela.</p>
";"08/09/2015 13";"37";"26";"11";"5";"864174087";"1054"
"1876";"Madrid más lejos: Derecho a la naturaleza a familias con escasos recursos";"<p>Muchas áreas rurales necesitan recuperar y rehabilitar su patrimonio urbanístico de casa tradicional, además de recuperar vida social y cultura. Muchos madrileñ@s, niñ@s, ancian@s, inmigrantes, precari@s, estudiantes, familias con escasos recursos tienen muchas dificultades para acceder a espacios naturales de calidad, ya sea para disfrutar de un descanso estival o por otros motivos, tener contacto con la naturaleza del mismo modo que una familia con alto poder adquisitivo puede hacerlo. Ambas necesidades, mediante acuerdos con particulares y ayuntamientos, se podrían complementar y establecer una red de alquileres sociales -y ayudas- que den solución a ambas carencias, establecer puentes urbano-rurales -más allá de la pura relación mercantil del turismo- y hacer que las politicas del cambio, y Madrid mismo, lleguen mucho más lejos y al mismo tiempo ofrecer vias para recuperación de un trabajo socialmente útil. </p>
";"08/09/2015 13";"33";"20";"13";"1";"860838907";"424"
"1878";"Billete Metro-EMT reducido para parados";"<p>He pasado varios meses en paro y sin casi dinero para poder pagarme el transporte público. Durante un año utilicé el ""bono valla"" para poder utilizar el Cercanías, no me podía permitir los más de 3 euros que me costaba cada sencillo (sé que el Cercanías no depende del Ayuntamiento). Es necesario que de alguna manera se facilite el acceso reducido al transporte público de aquellos que no pueden permitírselo, ya sean parados o personas con dificultades económicas, así como sus hijos --en el caso de que los tengan--.</p>
";"08/09/2015 13";"115";"94";"21";"2";"870887002";"5966"
"1879";" Actualizar PLAN GENERAL DE ORDENACION URBANA  de Madrid  Año 1996";"<p>es impresionante que todavía nos regimos por el  PGOM del AÑO 1996 !!!  . Es inaúdito hablar con los tecnicos municipales y que te remitan al plan de 1996 para no poder desarrollar una actividad porque un suelo es de un tipo u otro .</p>

<p>Madrid en 20 años ( 1996 a 2016 ) ha cambiado lo que nuestro cuerpo cambia en ese tiempo .</p>

<p>Madrid necesita crecer y adaptarse a los modificaciones parciales que se han aprobado  . Es evidente que hay zonas protegidas ( sin ningún sentido después de 20 años ) y de vecinos a escasos metros ahora hay edificios de oficinas con más de 2.000 trabajadores. Si queremos un Madrid de futuro , debemos actualizarnos y desarrollar un PLAN GENERAL flexible ante todo para poder desarrollar actividades que enriquezcan la ciudad de Madrid  y a su vez ofrezcan oportunidades de empleo.  . </p>

<p> Necesitamos flexibilidad y rápidez en las gestiones administrativas de Urbanismo . Y un urbanismo actual , de futuro , útil para los madrileños . Todo tipo de licencias deben tener un máximo tiempo de obtención que no puede superar los 30 días , desde la inicial (obra , etc ) hasta la final ( apertura , habitabilidad ) . </p>

<p>Un saludo y gracias por darnos la oportunidad de expresarnos por este medio . </p>

<p> </p>
";"08/09/2015 13";"49";"45";"4";"3";"870531333";"3765"
"1880";"Dejar de hacer webs que no sirven de nada pagadas con los impuestos";"<p>Hacer una web en la que cualquiera puede decir lo primero que se le pase por la cabeza no mejora la Democracia, la convierte en un patio de colegio. El nivel de burlas al consistorio que hay en esta web ponen de manifiesto que cada medida que toman, se convierte en motivo de chiste. </p>
";"08/09/2015 13";"267";"86";"181";"10";"849207864";"-3059"
"1881";"Mejora al acceso de debates";"<p>Se que esto está empezando, así que con la crítica sólo quiero apoyar el proyecto.
 </p>

<p> El sistema de etiquetas está muy bien, pero si bien no todo el mundo sabe usarlos igual, creo que se deberían añadir más opciones al crearlos y, en relación a cómo se harán después efectivos (según tengo entendido, habrá partida del presupuesto por el municipio y por los distritos), una de esas opciones podría ser una selección de si tu debate es un tema para Madrid (Municipio), o para alguno de sus Distritos, e incluso barrios.</p>

<p> Facilitar así un filtro de zonas, para poder ver con más fluidez todo lo que hay en torno a tu interés.</p>

<p> Los debates no deberían caer en el pozo del olvido, ¿el último que entra llega a ver el debate del primero que entró? Tal vez deberían rotar de manera aleatoria.

 La verificación de las cuentas. Me parece un tema importante, puesto que aunque cualquiera debe poder abrir un debate me imagino que a la hora de tener en cuenta las votaciones, ¿valdrán (más) las que sea de gente real y que viven en Madrid o en el Distrito de la propuesta? ¿Van a tener en cuenta esta distinción? ¿Otras maneras de verificación? ¿Es segura toda este tráfico información en internet?</p>

<p>Es posible que ya mucha gente haya abierto un debate parecido, o que todas estas preguntas ya las hayan solucionado. Siento si ha sido así, pero precisamente por ello abrí el debate, porque no accedo fácilmente a todo lo que hay.</p>

<p>
Gracias.</p>
";"08/09/2015 13";"28";"20";"8";"3";"863574089";"857"
"1885";"Accesos Casa de campo por Rosa Luxemburgo";"<p>Buenos días: El acceso a la casa de campo por Rosa de Luxemburgo - Aravaca se encuentra en un estado lamentable. es muy peligroso, las escaleras de madera estan todas rotas y no hay acceso para bicicletas, hay que subir un desnivel de 10 metros a pulso. Eh visto varios accidentes, afortunadamente sin consecuencias, pero tarde o temprano haberá mortos. Les solicito que  tomen las medidas necesarias para mejorar los accesos urgentemente. Necesitamos accesos cómodos.</p>
";"08/09/2015 13";"29";"24";"5";"13";"866890063";"1572"
"1887";"Peatonalizar carriles Paseo de las Delicias";"<p>El Paseo de las Delicias, es la calle más contaminada de Madrid. Para un madrid más amigable, menos ruidos, menos contminado estaría genial la limitación al tráfico y potenciar eluso de la bici y otros transportes más ecológicos. Sería posible peatonalizar 3 de los 6 carriles que tiene el Paseo de las Delicias??? Gracias</p>
";"08/09/2015 13";"48";"36";"12";"1";"866056594";"1800"
"1890";"Hacer la web del ayuntamiento más accesible";"<p>Hacer que la web del ayuntamiento seá más usable, quitando los capthas y hacerla que cumpla con la ley</p>
";"08/09/2015 13";"43";"30";"13";"6";"864565837";"1186"
"1896";"Fuera el Senado, endurecimiento de penas para delincuentes, BiciMad en extraradi";"<ul>
	<li>El Senado fuera de este país de una vez</li>
	<li>Penas mas duras para los delincuentes, extradicion para los extranjeros delicuentes</li>
	<li>BiciMad en los barrios fuera del anillo de la M30 .</li>
</ul>

<p>
.</p>
";"08/09/2015 13";"75";"53";"22";"12";"866582248";"2190"
"1901";"Convertir Madrid en una ciudad pionera en energía limpia";"<p>Muchos pueblos o ciudades de menor tamaño de España y Europa se han propuesto ser energéticamente independientes y limpios. Creo que tenemos la oportunidad de eliminar la famosa ""boina"" de Madrid a la par que lograr una energía limpia y barata para toda la ciudad.</p>

<p>Esto se lograría tanto con la generación de energía (paneles solares, molinos eólicos, la energía hidráulica que ya tenemos) como una disminución del consumo mediante instalaciones de bombillas LED o convertir el transporte de gasolina en autobuses elécticos o híbridos.</p>

<p>La inversión inicial se recuperaría fácilmente con todo el ahorro de alumbrado público, transporte y demás.</p>
";"08/09/2015 13";"952";"916";"36";"17";"884034021";"84672"
"1902";"Transporte publico barrio Horcajo Moratalaz";"<p>La zona llamada Horcajo que comprende entre calle Fuente Carrantona, prolongacion de O'Donnell, calle Laguna Negra y M40 es desde su contruccion hace 15 años una de las zonas peores comunicadas de Madrid. Disponemos del metro de Pavones a 15-25 minutos según la calle que se viva y una sola linea al centro (línea 30 a Goya) que recorre todo el barrio y tarda de 45 a 55 minutos en llegar a su destino con frecuencias de 10-15 minutos.</p>

<p>Se instalaron dos líneas express (E2 y E3) aprovechando la prolongación de O'Donnell pero esas dos líneas solo pasan por Vicálvaro y por Las Rosas no habiendo hecho una tercera línea que bajara desde Valdebernardo pasando por Dr. García Tapia y cogiendo Fuente Carrantona.</p>

<p>Solicito nuevas líneas de autobús que nos conecten con la M-30-centro de Madrid</p>
";"08/09/2015 13";"43";"35";"8";"7";"867604536";"2197"
"1906";"Medalla honor Ayuntamiento de Madrid para Ana Botella";"<p>A entregar el próximo San Isidro 2016</p>
";"08/09/2015 13";"283";"65";"218";"6";"850623242";"-3514"
"1909";"Quitar el azul del PP";"<p>Todos los estamentos del ayuntamiento usan el azul igual que el azul del pp, la bandera de Madrid es morada no azul,</p>
";"08/09/2015 13";"116";"44";"72";"5";"850206748";"-1062"
"1911";"Crear mas Centros de Dia y Residencias de mayores";"<p>Los Centros de Día actuales tienen demostrado un buen nivel de servicio, pero están saturados de peticiones de mayores que quieren acudir a un centro público, con todo lo que implica: Buena atención, Servicios auditados, buenos profesionales y un precio ajustado a las posibilidades de los usuarios.</p>

<p> </p>

<p>El Ayuntamiento de Ahora Madrid representado por Manuela Carmena, debería hacer prioritaria la atención a los mayores, creando más plazas, promoviendo a trabajadores sociales y ampliando el numero de personas que puedan ser atendidas. El envejecimiento de esta ciudad, lo reclama.</p>
";"08/09/2015 13";"120";"106";"14";"17";"873275205";"8126"
"1912";"3.	Madrid Envases Cero  plan de reducción de embalajes y envasados";"<p>Buena parte de nuestra basura doméstica se compone de envases y embalajes a menudo innecesarios, cuyo reciclaje es en todo caso costoso. Se propone estudiar de qué manera, desde la gestión municipal, sería posible regular envases y embalajes de los productos vendidos para reducir progresivamente su incidencia en la generación de residuos urbanos. La cuestión no ha de ser sencilla, porque probablemente es un tema que depende sobre todo de regulaciones estatales y UE, pero quizás algo se pueda hacer al respecto. El objetivo sería poner todos los medios al alcance del ayuntamiento (más de persuasión que coercitivos) para que en la ciudad circularan cada vez menos envases de difícil o costoso reciclaje.</p>

<p>Tal vez se pueda, desde del ayuntamiento,  poner por lo menos facilidades para todo tipo de comercio que se comprometa a la venta a granel sin envase, o con envases de muy bajo impacto y/o más fácil reciclaje (papel VS plástico, retorno de botellas vacías, etc.). Otra acción muy sencilla, pero quizás ejemplificadora podría, ser la sustitución en todas las sedes y actividades municipales de las botellas de agua mineral envasada en plástico por envases de menor impacto o, directamente por la colocación de  jarras de agua de grifo oportunamente filtrada o refrescada, cuando la circunstancia lo requiera (creo que en Madrid tenemos la gran suerte de disfrutar de un agua de mucha calidad, gracais a la cercanía de la sierra). </p>

<p>Al fin y al cabo se trataría de ""declarar la guerra"" a la generación descontrolada de desperdicios, sobre todo plásticos, que proceden de envases no reciclables o no reciclados, por causa de la falta de incentivos u obligación.  </p>
";"08/09/2015 13";"91";"81";"10";"2";"872240180";"6319"
"1920";"Acabar con la propaganda y publicidad que se dan en la calle y coches";"<p>Desde hace ya mucho tiempo vengo dandome cuenta de que gran parte de suciedad de nuestra ciudad esta ocasionada de alguna manera por la falta de regulacion respecto a la publicidad que se da en la calle o que se deja en los parabrisas de los coches. </p>

<p>Por lo tanto, como es imposible controlar a todos aquellos ciudadanos que no son capaces de depositar dichos panfletos en la papelera más cercana y los arrojan al suelo, opino que el Ayuntamiento deberia de hacer sus deberes y regular de alguna manera esta practica que tantos recursos de limpieza requiere, y que dado que es para el benieficio personal de algunas empresas no deberiamos costear todos los ciudadanos.</p>

<p>Propongo algún tipo de sanción, no a los que reparten dicha propaganda, sino a aquellas empresas que hagan uso de esta practica para anunciarse. Si fuese necesario que se les proporcione un canal adecuado a nuestros dias como una pagina web o paneles en las calles para que los pequeños y medianos comercios que quieran hacer uso de ello tengan un lugar apropiado.</p>

<p> </p>

<p> </p>
";"08/09/2015 13";"181";"161";"20";"7";"874922914";"12541"
"1924";"Revisión del Impuesto de Bienes Inmuebles";"<p>Iniciar conversaciones con el gobierno central para aprobar una revisión catastral para 2017 e intentar reducir el IBI a las zonas más desfavorecidas.   </p>
";"08/09/2015 13";"56";"50";"6";"2";"870486791";"3928"
"1928";"Trolls en el Portal";"<p>Entiendo que este portal mejorara a medida que evolucione. El hecho de que el portal este abierto a la ciudadanía es mas que positivo, sin embargo, esta generando ciertos debates irrelevantes para la mayoría ciudadana.</p>

<p>Quizás el cambiar la política de privacidad y solicitar el número de DNI o Pasaporte para poder iniciar un debate pueda evitar que determinados individuos, cuyo ánimo sea simplemente soslayar la buena voluntad del portal, inicien debates absurdos.</p>

<p>Saludos.</p>
";"08/09/2015 13";"103";"65";"38";"19";"865366695";"1703"
"1931";"Prohibir las razas de perros peligrosos";"<p>Prohibir las razas de perros peligrosos, como rotweilers, dogos y pitbulls y multar fuertemente a quienes no los lleven con bozal.</p>

<p> </p>
";"08/09/2015 13";"201";"95";"106";"14";"851412093";"-519"
"1933";"ENLACE LEGANÉS-VILLAVERDE ALTO (M402)";"<p>Buenos días, es necesario reformar el <strong>paso desde Villaverde Alto a Leganés (M402)</strong>. Ahora mismo se hace por debajo de un puente, y teniendo que atravesar posteriormente una salida de la A42, lo que lo convierte en un paso muy peligroso. El transito de personas es considerable. Supongo que no se puede reformar la parte que corresponde a Madrid sin reformar la parte que corresponde a Leganés, pero para los vecinos sería una gran avance en la comunicación del barrio y en la seguridad, por lo que se agradecería una obra por parte de los dos ayuntamientos. Un saludo</p>
";"08/09/2015 13";"41";"32";"9";"2";"866521810";"1795"
"1935";"Llenar el Alfonso Pérez con refugiados sirios.";"<p>Bonito gesto de bienvenida a los refugiados. Todos salimos ganando.</p>
";"08/09/2015 13";"103";"35";"68";"4";"850609575";"-1121"
"1940";"Desincentivar el uso del plástico";"<p>Desincentivar el uso del plástico y subvencionar a las empresas que eliminen o reduzcan su utilización.</p>
";"08/09/2015 13";"88";"74";"14";"1";"870798071";"5045"
"1943";"Cambio de farolas";"<p>La mayoría de las calles de la ciudad tienen farolas tipo báculo, iguales que las de las autopistas. Creo que es hora de cambiar las farolas, sobre todo de los barrios del interior de la M-30, no sólo por razones estéticas, que también. Además son demasiado altas para el tejido urbano, con lo que son ineficientes energéticamente y molestas para los habitantes de esas zonas. No digo que imitemos a otras ciudades que hacen de sus farolas un desfile de diseño estrafalario, simplemente cambiar a otros modelos más modernos, sencillos y eficientes.</p>
";"08/09/2015 13";"72";"53";"19";"5";"867254140";"2502"
"1945";"Desalojar a los chatarreros / poblado de Vereda de Ganapanes en Barrio del Pilar";"<p>Se han instalado varias furgonetas de chatarreros en el solar sin asfaltar en la calle Vereda de Ganapanes con Monforte de Lemos (enfrente de donde van a montar el polideportivo). Son varios camiones y furgonetas donde viven personas. Soy vecino y da pena como dejan todo de basura, y de objetos peligrosos como objetos punzantes, cristales, además de sus propios excrementos que lo hacen en la calle.</p>

<p>A parte del insufrible ruido que hacen tanto de día como de noche que se dedican a acumular chatarra, cambiarlas de camiones, destrozar neveras y lavadores en la vía etc...</p>

<p>No creo que sea legal ni estas actividades ni pernoctar ni ensuciar.</p>

<p>Propongo que no se permita realizar esta actividad y que los saquen de la zona.</p>
";"08/09/2015 14";"80";"66";"14";"6";"870119459";"4290"
"1947";"Quitar los parquímetros ";"<p>Creo que en beneficio de todos, deberían retirarse los parquimetros de la ciudad, ya que suponen un gasto innecesario para el ciudadano y una estrategia para sacar tajada, de la que se aprovecho el PP...encima gastaron millones de euros, que van amortizando a costa del ciudadano entre lo que sacan de los tickets, multas y demás;</p>

<p>Me parece que ya pagamos suficientes impuestos, entre otros el de matriculacion cada año, como para colmo tengamos que seguir pagando por aparacar en la via pública...que como su nombre indica, es de todos¡¡¡</p>

<p>Si de momento la medida parece dificil de hacer en toda la ciudad, por lo menos empiezen a hacerlo en los barrios obreros o con más dificultades económicas, ya que algunos de ustedes y de otros partidos políticos, prometieron hacerlo en sus promesas electorales;</p>

<p>gracias por crear esta página y esperemos que de verdad sirva para mucho,</p>

<p>saludos</p>
";"08/09/2015 14";"116";"57";"59";"13";"855842881";"-98"
"1948";"Nado Lago de la Casa de Campo";"<p>Habilitar el Lago de la Casa de Campo para poder nadar durante todo el año, entrenar en aguas abiertas como ejemplo,  lago Serpentine en Hyde Park de Londres.</p>
";"08/09/2015 14";"107";"80";"27";"6";"868885765";"3962"
"1954";"Entidad que regule de una vez las compañias telefónicas";"<p>No conozco una sola persona que no haya sido engañada al darse de alta en las empresas telefónicas y de internet. Crear un organismo SERIO que las regule, y que denunciarlas no sea un proceso tedioso y burocrático. Hacer públicos los resultados y los nombres lde las empresas más tramposas.</p>
";"08/09/2015 14";"63";"51";"12";"3";"868878935";"3157"
"1955";"Colocar la bandera de Castilla en el Ayuntamiento.";"<p>Según la ley 2/1983 Madrid es villa castellana y castellana ha sido durante su mayor historia. Es por eso, que se hace necesario mostrar la identidad completa de la ciudad con la bandera castellana, en el balcón del ayuntamiento junto a la enseña nacional y la de Madrid.</p>
";"08/09/2015 14";"197";"118";"79";"49";"866370696";"2336"
"1960";"Moción de censura a la Alcaldesa Carmena";"<p>Demasiados familiares suyos  enchufados en el Ayuntamiento. Es una mandada de Podemos.</p>
";"08/09/2015 14";"248";"77";"171";"8";"849748074";"-2918"
"1963";"Mole gigantesca de nueva construcción en Plaza de España";"<p>Quiero que el Ayuntamiento me explique por qué se ha dado permiso para construir un edificio de 17 plantas en la fachada sureste de la Plaza de España (la que sigue a la Cuesta de San Vicente), ocupando los números 3, 4 y 5.</p>

<p>Mi sorpresa viene por haber autorizado un hotel de 17 plantas donde antes había tres edificios diferentes de 11 -eran oficionas de Telefónica-, todos de la misma altura que los demás edificios de esa fachada de la plaza, tanto el número 6 (construido en los años 70) y el 7 (de años 90) como el 2, que fue construido más recientemente, o el 1, que es más antiguo. ¿Cuál es la razón para permitir una mole de esas características que no mantiene la coherencia ni arquitectónica ni urbanística del resto de esa fachada de Plaza de España?</p>
";"08/09/2015 14";"49";"24";"25";"5";"855945016";"-48"
"1975";"Multar por tirar chicles al suelo";"<p>En Irlanda actualmente te ponen una multa de 30 si te pillan tirando un chicle al suelo, me parece una gran idea ya que las calles están llenas de chicles pegados al suelo.</p>
";"08/09/2015 14";"165";"141";"24";"8";"873755741";"9998"
"1980";"La noche Madrileña, esa gran perjudicada";"<p>La noche Madrileña esa gran perseguida por la policía , y que tanto dinero genera les guste al ayuntamiento o no ..Puestos de trabajo directos e indirectos, turismo y diversidad .........................................</p>

<ul>
	<li>Activar el ocio nocturno dejando de perseguir a los locales como si fueran delincuentes</li>
	<li>Mas inspecciones de ruidos SI , pero con cabeza</li>
	<li>Mas licencias para discotecas nocturnas y locales a partir de las 03:00 ....</li>
	<li>Si Madrid sin noche no es Madrid</li>
	<li>Volver a dar los cursos a la gente multada por botellon en vez de la multa y punto .....</li>
	<li>¿Porque ya no se puede convalidar la multa con un curso?</li>
	<li>Se debería multar a quien ensucia con el botellón mas que el botellón en si , 600  por beberse una lata de cerveza en la calle no lo veo lógico</li>
	<li>IVA al 10% en todo lo que sea ocio cultural, musical y similar ...</li>
	<li>Adecuación de aforos de algunas salas ... a mejor o a peor ..... dependiendo de las mismas ...</li>
	<li>Persecución de los vendedores ambulantes de alcohol ... Quitan mucho dinero a los bares y locales</li>
</ul>
";"08/09/2015 14";"65";"46";"19";"4";"866296240";"1910"
"1981";"¿Como saber que estas a propuestas son realizadas por ciudadanos de Madrid?";"<p>Si debería ser un foro de debate para todo el mundo, ¿todos?, es del Ayuntamiento de Madrid así que las propuestas reales deberían tener más peso para los que posteriormente puedan votarlas, o sea ciudadanos de Madrid o personas que en algún modo usan los servicios de Madrid. ¿Qué impide a una persona que no disfruta de los mismos ni tan siquiera reside hacer propuestas?, a priori nada.</p>

<p>No es limitar la participación, es simplemente que propuestas son de los ciudadanos y usuarios y cuales son de ciudadanos que no las van a disfrutar y podrían generar ""ruido"".</p>
";"08/09/2015 14";"50";"28";"22";"9";"861165943";"336"
"1983";"Reciclado de aceites de consumo particular.";"<p>El aceite que actualmente se utiliza en cada hogar para cocinar, es una gran fuente de contaminacion, muchisimos litros de agua se contaminan a diario y es algo que se usa en grandes cantidades diariamente, por esto en algunas ciudades españolas y en muchas ciudades del mundo se han creado centros de reciclado de este liquido, pero en Madrid aun no tenemos ninguna planta  en la que se haga esta labor.  Se que no es prioritario y que hay mucho que arreglar, pero dado el trabajo que hay que desplegar para poner esta iniciativa en marcha, seria de agradecer que se empezara a hablar del tema para que en no demasiado tiempo fuera posible empezar a trabajar sobre ello.</p>

<p>Muchas gracias.</p>
";"08/09/2015 14";"115";"103";"12";"6";"873658401";"8150"
"1986";"Aumentar el precio del tabaco";"<p>Muchos jóvenes hoy en día empiezan a fumar porque no les resulta muy caro coger un paquete a medias con amigos, si aumentarán el precio verían que no les sale rentable gastarse toda la paga que les dan sus padres. Me parece lo mejor para reducir el consumo del tabaco, siguiendo el ejemplo de Inglaterra, Irlanda.. En donde por menos de 10 no puedes comprar un paquete de tabaco.</p>
";"08/09/2015 14";"108";"59";"49";"14";"862239585";"546"
"1988";"Círculo Transparente para el Diálogo sobre la Acogida de Asambleas de Refugiados";"<p>¿Por qué no establecer un círculo transparente para el diálogo sobre la acogida de asambleas de refugiados y refugiadas?</p>

<p>Seamos leales con nuestro pueblos, con nuestros compatriotas. Tenemos que lograr <strong>unir el mundo para salvar la tierra,</strong> nuestra tierra. Nuestra tierra, en la que viven pobres, demasiados pobres, y ricos, demasiados ricos.</p>

<p><strong>L</strong><strong>a tierra no pertenece a nadie. Salvo al viento.</strong></p>
";"08/09/2015 14";"43";"15";"28";"0";"852194308";"-453"
"1990";"ESCÁNDALOS(voces, música, peleas...) EN LAS CALLES POR LAS NOCHES";"<p>En el barrio de Usera, en la calle de Hermenegildo Bielsa, desde el jueves hasta el domingo (ambos días incluidos), y durante todo el año, los vecinos tenemos que convivir con continuos escándalos en las calles: borrachos que gritan y se pelean, personas que aunque no estén borrachas, pasean por las calles con gritos, ponen la música de los automóviles a un alto volumen... Y todo esto se produce en la vía pública, que es de todos, y por eso, habría que marcar unos límites, pues el hecho de que estos espacios sean de todos, no puede dar derecho a impedir el descanso de los vecinos, al que también tenemos derecho.</p>

<p>A este situación, contribuyen bares que están abiertos hasta altas horas de la madrugada, y que no está claro que tengan licencia para ello.</p>

<p>Me gustaría abrir este debate y poder explorar algunas soluciones entre todos.</p>
";"08/09/2015 14";"52";"45";"7";"5";"869892379";"3288"
"1994";"Auto-abastecimiento energético sin limitación";"<p>Debería permitirse el uso de energía de producción propia sin ningún tipo de penalización.</p>

<p>Actualmente si un individuo instala y almacena energía como puede ser el uso de placas solares, puede ser multado de forma exagerada con millones de euros.</p>

<p>En otras palabras, estas leyes actualmente te obligan a pagar una cuota (multa), como si estuvieras pagando la energía religiosamente cada mes que es lo que quieren.</p>

<p> </p>

<p>Propongo lo siguiente:</p>

<p>Libertad para crear, instalar, mantener y abastecerse individualmente. Sin restricciones.</p>

<p>Todos queremos un mundo mejor. ¿NO?</p>
";"08/09/2015 14";"284";"269";"15";"5";"878891313";"24058"
"1998";"Barreras antimendigos en marquesinas de autobuses.";"<p>Cierto que lo lleva una subcontrata, que a cambio del pingüe negocio de la publicidad en marquesinas no nos cuesta nada a los madrileños, pero la falta de sensibilidad social poniendo una barrera antimendigos no solicitada choca contra los principios de funcionamiento del Ayuntamiento: ayudar a las personas.</p>
";"08/09/2015 14";"62";"42";"20";"0";"865203203";"1490"
"1999";"S.Social negada a personas sin hogar por torpeza administrativa.";"<p>El procedimiento para la adquisición de una tarjeta de la Seguridad Social, requiere que se acredite un empadronamiento con validez actual. Los requisitos para tener derecho a la tarjeta de la Seguridad Social en ningun momento aclaran que sea necesario tener vivienda para ser merecedor de atención sanitaria, sin embargo para la asignación de un centro de la Seguridad Social se requiere estar empadronado en un area correspondiente a tal centro. Esto <u>es como decir que como no tienes vivienda, no te corresponde un centro y por tanto no tienes derecho a la atención sanitaria.</u></p>

<p>Les expondre el caso que me ha llevado a escribirles aqui:</p>

<p>Persona con 19 años de y cuyos padres se niegan a hacerse cargo. Padre toxicomano y madre con problemas psiquiatricos. Al verse el joven bruscamente sin vivienda y resuelta su tarjeta sanitaria tutelada, se encuentra con que no dispone de un lugar en el que estar empadronado.</p>

<p>He llamado al Telefono de información del INSS. Al 901166565, a su extensión 28 y habiendolo hecho dos veces y con dos funcionarios distintos, a pesar de mi insistencia y me pusiesen en espera para hacer las consultas pertinentes no me han dado ninguna clase de solución para este problema.</p>

<p>Así que, o efectivamente el hecho de quedarse sin hogar resulta indirectamente en la perdida del derecho a la atención sanitaria, o es que existe una solución tan compleja que ni los propios funcionarios del INSS pueden llegar a conocer y entonces menos aun una persona en riesgo de exclusión y con pocos recursos.</p>
";"08/09/2015 14";"32";"17";"15";"5";"858713799";"106"
"2001";"Autorizar el nudismo en la vía pública, parques y jardines.";"<p>Nacemos desnudos pero  no nos dejan vivir desnudos.  Madrid puede ser una ciudad más natural y amable si se eliminan todas las ordenanzas que impiden circular desnudos por la vía pública, parques y jardines.</p>

<p>Por otra parte a los hombres se les permite ir con el torso desnudo y a nosotras no hacen ponernos unos ridiculos triangulitos para tapar los pezones (que por otra parte es la parte de nuestro pecho que es igual a los hombres).  Esto es una grave discriminación sexual que no debe tolerarse en un ayuntamientos democrático.</p>

<p> </p>
";"08/09/2015 14";"194";"88";"106";"35";"851190479";"-816"
"2002";"Eliminar jornada intensiva en los colegios o Racionalización de los horarios.";"<p>Sería estupendo tener una racionalización de los horarios adecuada en los trabajos para la conciliación laboral y familiar. La realidad <strong><em>no es así,</em></strong> muchos trabajadores encuentran difícil cuadrar las horas para salir y recoger a los niños, tirando de abuelos, familiares o de alargar con extraescolares su jordana.</p>

<p>Si el ayuntamiento no tiene potestad o competencia para apoyar esta iniciativa en los colegios de Madrid / o no le apetece entrar en este tema; por favor apoyen la jordana intensiva  de septiembre y junio en los colegios.</p>

<p>No hace falta empezar a pleno rendimiento, pueden programar actividades más relajadas que no fatiguen a los niños y salgan a un horario en el que se les pueda recoger.</p>

<p>Sobre todo en los primeros ciclos donde el niño no es autónomo y depende totalmente de sus padres. Si ambos padres trabajan es muy difícil cuadrar la hora de recogida con el trabajo.</p>
";"08/09/2015 14";"49";"29";"20";"3";"861979076";"532"
"2003";"Tapones de plástico para ayudar a niños para tratamientos médicos";"Me gustaría que estudiasen implantar la iniciativa ""tapones solidarios"" en todos los edificios públicos como colegios públicos, bibliotecas, polideportivos, centros culturales o ayuntamiento para que los ciudadanos podamos llevar nuestros tapones de plástico gracias a la iniciativa que lleva haciendo la Fundación Seur para ayudar a niños que necesitan tratamientos médicos.

Esta iniciativa tiene como objetivo recaudar fondos, a través de la recogida y reciclaje de tapones de plástico, para ayudar a niños sin recursos a acceder a un tratamiento médico no reglado en el sistema sanitario con el fin de mejorar su calidad de vida. Se trata, por tanto, de una campaña con un doble objetivo: social y medioambiental. En la vertiente social supone una ayuda para niños y jóvenes hasta 18 años que necesitan un tratamiento, una intervención quirúrgica, un aparato ortopédico o una silla de ruedas y que no tienen recursos para acceder a ellos. En la vertiente medioambiental, este proyecto supone una acción intensiva de reciclaje que evita el vertido de miles de toneladas de plásticos al entorno.

Desde que se inició el programa ""Tapones para una nueva vida"", la Fundación SEUR y gracias a la ayuda de más de 13 millones de personas que han ayudado entregando sus tapones, se ha recaudado más de 770.000 euros con los que se ha ayudado a 100 niños.

Me preocupa mucho que se ayude a estos niños y la mejora del medio ambiente, por eso animo al ayuntamiento contactar con ellos para que muchísimos más ciudadanos tengan facilidades para llevar sus tapones y poder ayudar a más niños. ";"08/09/2015 14";"71";"46";"25";"4";"864842584";"1360"
"2007";"STOP vandalismo bicicletas madrid";"<p>Insto al ayuntamiento a perseguir, multar y prohibir las carreras callejeras que muchos ""ciudadanos"" realizan aprovechando las bicicletas del ayuntamiento, fuera vandalismo de nuestra ciudad! </p>
";"08/09/2015 14";"119";"100";"19";"1";"872204804";"6806"
"2010";"Prohibir el aparcamiento de los vehículos más contaminantes a los no residentes";"<p>Para reducir drásticamente la contaminación en ciertas zonas de la ciudad, bastaría con prohibir el aparcamiento de los vehículos más contaminantes a los no residentes, sin necesidad de impedirles el paso ni sancionarles por ello, ya que es posible que algún conductor tenga que pasar a dejar o recoger a algún no residente, o persona de movilidad reducida, o acceder a algún garaje particular...</p>
";"08/09/2015 14";"69";"27";"42";"8";"851603191";"-586"
"2011";"Escuelas municipales de música y danza de Madrid";"<p>Próximamente empezara el curso 2015-2016 en las escuelas municipales de musica y danza. Todos los partidos politicos -excepto el PP- estaban por realizar la remunicipalización de dichos centros. Espero que lo hagan lo más rápidamente y a lo largo de este curso, ya que la gestión privada no es lo más adecuada ni razonable, como se ha comprobado desde hace ya muchos años.</p>
";"08/09/2015 14";"59";"45";"14";"4";"867679075";"2364"
"2012";"Remodelación Av. Rosales (Villaverde) YA !!";"<p>Ya es hora de que impulsen de una vez la remodelación de la Avenida de Rosales en Villaverde, desde la zona del Tanatorio M40 hasta Villaverde Bajo. Mejoraría el acceso peatonal a la zona de la Caja Mágica (y Bricomart, Mercadona, Tanatorio...) para todos los habitantes de Villaverde. La M40 lleva 30 años hecha y seguimos con la fractura que provocó.</p>

<p>El debate sobre la remodelación de esta avenida lleva ya 10 años abiertos en la web del Espinillo (http://www.espinillo.org/foros/foroppp.php?foro=6&amp;tem=2701). No creen que ya está bien?</p>
";"08/09/2015 14";"39";"31";"8";"2";"867084275";"1828"
"2013";"Centro comercial frente al Matadero";"<p>Parece que el centro comercial Plaza Río 2 sigue construyéndose. Sin entrar ni salir en su estética (kitsch y hortera para unos, estupenda para otros) sigo preguntándome si alguien ha hecho un estudio serio del impacto de dicho centro en el tráfico de la zona. No sé si pretenden tener algún acceso por la avenida del Manzanares, pero teniendo en cuenta que la salida de la M-30 desemboca precisamente en ese tramo de la avenida del Manzanares, el caos automobilístico que se crearía sería realmente peligroso. Si la salida de Santa María de la Cabeza/carretera de Toledo ya está habitualmente atascada, el resultado puede terminar siendo un atasco continuo en el túnel de la M-30. ¿Va a hacer el nuevo gobierno algo respecto a este tema?</p>
";"08/09/2015 14";"66";"36";"30";"5";"860839346";"327"
"2014";"Ampliar la apertura del monte de El Pardo";"<p>Actualmente solo una pequeña parte de El Pardo está abierto al publico, quedando el resto como una reserva natural. Creo que se puede ampliar un poco las zonas abiertas sin afectar a la fauna existente. Aunque sea se pueden organizar visitas limitadas, guiadas (trekking, bici, caballos,..) para de paso generar algun puesto de trabajo como guia forestal y controlar que se mantiene en buen estado.</p>
";"08/09/2015 14";"45";"25";"20";"0";"860055580";"277"
"2016";"Sustituir residencias de ancianos por proyectos de co-vivienda de mayores";"<p>Cohousing o co-vivienda es el nombre con el que internacionalmente se designa a las comunidades de vida y cuidados compartidos o comunidades autogestionadas de mayores. Es una alternativa a las residencias de ancianos y centros de día que hace hincapié en la colaboración y la convivencia.</p>

<p>Estas experiencias responden a las necesidades asistenciales de colectivos muy concretos, como son las personas mayores o personas con alguna dependencia, que buscan residir en un entorno orientado a su desarrollo vital, cultural, social y de ocio y a su salud y bienestar.</p>

<p>La participación en todo lo que atañe a la gestión del espacio y de las actividades en él desarrolladas es el componente básico de este tipo <em>comunidades autogestionadas</em>. Todas las personas colaboran en la medida de sus capacidades y en función de sus propias necesidades en la búsqueda, diseño, gestión y planificación de las viviendas, espacios comunes y servicios que desean compartir. Se desarrollan proyectos orientados igualmente a favorecer su inserción y la dinamización social del pueblo o barrio donde estén implantados. La ecología y sostenibilidad son elementos también importantes en las construcciones de nueva planta desarrollada por este tipo de comunidades de vecinos.</p>

<p>A diferencia de otras grandes ciudades europeas, en los que estas experiencias se implantaron hace mucho tiempo, en en Madrid no existe (que sepamos) ningún tipo promoción, desarrollo ni financiación municipal hacia las mismas.</p>

<p>La implantación y desarrollo de proyectos municipales de co-vivienda en Madrid podría suponer potenciar la vida activa de las personas mayores y dependientes, su inserción social, sus cuidados y, con todo ello, una drástica mejora de su calidad de vida y una importante reducción de los costes asistenciales para la ciudad de Madrid.</p>
";"08/09/2015 14";"73";"53";"20";"3";"867292951";"2395"
"2017";"Sustitución del chirimbolo de Plaza de Castilla de nuevo por fuente.";"<p>Hay pocas cosas más horrendas en el paisaje de Madrid como el chirimbolo donado por Caja Madrid a la ciudad que hay en Plaza de Castilla. Propongo quitarlo y poner una fuente hecha con mejor gusto o cualquier cosa que no dañe la vista.</p>
";"08/09/2015 14";"96";"67";"29";"6";"867364098";"2652"
"2022";"Suprimir los aparcamientos para Funcionarios";"<p>Los Señor@s funcionari@s de Justicia y de otros Ministerios tienen plazas reservadas de 08:00 a 15:00 en sus lugares de trabajo. Por ejemplo, en el barrio de Justicia ocupan las zonas SER verdes para vecinos aludiendo que son zonas de seguridad en el horario de trabajo de 8 a 15 horas.</p>

<p>Esto está en contra del uso del transporte público, de la contaminacion en los barrios del Centro y es un abuso para los vecinos.</p>
";"08/09/2015 14";"249";"209";"40";"10";"874990761";"14185"
"2023";"Maquinas para reciclar latas.";"<p>Me gustaría que en vez de poner las latas de bebidas vacias en los contenedores que corresponde, existieran máquinas como en otros paises de Europa, que vas metiendo las latas y te lo convierten en dinero canjeable en supermercados o similares..... Por que encima tienen que lucrarse los demás con mi reciclaje?</p>

<p> </p>
";"08/09/2015 14";"188";"180";"8";"9";"877684151";"16468"
"2024";"Bajada de impuestos y cotizaciones a la Seguridad Social";"<p>Me gustaría que bajaran los impuestos en especial las cotizaciones para que el contribuyente pueda optar por un sistema de ahorro privado en vez de un sistema tan desastroso como es el actual sistema de pensiones público.</p>
";"08/09/2015 14";"52";"29";"23";"3";"860845625";"334"
"2028";"Horarios locales nocturnos";"<p>Habría que estar más pendiente de los horarios de los locales situados en los bajos de los portales vecinales que cierran cuando les apetece con el agravio para los vecinos de estar todos los fines de semana con voces hasta las 7 de la mañana. Pongo de ejemplo el pub situado en la calle Horcajo de Villaverde Alto. Mis hijas no pueden dormir en la habitación que da a esa calle porque es imposible hacerlo por el escándalo de las personas que acuden durante toda la noche. Si va la policía es peor, porque no les cierran el local, con lo que ellos sólo bajan el cierre con lo que se pasan toda la noche subiendo y bajando el cierre a parte de lo anteriormente expuesto.</p>
";"08/09/2015 15";"50";"40";"10";"3";"868186439";"2400"
"2030";"Convertir las farolas en productores de energía eólica";"<p>Ya que Madrid cuenta con un número muy grande de farolas, la idea sería convertir las que se puedan (ya sea porque tienen espacio suficiente o porque puedan soportar un peso extra) en productoras de energía.</p>

<p>Consistiría en  adaptar a estas farolas un aerogenerador de dimensiones adecuadas, como los que hay para uso doméstico. Y aunque este tipo de generador no genera mucha energía (400W-800W según tamaño), si contamos el número de farolas que existen en la capital, nos podríamos autoabastecer de energía limpia.</p>
";"08/09/2015 15";"70";"55";"15";"11";"869164156";"3142"
"2034";"programa piloto con el ESPERANTO para acelerar el aprendizaje de idiomas";"<p>Buenos días:</p>

<p>Como presidente de la Sociedad Juvenil de Esperanto en España y como uno de los comisarios en la Asociación Mundial Juvenil de Esperanto me veo en posición de sugerir que se analicen seriamente estos estudios y que se pongan en contacto con los organizadores de Springboard to languages para los detalles más actuales https://es.wikipedia.org/wiki/Valor_proped%C3%A9utico_del_esperanto</p>

<p> </p>

<p>Como la sugerencia puede despertar demasiados prejuicios en toda la gente ignorante sobre este idioma (yo hace 4 años por ejemplo) pido que se conside realizar un programa piloto en algunas escuelas públicas de Madrid donde se lleve a cabo la enseñanza del esperanto. Es un idioma que está em continua expansión, por ejemplo hora mismo hay 100000 personas aprendiendo esperanto en Duolingo en 3 meses, y es de esperar que en un año o menos esté traducido en español. http://duolingo.com/course/eo/en/Learn-Esperanto-Online</p>

<p> </p>

<p>Teniendo en cuenta que cada vez se estudia el inglés durante más tiempo (en mi caso ya una década de duro aprendizaje) la enseñanza anterior del esperanto además de motivar a los alumnos en el aprendizaje de idiomas, etc. y otros muchos beneficios personales que no vienen a cuento ahora, ahorraría fácilmente un tercio de esos años que pueden servir para otras asignaturas o para subir aún más el nivel del inglés, un idioma que resulta tan necesario en esta época. Yo sin embargo ya aprendo chino porque gana cada vez más peso (a tener en cuenta en las escuelas también) e igual que pasamos del francés al inglés, pasaremos al chino si seguimos sin llegar a un camino medio y sin imposiciones ineficientes.</p>

<p> </p>

<p>Con este paso, además, creo que se construirían los cimientos para que otras ciudades y países imiten este enfoque e indirectamente creáramos una Europa más justa y eficiente, una europa de pueblos y no solo monetaria o legislativa, y un madrid más multicultural donde los idiomas por minoritarios que sean crezcan en valor y respeto junto a toda la cultura étnica que comportan. El esperanto sale vencedor es en el informe del profesor suizo Grin realizado objetivamente y con estimaciones de ahorro para todos los estados miembro muy conservadoras.http://es.wikipedia.org/wiki/Reporte_Grin En parte el resultado se debe a que es un idioma considerablemente menos difícil de aprender que los étnicos, que busca ser simplemente un segundo idioma y que funciona realmente bien para lo que fue diseñado, servir de puente más justo y eficiente entre gentes sin imponernos la lengua más fuerte de turno.</p>

<p>En cuanto a conseguir profesores no habría problema pues sabiendo ya inglés lo aprenderán rápido. He comocido a un chico catalán de 15 años que aprendió en su casa esperanto y a los seis meses llegó a un congreso y consiguió su título B2 (y el C1 lo tenía seguro pero quiso asegurarse). Yo soy un caso parecido aunque ya sabía inglés y francés por lo que en tres meses ya llegaba a ese nivel. </p>

<ul>
	<li>Info sobre el esperanto en http://es.ligilaro.wikia.com/wiki/ligilaro</li>
</ul>

<p> </p>
";"08/09/2015 15";"91";"29";"62";"4";"851432577";"-1051"
"2036";"Reapertura de los ""Montes de Piedad"" para I+D+I.";"<p>Con dicho nombre se conoce a lo que posteriormente darían lugar a las famosas cajas que saquearon los políticos. Para ello podrían estar dirigidas por profesionales elegidos mediante una prueba de acceso u oposición de concurso público, a la que los mejores formados pudieran optar.</p>

<p>De esta forma poder costear a pequeños emprendedores, en especial en el apartado I+D+I (creo absolutamente necesario para el desarrollo de la ciudad).</p>

<p>Importante que sea un organismo, aunque dependiente del Ayuntamiento, que esté libre de los que en él mandan, sean del signo que sean.</p>
";"08/09/2015 15";"35";"27";"8";"0";"866202767";"1465"
"2038";"Modificación urgente de la normativa del ruido de Ana Botella";"<p>La ordenanza contra el ruido fue un instrumento político de Ana Botella para acabar con las fiestas del Orgullo Gay. El artículo que prohibe cualquier tipo de manifestación sonora a menos de 250 metros de cualquier centro socio sanitario fue el argumento que utilizó el partido popular para desmembrar las fiestas del Orgullo Gay y desnaturalizarlas, logrando eliminar de un plumazo los escenarios de la plaza de Pedro Zerolo y de la emblemática plaza de Chueca. Si bien la protección del descanso es un derecho y encuentro razonable esa claúsula, no así su ámbito de aplicación, que debe incluir una excepción a las fiestas populares o a los eventos de interés público.</p>

<p> </p>
";"08/09/2015 15";"64";"30";"34";"5";"854094382";"-187"
"2041";"Camiones de la basura nocturnos y ruidosos";"<p>Comprendo que es un buen momento de recoger la basura, a las dos o las tres de la mañana, pero teniendo en cuenta el ruido que hacen estos vehiculos al maniobrar sus mecanismos para cumplir su funcion, he de decir que si bien esto molesta menos en calles anchas y pisos altos, tenemos un gran problema los pisos primeros y mas cercanos a la calle y encima situados en calles estrechas. En Tetuan esto es todas la noches y eso conlleva despertar a los vecinos madrugadores a una hora en la que retomar el sueño se hace muy costoso. </p>

<p>Me gustaria que se encontrara una solucion mas llevadera por ambas partes.</p>
";"08/09/2015 15";"72";"62";"10";"17";"871520006";"4477"
"2042";"Fusión de distritos para ahorrar costos.";"<p>Como ya se ha venido haciendo en otros países (por ejemplo Francia) uniendo comunas, o aquí mismo en nuestra Comunidad, compartiendo servicios entre diversos pueblos de la región, podrían fusionarse distritos, reduciendo el coste de alquiler de edificios públicos y otros gastos superfluos y de esta manera ahorrar dinero a los madrileños.</p>

<p>Podrían desaparecer así los ""concejales de distrito"" y ahorrarnos salarios de trabajos poco o nada productivos, manteniendo a los administradores en centros más grandes y mejor equipados.</p>
";"08/09/2015 15";"55";"36";"19";"7";"864786527";"1112"
"2043";"Práctica de natación en Agosto";"<p>No existen piscinas municipales para la práctica de natación (con carriles habilitados) que no sean cubiertas, por lo que en Agosto que cierran las piscinas municipales cubiertas simplemente este servicio desaparece.</p>

<p>Esto implica que personas que por enfermedad o por deporte quieran practicar la natación en Agosto tengan que ir a otro munipio o recurrir a centros privados.</p>

<p> </p>
";"08/09/2015 15";"40";"37";"3";"2";"870632583";"3145"
"2044";"Cambiar el nombre del Parque Carlos Arias Navarro";"<p>Nadie en el barrio, ni en la ciudad, nombra a este parque ubicado en el barrio de Aluche usando el nombre de Carlos Arias Navarro.</p>

<p>En su lugar, propongo renombrarlo a ""Parque Aluche""</p>
";"08/09/2015 15";"70";"34";"36";"6";"856424048";"-97"
"2045";"Penalizar deterioro de solares urbanos";"<p>En Carabanchel hay varios solares que quedaron sin edificar. Algunos de ellos, como puede verse en la calle Eugenia de Montijo a la altura del  número 60, se han convertido en basureros incontrolados, lo cual puede ser foco de infecciones o incendios. Propongo multar duramente a los dueños de esos solares si no los mantienen limpios y seguros para el barrio. En el caso de que esos solares sean de titularidad pública exijo limpieza inmediata.</p>
";"08/09/2015 15";"71";"68";"3";"8";"873917738";"6225"
"2046";"Desprivatizar Actividades Extraescolares en Colegios Públicos";"<p>Los Monitores de Ocio y Tiempo Libre llevamos sufirendo durante muchos años la falta total de respeto por nuestra profesión. Quien haya ejercido alguna vez, sabrá la miseria que se cobra, y más si se tiene en cuenta la gran responsabilidad que tenemos al estar trabajando con niños. Además de eso, todos los veranos nos quedamos sin trabajo, de cobrar vacaciones ni hablamos, y cada mes de Septiembre tenemos que empezar de cero y volver a echar nuestro currículum en la empresa de turno que se haya llevado el gato el agua con el mínimo presupuesto. Esto, además de suponer para nosotros un trabajo totalmente precario, influye además en la calidad de las actividades que se ofrece a los niños. Todos los que hemos trabajado en esto, sabemos que rara vez hay un coordinador en el centro, por poner un ejemplo.</p>

<p>Mi propuesta es que el ayuntamiento se haga cargo de las actividades extraescolares de los Colegios Públicos, creando una oficina con personal especializado que además de hacer la programación de todas las actividades para ofertarlas a los centros según sus necesidades, gestione los contratos de todos los monitores, dignificando de una vez esta profesión tan necesaria y tan poco valorada.</p>
";"08/09/2015 15";"53";"34";"19";"17";"864824842";"962"
"2047";"Menos gasto en cosas innecesárias";"<p>Seamos sinceros, Madrid no necesita un huerto. Cuando aumente el déficit con estas medidas de gasto desproporcionado y con ello la deuda no vamos a pagar a los acreedores con tomates. Tampoco necesitamos un carril bici, más bocas de metro o comedores sociales para niños desnutridos que no existen. Mi propuesta es menos gasto y cuando hayamos pagado la deuda menos impuestos. Basta de asfixiar al contribuyente.</p>
";"08/09/2015 15";"53";"23";"30";"7";"853098209";"-303"
"2049";"Limpieza,poda y caquitas perrunas en Simancas";"<p>En el barrio de Simancas tenemos muchos  arboles que estan muy descuidados, las hojas estan ""picoteadas"" y en los pisos mas altos que estaban cerca de las copas de los arboles, durante el verano no han dejado de entrar bichitos verdes. El barrio esta muy sucio y descuidado, necesitamos una solucion a los portales de Castillo de Simancas, ya que en la parte de atras del portal van todos los perros a hacer sus cositas y ahi se quedan, los dueños son unos irresponsables, necesitamos ayuda! </p>
";"08/09/2015 15";"38";"32";"6";"3";"868492846";"2189"
"2050";"La Policía Municipal al servicio del ciudadano.";"<p>Tengo 57 años vividos todos en Madrid. De acuerdo a mi larga experiencia como ciudadano madrileño, la Policía Municipal de Madrid a pesar de ser una de las mejores pagadas es de las menos efectivas. Estoy en condiciones de afirmar que nunca me han ayudado o han hecho nada por mí. Si  he requerido sus servicios, generalmente por ruidos nocturnos, coches abandonados etc. no han acudido y si he insistido en la centralita me dicen que están ocupados en cosas más importantes. Eso sí, mi contacto directo con ellos ha sido siempre como receptor de multas e incluso de alguna extralimitación de autoridad con paripé incluido a nivel de mentalidad tercermundista. Como recaudadores no tienen precio, eso sí sigo esperando que hagan algo positivo cuando lo necesite como ciudadano y como tal sienta que el gasto de tener una policía propia sirva para algo contructivo.</p>
";"08/09/2015 15";"49";"40";"9";"2";"868703449";"2530"
"2052";"Acceso a debates eliminados";"<p>Buenos días,</p>

<p>sería mejor que los debates eliminados fueran accesibles, a modo de historico, desde el combo de tipo de debates. Así se evitan suspicacias de si se han eliminado hilos por motivos políticos u otros, y ver que se han eliminado por estupideces.</p>

<p>Un saludo.</p>
";"08/09/2015 15";"39";"29";"10";"7";"866359481";"1412"
"2053";"BASURA, CHATARRA Y HECES HUMANAS EN PARQUES";"<p>Algunos colectivos acampan en parques públicos, machacan aparatos electrónicos y chatarra, y <strong>utilizan setos para hacer sus necesidades</strong>, usan las alcantarillas y setos para guardar enseres y comida, <strong>dejando basura</strong> repartida. </p>

<p>Es un problema de pobreza y supervivencia, pero en muchas ocasiones no se respetan los espacios públicos y se crean problemas de contaminación química y acústica, <strong>salubridad</strong>. Nuestros parques son para el disfrute de todos, y todos tenemos que cuidarlos.</p>
";"08/09/2015 15";"72";"69";"3";"10";"874104768";"6325"
"2054";"Plataforma por el fomento de peñas béticas en Madrid";"<p>Muy buenas a todos, soy José Antonio Perez Chaves, sevillano de nacimiento pero madrileño de facto. Desde que vivo en la gran ciudad he estado afiliado a una peña bética del barrio en el que vivo, y últimamente se comenta las dificultades en la ley que hay para este tipo de asociaciones. No pudimos ir al Bernabeu, y es más, es probable que no podamos ir a ver a nuestro Betis cuando juegue contra los equipos grandes de la capital debido a faltas de presupuesto y problemas legales. Señora Carmena, nosotros queremos ver a nuestro Betis al Calderón, a falta de nuestro querido Villamarín. Por favor, destine menos dinero público a refugiados extranjeros y dedíquelo a las peñas del Betis y a los pobres sevillanos  que echamos de menos los goles de Rubén Castro en directo. Muchas gracias por escuchar mi propuesta y espero con ansia la resolución.</p>
";"08/09/2015 15";"49";"10";"39";"3";"853437709";"-591"
"2055";"Permitir a gente con VIH acceder a la policía municipal y al cuerpo de bomberos";"<p>Según la normativa actual, una persona seropositiva no puede optar a los puestos de bombero ni de policía municipal porque se considera que n tienen salud suficiente para el desempeño de dichos puestos de trabajo. Sin embargo, esto contradice a todos los estudios actuales. La esperanza y la calidad de vida de los infectados por el Virus de Inmunodeficiencia Humana ha crecido contundentemente en las últimas dos décadas y los estudios epidemiológicos demuestran que contagios profesionales de estas características son casi imposibles más cuando la persona está en tratamiento. De tal modo que no permitir a estas personas entrar en los procesos selectivos a las fuerzas de seguridad (tanto municipales como estatales) es un remanante de discriminación que nada tiene que ver con la salud. Sería conveniente empezar dando ejemplo y no poner más trabas a las personas que tienen que vivir con esta condición.</p>
";"08/09/2015 15";"55";"25";"30";"8";"854049919";"-227"
"2056";"Revisión de las prohibiciones municipales que implantó el Partido Popular";"<p>El partido popular jamás entendió Madrid ni a los madrileños. Durante estos 24 años nos han atado con prohibiciones que mas allá de ordenar la convivencia, lo que han hecho es castrar nuestra idiosincrasia, borrar la identidad de la ciudad y transformarla en una ciudad cualquiera del norte de europa. Hay que recuperar lo mejor del Madrid que nos han robado y para ello hay que revisar el listado de prohibiciones municipales del partido popular. </p>

<p> </p>
";"08/09/2015 15";"44";"18";"26";"2";"852905611";"-327"
"2057";"Instituto José de Acero como garante de Seguridad Ciudadana.";"<p>Un saludo ciudadanos.</p>

<p>Proponemos que el <strong>Instituto de Estudios Estratégicos José de Acero</strong> tome las riendas de la Policía Municipal de Madrid para garantizar la Seguridad Ciudadana, mediante estrictos protocolos de actuación que impidan la celebración de cualquier acto subversivo, así como controlar las conversaciones que vayan en contra de los intereses del Ayuntamiento de Madrid y, por extensión, del Reino de España. Podéis consultar nuestra línea de pensamiento en la cuenta de Twitter <strong>@InstJosedeAcero</strong>, dirigida por los miembros de nuestro aparato de Comunicación.</p>

<p>Así mismo, solicitamos que el Colegio Mayor Universitario San Juan Evangelista, ""el Johnny"", pase a ser base permanente de nuestro glorioso Instituto, para mayor grandeza de la capital y poder servir de faro de esperanza a toda la comunidad universitaria, convirtiéndonos en su referente moral.</p>

<p>Larga vida al José de Acero.</p>

<p> </p>

<p>Excmo. Secretario General del I.E.E. José de Acero                    Excmo. Director del I.E.E. José de Acero</p>
";"08/09/2015 15";"20";"5";"15";"4";"853872091";"-250"
"2058";"Carril bici en condiciones";"<p>Hay muchas zonas de Madrid donde el carril bici está en una calidad deplorable. Grietas, baches, o piedras hacen que un trayecto en patines sea IMPOSIBLE. Hablo por mí y por el carril bici que recorre la zona de La Peseta, el cual no debe de tener más de 15 años y sin embargo parece que lleva ahí desde la transición.</p>
";"08/09/2015 15";"47";"37";"10";"5";"868016363";"2125"
"2060";"Escuelas de idiomas Municipales";"<p>Ampliar las EEII de la Comunidad favoreciendo que cada vez los madrileños dominen mas idiomas a un precio asumible por cualquiera</p>
";"08/09/2015 15";"42";"36";"6";"0";"869260004";"2571"
"2061";"Más contenedores de reciclado en la zona centro";"<p>Lamentablemente, Madrid es una de las ciudades donde es más difícil reciclar la basura. Me cuesta encontrar contenedores de reciclado de vidrio, envases y papel en la zona Centro de Madrid.</p>

<p>Sería interesante que el ayuntamiento y las contratas de basura colocaran más contenedores y elaboraran un mapa de dónde se encuentran éstos.</p>
";"08/09/2015 15";"26";"21";"5";"4";"866566725";"1292"
"2062";"Crear puntos de servicios integrados al ciclista: parking, duchas, vestuarios.";"<p>Parece quedar demostrado que un límite a la expansión del uso de la bici es lo que pasa después de haberla utilizado: donde dejarla aparcada en condiciones de máxima seguridad y cómo podernos cambiar/asear si hemos estado sudando al pedalar, sobretodo en verano. Se propone estudiar de qué manera el ayuntamiento  podría favorecer el surgimiento de espacios (de iniciativa pública, privada o mixta) donde se proporcionen una serie de servicios básicos al ciclista: aparcamiento seguro, reparación, duchas y vestuarios, otros.</p>

<p>En algunos casos probablemente no haría fala crear nuevos espacios, sino permitir un nuevo o mayor uso de espacio existentes. En cuanto al aparcamiento, ya existen empresas que subalquilan plazas en garajes privados para ponerlas a disposición de bicicletas. Por otro lado, muchos baños de edificios públicos (sobre todo instalaciones deportivas) podrían ampliar su utilización a usuarios ciclistas, previo la creación de una tarjeta de servicios integrados al ciclista. Quizás el ayuntamiento podría explorar también la posibilidad de animar a las empresas de mayor tamaño para que alojen dentro de sus sedes una parte de estos servicios, por ejemplo colocando duchas y vestuarios para los empleados.</p>
";"08/09/2015 15";"70";"24";"46";"0";"851998602";"-754"
"2064";"Escuelas de idiomas Municipales";"<p>Ampliar las EEII de la Comunidad favoreciendo que cada vez los madrileños dominen mas idiomas a un precio asumible </p>
";"08/09/2015 15";"7";"5";"2";"1";"860255631";"214"
"2066";"Extender la línea 8 de Metro hasta Mercamadrid";"<p>Me gustaría que se estudiara la posibilidad de alargar la línea 8 de Metro hacia el sur, ya que en mi opinión no está demasiado bien planteada. Estaría bien que la alargaran hasta Mercamadrid pasando por Atocha, Méndez Álvaro y Entrevías, ya que Atocha y Méndez Álvaro son estaciones con intercambiadores importantes por las que sólo pasa una línea de Metro, Entrevías es un barrio residencial sin Metro y Mercamadrid también carece de Metro (lo que causa problemas de tráfico en las carreteras adyacentes).</p>
";"08/09/2015 15";"29";"25";"4";"2";"868120696";"1810"
"2068";"PEATONALIZACION MADRID CENTRO ";"<p>No entiendo como este debate no es importante en su programa, tenemos un deficit enorme de calles peatonales comparadas con otras grandes ciudades Europeas y Españolas.</p>

<p>Hay que sacar coches particulares del centro, la contaminacion es tremenda. Los que vivimos en esas calles centricas y que no usamos </p>

<p>coches tenemos que tragar toda la porqueria que estos generan. Pero sobre todo es devolver la calle a la gente.</p>

<p>Todo la almendra central deberia ser peatonal, la calle fuencarral no se a que esperan a prolongar su peatonalizacion hasta calle Barcelo, y asi muchas calles mas. </p>

<p> </p>

<p> </p>
";"08/09/2015 15";"88";"69";"19";"5";"870079360";"3920"
"2069";"Arboles peligrosos en el Ensanche de Vallecas";"<p>En el Ensanche de Vallecas alguien decidió poner abetos en las aceras cerca de las esquinas con las carreteras. Este tipo de árbol son de copa baja e impiden, en muchas ocasiones la visibilidad de los conductores, incluso en paso de peatones cercanos a centros escolares, de hecho, ya ha habido varios sustos en los que niños pequeños han estado a punto de ser atropellados. ¿no sería mejor cambiar este tipo de árboles?</p>
";"08/09/2015 15";"43";"34";"9";"2";"867784188";"1976"
"2070";"La fábrica PSA Peugeot Citröen: explotando más que generando trabajo.";"<p>Muchos madrileños (cada vez menos) trabajan o han trabajado en esta fábrica y no sé si saben cómo anda ahora mismo la situación. Todos sabemos que el capitalismo supuestamente beneficia al empresario para que este ayude a los trabajadores pero el tema no funciona así ni de lejos, pero una cosa es levantar la mano en ciertos aspectos por, digamos, resignación ante el típico ""al menos tienes trabajo"" y otra dejar que las empresas privadas se aprovechen de nuestros impuestos sistemáticamente y a cambio de nada.</p>

<p>No solo el presidente de PSA se ha subido el sueldo (http://www.lavozdegalicia.es/noticia/economia/2015/04/09/presidente-psa-dispara-nomina-211-obliga-bajar-sueldos-vigo/0003_201504G9P34993.htm) mientras que los empleados lo tienen congelado - cosa que, si permiten los altos cargos, no se puede remediar - sino que esta empresa, como muchas otras, pide ayudas a la Comunidad de Madrid casi cada año para EREs y derivados cuando no lo necesitan en absoluto. Entiendo que la Comunidad, sobre todo con la mentalidad del PP, les dé todo lo que pidan, pero que no engañen diciendo que esto beneficia a los madrileños y demás trabajadores. Ahora mismo está habiendo ""despidos"" (no son despidos como tal, por ahora, solo dejan de renovar o le dan a la gente la alternativa de seguir trabajando en el extranjero o irse a su casa) porque quieren que el coste del nuevo Citröen C4 Cactus baje de 1000 euros a 750, para sacar más beneficio que obviamente no va a ir a parar a los empleados, como pueden deducir. De mano de obra ""rasa"" ya van muy justitos (no hay problema porque ya la van sustituyendo por robots) y están ""despidiendo"" a personal de oficina, que cobra más. Y a saber hace cuánto tiempo que no hacen fijo a nadie. Esto es algo que se puede comprender en una empresa en pérdidas, pero frustra y cabrea que lo hagan empresas que se están beneficiando y mucho con la excusa de que aún hay crisis.</p>

<p>Porque, mientras toman estas medidas de recorte escudándose en que tienen muchas pérdidas, se sabe que sus ventas han subido http://psa-peugeot-citroen.com.ar/2015/01/el-grupo-psa-peugeot-citroen-dio-conocer-los-resultados-comerciales-de-2014/ y que, además, tienen pensado hacer muchísimos más coches el año que viene http://www.actualidadmotor.com/100-000-unidades-la-proxima-meta-del-citroen-c4-cactus/. Más de lo que pueden permitirse con la mano de obra que tienen ahora, por lo que seguramente se nutran de las ETTs. Con lo cual, están metiendo la típica bola a la patronal y la CCAA (y no sé si al ayuntamiento) para que los traten como a dioses mientras ellos tratan a sus empleados, que son las personas gracias a las cuales esos coches sale a la calle, como basura.</p>

<p>Desde aquí solo quiero dejar clara la situación para que la gente lo sepa, porque no creo que se pueda hacer mucho. Eso sí, no les den ni un duro desde el ayuntamiento porque hay cosas mucho más importantes en las que invertir y ellos realmente no lo necesitan.</p>

<p> </p>

<p>Un saludo.</p>
";"08/09/2015 15";"16";"9";"7";"2";"858828657";"112"
"2071";"Impulsar cierre del CIE ""de Aluche"" y conversión en Museo de la Memoria";"<p>El llamado CIE ""de Aluche"" es realmente el único edificio que queda en pie de la antigua cárcel de Carabanchel. A pesar de su denominación, se encuentra en el distrito de Carabanchel. </p>

<p>En todos los países democráticos se han reconvertido instalaciones que fueron lugares de represión en espacios memoriales y pedagógicos para mostrar los hechos ocurridos, como mejor garantía de la NO-repetición de los mismos.</p>

<p>Quizás el espacio más significativo en nuestro país fue la cárcel de Carabanchel. Su construcción empezó hace ya 75 años y, desde hace más de 10, el edificio del CIE (antiguo Hospital Penitenciario) es utilizado -nuevamente- como centro de reclusión.</p>

<p>Ya está bien. </p>
";"08/09/2015 15";"52";"31";"21";"0";"862612619";"596"
"2072";"Aumentar Impuestos a viviendas vacías y en alquiler ";"<p>Aumentar progresivamente los impuestos a las viviendas vacias y a quién disponga de mas de una viviennda adicional en Madrid. Se gravaría en función de la renta y propiedades del propietario.</p>

<p>No se debe utilizar la vivienda para lucrarse, es un derecho. No se debe permitir que alguien pueda vivir de disponer de varios pisos y lucrarse de los demás subiendo el precio de compra de las viviendas</p>
";"08/09/2015 15";"50";"21";"29";"4";"852975838";"-336"
"2073";"Cobrar tasa a los propietarios de perros";"<p>Quien tiene un perro debe ser responsable de su comportamiento.</p>

<p>Las calles y los parques estan repletos de heces y suciedad generada por los perros que debemos sufrir todos los demás ciudadanos.</p>

<p>Hagamos que los propietarios de los perros contribuyan al mantenimiento y limpieza de los parques, y que esta tasa que se propone sirva para financiar el servicio de recogida de heces.</p>
";"08/09/2015 15";"86";"43";"43";"10";"858194449";"0"
"2074";"No a la censura en los debates.";"<p>¿Quién decide si un debate es debatible o no? Si se hace con educación, no entiendo porque se borran. Si alguien quiere un monorail por ejemplo es tan respetable como cualquier otra propuesta, aunque sea una minoría los que lo quieran y no prospere la propuesta. No todo lo que considero importante para mi lo puede ser para los demás, pero hay que respetar las opiniones de todos.</p>

<p> Por muy absurda que sea la propuesta, pido que no se censure y que se permita opinar. Y el que no esté deacuerdo que vote en contra, pero que no se borre, siempre que se exponga con educación, para eso estamos en democrácia.</p>
";"08/09/2015 15";"61";"48";"13";"8";"869050099";"2754"
"2075";"Restaurar el frontón Beti-jai";"<p>Lleva años hablándose de reformar este edificio emblemático y sigue aplazándose hasta que termine calléndose.</p>
";"08/09/2015 16";"49";"43";"6";"4";"870556722";"3246"
"2076";"Oficina gratuita de intercambio de favores";"<p>Todos sabemos hacer algo y podemos ayudarnos mutuamente. Tendría que ser algo en lo que el ciudadano se apunte indicando el favor que desea recibir y lo que está dispuesto a ofrecer a cambio. Todo de forma totalmente gratuita. Por ejemplo, si yo sé inglés y quiero aprener a tocar un instrumento de música y un músico quiere aprender inglés, pues el uno ayuda al otro y ya está el intercambio. La oficina se ocuparía de recoger las habilidades e intereses de los ciudadanos y de conectar a las personas adecuadas.</p>
";"08/09/2015 16";"38";"26";"12";"7";"864942512";"957"
"2078";"Ampliación Metro Linea 3 Villaverde Alto-El Carrascal";"<p>El único acceso a Metro Sur por metro es por una única estación (Puerta del Sur). Tenemos la estación de Villaverde Alto a no llega 5km de distancia de la estación de El Carrascal de Metro Sur. No hay que hacer ni paradas nuevas. Ampliación de las existentes y un corto tunel. Uniría Madrid con Leganes.</p>

<p> </p>
";"08/09/2015 16";"39";"27";"12";"1";"864901520";"1038"
"2083";"Dia del bigote.";"<p>Que se celebre un día como festivo regional donde se exhiban los mejores bigotes de la comunidad. Si funciona festivo nacional!</p>
";"08/09/2015 16";"49";"24";"25";"3";"856733516";"-48"
"2085";"Sustitucion Bolardos";"<p>¿Se deben sustituir los bolardos por elementos más útiles y seguros? </p>

<p>En la actualidadlos bolardos, no visibles a los ojos del conductor, generan daños por doquier.  Las personas mayores se tropiezan, son estéticamente feos puestos en grandes cantidades y son peligrosos en la conducción y aparcamiento</p>
";"08/09/2015 16";"28";"22";"6";"2";"866318004";"1257"
"2086";"Eliminacion del limite de velocidad en tramos selectos del Po. de la Castellana";"<p>Calles anchas, glamour, sonido, velocidad. Porque algunos tramos son perfectos para poder exhibir los mejores automoviles del mundo, gracias a una idea totalmente revolucionaria y unica en el mundo que levantaria rapidamente la economia gracias al turismo high-class.</p>

<p> </p>

<p> </p>
";"08/09/2015 16";"49";"14";"35";"0";"852981633";"-600"
"2088";"Interfaz partidista de la web";"<p>Hola, me gustaría que, a pesar de que la web se haya hecho con un claro objetivo partidista, al menos la interfaz, que utiliza símbolos que representan a <strong>todos los madrileños</strong>. No utilice fotos de las manifestaciones de la puerta del sol y mítines del partido político del régimen gobernante en Madrid.</p>

<p>Madrid es de todos los madrileños y, sobretodo de los que pagamos impuestos para que siga la fiesta y tengáis todo lo que estáis pidiendo por aquí.</p>

<p>Ya que dudo que exista imparcialidad en el moderador, al menos que trate de aparentar.</p>

<p><em>Pido al régimen que no elimine este post.</em></p>

<p> </p>

<p><strong>Gracias.</strong></p>
";"08/09/2015 16";"51";"27";"24";"2";"859608587";"158"
"2089";"Limpieza en los PUNTOS LIMPIOS. ";"<p>Los llamados puntos limpios de Madrid están mugrientos. No se recogen la basuras con la periodicidad suficiente.  Se utilizan como lugares de meadas por la privacidad que da la altura, los suelos de esas zonas no se limpian y muchos están rotos por las mafias que los desvalijan.</p>

<p>Se podrían soterrar, implementar un sistema que no permita sacar lo que se ha metido, aumentar la frecuencia de vaciado,  establecer un protocolo de limpieza especial para esas partes de la acera...</p>
";"08/09/2015 16";"72";"64";"8";"0";"872331204";"4977"
"2090";"Multar las personas que hacen sus necesidades en la vía pública (de todos)";"<p>Esta falta de civismo hay que multarla. Se hace con mucha facilidad y frecuencia en Madrid por falta de conciencia de que el espacio público es de todos. Creo que incluso hay que poner una aplicación para denunciar a las personas que lo hacen.</p>

<p>En las fiestas de que tienen lugar en la capital, la gente hace su necesidades en las calles paralelas a la calle principal donde está teniendo lugar el evento. El ayuntamiento tampoco pone suficientes servicios públicos para evitar que se haga esto.  Esto provocar que varías calles del centro principalmente se convierten en un sitio invivible.  </p>
";"08/09/2015 16";"76";"65";"11";"4";"871695017";"4618"
"2093";"Que el MONORAIL sea de tipo Maglev (Magnetic Levitation) por favor";"<p>El transporte de levitación magnética, o tipo maglev, es un sistema de transporte que incluye la suspensión, guía y propulsión de vehículos, principalmente trenes, utilizando un gran número de imanes para la sustentación y la propulsión a base de la levitación magnética.</p>

<p>Este método tiene la ventaja de ser más rápido, silencioso y suave que los sistemas de transporte colectivo sobreruedas convencionales. La tecnología de levitación magnética tiene el potencial de superar 6.440 km/h (4.000 mph) si se realiza en un túnel al vacío.1 Cuando no se utiliza un túnel al vacío, la energía necesaria para la levitación no suele representar una gran parte de la necesaria, ya que la mayoría de la energía necesaria se emplea para superar laresistencia del aire, al igual que con cualquier otro tren de alta velocidad.</p>

<p>La mayor velocidad obtenida hasta ahora fue de 603 km/h en la ruta Yamanashi el 21 de abril de 2015.2 Unos días antes llegó a alcanzar los 590 km/h,3 el 16 de abril de 2015, en la misma ruta, siendo 15 km/h más rápido que el récord de velocidad del TGV convencional.</p>
";"08/09/2015 16";"48";"28";"20";"1";"862153316";"466"
"2094";"Cambiar el Sistema Internacional de Unidades por el de Unidades Naturales";"<p>Si hacemos la velocidad de la luz en el vacío, la constante de gravitación universal, la constante de Plank reducida, la constante de Coulomb y la constante de Boltzman igual a 1, las ecuaciones de la física se quedan de lo más bonitas, a parte de ahorrar tiempo en la memorización de dichas constantes</p>

<p>Por ejemplo</p>

<p>Relación masa energía: E=mc^2-----&gt;E=m</p>

<p>Fuerza gravitatorio entre 2 masas: F=Gm1m2/r^2-----&gt;F=m1m2/r^2</p>

<p>Viva Gauss!!!</p>
";"08/09/2015 16";"39";"18";"21";"2";"854869402";"-138"
"2097";"Madrid Bici. Primera media hora gratis";"<p>Por dos razones. Primero para incentivar el uso del transporte limpio como hacen otras ciudades en el mundo, y segundo para compensar los constantes fallos del sistema que nos obligan llamar constantemente al 010 para que no se carguen en nuestro saldo desplazamientos que no se producen cuando falla el sistema o las bicicletas.</p>
";"08/09/2015 16";"40";"32";"8";"0";"867861764";"1920"
"2099";"Ampliación de la PIscina municipal arganzuela";"<p>Los vecinos del barrio de Arganzuela contamos con una de las piscinas públicas más pequeñas y concurridas en verano. El espacio es insuficiente para todo el barrio y debemos añadir además la asistencia de campamentos infantiles cada día en julio, los vecinos no tenemos un espacio donde llevar a nuestros hijos los días de calor. Es urgente la ampliación de la misma, ya que es una piscina claramente insuficiente para un barrio tan extenso. El parque de arganzuela, donde se ubica la piscina, esta muy deteriorado, podrían tomar parte del mismo para la ampliación.</p>
";"08/09/2015 16";"45";"39";"6";"3";"870101218";"2860"
"2101";"Reasfaltado con asfalto sonorreductor";"<p>Madrid es una ciudad ruidosa. A este ruido contribuye el hecho de que muchas vías, algunas de ellas principales arterias, llevan dos o tres décadas sin ser asfaltadas. Asfalto antiguo y deteriorado hacen que el nivel sonoro se eleve más de lo que resulta soportable. En algunos casos, el simple sonido de rodadura imposibilida mantener una conversación a quienes transitan por las aceras adyacentes a la vía.</p>

<p>Opino que debería ponerse en marcha un plan para reasfaltar con asfalto sonorreductor algunas de las vías que más tráfico soportan con el fin de:</p>

<ul>
	<li>Renovar asfalto deteriorado</li>
	<li>Eliminar baches y zonas de creación de charcos en caso de lluvia</li>
	<li>Reducir el impacto sonoro del tráfico</li>
</ul>

<p>Conozco un caso particular: la avenida Herrera Oria. En este caso, a razón de unas obras en la red de agua potable, uno de los carriles tuvo que ser reasfaltado. La diferencia de ruido entre los vehículos que transitan por el asfalto nuevo y los que lo hacen por el antiguo es notable. Si además el asfalto nuevo empleado fuese sonorreductor, la diferencia sería aún mayor.</p>

<p>Nadie dice que sea barato, eso sí.</p>

<p>Saludos,</p>
";"08/09/2015 16";"52";"47";"5";"0";"871522338";"3796"
"2103";"Restituir los medidores de contaminación del aire al centro de Madrid";"<p>La anterior alcaldesa, Ana Botella, alejó todos los sistemas de medición de contaminación del aire del centro de Madrid, con el objetivo de no ser sancionada pública y administrativamente por la UE. Desde ese momento, los madrileños no conocen la calidad real del aire que respiran. Va siendo hora de que todos los aparatos de medida medioambientales y de calidad del aire sean restituidos a sus emplazamientos anteriores para que los ciudadanos puedan conocer los niveles de contaminación de la ciudad y tomar medidas preventivas individuales o conjuntas con el Ayuntamiento.</p>
";"08/09/2015 16";"74";"72";"2";"4";"874873869";"6810"
"2104";"Cesión de espacios municipales para actividades de asociaciones de los distritos";"<p>Muchas asociaciones distritales(juveniles, culturales...) están desapareciendo por la pérdida de sus locales, sean cedidos por el IVIMA, o por no poder hacer frente a los alquileres debido al descenso de sus ingresos por las reducciones de subvenciones.</p>

<p>Muchas de estas entidades están ayudando a los vecinos de sus distritos ante la pérdida de recursos municipales, pero no disponer de espacios para realizar sus actividades, también su trabajo se pierde.</p>

<p>En el caso concreto del distrito de hortaleza, entidades como Fray Escoba o Amejhor, se encuentran en esta situación, y los gobiernos anteriores no han apoyado a la supervivencia de estas entidades. Existen espacios abandonados o sin uso, que podrían albergar a estas entidades, permitiendo que continúen ejerciendo su labor. </p>

<p>Existen espacios como el edificio que albergaba el primer ciclo de educación secundaria del instituto conde de ordaz, actualmente en situación de total abandonó, pero con espacios para albergar las actividades de varias entidades. En este caso, la negociación con otros estamentos públicos, como la comunidad de Madrid, podría solucionar la falta de espacios y aprovechamiento de recursos en desuso</p>
";"08/09/2015 16";"45";"34";"11";"1";"867208610";"1737"
"2105";"Extinción de las Kundas en embajadores";"<p>Estamos hartos, no podemos seguir así, nuestros hijos tienen que convivir a diario con grupos de drogodependientes que vagan por nuestras calles, que cagan y mean en las aceras y dejan jeringuillas usadas en nuestros portales. Por favor, basta ya de mierda. Estamos desesperados, la calle Martín de Vargas  parece una cloaca, y la glorieta de embajadores la parada de los monstruos. </p>
";"08/09/2015 16";"148";"145";"3";"1";"877972282";"13912"
"2107";"Ambulatori de El Pardo abierto las 24 horas";"<p>La gente que vive en en El Pardo, apartir del Viernes por la tarde se queda si sanidad y si tiene una urgencia, tiene que rezar para que venga una ambulancia</p>
";"08/09/2015 16";"20";"12";"8";"0";"860505697";"240"
"2109";"Quitar los radares de salto de semáforo en rojo";"<p>Opino que este tipo de radares lo único que fomenta son los frenazos en seco en cuanto el conductor ve ponerse en semáforo en color ambar. </p>

<p>Bastante atentos tenemos que ir ya de no superar los 70 km/h en tunel, que muchas veces vas más pendiente del cuentakilómetros que de la carretera, como para también tener en cuenta los posibles frenazos o comportamientos extraños de la gente ante este tipo de radares.</p>

<p> </p>

<p> </p>
";"08/09/2015 16";"36";"20";"16";"3";"860635365";"222"
"2113";"Cambios en los impuestos";"<p>Estaría bien hacer cambios en los impuestos, sobre todo subir el IVA a los artículos de lujo y bajarlo en el caso de los contenidos culturales, e imponer el IBI a la Iglesia. Otra idea que se me ocurre es ajustar los impuestos directos, o bien haciéndolos proporcionales o bien aumentándolos según la renta per cápita.</p>
";"08/09/2015 16";"20";"11";"9";"2";"859044687";"110"
"2115";"Hola, soy nuevo, ¿alguien me explica cómo va esto?";"<p>Gracias. :-)</p>
";"08/09/2015 16";"26";"11";"15";"5";"854833214";"-169"
"2117";"Habilitación de zonas de botellón.";"<p>- La gente seguirá haciendo botellón (sea legal o no).</p>

<p>- Estos seguirán molestando a los vecinos de la zona con el ruido, ensuciando las calles con las botellas, plásticos y demás deshechos, y también, es muy posible que creen problemas por las conductas derivadas del alcohol.</p>

<p>- Como he dicho antes, estos problemas seguirán siendo un constante, pues esta práctica no dejará de hacerse.</p>

<p>PROPUESTA: </p>

<p>Habilitar zonas controladas donde se pueda hacer botellón de manera que cause los menos perjuicios posibles. En las cuales pueda haber seguridad, para evitar problemas; que haya un equipo de limpieza, el cual pueda ser financiado por los mismos usuarios pagando una ""entrada""; que estén alejadas de los edificios de vecinos, así no se les molestaría con el ruido.</p>

<p>Seguramente me deje alguna ventaja más, a ver que se os ocurre a vosotros en los comentarios.</p>

<p>PSDT: Sé que esto nunca saldrá adelante pues las multas de 600  y las copas con elevado precio en los establecimientos nocturnos seguirá siendo más rentable que eliminar los problemas descritos arriba, pero bueno. Soñar es gratis.</p>
";"08/09/2015 16";"41";"19";"22";"2";"855022096";"-139"
"2118";"Zonas de aparcamiento azul y verde para trabajadores autónomos, fuera ya!!!!";"<p>Soy autónomo y me dedico a la climatización,</p>

<p>Llevo años trabajando en muchas zonas de Madrid y me parece increible que tengamos que estar moviendonos de distrito en distrito para que no nos multen, en la zona verde tienes 2 horas de tiempo y en la azul 4, no da tiempo hacer nada, </p>

<p>deberían de, a los autónomos, dejarnos aparcar en vez de 2 o 4 horas, 8 horas, pagando lo que tengamos que pagar pero no obligarnos a tener que dejar lo que estas haciendo para mover la furgoneta a otro distrito,</p>

<p>O eso o que me pongan coche oficial, no en serio, es una vergüenza,</p>

<p>Espero que la nueva alcaldesa tome cartas en el asunto y haga algo porque es insufrible.</p>
";"08/09/2015 16";"38";"25";"13";"2";"864225928";"789"
"2120";"Separación entre la Iglesia y el Estado";"<p>Soy de las personas que piensan que el Estado español, aconfesional en la teoría, también debería serlo en la práctica. Por eso pienso que se deberían abolir los vínculos económicos entre Iglesia y Estado, incluyendo la casilla de la Iglesia de la Declaración de la Renta.</p>
";"08/09/2015 16";"58";"33";"25";"3";"862374901";"455"
"2125";"Yo NO quiero refugiados";"<p>El otro día estuve hablando con mis familiares, y con amigos míos del barrio, y me sorprendió que coincidían conmigo: Ni ellos ni yo queríamos acoger refugiados ¿Por qué? Todos coincidimos en que España está en una situación catástrófica, con un paro elevadísimo ( a uno de mis amigos le van a quitar la tarjeta sanitaria) y mucha gente siquiera tiene para comer, teniendo que presentarse a algún comedor social. He visto a ancianas REBUSCANDO EN CONTENEDORES, porque les daba mucha vergüenza ir a los comedores y NADIE les ha ayudado. Sin embargo a nosotros, los madrileños, que nadie nos ha preguntado, ni por referéndum ni por encuestas ni nada, tenemos que aceptar miles de refugiados, a los que les van a dar ayudas en todos los aspectos, y rentas que muchas personas desearían tener ahora mismo. ¿No es más lógico ser solidarios con los madrileños de toda la vida, que lo están pasando muy mal, antes de empezar a ayudar a extranjeros? Por eso os pido desde esta supuesta página de participación popular, que orgániceis un referéndum entre TODOS los Madrileños, para ver si la mayoría quiere o no acoger a los refugiados viendo la situación en la que nosotros estamos. Si aceptan demostrarían ser un gobierno, tal como presumen, participativo y democrático. Espero que este mensaje no sea censurado, solo es una opinión que no hace daño a nadie.</p>
";"08/09/2015 16";"226";"108";"118";"64";"859341399";"-477"
"2127";"fomentar cursos para certificados de profesionalidad construcción";"<p>El personal de construcción se encuentran con otro problema añadido a la hora de encontrar empleo y es la necesidad de aportar los nuevos certificados de profesionalidad, a parte de la edad y la falta de estudios en su gran mayoría. Habría que fomentar desde el ayto. la formación para los desempleados de este sector de manera gratuita y en consenso con el sepe, ya que sus cv no les facilita otras salidas laborales. Pienso que habría que hacerlo (dando prioridad) en barrios donde este sector se ha visto más perjudicado como Villaverde</p>

<p> </p>
";"08/09/2015 17";"29";"22";"7";"0";"866011212";"1137"
"2128";"Control de vandalismos";"<p>Me gustaría que se pusiera más control sobre la web para evitar vandalismos. Por ejemplo, nombrar a un administrador y a moderadores, como ya se ha hecho en varias páginas web, wikis y foros.</p>
";"08/09/2015 17";"20";"11";"9";"4";"859630501";"110"
"2129";"Carteles mal traducidos en el Metro / Statios mobile coverage";"<p>Desde hace años, todos tenemos la oportunidad de ver en diversas estacioens d emetro una pegatina con la inscripción "" Estación con cobertura móvil / <strong>Station mobile coverage</strong>"".</p>

<p>Esa traducción no tiene absolutamente nada que ver con la realidad, ningún extranjero que lea ese cartel se va a enterar de lo que ahí pone.</p>

<p>Este tipo de servicios se deberían encomendar a un <strong>nativo</strong>, no al primo del alcalde o a Google Translate. </p>

<p>Saludos a todos</p>
";"08/09/2015 17";"25";"24";"1";"0";"870178503";"2208"
"2130";"Comisión por denunciar a defraudadores.";"<p>Para fomentar que todos paguemos nuestros impuestos, a los ciudadanos que denuncien a cualquier persona o empresa que defrauda se les daría una comisión de un % de la multa en caso de que la denuncia progresase, de esta manera no habría ni un solo defraudador en Madrid. Extrapolable a toda España, ya que por el caracter y picaresca de nuestra tierra es lo único que funcionaría.</p>
";"08/09/2015 17";"29";"15";"14";"2";"857875303";"51"
"2131";"Mercadillo mensual de segunda mano gratuito para vecinos";"<p>Inspirados en los mercadillos vecinales que se hacen en Amsterdam, Rotterdam y otras ciudades de Holanda, hemos pensado que sería buena idea organizar mensualmente, en cada barrio o  en un sítio específico, un rastro donde los vecinos podamos ir a vender libremente nuestras cosas semi nuevas o en buen estado y que ya no necesitemos o vayamos a tirar. </p>

<p>De esta manera, podríamos deshacernos de las cosas que ocupan espacio en casa, pero dandoles aun uso. Evitamos crear más residuos, y podríamos luego encontrar y comprar cosas útiles que necesitemos a buen precio.</p>
";"08/09/2015 17";"78";"67";"11";"4";"872206412";"4810"
"2134";"Unión de Ciudad de Los Ángeles-Villaverde Alto";"<p>La separación que produce la vía de tren que va a la PSA Peugot es una brecha entre dos barrios del mismo Distrito. El paso peatonal de Anoeta a Puente Alcocer es de risa bajando terraplenes y cruzando las vías. Está todo perfecto para la unión -prolongación- de C/Anoeta con Puente Alcocer con carretera y acera con paso de tren a nivel. Unos pocos metros de asfaltado..y ya. Ayuntamiento y Adif tienen que darle caña a esto ya, no se puede permitir esta brecha.</p>
";"08/09/2015 17";"35";"29";"6";"1";"868453131";"1905"
"2135";"Multas para aquellas personas que entren en Templos Sagrados";"<p>Sea cual sea la confesión religiosa del templo en cuestión, solicitamos una regularización efectiva de las afrentas sufridas en los templos sagrados. </p>
";"08/09/2015 17";"75";"22";"53";"3";"852707364";"-909"
"2136";"Peatonalizar el entorno de la plaza de Olavide";"<p>El entorno de la plaza de Olavide (el barrio de Trafalgar), comprendido entre las calles Fuencarral, Luchana, Santa Engracia y Eloy Gonzalo, debería ser una zona de acceso residencial restringido. Las calles no tienen repercusión en el tráfico de la ciudad, y la mayor parte del tréfico son no residentes buscando sitio para aparcar. Creo que la zona, que ya tiene gran oferta de ocio, se revitalizaría. </p>
";"08/09/2015 17";"38";"26";"12";"3";"865167200";"957"
"2137";"Actividades en parques y jardines";"<p>Hace un año que participo en una urbana y me encanta. Luego paso por los jardines y parques del barrio y ni puedo mejorarlos ni los siento tan míos. Sugiero crear actividades como talleres de jardinería en parques y jardines, por ejemplo.</p>

<p>Con esto, se conseguiría:</p>

<p>- Mayor sensibilización ciudadana del cuidado de los espacios públicos</p>

<p>- Participación en ellos e identificación</p>

<p>- Actividades alternativas de ocio para vecinas y vecinos</p>

<p>La idea es que se una con otras propuestas en las que vecinas y vecinos participen en la configuración e ideación de cómo quieren el espacio, pero también con esto se implicarían en su ejecución y mantenimiento.</p>
";"08/09/2015 17";"34";"29";"5";"1";"868961775";"2047"
"2140";"Multar faltas de ortografía";"<p>Implantar sanciones a todo aquel que, siendo residente en Madrid, cometa faltas de ortografía al escribir en castellano en cualquier ámbito; ya sea en redes sociales, foros, sistemas de mensajería, manuscritos, etc.</p>

<p>Con esta medida se mejoraría la ortografía de todos los madrileños, o por el contrario se conseguirían fondos suficientes para mejorar las infraestructuras y servicios públicos de la ciudad.</p>

<p>Para los reincidentes se podría incluir un curso de lengua española tras el que deberían aprobar un examen para evitar la cárcel.</p>

<p>El fin de esta medida es que expresiones como ""ola k ase"", ""x fin es biernes"", ""asercame ese baso"", etc. sean cosa del pasado en la ciudad de Madrid.</p>
";"08/09/2015 17";"53";"28";"25";"1";"859848348";"158"
"2141";"Farolas: generadoras de energia y punto de recarga de vehiculos eléctricos";"<p>He visto varias propuestas de actuación en las farolas, y ya que es necesario, ir sustituyendolas progresivamente por luces LED que dan más luz y consumen menos, se puede aprovechar para implementar algunas ideas que ya funcionan en algunas ciudades, se trataria de convertir las que se puedan o al menos un cierto porcentaje (ya sea por su situación idonea o porque puedan soportar un peso extra) en productoras de energía, tanto solar como eólica, minieólica más concretamente y colocar un punto de recarga en la misma.</p>

<p>No tienen por que tener todas todos los elementos, existen muchos modelos y <strong>supondrían un ahorro considerable a largo plazo</strong> además de permitir que los que no disponemos de una plaza de garaje podamos optar por un vehiculo eléctrico, que no contamina.</p>

<p>Fuentes y algunos ejemplos:</p>

<p>http://elperiodicodelaenergia.com/berlin-convierte-las-farolas-en-puntos-de-recarga-de-vehiculos-electricos/</p>

<p>https://ubitricity.com/en/benefits/benefits-municipalities/</p>

<p>http://www.eolgreen.com/producto.html</p>

<p>http://www.light-blue.es/</p>

<p>http://www.gycsolar.com/modelos.php?activa=modelos</p>
";"08/09/2015 17";"50";"45";"5";"2";"871651736";"3600"
"2142";"Introducir una población de búhos en el Parque de El Retiro";"<p><strong>La Idea</strong></p>

<p>Madrid es una capital vibrante, fiel reflejo del dinamismo de Europa y del apasionado carácter de los españoles. Pero incluso una ciudad como la nuestra necesita de un remanso de paz, de un refugio al que muchos madrileños y madrileñas acudimos para desconectar del estrés del trabajo.</p>

<p>Lamentablemente (y me duele mucho decirlo), la variedad de fauna que se puede encontrar en nuestro parque resulta deficiente. No propongo reabrir la Casa de Fieras (como ecologista me repugna mantener animales en cautividad) además de lo caro e  impráctico que resultaría.  Pero de la misma manera que los parques con más solera del mundo tienen sus propias especies en libertad  sirva como ejemplo el St. James Park de Londres, con sus cuervos y ardillas parece natural que una ciudad con voluntad cosmopolita como es Madrid, quiera exportar su propia marca. Y pocos animales hay tan imponentes como los Búhos, candidatos idóneos para poner al Retiro en el mapamundi de de los parques públicos.</p>

<p>No se trata de soltar búhos sin ton ni son. Si no de adecuar mínimamente las instalaciones del parque para ofrecerles un ecosistema favorable en el que puedan asentarse, de la forma menos disruptora posible para ellos, y para nosotros.</p>

<p><strong>¿Por qué Búhos?</strong></p>

<p>Todo el mundo adora a los búhos. Son animales que caen simpáticos, además de poseer rasgos muy distintivos. Mitológicamente el Búho es el símbolo de Minerva, diosa de la sabiduría. Así como la divisa tradicional de la ciudad-estado de Atenas. Sus ojos grandes y atentos represenran la prudencia que acompaña al conocimiento. Unos valores inmejorables para proyectar a una Madrid volcada en la ciencia y la cultura.</p>

<p><strong>¿Supone el Retiro un ecosistema adecuado para la especie?</strong></p>

<p>El bienestar de nuestros estrigiformes amigos es nuestra máxima prioridad. Antes de desplazar ningún ejemplar  se organizaría un comité que estudiaría la adecuación de la especie y de sus hábitos, así como el impacto que éstos tendrían sobre la zona. En caso de no darse las condiciones necesarias, se renunciaría a la propuesta en pro del bien común.</p>

<p><strong>¿Son los búhos peligrosos?</strong></p>

<p>En absoluto. Los búhos son rapaces nocturnas,  y como tales los únicos que tienen que temer algo de ellas son los roedores, o como mucho alguna paloma despistada. La práctica totalidad de ataques a humanos que se han descrito en literatura científica, estaban relacionados con la época de cría y el instinto de protección a su progenie.</p>

<p><strong>¿No son los búhos una especie protegida?</strong></p>

<p>Es correcto.  Pero nótese que dicha protección solo se da para ejemplares residentes en España y en aquellos países donde presenta poblaciones en declive y se ha legislado sobre su conservación. La idea sería importar ejemplares de Búho Real Euroasiático<em> (Bubo bubo)</em> de países con sobrepoblación de estos. Además a una mala se podrían introducir una población de mochuelos <em>(Athene Noctua) </em>que aunque no sean animales tan nobles, a media distancia dan el pego.</p>

<p><strong>Pero si son una especie nocturna ¿Qué sentido tiene entonces?</strong></p>

<p>Si bien es cierto que son más activos durante las horas de oscuridad, no es nada infrecuente divisarlos de día, especialmente en la primeras horas de la mañana o últimas de la tarde.</p>

<p><strong>Conclusión:</strong></p>

<p>Gracias a esta propuesta se plantea la posibilidad de crear un nuevo icono para Madrid, al mismo tiempo que convertirla en una ciudad un poco más owl-friendly . Decir si a los búhos es decir si al futuro, así como un manifiesto a la diversidad que de la que somos acreedores. Si los búhos pudieran hablar, manifestarían su entusiasmo con la idea.</p>

<p><strong>Addendum:</strong></p>

<p>Permítanme recordarles que los búhos NO puede hablar. Si oyeran hablar a un búho, por favor, ignórenlo.</p>
";"08/09/2015 17";"64";"50";"14";"2";"869411479";"2812"
"2145";"Mercadillo fines de semana, aprovechamiento de las calles del centro";"<p>La calle San Andres en Malasaña, parte de la cual esta abierta al trafico (tramo desde divino pastor a carranza) yo optaria por cerrarla al trafico y hacerla peatonal pudiendo asi habilitarla para los fines de semana e incluso entre semana de puestos a modo mercadillo para que muchos comerciantes de la zona puedieran hacer un buen escaparate alli, tb al ser una zona con bastantes turistas fomentariamos bastante los pequeños negocios del barrio aumentando sus visitas, reduciriamos los ruidos de los vehiculos los fines de semana que es algo horroroso, se podria hacer tb un pasillo verde para poder pasear tranquilamente ya que las aceras son ahora bastante estrechas. Imaginaros la calle con un pasillo verde y bonito desde la plz de joan pujol hasta carranza, claro eso si sin mas terrazas de bares que creo que ya hay suficientes.  </p>
";"08/09/2015 17";"25";"17";"8";"3";"863950065";"612"
"2147";"Blablabus: plataforma de reservas de viajes EMT, para optimizar líneas/horario  ";"<p>Si los usuarios de los autobuses de la EMT, pudieren reservar sus viajes en una plataforma online, todos estos datos podrían introducirse en programas informáticos de optimización, para generar los recorridos y horarios más eficientes, según la demanda existente en cada momento.</p>
";"08/09/2015 17";"15";"7";"8";"0";"857248643";"-46"
"2148";"Acabar con la discriminación hacia los inmigrantes";"<p>Se debería de hacer algo al respecto. Me indigna muchísimo ver a un rumano o un colombiano con estudios superiores trabajando de camarero, limpiador o cajero, por poner ejemplos.</p>
";"08/09/2015 17";"51";"14";"37";"6";"853360628";"-631"
"2150";"WIFI gratuíta en todo el centro de Madrid";"<p>Por una Madrid ConeKtado. Sufragado por las compañías telefónicas, que ya roban bastante, y si se quejan se les expropian los postes de señal. Hasta la victoria siempre! Viva el bolivarismo Cleptocratico</p>
";"08/09/2015 17";"74";"41";"33";"6";"862674441";"443"
"2152";"Reforma Rotonda Colón y Jardines del descubrimiento";"<p>Como se puede ver en fotografías como esta (http://www.secretosdemadrid.es/wp-content/uploads/2015/02/Plaza-de-Col%C3%B3n-antigua.jpg) o esta (http://www.viejo-madrid.es/Imagenes/fotos/40/1940ca-Plaza_Colon-002-71.jpg) la Plaza de Colón no ha sido siempre un espacio tan degradado como el que existe actualmente. El derribo de los edificios para hacer las torres Colón pero sobre todo el derribo del palacio de Medinaceli para hacer el horrendo Centro Colón han Conseguido destrozar un lugar que era hermoso para propios y extraños. Yo no digo que el ayuntamiento deba hacer reconstruir el Palacio (aunque por dentro los interiores fueran modernos y acogiese algún museo (EJ: Museo de cera, museo de historia etc etc), no. Solo pido que al menos se dignifique la estatua que da nombre a la plaza y se acreciente y embellezca el espacio peatonal de la zona. Me da auténtica vergüenza ver lo bonita que era esa rotonda, con sus flores en forma de anclas y sus palmeras, y como está ahora (Si los madrileños la llamamos bañera es por algo). La remodelación no es cara pero claro, como todo hay que hacerla y bien. Simplemente bastaría con volver a lo que aparece en estas fotos, donde además de ser más bonito a la vista y más verde el paseante podía pasear por la rotonda. 

Además de esto están los jardines del descubrimiento, totalmente degradados. El conjunto escultórico de las piedras en la acera de la Calle Serrano, la irregularidad y asimetría del conjunto y el mal cuidado de este han creado un espacio que no es nada atractivo para el ciudadano. Propongo llevar la bandera de Colón, si se quiere incluso se podría reducir algo sus dimensiones, y ponerla en el centro de la plaza sobre un pedestal con dos escalones para subir, dando más elegancia al lugar. a su alrededor 4 grandes ""calles"" peatonales que se juntasen siméricamente en el centro, que sería la bandera. y para completar el connjunto zonas ajardinadas donde se podrían situar estatuas de personajes hispanos en América que la gente erigiese por suscriopción popular, evitando al ayuntamiento gastarse más dinero del debido si no quiere. Además de Blas de Lezo, ya en la plaza, y deGálvez, que al parecer le falta poco para estar junto a este, se podrían erigir estatuas a Bartolomé de las casas (Junto a otros monjes que lucharon junto a él por los derechos de los indios 5más de 400 años antes de que en el mundo anglosajón empezasen a darse cuenta de la igualdad de las razas humanas. Si se hace bonito podria ser un espacio perfecto y único para pasear, entre Alonso MArtinez, las bibliotecas nacionales y el MAN y la puerta de Alcalá y el Retiro. También se deberían quitar las rocas, que yo sustituiría por un monumento sobrio, clasico y conciliador. 
Por último habría que dignificar las entradas al teatro Fernándo Fernán Gómez. Con una entradas de hierro con deroración sobria pero haciendo efecto de contrachapado quedaría muy bien, de finales del XIX, sin romper con al estética de la zona y bonito a la vista, además de que el teatro mejoraría en calidad (La calidad va desde cómo se ve por fuera hasta la calidad de las butacas, no lo olvidemos).
Claro que es necesario que Madrid tenga mejor transporte o esté más limpio, pero si los parques están por su composición propia degradados es malo para turistas y para los propios vecinos, que no pueden sacarle tanto partido a unos espacios verdes merecidos.</p>
";"08/09/2015 17";"30";"22";"8";"2";"865837929";"1026"
"2153";"Fase ámbar de los semáforos intermitente 3 veces antes del rojo                ";"<p>Para evitar los peligrosos frenazos en seco de los vehículos en los semáforos, la fase ámbar debería ser intermitente 3 veces (1 por segundo), antes de pasar a rojo.</p>
";"08/09/2015 17";"31";"25";"6";"6";"867928758";"1532"
"2154";"Seguridad árboles";"<p>Revisión urgente y exhaustiva de los árboles de Madrid (entiendo que es algo que ya se había iniciado, pero creo que es necesario darle prioridad). Desde hace unos años son alarmantes el número creciente de casos de ramas/árboles que se caen (sin motivo aparante o como la tormenta de principios de Septiembre de 2015). En algunos casos, han quitado la vida de ciudadanos. Yo no me siento seguro paseando por la calle con mis hijos un día de viento o tras un día de tormenta.</p>

<p>Por último, la solución al problema puede que sea la revisión del sistema de riego. Antes se regaba con manguera barrio a barrio y ahora lo hacen unas máquinas con menos agua y encima reciclada. Tanto en la Comunidad de Madrid como en la ciudad no hay problemas de agua, es una de las grandes ventajas que tenemos</p>
";"08/09/2015 17";"150";"141";"9";"1";"877254279";"12408"
"2155";"Renovación integral del servicio de recogida de basuras y de los vehículos.";"<p>El servicio de gestión de recogida de basuras en Madrid está completamente obsoleto. Además de contar con una flota de vehículos en un estado lamentable, la forma como se lleva a cabo la recogida de residuos es la misma de hace 30 años. ¿Como funcionan las ciudades grandes de España?. Desde luego como aquí no. Los cubos individuales son del siglo pasado, ( claro está que donde no puede haber grandes tienen que seguir estos). En cualquier ciudad de España se usan cubos permanentes de un tamaño mayor, (eliminando así los cubos pequeñajos) con limpieza periódica de estos por camiones modernos. Va siendo hora de ponerse al día.</p>
";"08/09/2015 17";"15";"10";"5";"2";"862271391";"333"
"2157";"EMT: Horarios autobus en todas las paradas";"<p>Sería muy útil que el horario de paso de los autobuses figurase en paneles en TODAS las paradas, incluyendo las cabeceras de línea. Hay gente que no lo puede consultar en Internet, gente mayor, extranjeros. Nos facilitaría la vida y no creo que sea complicado. Gracias y enhorabuena por la iniciativa de la web</p>
";"08/09/2015 17";"34";"29";"5";"5";"869320375";"2047"
"2159";"Modificar los impuestos a la vivienda (IBI progresivo)";"<p>Crear una fiscalidad social para la vivienda, facilitando el pago del IBI a personas solas y familias de bajos recursos (en función del nivel de renta) y aumentandolo progresivamente a propietarios de varios inmuebles, de este modo se desincentivaria la acumulación especulativa de vivienda, se activaria el mercado de alquiler y venta y mejoraría el acceso de los madrileños a la vivienda.</p>

<p>Madrid es una ciudad con mucha vivienda vacia y con precios excesivamente altos para los niveles salariales de nuestro pais.</p>
";"08/09/2015 17";"23";"15";"8";"0";"862852700";"456"
"2161";"Suprimir la absurda expresión doble de género";"<p>Por ser una barbaridad contra nuestra lengua, por respetar los dictados de la adecuada gramática con sus raíces en el gran Nebrija, pido por favor la eliminación definitiva de la expresión ""madrileños y madrileñas"", ""ellos y ellas"", etc que tan mal uso hacen los políticos caducos anclados en lo absurdo. Para ello se hará uso del plural masculino - todos - por su carácter globalizador también de ""todas""</p>
";"08/09/2015 17";"74";"53";"21";"5";"868290072";"2291"
"2162";"MENOS RUIDO DE MOTOS";"<p>Por favor, que algien aplique las ordenanzas de ruido y de industria con las motos. Te despiertan a ti y lo peaor de todo al Bebe a cualquier hora. Son insufribles y nadie hace nada.</p>
";"08/09/2015 17";"50";"41";"9";"1";"869733516";"2624"
"2163";"Legalización de la planta del cáñamo";"<p>Hace años, las grandes corporaciones, especialmente tabaqueras, cargaron contra el cáñamo por considerarlo un peligro para su economía. Esto empujó a su ilegalización en muchos países, y que comenzase a ser conocida como una droga ilegal llamada marihuana. Ahora abogo por volver a legalizar el uso de la planta, así no sólo se solucionarían los problemas relacionados con la ilegalidad, sino que se sabe que esta planta cuenta con múltiples usos, tales como fabricación de papel, textiles, aceites, usos medicinales... Y se podrían explotar con mayor libertad y seguridad.</p>
";"08/09/2015 17";"46";"28";"18";"1";"863522506";"608"
"2164";"Remunicipalización del servicio de recogida de basuras.";"<p>Después de decirnos durante 30 años que la gestión privada sale más barato para las arcas que la gestión pública, ha quedado más que demostrado que era<strong> Mentira.</strong>  </p>
";"08/09/2015 17";"54";"43";"11";"4";"869484362";"2548"
"2165";"ELCCION VOCALES VECINOS JUNTAS";"<p>Democratizar la selección de los vocales vecinos de los Distritos, y que la elección corresponda directamente a los vecinos empadronados en el Distrito. Habría que establecer previamente un sistema de candidatos avalados por un número mínimo de vecinos del Distrito. Participación para elegirlos y, en su caso, establecer mecanismos para poder quitarlos también.</p>
";"08/09/2015 17";"16";"7";"9";"3";"856720448";"-87"
"2166";"Multas: o pagas o servicios a la comunidad";"<p>A la hora de multar, poner la alternativa de trabajar para Madrid y ayudar a mantenerla limpia o cualquier otro tipo de servicio a nuestra ciudad.</p>
";"08/09/2015 17";"46";"35";"11";"2";"867976681";"1826"
"2167";"Tomarse BICIMAD en serio";"<p>BICIMAD puede servir para sustituir muchos traslados que ahora se hacen en coche o en transporte público. Para eso hay que tomárselo en serio, ante la aparente demanda que parece tener:</p>

<p>- Mantener las bicicletas eléctricas. No caer en la tentación de comprar bicicletas sin motor más baratas. Madrid tiene muchas cuestas y no todo el mundo tiene la capacidad de hacer deporte para ir a trabajar.</p>

<p>- Resolver el problema de vandalismo. Propuesta: fuertes multas al que robe o rompa una bicicleta, cámaras en los puestos y cambio del sistema de anclaje.</p>

<p>- Aumentar el número de bicicletas de forma considerable</p>

<p>-En las aceras muy anchas (Castellana, Bravo Murillo etc) colocar las bicicletas en aquellas zonas de las aceras que no se utilizan o se utilizan menos por parte de los peatones. Es muy peligroso sacar o coger una bicicleta ahora con los coches pasando rozándote el trasero mientras lo haces.</p>

<p>- Solucionar el problema de la vía de uso de la bicicleta. No me parece razonable ni ir jugándonos la vida por la calzada, sin casco en la mayoría de los casos y con muchos estrés, ni ir agobiando al peatón por la acera. Se debe conseguir o bajar mucho la velocidad de los coches (que los técnicos municipales decidan cómo que para eso cobran un salario), o marcar claramente un carril bicicleta como hay en muchas ciudades del resto de Europa.</p>

<p>- La primera media hora gratuita con un abono anual más caro. </p>

<p> </p>
";"08/09/2015 17";"37";"25";"12";"3";"865113640";"878"
"2171";"Polideportivo Marqués de Samaranch";"<p>Como en el resto de polideportivos de Madrid ampliar el horario, especialmente en fines de semana. </p>

<p>Tanto de la piscina cubierta como de las actividades dirigidas. Muchos horarios laborales son incompatibles con el uso de estas instalaciones.</p>

<p>Creo que además se podrían crear más puestos de trabajo, financiados por un mayor número de usuarios</p>
";"08/09/2015 17";"19";"15";"4";"1";"865720077";"868"
"2172";"Multar los PITIDOS innecesarios de los coches";"<p>Los coches o, mejor dicho, los conductores de coches, tienen la manía de pitar: pitan cuando hay un atasco, pitan cuando un taxi para a dejar a un cliente, pitan cuando ha pasado medio segundo y el de delante no ha arrancado con el semáforo en verde... La gente que vive en grandes avenidas, ya sufre del inevitables ""runrun"" de los coches, pero no creo que sea necesario tener que aguantar también constantes pitidos. ¿La solución? Fácil, multas de 50 euros a los coches que piten sin tener que hacerlo, es decir, si no hay un peligro que deben advertir y evitar. Esos conductores de ""pito suelto"", después de la primera o segunda multa, se lo pensarán un poco más, y todos podremos descansar nuestros oidos.</p>

<p>*Gracias por darnos este espacio, Ahora Madrid.</p>
";"08/09/2015 17";"31";"24";"7";"2";"867056476";"1316"
"2173";"Desmantelar el Cementerio de la Almudena y convertirlo en un parque público.";"<p>Todos conocemos el cementerio de la Almudena. En el centro de Madrid y uno de los cementerios más grandes de Europa dentro de una ciudad. Ser creyente o no no significa tener que mantener un cementerio indefinidamente en el centro de la ciudad. Historicamente según las ciudades crecían los cementerios se cerraban y pasaban a estar en las afueras. 
Por tanto propongo crear un parque ocupando todo el solar del cementerio, dejando las cnotrucciones icónicas del cementerio en pie. Los familiares de los enterrados alli podrían optar a enterrar a sus muertos en otro lado o dejarlos debajo del parque. Se crearía un grán mural con los nombres de todos los muertos que hay en ese cementerio que rodearía (a modo de muro si se quiere) todo el parque. el día de todos los santos se podría seguir dejando flores en ese mural e incluso se podría dejar una pequeña capilla ya construida para los creyentes que deseasen celebrar misa ese día. Mientras el parque entero se ajardinaría y debería seguir el rumbo del Hyde park de Londres o del Retiro. No pido grandes monumentos cinicos, solo pido que no se convierta en un parque Juan Carlos I 2 o en un parque como tantos de barrio que se degradan. Debería estan vallado (usando el muro del que hablamos antes o una valla metálica de estilo clásico) para que a cierta hora se cerrase. Farolas y mobiliario en general a la antigua y con espacios grandes sin árboles que se pudieran usar para realizar distintas actividades llegado el caso. Con farolas clasicas de las de Fernándo VII, rejas bonitas, caminos cuidados, arboles y cesped para sentarse  alguna fuente aseguro que el parque se convertiría en un referente para todo Madrid. Obviamente es un gasto de dinero, pero no creo que si se hace bien suponga un gran desembolso. Además hasta si dejasemos una pequeña esquina para algunos comercios de restauración estoy seguro de que estos comercios podrían ayudar economicamente a financiar el nuevo parque.</p>
";"08/09/2015 17";"111";"22";"89";"14";"853480968";"-1327"
"2174";"Abrir el parque Canal de parque Canal Isabel II en Bravo Murillo-Santa Engracia";"<p>No es competencia del Ayuntamiento pero quizá tenga algo que decir:</p>

<p>Chamberí necesita zonas verdes. Hay una enorme manzana verde en Santa Engracia-Ríos Rosas-BravoMurillo- Cea Bermúdez cerrada al público y sin uso aparente. ¿Podría abrirse al público para ampliar el parque de Santander? Es una idea</p>
";"08/09/2015 17";"27";"21";"6";"1";"866636643";"1166"
"2175";"DIFUSIÓN ANIMALES CPA EN ESPACIOS PÚBLICOS ";"<p>Solicito y propongo que parte de los espacios públicos de la ciudad de MADRID sean destinados a la difusión de los animales en Adopción del Centro de Protección Animal CPA "" La Fortuna""  Actualmente se hace a través de la web del centro.</p>

<p>Usar las <u>MARQUESINAS </u>de los autobuses y otros espacios de DIFUSIÓN para los ANIMALES EN BUSCA DE ADOPCIÓN de la ciudad de MADRID.</p>

<p>Además de ACERCAR a los PERROS y GATOS del CENTRO DE PROTECCIÓN ANIMAL a la ciudadanía, ampliaríamos la información sobre el centro y FACILITARÍAMOS así  la Adopción de estos Animales.</p>

<p> </p>

<p>GRACIAS POR APOYARME!!!</p>

<p> </p>

<p> </p>

<p> </p>
";"08/09/2015 17";"88";"73";"15";"9";"872228981";"4811"
"2176";"Sólo taxis eléctricos de aqui a 5 años";"<p>La tecnología está suficientemente desarrollada para la conversión obligatoria de la flota de taxis. Al hacerlo se fomentará muchisimo las infrastructuras de recarga, con lo que facilitará que los particulares también opten por coches eléctricos.</p>

<p>Una vez hecha la conversión entiendo que se podrán bajar las tarifas oficiales del taxi, ya que la electricidad es mucho más barata que la gasolina en /Km y el coche eléctrico tiene unos costes de mantenimiento menores). Así muchos que hoy optamos por usar un coche privado podremos permitirnos el uso de un servicio municipal.</p>

<p>Menos humos, menos ruido, menos coches.</p>
";"08/09/2015 17";"57";"49";"8";"5";"871424678";"3524"
"2177";"Restablecimiento de las líneas L, viernes, sábados y festivos.";"<p>De esta manera se facilita el transporte y recuperamos líneas bastante usadas cuando se encontraban disponibles.</p>
";"08/09/2015 17";"29";"27";"2";"0";"870446685";"2327"
"2178";"Multas más altas a vándalos y grafiteros.";"<p>Es una verguenza como esta Madrid. Lleno de pintadas, sucio, destrozado. Papeleras que les prenden fuego, paredes que parecen que las han pintado un niño medio lelo (probablemente sea asi), columpios destrozados, parques llenos de basura.</p>

<p>Y el problema de esto son las multas. ¿600 euros? ¿1500?. ¿Para cuando una multa que de verdad hagan temblar las piernas? Hay que evitar que esto pase, y la unica solucion por triste que sea es con miedo. Miedo a las multas.</p>

<p>¿Que es eso de que una multa sea conmutable por labores de limpieza? Es una broma de mal gusto. Destrozan las casas de la gente (puertas, ventanas, paredes....) ¿y la solucion es que limpien lo que han pintado?. No señor. La solucion es que se les quiten las ganas de destrozar las cosas. Que les salga caro a ellos y no al resto de los Madrileños que somos gente civilizada.</p>

<p>Basta ya de esta gente. Basta ya de regalar las cosas. Basta ya unas leyes que protegen a los delincuentes y no al resto de los ciudadanos.</p>

<p>Si quieren tirar basura al suelo que lo hagan en su casa. Si quieren prender fuego a una papelera que sea la de su casa. Si quieren pintar paredes como cuando tenian 5 años, que lo hagan en su casa, y no en la CASA DE TODOS.</p>
";"08/09/2015 17";"274";"239";"35";"11";"877650798";"17794"
"2179";"Cierre de la web Decide-Madrid";"<p>Hola madrileños, aprovechando que el actual gobierno de la capital fomenta la participación ciudadana y, que como un madrileño más, tengo derecho a decidir sobre la utilización de los recursos públicos, a continuación expongo mis motivos para el cierre de la web:</p>

<ol>
	<li>Considero que esta web tiene un objetivo partidista</li>
	<li>Desde mi punto de vista no engloba a todos los madrileños, dado que es evidente que no todos los madrileños tienen acceso a internet</li>
	<li>Los moderadores son personas afines a un partido político con una ideología muy marcada, por lo tanto no existe libertad de opinión</li>
	<li>Gente de fuera de Madrid puede opinar sobre cuestiones que afectan a los contribuyentes madrileños</li>
	<li>Reciben un sueldo para gobernar, si les decimos que hacer, devuelvan el sueldo, no ¿verdad? Entonces cierren la web y trabajen </li>
</ol>

<p>Gracias por su tiempo.</p>

<p> </p>
";"08/09/2015 17";"150";"35";"115";"16";"852741948";"-1866"
"2181";"Instalar reductores de velocidad con paso para ciclistas en los ciclocarriles";"<p>Los ciclocarriles con limitación a 30 km/h no los respeta ningún coche, por eso propongo que en las vías que dispongan de un ciclocarril instalar un reductor de velocidad, exactamente dos reductores de velocidad para que los coches reduzcan la misma, pero con una separación entre ambos situada en el centro del carril que permita que las bicis pasen por ahí sin que les afecten.</p>

<p>Que una bici supere los 30 km/h es complicado, pero un coche sí, así que la idea es que el reductor de velocidad solo afecte a los coches, además se consigue que las bicis vayan por el centro del carril y no por un extremo. En el resto de carriles no hace falta que se instalen, así los coches que quieran ir a más velocidad evitarán el ciclocarril.</p>
";"08/09/2015 17";"54";"36";"18";"4";"866018528";"1200"
"2182";"Asistencia a actos religiosos";"<p>En la medida que el alcalde de Madrid representa a todos los madrileños debe asistir a todos los actos religiosos a los que sea invitado, asistiendo y representando a sus ciudadanos, y ello independientemente de sus creencias personales o de su corporación. </p>
";"08/09/2015 17";"80";"21";"59";"4";"853226007";"-997"
"2183";"Sembrar de ciclocarriles-30 la ciudad.";"<p>Las bicicletas son vehículos y deben circular por la calzada. Su utilidad cómo medio de transporte alternativo se basa en ir, exactamente, al mismo sitio que el resto de los vehículos. El ciclocarril- 30, junto con otras medidas tendentes a la equiparación de velocidades entre los diferentes vehículos, es una autopista a la intengración progresiva de los nuevos y temerosos ciclistas. No podemos pretender que todos los cilistas, ocio y deporte, se equiparen a los urbanos por el mero hecho de circular por unos carriles bici que discurran, segregados, por la calzada o por la acera o por el parque. Eso es segregación y haría al monstruo del coche intocable para siempre jamás. Hace falta una educación y una cultura cilista urbana que no se aprende con visionar un vídeo. Progresiva: Primero, los urbanos, luego, los trabajadores (con medidas pro) , después, todos los demás y, al final, los niños, ya mayores, que se educaron en programas como Stars o los bicibuses. Y soluciones seguras con carril segregado para los puntos especialmente conflictivos. Sembremos la ciudad de ciclocarriles-30 y recolectaremos un ciudad sostenible en una generación. La BiciMAD nos abrió las puertas y nos trajo la infraestructura. P´alante, pues. Unas simples líneas nos marcan el camino. Hagamos camino al circular.</p>
";"08/09/2015 17";"36";"20";"16";"0";"860825739";"222"
"2184";"Recogida de Residuos Orgánicos separados de Inorgánicos";"<p>En la recogida de residuos puerta a puerta distinguir en lo que ahora se recoge como fracción Resto en los contenedores grises considerando separar orgánico de inorgánico para así poder reciclar los orgánicos. Que se lleve hasta el final del proceso de tratamiento de residuos y así conseguir abanos y eliminar contaminación evitando la incineración. Así se realiza ya en algunos Aytos. Como el de Barcelona. El cubo de orgánico es marrón. Quedando las fracciones de recogida actuales: envases, vidrio, papel, y además orgánico e inorgánico. </p>
";"08/09/2015 17";"18";"11";"7";"3";"861615550";"244"
"2185";"Publicación y auditoria del árbol genealógico de los concejales.";"<p>sería muy interesante que el ayuntamiento audite y publique el árbol genealógico de los consejales, pues puede estar ocurriendo - dios no lo quiera- que algún funcionario o laboral del consistorio, por desconocimiento, manteniendo un parentesco de segundo grado o mayor con un concejal electo, no fuera nombrado alto cargo de libre designación a pesar de su hereditaria valía.</p>
";"08/09/2015 18";"53";"25";"28";"8";"856803554";"-141"
"2186";"Conciliar vida familiar";"<p>Tanto hablar de la conciliación familiar y resulta que los comercios abren 2 horas después de empezar los colegios y cierran en algunos casos a las 11 de la noche....como es posible eso? Es que las dependientas-es no tienen familia? He visitado países de Europa, America y Asia y los comercios cierran a las 6 de la tarde y no por eso la gente deja de comer o vestir. Es cuestión de ""educar"" a los clientes a comprar a otras horas...no es tan difícil. Se podría hacer algo al respecto? Y me parece indecente que bajo la excusa de crear empleo se puedan abrir todos los domingos y festivos. En la mayoría de los comercios ha dado lugar a la explotación de los trabajadores haciéndoles trabajar más horas por el mismo sueldo bajo amenaza de despido. Que se note el cambio en Madrid!!!!!</p>
";"08/09/2015 18";"39";"27";"12";"0";"865676845";"1038"
"2188";"App de denuncias on line de vehículos mal aparcados con una simple fotografía";"<p>Implantando una plataforma web de denuncias online de vehículos mal aparcados, enviando una simple fotografía del vehículo mal estacionado, se reduciría notablemente la doble fila, y se podría prescindir de los bolardos en todas las calles.</p>
";"08/09/2015 18";"50";"37";"13";"3";"867884762";"1775"
"2189";"Fomento del uso de vehículos eléctricos";"<p>Habría que ir cambiando progresivamente los vehículos más contaminantes por otros que contaminen menos. Por eso opino que se debería facilitar la adquisición y el uso de vehículos eléctricos o de hidrógeno, facilitando la investigación, subvencionándolos e instalando más puntos de recarga.</p>
";"08/09/2015 18";"36";"31";"5";"1";"869777719";"2238"
"2190";"Recuperación de los espacios píblicos";"<p>Con motivo de recaudar mas en impuestos el anterior gobierno del ayuntamiento de Madrid se ha dedicado a vender los espacios publicos a las entindades privadas (terrazas ocupando plazas enteras, instalaciones deportivas publicas, etc). No estoy totalmente en contra de que haya ciertos espacios destinados a terrazas, etc, pero lo que no puede hacerse es ceder completamente estos espacios publicos para turismo, hosteleria, etc y excluir a la mayoría de la ciudadania del uso y disfrute de algo que se ha pagado y creado con dinero publico.</p>
";"08/09/2015 18";"34";"21";"13";"1";"863222633";"494"
"2193";"PLAN DE EMPLEO Y TRABAJO DIGNO PARA MAYORES DE 50 AÑOS.";"<p><strong>Se habla mucho del empleo, mejor dicho, de la falta de empleo para los jóvenes pero no se habla tanto de los mayores de 50 años. Personas que han trabajado muchos años, que pueden demostrar su experiencia, son mayores para ser contratados y jóvenes para ser jubilados. </strong></p>

<p> </p>

<p><strong>Estas personas solo quieren un trabajo digno y poder trabajar hasta su jubilación sin tener la incertidumbre de no saber si podrán vivir mientras la jubilación llega y sin saber si podrán jubilarse. </strong></p>

<p> </p>

<p><strong>Por eso pido un plan especial de empleo, no solo para los parados de larga duración, para todos para no ser parados de larga duración.</strong></p>
";"08/09/2015 18";"67";"61";"6";"18";"873759811";"5007"
"2194";"Elección de concejales y alcalde por concurso público..";"<p>Cuando compramos pan no elegimos al panadero por su ideología política, lo elegimos porque nos ofrece el mejor pan al mejor precio. Propongo despolitizar el Ayuntamiento de Madrid y elegir al alcalde y a los concejales uno a uno, en listas abiertas en función de sus propuestas. Las propuestas serán públicas y deberán acompañar: el proyecto que proponen, el gasto que representará para los ciudadanos, el tiempo de ejecución y el sueldo por el que el alcalde o el concejal se compromete a llevarlo a cabo. Así mismo incluir una claúsula de penalización en caso de no cumplir el proyecto en el plazo y presupuesto comprometido. El ayuntamiento al igual que la panadería debe dar el mejor servicio al menor coste posible para los ciudadanos y que la política deje de ser la coartada de los ineptos y de los aprovechados. </p>
";"08/09/2015 18";"41";"18";"23";"3";"854750540";"-219"
"2195";"Parking privado en hospital público";"<p>Tratar de erradicar el negocio del parking privado en hospitales públicos.El negocio que se hace cobrando por  la visita a un familiar al hospital es despiadado.Somos nosotros los que nos construimos hospitales públicos, como hemos llegado a esto?.</p>
";"08/09/2015 18";"57";"49";"8";"0";"871513202";"3524"
"2196";"Rita Maestre";"<p>Ha habido mucho revuelo en torno a esta persona, no sólo por su acto de vandalismo a una capilla universitaria (lo cual considero de mala educación, pese a no ser creyente), sino también por el sueldo que está cobrando ahora mismo (92.000 /año) y por el posible enchufismo de sus padres. Me gustaría que investigárais a fondo todo esto.</p>
";"08/09/2015 18";"71";"43";"28";"7";"865112750";"908"
"2197";"Aplicaciones de servicios públicos para todos los terminales";"<p>Esta mañana estuve leyendo y vi un tema abierto pero que ahora no soy capaz de encontrar.</p>

<p> </p>

<p>https://turismomadrid.es/es/organizate/aplicaciones.html</p>

<p> </p>

<p>En esta página, se ve una extensa lista de dos aplicaciones y ambas desarrolladas única y exclusivamente para Android e iOS... pero viendo la playstore tanto de Android como iOS veo que hay bastantes mientras que en la de Windows Phone / Microsoft no hay casi ninguna... </p>

<p>Al menos podemos pedir cita vía esta app... y no tengo claro que esté a pleno funcionamiento </p>

<p>https://www.microsoft.com/es-es/store/apps/cita-sanitaria/9wzdncrdx49n</p>

<p>Y luego, tenemos chorradillas que son basura desrrolladas por terceros que sería necesario que vosotros mismos desarrollarais. En fin, que como ciudadano de Madrid que pago mis impuestos, creo conveniente tener disponible las mismas aplicaciones que otros usuarios tienen al alcance de la mano por tener un terminal diferente. Y no, no es la solución que yo cambie de terminal ni de sistema operativo.</p>

<p>Un saludo y vamos a ver si TODOS podemos disfrutar de Madrid de todas las maneras posibles. No debería ser un gran problema portar o reescribir esas aplicaciones a un sistema móvil diferente.</p>
";"08/09/2015 18";"16";"8";"8";"0";"857669388";"0"
"2198";"Prohibir la circulación de motos ruidosas";"<p>Cada vez destaca más sobre el murmullo del tráfico el ruido de motos de gran potencia acústica que parece que se han diseñado quiza para el desierto de Arizona pero no para una ciudad tan apretada como madrid. Propongo que se prohiba su circulación o se les imponga alguna limitación.</p>
";"08/09/2015 18";"91";"83";"8";"3";"874816699";"6840"
"2199";"Manuela: colócanos a tós";"<p>Creación de puestos de trabajo municipales que absorban a toda la población desempleada de Madrid, consiguiendo de este modo que Madrid sea la primera ciudad europea con PARO CERO. Jardineros, animadores sociales, barrenderos, etc...</p>
";"08/09/2015 18";"59";"34";"25";"2";"863345323";"518"
"2201";"Cierre al tráfico de vehículos no residentes, transporte público o repartos";"<p>Todo el centro de Madrid se aqueja de la dolencia que supone tener un tráfico tan intenso en unas calles que no lo permiten. Así que sería lógico recuperar la propuesta de Botella y cerrar al tráfico (excepto que se pague una tasa) a los vehículos particulares que no sean residentes de la zona ni hagan repartos comunicados al ayuntamiento. Así descongestionaríamos la zona y limpiariamos más el aire de Madrid. Habría que construir a la par aparcamientos disuasorios como el de Ciudad Universitaria y darles promoción. En este aparcamiento, que está conectado al metro, hay tarifas mensuales que pueden unirse con el abono trasporte y salen muy económicas.Se debería hacer igual en todas las entradas de Madrid.</p>
";"08/09/2015 18";"46";"24";"22";"5";"860271595";"104"
"2202";"Zona sin uso";"<p>En la Calle de la verdad , cerca de Marques de Vadillo hay un espacio deportivo on abandonado . Eran las antiguas instalaciones de hermandades del  trabajo . Parte se vendio y se levantaron pisos y la otra funciono como zona deportiva hasta que se abandono . .? Porque no se recupera como zona deportiva ?</p>
";"08/09/2015 18";"15";"13";"2";"0";"866767323";"953"
"2206";"Tarjetas de transporte por días (recargas el dinero necesario)";"<p>Mi propuesta es mantener la tarjeta de transporte público mensual como la que actualmente tenemos, pero emitir unas de cartón con validez de un año (en Portugal está a 0,50 euros) en las que recargas un billete sencillo, el precio del abono por un día o por lo que sea necesario para el cliente. Con esto obtenemos una reducción en cuanto a gasto de papel y una forma cómoda para el cliente.</p>

<p>El ejemplo lo he sacado del modelo que está implantado en Lisboa que tiene estas tarjetas de cartón y luego aparte el abono mensual tradicional.</p>

<p> </p>
";"08/09/2015 18";"27";"24";"3";"2";"869630603";"1866"
"2207";"Facilitar acceso a salas de centros municipales.";"<p>Hola.</p>

<p>Como persona interesada en temas de ocio y cultura, quería proponer que se facilitase el acceso a las salas de centros municipales para la realización de talleres o actividades por parte de asociaciones. En mi experiencia, los centros municipales tienen horarios muy cerrados y en todos los que he preguntado me han dicho que es casi imposible conseguir una sala para realizar una tarea suelta, como un taller de un día, una actividad para jóvenes.</p>

<p>Me gustaría que se estudiase el facilitar el acceso a este tipo de actividades, que los cursos están bien, pero hay mucha gente en Madrid dispuesta a dedicar su tiempo a actividades de ocio y cultura de forma desinteresada y la ciudad se lo pone muy difícil para conseguirlo.</p>

<p> </p>
";"08/09/2015 18";"21";"17";"4";"0";"866802281";"1052"
"2208";"Propaganda en coches";"<p>se deberia multar la propaganda de Los parabrisas de Los. Coches . La mayor parte de Los papeles terminal en el sue lo .</p>
";"08/09/2015 18";"38";"35";"3";"1";"871683354";"2947"
"2209";"hace falta un monumento emblemático y moderno";"<p>A esta ciudad la adoro, pero en algunos aspectos se queda anticuada. Hace falta algo que llame la atención y haga reconocer a Madrid con una imagen. Algo tipo ""la noria London Eye"" de Londres .Atracción de turismo y una imagen representativa de una ciudad moderna. Madrid río sitio ideal para tener unas vistas únicas de madrid y no tanto centro comercial. Solo es una respetuosa opinión. </p>
";"08/09/2015 18";"28";"13";"15";"4";"857410898";"-92"
"2213";"Realmente sirve esto para algo?";"<p>Me gustaría saber si hay algún mecanismo para que esto, el foro o como se quiera, sirva para algo. Si uno propone algo y tiene 100 votos y otro propone lo contrario y tiene 99 se elimina al segundo o entre los dos se compensan. O que número de votos hay que tener para que alguien tenga en cuenta una sugerencia. En resumen alguien excepto los programadores han pensado algo?</p>
";"08/09/2015 18";"25";"18";"7";"5";"865715002";"792"
"2214";"Código de vestimenta";"<p>Dado lo escandaloso de la indumentaria de nuestros nuevos políticos propongo el establecimiento de un código de vestimenta adecuado a fin de que no pasemos vergueza los votantes de la imagen que dan. A tal fin pido por favor la eliminación de camisetas, chandal o similares  de nuestros amados gobernantes, proponiendo un casual business adecuado. El código de vestimenta supondrá la apertura de un concurso público al que podrán concursar todos los diseñadores españoles y extranjeros que establezcan con elegancia la indumentaria más adecuada para cada evento. El asesor de imagen deberá contar con todas las herramientas necesarias para ejercer su trabajo con libertad, aprovechando en ocasiones lo atrevido de las pasarelas que en ocasiones encumbran la planta noble de nuestro ayuntamiento. A todos aquellos que consideren inadecuado mi propuesta aconsejo mirarse al espejo antes. Les podré facilitar tarjeta de visita de profesional de la imagen a fin de mejorar en su vida personal y profesional. </p>
";"08/09/2015 18";"65";"27";"38";"0";"853503545";"-456"
"2215";"Código de vestimenta";"<p>Dado lo escandaloso de la indumentaria de nuestros nuevos políticos propongo el establecimiento de un código de vestimenta adecuado a fin de que no pasemos vergueza los votantes de la imagen que dan. A tal fin pido por favor la eliminación de camisetas, chandal o similares  de nuestros amados gobernantes, proponiendo un casual business adecuado. El código de vestimenta supondrá la apertura de un concurso público al que podrán concursar todos los diseñadores españoles y extranjeros que establezcan con elegancia la indumentaria más adecuada para cada evento. El asesor de imagen deberá contar con todas las herramientas necesarias para ejercer su trabajo con libertad, aprovechando en ocasiones lo atrevido de las pasarelas que en ocasiones encumbran la planta noble de nuestro ayuntamiento. A todos aquellos que consideren inadecuado mi propuesta aconsejo mirarse al espejo antes. Les podré facilitar tarjeta de visita de profesional de la imagen a fin de mejorar en su vida personal y profesional. </p>
";"08/09/2015 18";"77";"36";"41";"3";"854800607";"-233"
"2216";"contribución para mejorar la calidad del aire en Madrid";"<p>Todos sabemos que el aire que respiramos los madrileños está altamente contaminado, entre otros factores, por las emisiones de gases de los vehículos (automóviles, furgonetas, camiones...). A pesar de ello, es habitual que cuando se estaciona un vehículo se mantenga el motor encendido, tanto si el conductor/a está en su interior como si no lo está, muchas veces  durante largo rato (especialmente en el caso  de furgonetas y camiones de reparto, aunque también los vehículo particulares). La normativa municipal sobre movilidad, tanto la de 2005 como la de 2012, establece un lapso máximo de dos minutos para mantener el motor arrancado cuando éste se encuentra estacionado (la modificación de 2012, incluso, establece una multa de 100  en caso de incumplimiento). <strong>Nunca ha visto a ningún agente municipal intervenir a este respecto y creo que, por el bien de la salud de todos sería bueno que, con el nuevo equipo de gobierno, comenzaran a hacerlo</strong>.</p>

<p>En paralelo, sería bueno que todos nos diésemos cuenta de que <strong><em>un gesto tan simple como girar la llave del arranque cuando vamos a estar estacionados</em></strong> evitaría añadir mayor cantidad de emisiones de gases a las que ya genera la circulación.  </p>
";"08/09/2015 18";"19";"13";"6";"0";"863628058";"478"
"2217";"Empleos públicos para jóvenes.";"<p>Creo que sería una buena medida, empleos aunque sean temporales, para los jóvenes, sería una forma de bajar el paro juvenil y de dar una oportunidad a mucha gente de probar su valía, sobre todo, para que el propio ayuntamiento y seguramente más tarde incluso el Estado, la tuviera en cuenta. Es una medida copia del New Deal de Roosvelt y de las dictaduras, y les suele funcionar. Además, permitiría a los jóvenes acercarse al mundo laboral por primera vez, regulado por el ayuntamiento, impidiendo así que las empresas puedan aprovecharse de ellos, y a muchos les daría una ilusión y sería un incentivo para seguir adelante, porque hoy en día hay muchos jóvenes frustrados que no saben ni qué hacer con su vida, y que ni siquiera pueden mantenerse o ayudar a sus padres a mantener la familia.</p>
";"08/09/2015 18";"34";"15";"19";"1";"855362095";"-176"
"2218";"contribución para mejorar la calidad del aire en Madrid";"<p>Todos sabemos que el aire que respiramos los madrileños está altamente contaminado, entre otros factores, por las emisiones de gases de los vehículos (automóviles, furgonetas, camiones...). A pesar de ello, es habitual que cuando se estaciona un vehículo se mantenga el motor encendido, tanto si el conductor/a está en su interior como si no lo está, muchas veces  durante largo rato (especialmente en el caso  de furgonetas y camiones de reparto, aunque también los vehículo particulares). La normativa municipal sobre movilidad, tanto la de 2005 como la de 2012, establece un lapso máximo de dos minutos para mantener el motor arrancado cuando éste se encuentra estacionado (la modificación de 2012, incluso, establece una multa de 100  en caso de incumplimiento). <strong>Nunca ha visto a ningún agente municipal intervenir a este respecto y creo que, por el bien de la salud de todos sería bueno que, con el nuevo equipo de gobierno, comenzaran a hacerlo</strong>.</p>

<p>En paralelo, sería bueno que todos nos diésemos cuenta de que <strong><em>un gesto tan simple como girar la llave del arranque cuando vamos a estar estacionados</em></strong> evitaría añadir mayor cantidad de emisiones de gases a las que ya genera la circulación.  </p>
";"08/09/2015 18";"24";"17";"7";"2";"865118245";"708"
"2219";"Tarjeta inteligente prepago o postpago 0,05 /km, para el transporte público";"<p>Aplicando las tarjetas inteligentes en el transporte público, y una plataforma de reservas de viajes online, sería mucho más fácil aplicar programas informáticos de optimización, para crear o adaptar las línas de autobus o ferrocarril, y ajustar sus horarios, para evitar esperas y reducir los tiempos de los trayectos.</p>
";"08/09/2015 18";"19";"13";"6";"1";"863770988";"478"
"2221";"Recuperar la Noche en Blanco";"<p>Creo que debería recuperarse uno de los eventos más interesantes y divertidos de Madrid: La Noche en Blanco. Es una excelente forma de promover las diversas actividades y espacios culturales de la ciudad y de pasar una noche divertida para madrileños de todas las edades y gustos.</p>
";"08/09/2015 18";"65";"54";"11";"0";"871449414";"3572"
"2223";"Quiero el mismo sueldo que Carmena o el de Rica Maestre";"<p>Si no es posible tener el sueldo de la alcaldesa, al menos, quiero el de su concejala. Según el art. 14 de la Constitución Española, de 1978, todos somos iguales ante la ley, sin distinción de ideas políticas. No tengo las ideas de Podemos ni Ahora Madrid, pero la Carta Magna lo establece. A ver si en Navidades todos los españoles y los extranjeros que permanecen en España legalmente tenemos el mismo sueldo. </p>
";"08/09/2015 18";"52";"29";"23";"6";"862763044";"334"
"2224";"Aprovechar las bolsas de papel que nos dan al comprar el pan";"<p>Cada vez estamos más concienciados con el reciclaje, pero no lo tenemos fácil con determinados temas. Por ejemplo, con el papel que queremos tirar en el contenedor del mismo. ¿Lo vamos almacenando en una bolsa de plástico para que, una vez tirado el papel, volvemos a llevarnos?. Yo lo voy echando en las bolsas de papel que me dan al comprar el pan. Suelen ser papeles pequeños y, si no, los doblo y los corto en pedazos para que quepan. Sdemás son fáciles de cerrar (arrugando el extremo) y de llevar y tirar. Y te vuelves de vacío.</p>

<p>Además, yo lo tengo de pie, contra la pared en la mesa de la cocina, y me vale para probar mi puntería con lanzamientos de basket.</p>
";"08/09/2015 19";"16";"9";"7";"0";"859669818";"112"
"2225";"Mejora de infraestructuras para discapacitados";"<p>Como el título refleja, hay muchos obstáculos en la vía pública para las personas con alguna discapacidad física, y no digo sólo en edificios o escaleras sin rampas, sino incluso en el metro, dos ejemplos claros, las estaciones de Puerta del Ángel y Alto de Extremadura no tienen ninguna mejora para facilitar el acceso a esta gente, que muchas veces tiene que irse hasta Príncipe Pío para poder entrar al metro. Creo que sería conveniente que se hiciera una empresa en común con la EMT y que se pusieran mejoras para estas personas en todas las estaciones de metro. Por último, comprobar que el acceso a todas las instituciones y edificios de importancia disponen de rampas o algún medio para ayudar estas personas.</p>
";"08/09/2015 19";"50";"46";"4";"0";"872915090";"3864"
"2226";"Hay que racionalizar  la señalización del tráfico, por lo menos en el centro. ";"<p>Es una pena que en determinados puntos del centro histórico sea imposible hacer una foto de un monumento sin que salga alguna señal de tráfico. Hay señales que directamente sobran, y otras que se pueden sustituir por otro tipo de señalización (en el suelo, por ejemplo). Comparar en esto Madrid con otras ciudades monumentales es simplemente ofensivo.</p>
";"08/09/2015 19";"15";"12";"3";"3";"865924573";"720"
"2227";"Conciertos";"<p>Propongo organizar mas conciertos en madrid de grande exponentes de la musica actual como Avicii, Dj Karpa, Wagner o Martin Garrix para disfrute de los jovenes.</p>
";"08/09/2015 19";"19";"10";"9";"1";"858430711";"52"
"2229";"Controles de drogas a todos los concejales";"<p>Incluyendo a todos los porreros que vienen de la cimplutense.</p>
";"08/09/2015 19";"40";"24";"16";"0";"863458653";"480"
"2230";"Podéis borrar hilos pero no callarnos. Sectarismo NO";"<p>?quien decide la legitimidad de las propuestas? Acaso defender el nudismo por el centro es más apropiado que muchas de las propuestas eliminadas? Resulta que aqui únicamente tienen cabida las propuestas que encajan con la ideología de podemos... Esta web debería llamarse ""dale coba a Carmena""</p>

<p>Podeis eliminar nuestros hilos pero NO NOS CALLAREIS. Todos somos madrileños!!</p>
";"08/09/2015 19";"43";"25";"18";"1";"863055834";"406"
"2231";"Facilitar el acceso peatonal a Cibeles y Neptuno";"<p>En una ciudad que siempre está buscando símbolos que la identifiquen, es una pena no poder alcanzar las fuentes de Cibeles y Neptuno, que siendo una maravilla no son accesibles para su disfrute. Ver a los turistas hacer fotos desde tan lejos, con los autobuses pasando (esa es otra) y sin poderse acercar me hace pensar en fuentes de otras ciudades como Roma o París, que tanto nos gustan. Mientras se resuelve la peatonalización o no del Paseo del Prado (Baronesas mediante) sería un gran avance racionalizar la circulación y facilitar el acceso a estos monumentos.</p>
";"08/09/2015 19";"40";"23";"17";"3";"862820205";"345"
"2234";"Impedir la recogida de basuras más tarde de las 12 de la noche";"<p>El título lo dice todo. No hay ruido más molesto que el de la recogida de basuras a la una de la mañana, como pasa en mi calle. No creo que cueste tanto organizar las rutas de recogida para respetar el descanso de los paganos (perdón, vecinos).</p>
";"08/09/2015 19";"37";"24";"13";"6";"865258058";"713"
"2236";"Retirada de las cámaras de control de semáforo";"<p>La seguridad en la movilidad es fundamental para que todos los usuarios de la vía puedan usarla con tranquilidad. Son muchas las actuaciones que se han llevado a cabo para acometer este objetivo: carriles y aceras bici, pasos de cebra con señales verticales luminosas, instalación de radares, instalación de cojines berlineses, aumento de la altura de bordillos y adaptación para personas con discapacidad de los mismos en pasos de cebra, y un largo etcétera que, sin ninguna duda, han permitido que se mejore mucho en este aspecto.</p>

<p>No obstante, muchos somos los ciudadanos que creemos que las cámaras conocidas como foto-rojo provocan más problemas en la movilidad que los que busca resolver. Dado que se tratan de unos dispositivos que simplemente realizan automáticamente una foto a los coches que sobrepasan un semáforo en rojo sin tener en cuenta el resto del entorno (como ceder el paso a vehículos de emergencia, quedarse parado encima del paso de cebra en un exceso de tráfico o no poder detenerse con seguridad en ámbar y se efectúa la ""transición"" a rojo pueden ser algunos de los motivos), además de posibles problemas de seguridad que pueden causar: no sería extraño el caso del conductor que da un frenazo cuando el semáforo se le pone en ámbar, para antes de la línea de semáforo y es embestido por el vehículo que va detrás. Dichas consecuencias se agravarían si cruza un niño. Cabe destacar, además, que algunas de las cámaras están colocadas en puntos que no son precisamente peligrosos (c. García Noblejas, av. Poblados, c. Alcalá-Suanzes, etc.).</p>

<p>Por estos motivos sería importante revisar la utilidad real de estos aparatos y, si procede, efectuar su retirada.</p>
";"08/09/2015 19";"52";"25";"27";"2";"857107838";"-96"
"2238";"Estacionamiento regulado fines de semana y festivos ";"<p>No es lógico que los fines de semana y los festivos se permita aparcar en las plazas azules y verdes sin coste alguno. Seria una forma de limitar la entrada de coches al centro de Madrid, a cambio precios simbólicos en el transporte público tan abundante en el centro, cercanías Sol y Atocha, todas las líneas de metro, así como autobuses </p>
";"08/09/2015 19";"52";"14";"38";"2";"854364833";"-646"
"2244";"Aparcamiento para motos y bicis";"<p>Cada vez es más frecuente que el espacio público de las aceras y plazas esté plagado de motos aparcadas impidiendo y obstaculizando la circulación peatonal. Deberían delimitarse zonas de aparcamiento en la calzada para motos y bicis, sobre todo a la entrada de oficinas y lugares donde la presión de este tipo de vehículos sea mayor.</p>
";"08/09/2015 19";"27";"14";"13";"0";"858288854";"51"
"2248";"Eliminar zona azul y verde";"<p>Ya pagamos el impuesto de matriculación de manera anual, está muy bien que se busque la excusa de que se hace para reducir el trafico, pero no deja de ser otro impuesto.</p>
";"08/09/2015 19";"50";"18";"32";"5";"854163668";"-504"
"2249";"Reformar la Plaza del Carmen y utilizar el edificio Montesol";"<p>He visto que son varios los debates que proponen devolver las plazas a las personas, recuperar los espacios públicos para los vecinos, no para las empresas. Creo que la plaza del Carmen es un buen lugar donde ensayar estas ideas por varios motivos. Es muy grande (casi 5000m2), céntrica (tiene mucha visibilidad pública), presenta un lamentable estado de conservación y ha alojado durante muchos años (y lo sigue haciendo) decenas de contenedores para oficinas de empresas constructoras, mercadillos de artesanía y carpas de publicidad. El pavimento está destrozado, muchos alcorques vacíos, no hay zona infantil, la mitad de la plaza está ocupada por una terraza y parte de la otra mitad por contenedores de oficinas.</p>

<p>Además la plaza tiene una joya oculta (y propiedad del Ayuntamiento), el edificio Montesol, de 8 plantas y miles de metros cuadrados. Comprado hace años por el gobierno municipal del  PP para hacer un hotel 5 estrellas para alojar a los turistas de las inefables olimpiadas, el edificio languidece abandonado y vacío desde hace años. Pocas veces una ciudad tan densa como Madrid tiene la posibilidad de crear un espacio público de esas dimensiones en un lugar tan céntrico y bien conectado de la ciudad. Las posibilidades son infinitas; polideportivo, piscina municipal, escuela infantil, espacios de coworking, locales de ensayo, centro de mayores, atención al turista o todo a la vez.</p>

<p>La plaza del Carmen es de las pocas plazas del centro que no han sido reformadas en las últimas décadas. Con las desafortunadas reformas de Sol, Callao, Santa Ana  y Jacinto Benavente los vecinos del centro hemos visto como los espacios de juego, encuentro y socialización se han subordinado a los intereses comerciales de los bares con sus terrazas, las marcas que instalan carpas de publicidad y las ferias de artesanía. Es decir la norma parece haber sido crear plazas duras sin obstáculos, bancos, árboles, fuentes o zonas de juego para niños que dificulten a las empresas montar sus negocios. Basta ya, otra ciudad es posible.</p>
";"08/09/2015 19";"30";"22";"8";"1";"866792020";"1026"
"2250";"Abuso de algunos taxistas";"<p>Evitar que algunos taxistas bloqueen el ""carril bus"" de la Gran Via, quedandose parados y libres en las puertas de los hoteles de dicha calle. Obligando a los autobuses a cambiarse de carril, sin necesidad, ocasionando un severo trastorno a la delicada circulacion por esta calle.</p>
";"08/09/2015 19";"50";"42";"8";"7";"871404088";"2856"
"2252";"Retirar radares fijos";"<p>Circular en Madrid se ha vuelto un peligro. La desmesurada cantidad de radares fijos hacen imposible circular. Terminas estando más atento a la velocímetro que al tráfico en si mismo. Muchos de los radares puestos en los gobiernos del PP sólo tienen un fin lucrativo, multas de 90 por circular a 74km/h en lugar de 60 km/h. Una broma sin duda de mal gusto. No pido que se retiren radares que están en puntos negros y de seguridad, pero SÍ en puntos con un único y marcado afán lucrativo que peuden llegar a ser peligrosos incluso para los propios conductores. Por ejemplo en un cambio de rasante en que la velocidad pasa de 90 a 60 de manera brusca, en que o te llevas un multazo o un frenazo del conductor de delante.  </p>
";"08/09/2015 20";"57";"17";"40";"1";"854253413";"-685"
"2254";"Contenedores (amarillos) de reciclaje de envases con apertura más grande";"<p>Los contenedores de reciclaje de envases (amarillos) que se encuentran en las calles junto a los de papel y vidrio tienen una apertura minúscula. Resulta imposible hacer pasar por esa pequeña bocana una bolsa de envases para reciclar de tamaño normal. Se favorecería el reciclaje si se facilitase el uso de esos contenedores para los domicilios en los que no existe cubo comunitario amarillo.</p>
";"08/09/2015 20";"39";"35";"4";"1";"871764181";"2782"
"2255";"Permitir la presencia de los perros en el Transporte Público de Madrid";"<p>Tengo familia viviendo en Suecia.  Cuando monto allí en autobús me da mucha envidia al ver cómo la gente puede subir con sus perros con total normalidad. ¡Nadie lo discutiría! Pediría que lo mismo pudiera suceder en el transporte de mi ciudad y que se regulase esta posibilidad. Además, es una medida de coste cero y, por ello, plenamente factible.</p>
";"08/09/2015 20";"96";"59";"37";"4";"866744564";"1352"
"2256";"Plan movilidad";"<p>Reorganizar el estacionamiento en la colonia Pedro Vives (Latina).</p>
";"08/09/2015 20";"8";"4";"4";"0";"858359229";"0"
"2257";"Ilegalizar el pronto pago.";"<p>La máxima sinvergonzonería del estado es la medida llamada ""pronto pago"" por la cual planteas al ciudadano renunciar a su DERECHO de defensa por el temor de perder un descuento físcal. Claramente un acto vandálico del Estado con un fin meramente recaudatorio. El descuento debería prorrogarse para todos aquellos que decidan acogerse a su derecho de defenderse de una multa. Dándole la oportunidad de pagar mínimo en una semana hábil en caso de fallo a favor del estado.</p>

<p>Todos tenemos derecho a defendernos sin temor a que un fallo en la gestión o inexperiencia del recurso nos haga perder el descuento fiscal.</p>
";"08/09/2015 20";"41";"29";"12";"0";"867078319";"1202"
"2258";"Una línea más de EMT por San Fermin - Avenida de Rosales";"<p>Creo necesaria para la zona de edificios nuevos de San Fermín, en Avenida de Rosales, una línea más de autobuses que comunique la zona, aparte del 23 y el N12, ya que para moverse en transporte público dependemos demasiado del 23, el cual ni es muy frecuente ni une con zonas importantes de transbordos, como la Avenida de Andalucia o la Plaza de Legazpi.</p>

<p>Creo que se podría derivar alguna línea de todas las que pasan por Avenida de Andalucia por Avenida Rosales, especialmente el 85, el cual creo que se contempló en el pasado modificar su recorrido por esta zona que digo.</p>

<p>Además no solo nos vendría bien a los vecinos de la zona, si no también a los vecinos de otras zonas que qusieran ir al Bricomart, al Mercadona o al Tanatorio.</p>

<p>Gracias por la atención, un saludo.</p>
";"08/09/2015 20";"19";"15";"4";"0";"866645889";"868"
"2259";"Revisar los contratos de Recogida de Basura por Abusivos";"<p>Revisar los contratos de recogida de basura porque nos estan esquilmando el bolsillo a los madrileños. La pregunta es, ¿cuanto dinero ganara la adjudicataria por cada trabajador, para que pueda hacer frente al pago de las nominas que rondan los 35.000  al año.?. Es que me parece desorbitado y mas teniendo en cuenta la cualificacion profesional. Y hay jornadas en las que no llegan a hacer ni 6 horas de trabajo, o como mucho 7.</p>

<p>Me parece una pasada de sueldos y no digo que no tengan derecho a un sueldo bueno por lo insolubre del trabajo, aunque habra quien diga que los olores hay que aguantarlos, tambien el carpintero traga el serrin de la madera y el soldador los gases de la soldadura  y de la radial y no tienen esos sueldos.</p>

<p>Pero el tema no es lo que ganan, si no, cuanto se llevara la empresa de recogida para poder hacer frente a  esos gastos.</p>

<p>Se que habra quien este en contra de mi exposicion sobre todo los trabajadores, pero a mi me duele el dinero que pago por la recogida de basura y me cuesta mucho trabajo ganarlo. Soy trabajador cualificado y no llego a esos sueldos ni de lejos. Estoy seguro que controlando los contratos de estas empresas se ahorraria mucho dinero a nuestros bolsillos.</p>

<p>Ya está bien.</p>
";"08/09/2015 20";"20";"14";"6";"5";"865268174";"560"
"2260";"Programa urgente de AutoEléctrico";"<p>Para fomentar el I+D+i de la región, el ayuntamiento debería sacar un concurso público llamado ""Programa Urgente de AutoEléctrico"", que consista en que empresas e industrias ubicadas en Madrid diseñen, desarrollen y fabriquen automóviles eléctricos bajo la premisa 100x100x100; esto significa que deben tener una autonomía de 100 km, que alcancen una velocidad de 100km/h y que cuesten 100/mes. De esta manera se crearía empleo de calidad en la región, Madrid sería un referente en la tecnología de automóvil urbano eléctrico y por supuesto se reducirían notablemente los índices de contaminación de la ciudad al incrementarse la flota de vehículos con cero emisiones.  </p>
";"08/09/2015 20";"19";"9";"10";"0";"858453919";"-47"
"2261";"Más piscinas / gimnasios municipales en Centro";"Con 150.000 habitantes el distrito Centro tiene 1 piscina/gimnasio (inaugurado hace tres años),  ciudades con una población similar, como Pamplona o Las Rozas-Majadahonda tienen 12 y 6 respectivamente.

<p>A pesar de gastarnos decenas de millones en promocionar las olimpiadas, el único polideportivo que existía en el distrito Centro (en la Plaza de la Latina) se demolió y ahí sigue el agujero.  </p>

Promocionemos el deporte de verdad, no a base de marketing.
";"08/09/2015 20";"60";"53";"7";"1";"873168656";"4063"
"2262";"Libertad animal";"<p>La libertad es un derecho inalienable para cualquier ser vivo, sobre todo para aquellos cuya inteligencia haya sido demostrada, es decir todo mamífero superior al igual que algunas especies de reptiles desarrolladas. Es por ello que proponemos la puesta en libertad de todos los animales que pueblan el Parque Zoológico de Madrid de manera inmediata e irrevocable.</p>

<p>Esta propuesta, además de otorgar a los animales la libertad que merecen, pondrá a Madrid, nuestra ciudad, a la cabeza de Europa en lo que a diversidad de fauna metropolitana se refiere. Los animales convivirán en armonía con los ciudadanos y ciudadanas madrileños y madrileñas, enriqueciendo nuestros valores de solidaridad y compañerismo. Entre todos y todas, conseguiremos que vivan en paz y libertad.</p>
";"08/09/2015 20";"45";"13";"32";"3";"854692473";"-548"
"2264";"Mejorar, Incrementar e incluso sustituir lineas de EMT por lineas EXPRESS";"<p>Hay barrios alejados del centro de Madrid y de las estaciones del Metro, muchas veces por mala planificacion del trazado. Muchas lineas de autobus de la EMT dan demasiadas vueltas y tienen recorridos demasiado extensos y duraderos.</p>

<p>Propongo que se estudie la mejora de los recorridos y que se añadan lineas express o se mejoren las que existen actualmente, ya que dan un servicio realmente bueno conectando rapidamente con diferentes zonas del centro.</p>

<p>La linea E3, por ejemplo, podria subir hasta el final de la calle Minerva (por gran via del este), ya que esta zona queda alejada de las estaciones de metro de la zona.</p>
";"08/09/2015 20";"24";"18";"6";"0";"866599810";"900"
"2265";"Contraten informáticos que creen una web que no se cuelgue cada minuto";"<p>Pues eso, mejoren esta estupenda web. No se lo tomen mal</p>
";"08/09/2015 20";"25";"13";"12";"1";"858923096";"52"
"2266";"Abrir al público los jardines del Cuartel General del Ejército en Cibeles";"<p>En una ciudad tan densa como Madrid, disponer de miles de metros cuadrados de espacio verde consolidado y tenerlos cerrados al público es una desgracia. Supongo que el motivo que se aduce para que no podamos usar este espacio a diario es la seguridad pero creo hay maneras de proteger el Cuartel y permitir el uso de los jardines. Otros lugares delicados son por ejemplo la plaza frente al Cuartel General del Ejército del Aire en Moncloa o los jardines de Sabatini, ambos con uso público. Si se abrieran a diario y no esporadicamente serían un lugar óptimo para juegos de niños, pequeños escenarios para músicos o artistas o simplemente para salir del asfalto.</p>
";"08/09/2015 20";"51";"32";"19";"3";"865669897";"815"
"2267";"Por una limpieza digna";"<p>Los madrileños deberíamos solidarizarnos con Cádiz. Una ciudad hermana en la que muchos de nosotros pasamos las vacaciones en verano. Es por eso que propongo que el ayuntamiento inicie una colecta para pagarle al Kichi una visita al odontólogo para que le haga una limpeza de piñata así como un alineado dental que representará mucho mejor a los gaditanos. Saludos camaradas.</p>
";"08/09/2015 20";"23";"17";"6";"1";"866289811";"813"
"2268";"Ejecutar ya la plaza de los Jardines del arquitecto Ribera (plaza de Barceló)";"<p>Tras soportar años de ocupación de este espacio público por parte del mercado temporal de Barceló, la plaza de los Jardines del arquitecto Ribera lleva casi un año abandonada, vallada y acumulando basura. Son más de 5000m2 en una zona sin apenas plazas, delante de un colegio público, una biblioteca y un mercado. Además existe un proyecto aprobado por el Ayuntamiento y realizado contando con asociaciones de vecinos de la zona. ¿A qué se está esperando?</p>
";"08/09/2015 20";"65";"57";"8";"12";"873606320";"4296"
"2269";"Devolución del 50% de la tasa de basuras a los vecinos de centro";"<p>Desearía que el Ayuntamiento de Madrid devolviese el 50% de la Tasa de Basuras a los vecinos de centro desde su cobro hasta 2014 porque no contábamos con el mismo sistema de recogida que el resto de distritos bien por cubos o por contenedores. En el Ayuntamiento no hay cubo amarillo, ni en ningún inmueble de la plaza Mayor o de cualquier calle del distrito Centro. Hay islotes inutilizados.</p>
";"08/09/2015 20";"35";"12";"23";"1";"854951557";"-377"
"2270";"Que el ayuntamiento pague las hipotecas de la gente que no las puede pagar";"<p>Queremos que el Ayuntamiento evite los deshaucios pagando las cuotas que no puede la gente y evitar los deshaucios. Es la manera más barata y eficaz de evitarlos. Al menos pagar los primeros 500 euros para que los que tienen menos puedan mantenerse en su casa, es más barato que buscarles después realojos o cosas de estas.</p>
";"08/09/2015 20";"83";"8";"75";"3";"856665370";"-645"
"2271";"Por un Madrid políglota";"<p>Buenas camaradas. No sé a vosotros, pero yo me muero de envidia al ver esas comunidades autónomas de España con su idioma propio. Esos catalanes, sus butifarras y su catalán. Esos gallegos, sus percebes y su gallego. Esos vascos... Es por eso que traigo esta propuesta. Como tenemos un gobierno municipal que parece vivir en el espacio, propongo implantar el idioma Klingon en nuestros colegios para poder tener un idioma con el que amamantar a nuestros retoños. Muchas gracias.</p>
";"08/09/2015 20";"41";"17";"24";"1";"855085822";"-290"
"2272";"Aprovechamiento de lugares públicos";"<p>Visto que muchos lugares públicos no se utilizan para completamente nada, estaría bien que se les buscara otro uso. Un ejemplo de esto: si algunas oficinas públicas no se utilizan para lo que se debe por cualquier extraña razón y se gasta la luz, el agua, etcétera, por qué no usarlo para cursos de formación para parados o para terapias en grupo contra la drogadicción. Sé que suena muy descabellado, pero así convertiríamos un gasto inútil en un futuro mejor de la sociedad. Por otra parte, habiendo gente que duerme a la intemperie, también se podría buscar de esta manera algún lugar donde poder permitirles pasar la noche sin tener que sufrir el frío que viene ahora en invierno. Todo el mundo tiene derecho a un lugar digno donde dormir. </p>
";"08/09/2015 20";"15";"10";"5";"0";"863226348";"333"
"2273";"Facilitación de pisos a los okupas de Madrid";"<p>No puede ser que un ayuntamiento no trabaje por la meritocracia y dar pisos a los okupas es trabajar contra ella. Todo hay que ganárselo a base de esfuerzo y trabajo, ya sea un empleo, dinero o una casa. Una cosa es ayudar a gente con necesidades sociales a través de alquileres sociales y otra muy diferente es dar pisos a okupas que lo único que hacen es molestar y armar escándalo allá por donde van. Menos trabajar por el comunismo, un sistema que ha demostrado su fracaso e ineficacia siempre que se ha puesto en marcha, y más fomentar una cultura meritocrática en la sociedad, que es la mejor forma de progreso. Escuchar a los okupas decir que tienen derecho a okupar una vivienda cuando son expulsados de otra es un ataque contra la ética y la justicia.</p>
";"08/09/2015 20";"99";"30";"69";"8";"853632181";"-1181"
"2274";"Identificar con el ADN las heces de los perros";"<p>   Hace unos años en un informe sobre limpieza en las ciudades,Madrid fue nombrada como la capital europea de las ""cacas"" de perro. Se han tomado medidas como habilitar areas cerradas (seguramente pocas), repartir bolsas para las heces, sanciones. Pero el problema no se ha resuelto.</p>

<p>   Es viable, tanto técnicamente como económicamente,  incluir un análisis de ADN en la identificación de cada perro tal y como ha implantado el ayuntamiento de Crevillent (Alicante) (Diario Información de Alicante del 20 de enero de 2015). El análisis de las heces puede identificar el perro y en consecuencia al propietario del animal.</p>

<p>   Esta medida debería servir más para disuadir que para sancionar.</p>

<p> </p>

<p>  </p>
";"08/09/2015 20";"92";"48";"44";"3";"862053632";"208"
"2275";"Campaña de concienciación de la limpieza";"<p>Actualmente, los servicios de limpieza de Madrid dan un servicio que deja bastante que desear por los contratos de las adjudicatarias. Sin embargo, otro elemento que influye, es la <strong>poca conciencia ciudadana por la limpieza.</strong> </p>

<p>Se ve como ""normal"" tirar un papel al suelo, una colilla,... Incluso los niños sin que sus padres les digan nada. La c/Palma, zona de bares y pubs, está cada fin de semana hasta arriba de latas, botellas y comida tirada por los suelos. Por ello, el Ayuntamiento debería <strong>poner en marcha una campaña de concienciación, con publicidad en marquesinas etc,</strong> en que si es necesario salgan fotos de cerdos bajo el lema ¿En esto quieres convertir Madrid? o algo parecido. Pero de poco sirve aumentar el presupuesto en limpieza si cada vez somos más cochinos.</p>
";"08/09/2015 20";"34";"32";"2";"4";"872614419";"2823"
"2277";"Soterrar el tramo de M-30 que transcurre por la Avenida de la Ilustración.";"<p>Se trata de un tramo que rompe con la fluidez de la propia M-30. De este modo se potenciaría la zona pudiendo en su lugar aumentar las zonas verdes y aportar mas vida comercial a la zona y de ocio ademá de reducir el ruido y la contaminación visual para los vecinos. Además de descongestionar las salidas de madrid por la Carretera de Colmenar, Coruña y Burgos ahorrando tiempo y proporcionando calidad de vida a miles de Madrileños. Por no decir  que en diicho tramo se han ocasionado multitud de atropellos algunos de ellos con victimas mortales. </p>
";"08/09/2015 20";"60";"42";"18";"3";"868371605";"1679"
"2278";"Campaña por el intercambio de libros para los colegios madrileños";"<p>Se podría hacer una campaña en todos los colegios públicos promoviendo el intercambio de libros ya usados. Así no habría tantísimo gasto por parte de las familias que más lo necesitan. Se podría dar a cambio algún ticket promocional para comprar ropa por ejemplo o para ir al cine. Es una manera de permitir obtener libros gratis a familias que más lo necesitan a cambio de algo que gusta a todos. </p>
";"08/09/2015 20";"28";"25";"3";"1";"870640893";"1964"
"2281";"Unir las líneas 1 y 7 de metro mediante un pasillo subterráneo";"<p>Creo que sería muy beneficioso para el distrito de Chamberí y en general para todos los madrileños que tengan que moverse por el mismo, la unión de la línea 1 con la 7 mediante un pasillo subterráneo en las paradas de Iglesia (L1) y Alonso Cano (L7) como el que existe en la parada de Plaza de España (L3 y L10) y Noviciado (L2).  </p>

<p>Ya que la línea 7 conecta de forma transversal el distrito y no goza de ningúna conexión con la línea 1 (una de las más importantes de la red). Además la línea 1 tiene varias paradas en el distrito que quedan mal comunicadas con otras zonas colindantes, obligando por ejemplo a un vecino que viva cerca a la parada Islas Filipinas (L7) y que necesite ir a la parada Río Rosas (L1) a tener que hacer dos transbordos con el incremento de tiempo que eso supone, que de haber una conexión entre ambas líneas en pocos minutos los vecinos podrían desplazarse comodamente. </p>
";"08/09/2015 20";"51";"43";"8";"5";"871798341";"2950"
"2282";"Himno oficial";"<p>""Yo estaba en el medio, giraban las otras al corro"" ¿En serio? ¿Realmente así empieza el himno de Madrid? No lo veo... En fin. Lo que propongo es poner una canción más apropiada como himno de nuestra adorada capital. Una canción que llene de alegría e incite a la danza y la diversión a los extranjeros que nos visiten. Pocos temas tan apropiados para este fin como el ""Aserejé"". Un tema pegadizo y que haría que nuestros ciudadanos se sientiesen mucho más identificados con Madrid como nación. Saludos camaradas.</p>
";"08/09/2015 20";"36";"7";"29";"2";"855922358";"-427"
"2284";"Limitar el Impacto acústico en zonas residenciales por las zonas de ocio";"<p>Lo cierto es que hay zonas de la ciudad claramente residenciales que sufren un exceso de ruido provocado por la afluencia a los bares. A modo de ejemplo, la calle Ponzano, esquina Bretón de los Herreros, zona netamente residencial, hay edificios que tienen en sus bajos 3 locales de ocio... esto genera:</p>

<p>- Ruido de la gente que sale a fumar y de paso (en contra de la ley) saca su bebida a la calle. En la zona que os comento (pero en muchas otras también) todos los días hasta las 2/3 de la mañana el ruido es muy superior al que marca la normativa. Todo ello por no hablar de la normativa que prohibe hacer uso de la calle para fines privados (es muy habitual que se ocupen espacios públicos y en ocasiones se hace difícil pasar andando o con un carrito de bebé)</p>

<p>- Ruido por los coches, la doble fila hace que en ocasiones uno no pueda aparcar en su propia plaza de parking o bien se vea despertado a las 3 de la mañana por los pitos de un coche que quiere salir. Esta doble fila y el ruido de circulación es endémico en Ponzano, Malasaña, ....</p>

<p>Creo que o bien se establece una zona de protección acústica en zonas residenciales (esto ya existe en algunas zonas) o bien, creo que lo más sencillo, se limite el número de bares por cada 100 metros (1 o 2) que sería más razonable. No se entiende cómo un mismo edificio puede tener 2 o 3 locales de ocio sin insonorizar y que no cumplen la normativa de cierre. Sería también bastante razonable limitar la apertura hasta las 11 o 11:30 pm entresemana o sino... que a partir de esta hora los clientes obligatoriamente deban de estar dentro del local y éste cerrado (por supuesto insonorizado).</p>

<p>No se trata de acabar con el negocio del ocio nocturno sino de propiciar que éste conviva con las necesidades de los vecinos y también intentar que se cumpla la ley... de consumo de alcohol en la calle, de uso de la vía pública, de doble fila, de nivel de ruido, etc.</p>

<p> </p>
";"08/09/2015 20";"40";"30";"10";"12";"868966197";"1500"
"2285";"Emplear a los parados que reciben subvencion";"<p> Considero que cualquier ciudadano que recibe una subvención por desempleo debería dedicar al menos tres horas al día de su tiempo a colaborar de forma gratuita para el bien de todos los ciudadanos. </p>

<p>El Ayuntamiento de Madrid debería organizar grupos de trabajo para  emplear a estas personas en las tareas que convenga </p>
";"08/09/2015 20";"53";"25";"28";"4";"857010625";"-141"
"2287";"¿Cuánto cuesta mantener esta web?";"<p>¿Y a quién se ha contratado para implementarla y mantenerla? ¿Familiares de la alcaldesa o de los concejales? No con mis impuestos...!!!</p>
";"08/09/2015 20";"53";"21";"32";"3";"854562132";"-435"
"2288";"Stop al racismo en las actuaciones policiales";"<p>Hay que terminar con las identificaciones policiales en la calle, supuestamente ""al azar"", basadas fundamentalmente en los rasgos físicos de las personas. </p>
";"08/09/2015 20";"48";"19";"29";"1";"854744591";"-395"
"2293";"Parques publicos en Sanchinarro";"<p>Depués de 10 años viviendo es Sanchinarro, este barrio sigue siendo un erial en cuanto a Parques se refiere. Después de prometernos (años atrás) un barrio con 3 millones de metros cuadrados de zonas verdes, lo único que hay verde todo el año son las medianas de la Calle Alcalá Aniceto Zamora.</p>

<p>Nuestros parques son auténticos zarzales, sin equipamiento o en mal estado, alumbrado pésimo , etc.</p>

<p>Cuando paseo por otros distritos y no muy lejos de donde vivo, en Pinar de Chamartín, los parques tienen césped, están cuidados y bien regados.</p>

<p>Gallardón se gastó más 12 millones de euros en llevar el agua reciclada desde la depuradora de Valdebebas hasta Sanchinarro, pero parece que solo sirve para que los camiones de baldeo la carguen en la Calle Isabel Clara Eugenia, justo al lado de unos parques sin riego.</p>

<p>Me gustaría que nuestro ayuntamiento se implique más con Sanchinarro después de años de olvido.</p>

<p>Saludos a todos</p>

<p> </p>
";"08/09/2015 20";"77";"67";"10";"3";"874070825";"4959"
"2294";"Que el coste de esta web sea pagado del sueldo de los concejales";"<p>Como ciudadano me parece una autentica aberracion que el dinero de los impuestos se utilice en esto, por lo tanto propongo que el coste operativo y de desarrollo de esta web sea sufragado por sus concejales o partido politico.</p>
";"08/09/2015 20";"55";"29";"26";"2";"861557568";"158"
"2296";"Más autobuses para Butarque (Vvde Bajo)";"<p>La zona de Nuevo Rosales o Butarque está creciendo a pasos agigantados y solo dispone de un autobús (linea 85) que tiene un enorme recorrido (Atocha-Rosales) y esto va en detrimento del uso público de la zona que nos vemos a veces incitados a coger nuestros coches privados para poder llegar a trabajar. ¿se podría poner otra linea adicional con un recorrido más corto que fuese hasta Legazpi? (los barrios de Vvde Alto, Ciudad de los Angeles y San Cristobal cuentan cada uno con dos o más lineas, ¿y Vvde Bajo??)</p>

<p> </p>
";"08/09/2015 20";"14";"12";"2";"1";"867403175";"857"
"2297";"Madrid a favor de la unidad de España";"<p>Madrid, como capital de España deberia pronunciarse contra los movimientos que intentan acabar con la nación; en contra de los movimientos  independistas y declarar persona non grata a los que lo promueven.</p>

<p> </p>
";"08/09/2015 20";"59";"31";"28";"1";"861404168";"157"
"2298";"Una línea más de bus para Butarque (Vvde Bajo)";"<p>La zona de Nuevo Rosales o Butarque está creciendo a pasos agigantados y solo dispone de un autobús (linea 85) que tiene un enorme recorrido (Atocha-Rosales) y esto va en detrimento del uso público de la zona que nos vemos a veces incitados a coger nuestros coches privados para poder llegar a trabajar. ¿se podría poner otra linea adicional con un recorrido más corto que fuese hasta Legazpi? (los barrios de Vvde Alto, Ciudad de los Angeles y San Cristobal cuentan cada uno con dos o más lineas, ¿y Vvde Bajo??)</p>

<p> </p>
";"08/09/2015 20";"16";"13";"3";"1";"866960397";"812"
"2301";"Mejor señalización de las calles con circulación restringida a residentes";"<p>Así se evitan las multas cuando se accede a una porque hay poca visibilidad y la señal no se ve bien. Deberían identificarse claramente y se evitarían las multas injustas.</p>
";"08/09/2015 21";"41";"38";"3";"0";"873078301";"3243"
"2302";"Plantar árboles,árboles,árboles, en todas las calles y plazas";"<p>Los gobiernos municipales anteriores parecían odiarlos.Los vecinos,incluso, estaríamos dispuestos a cuidarlos.Quizás en algunos sitios las conducciones,pavimento, etc., no admitan alcorques, pero sí macetones. Por favor, el árbol es la criatura (ó una de ellas) más generosas de la naturaleza.</p>

<p>(y,en concreto, la calle Españoleto es la única del entorno próximo carente de ellos.La anchura de la acera sí da para ello:alcorque ó macetón)</p>
";"08/09/2015 21";"61";"55";"6";"1";"874029263";"4418"
"2303";"Limpieza comercial y ciudadana";"<p>Que sea <strong>OBLIGATORIO</strong> <strong><u>para los comerciantes limpiar el trampo de calle que corresponde a su comercio</u></strong>.<u> Al igual que cada bloque de pisos se responsabilice del tramo que tenga frente a su domi</u>cilio. Sería mucho <strong>más eficiente</strong> esta limpieza que la que brinda la Comunidad <strong>y</strong> mucho <strong>menos costosa</strong>. Entre todos estará mucho más limpio Madrid y la población estaría más concienciada de que la suciedad que se arroja la tiene que recoger alguien. Ya que los comercios y personas de cada edificio llamarían la atención de los guarros que tiran papel y basura al suelo. Además de que en muchos bares que disfrutan de terrazas se concentran mucho de estos guarros.
Es una práctica que se hace en Alemania y por ello la CIUDADANÍA está más concienciada.</p>
";"08/09/2015 21";"31";"20";"11";"1";"865012208";"580"
"2305";"Grandes macetas en las aceras";"<p>No entiendo porqué no retiran las grandes macetas que propietarios de lujosos inmuebles situan a la puerta de sus garajes.</p>

<p>Ello obliga al conductor que se la encuentra de frente a invadir la calzada contraria y si chocara con otro vehículo que viniera de frente la culpa sería suya.</p>

<p>Pero claro la policía municipal ni da parte ni los retira. En la zona de puerta de hierro están por doquier. Y que se aparten los demas.</p>
";"08/09/2015 21";"21";"12";"9";"0";"861510127";"171"
"2308";"Prohibamos vaciar los cubos de fregar en la calle";"<p>Muchos comercios y porterías del centro vacían en las calles el agua sucia que queda en los cubos de fregar después de limpiar sus respectivos inmuebles, algo innecesario y que ensucia mucho la vía pública, además de dar una imagen bastante cutre de la ciudad. </p>
";"08/09/2015 21";"29";"16";"13";"0";"861424023";"165"
"2310";"Servicio de apoyo y/o voluntariado para las personas refugiadas";"<p>Buenas tardes,</p>

<p>Debido a las relativamente recientes noticias de la llegada de personas refugiadas a España, pero para el caso, a la ciudad de Madrid, existirán una gran variedad de situaciones de necesidad, desde las más básicas como alimento, higiene, hospedaje, traducción hasta otras de otra índole, tales como la sanidad física y mental, la educación, el ocio, la organización de los espacios, la labor administrativa y personal que requerirá atender a tan abundante demanda...</p>

<p>Se me ha ocurrido que este sería un buen espacio para proponer, debatir, promover la movilización de la ciudadanía de Madrid en colaboración con los Servicios Sociales, Sanitarios, Educativos, Colegios Profesionales, entre otros... para atender en la medida de las posibilidades y voluntad de la gente y la aceptación de las personas refugiadas, estas necesidades a través de la contratación de servicios específicos o la organización del voluntariado.</p>

<p>¿Hasta que punto sería posible organizarlo y promoverlo desde el Ayuntamiento?</p>

<p>Saludos!</p>
";"08/09/2015 21";"41";"19";"22";"5";"857363874";"-139"
"2314";"Apertura de centros de día y residencias para menores de 55 años ";"<p>Cada vez aumentan más los casos de niños y jóvenes con demencias preseniles (y patologías similares). Por desgracia, las pocas residencias que hay son para mayores de 55 años. Hay que aumentar el número de ambas: aumentar los centros de mayores, porque la sociedad cada vez está más envejecida, pero también se necesita contemplar este apoyo para los menores de 55 años.</p>
";"08/09/2015 21";"26";"19";"7";"1";"866783577";"876"
"2315";"Que se publiquen las listas de espera de los P.A.R. y se persiga los alquileres.";"<p>Es totalmente opaca la lista de espera para poder acceder a una plaza de residentes en aquellos aparcamientos públicos que ya tienen cubierto el cupo desde hace años. Por otra parte, es un secreto a voces que en algunos aparcamientos para residentes se alquilan ilegalmente las plazas, siendo a veces complices y encargandose de la recaudación y entrega de llaves, los propios vigilantes. </p>

<p>Deberían publicarse las listas de espera y perseguir estas ilegalidades mediante un control aleatorio de las mismas.</p>
";"08/09/2015 21";"17";"14";"3";"2";"867569347";"905"
"2316";"Cinturón verde de Madrid: Zona del río Manzanares sur, parque lineal.";"<p>El río Manzanares es una vértebra de Madrid, en este caso quería hablar del Manzanares en su salida de la ciudad por el sureste. Se trata de una zona donde, históricamente, se han arrojado los residuos de todo tipo de Madrid además de haberse colocado instalaciones e infraestructuras de todo tipo, sometiéndola a una gran presión humana, abandono, maltrato medioambiental y social. La ciudad vive de espaldas a la vega del Manzanares que sobrelleva décadas de degradación de sus valores medioambientales, patrimoniales y paisajísticos. Donde Madrid podría tener una zona verde y paisajística, un tesoro, tiene un vertedero, literalmente.</p>

<p>Mi propuesta es regenerar la zona. Primeramente el río, saneando sus fondos y recuperando el bosque de rivera desde el parque del Manzanares en Usera hasta el límite de la ciudad con Getafe y Vaciamadrid. Recuperar zonas de descampados y escombreras, cercanas al río y a la ciudad, que eran antiguos campos de cultivo, como huertos urbanos para los vecinos de los distritos próximos. Más alejado de Madrid recuperación de la vega mediante taller escuela con cultivos tradicionales de la zona, cereal, hortalizas, pastos, etc. Recuperación de los restos del canal del Manzanares y sus edificaciones, utilizables como sede del taller escuela antedicho. Se recuperaría el paisaje tradicional y los madrileños, especialmente los niños, entrarían en contacto con las labores agroganaderas. Se plantarían en distintas lindes árboles coherentes con la zona de vega.</p>

<p>Recuperación y señalización de los riscos y los restos arqueológicos que existen, desde cuevas hasta poblados prerromanos. Recuperación de parte de las trincheras y búnkeres de la guerra civil con sencillo centro de interpretación en los edificios recuperados del canal del Manzanares.</p>

<p>Zona de meseta superior a los riscos, actualmente descampados y zonas de vertidos. Plantación de bosque Mediterráneo y recuperación del paisaje, incluyendo antiguos vertederos como la zona en recuperación de Valdemingómez, creando en el sureste un bosque periurbano enlazado con la vega del Manzanares y que se extienda, protegiendo a la vega, hacia el sureste, enlazando con el parque regional del Manzanares.</p>

<p>Creación de distintas rutas que permitan a los vecinos de los distritos cercanos una zona de expansión y tiempo libre, un espacio natural que una el centro de la ciudad con el parque natural del Manzanares y que suponga una reparación y puesta en valor del término municipal en esa zona, enlazándola con un hipotético cinturón verde de Madrid en el futuro.</p>

<p>Habría que dialogar con el municipio de Rivas-Vaciamadrid y el de Getafe para realizar una labor conjunta en la vega con recuperación del antiguo convento o la villa romana, entre otros. Es un proyecto a largo plazo, como es natural, pero que podría irse iniciando paulatinamente sin un coste importante y revitalizaría esa zona.</p>

<p>Habría que afrontar, de una vez, el ordenamiento de la cañada real en ese tramo, integrándolo en el parque, restaurando los daños, recuperando el espacio público y encarando la solución a los problemas de todo tipo existentes en ese lugar.</p>
";"08/09/2015 21";"80";"74";"6";"2";"875804615";"6290"
"2322";"Multar seriamente a los que aparquen en zona de minusválidos.";"<p>Ya que el número de plazas de aparcamiento para minusválidos es muy reducido, por lo menos deberían sancionar con más contundencia a quien aparcara en ellas sin tener la tarjeta para ello. Estas zonas deberían estar más vigiladas por la policía municipal, ya que con frecuencia aparca gente sin la acreditación adecuada.</p>
";"08/09/2015 21";"46";"31";"15";"3";"867179552";"1078"
"2323";"Utilizar Ayuntamiento y dependencias municipales para acoger refugiados";"<p>Buenas noches,</p>

<p>Nos encontramos en pleno año 2015 y la tecnología permite trabajar correctamente de forma telemática. Por ese motivo propongo que el Ayuntamiento y todas las dependencias municipales se vacíen y se conviertan en residencias para refugiados, pasando los trabajadores de dichos puestos a realizar sus trabajos desde sus casas. Así podríamos acoger a miles de refugiados. También se podría considerar detraer un porcentaje de los salarios de los funcionarios y políticos del ayuntamiento para financiar la manutención de estos pobres hombres que huyen de la guerra.</p>

<p>Es hora de ayudar en la Ciudad del Abrazo.</p>

<p> </p>
";"08/09/2015 21";"49";"22";"27";"7";"856384144";"-224"
"2324";"Desencuentros ciclistas urbanos y peatones";"<p>Uno de los principales desencuentros entre ciclistas y peatones se produce por causa de las bicis que circulan por las aceras, en especial con los usuarios esporádicos de <strong>BiciMad</strong>. El <strong>artículo 39 ter</strong> de la <strong>Ordenanza de Movilidad del Ayuntamiento de Madrid</strong>  explicita la prohibición de circulación de bicicletas en aceras y demás zonas peatonales. El asunto es claro, pero es habitual ver ciclistas en las aceras, algunos ignorando por completo el impacto que producen y comportándose sin el más mínimo respeto.</p>

<p>Creo que el Ayuntamiento debería concienciar a los usuarios de las bicis del buen uso y del respeto de las normas de tráfico, pués no dejan de ser un vehículo, en una primera fase con advertencias de la policía municipal. Y más adelante, con las medidas punitivas al uso: las multas.</p>
";"08/09/2015 21";"33";"20";"13";"6";"864632180";"424"
"2327";"Las aceras";"<p>Falta un control más exhaustivo de las aceras públicas, ya no soportan más elementos que estorben el paseo tranquilo por ellas, en el Centro de Madrid hay aceras en la que ya es casi imposible caminar: mesas, sillas, motos, carteles, toldos, kioskos, bolardos, postes, etc. Falta un control que haga de las aceras la función para las cuales fueron ideadas y ese es el paseo y el desplazamiento a pie sin obstáculos. Hoy existe un desmadre con las terrazas, ciclistas, peatones, segway, hombres anuncios, soportes publicitarios y un gran ETC.</p>
";"08/09/2015 21";"39";"32";"7";"3";"870575152";"2051"
"2328";"Mismos derechos para todos los niños.";"<p>Todos los niños tienen derecho al mismo dinero para su enseñanza con independencia de si su colegio es de titularidad pública o privada, si es legal y esta escolarizado y cumple las leyes tiene derecho a una enseñanza igual de subvencionada que los demás. Ya vale de sobre-financiar la enseñanza pública en detrimento del resto. ya vale de ""el que parte, reparte y se lleva la mejor parte"".</p>
";"08/09/2015 21";"33";"10";"23";"0";"855606664";"-393"
"2329";"Recuperar tradiciones madrileñas";"<p>Propongo que para que nos sintamos orgullosos de nuestra ciudad y darle un mayor realce al turismo, todos los empleados publicos del ayuntamiento, deberian vestirse de chulapos y chulapas, alcaldesa y concejales incluidos, a fin de dar ejemplo.</p>

<p>Eso crearia una marca unica para la ciudad de madrid con los beneficios que ello comportaría.</p>
";"08/09/2015 21";"64";"30";"34";"5";"856735497";"-187"
"2333";"Limpieza de Madrid, a fondo.";"<p>Madrid necesita, sin duda, un proyecto serio de limpieza. No hay peor imagen para una ciudad que la suciedad. ¿A quién le gusta pasear por la Gran Vía esquivando basura? Bolsas, cigarrillos, cartones, panfletos propagandísticos, cubos de basura desbordados...¿acaso no nos merecemos, como mínimo, una ciudad limpia? A los turistas los ahuyentamos, pero nosotros vivimos aquí...</p>

<p>Ojalá pongamos solución a un problema tan importante.</p>

<p> </p>
";"08/09/2015 21";"29";"25";"4";"2";"870555638";"1810"
"2334";"banco gratuito madrileño de libros";"<p>Poseo una cantidad importante de libros leídos y que ya no volveré a leer. He intentado varias veces venderlos en casas de segunda mano pero no los quieren (o dicen que no, pero en el rastro se ven puestos de libros viejos). Supongo que, como yo, habrá mucha gente que no sabe lo que hacer con ellos. Estoy hablando de literatura, historia... y libros de texto.</p>

<p>Se me ocurre que el Ayuntamiento, por medio de su area de cultura, podría potenciar un depósito a donde se puedan llevar estos libros para que otros ciudadanos los puedan leer, llevándolos con el compromiso de prestarlos a otras personas.</p>

<p>Tal vez haya algo a nivel municipal pero yo no lo conozco.</p>

<p> </p>
";"08/09/2015 21";"30";"21";"9";"1";"866706455";"839"
"2335";"Migración de DECIDE.MADRID a NodeBB: ¡por la actualidad!";"<p>Estamos en una época en la que la era digital es el pan de cada día. Llevo tiempo pasando por redes sociales y últimamente por foros y he gestionado profesionalmente diversas plataformas. Hoy en día, plataformas como esta junto a vBulletin y otros formatos más antiguos están ya muy aprovechadas y no se puede sacar más de ellas.</p>

<p>Disponemos de otros formatos mucho más estables y novedosos, con una interfaz lograda y modularidad impecable. Con funciones que vBulletin jamás podría llegar a soportar debido a limitaciones técnicas.</p>

<p>Es por ello que mi propuesta es obviamente migrar este sitio web a NodeBB. En caso de realizar tal migración, debéis tener en cuenta las siguientes mejoras:</p>

<p> </p>

<p>1. Interfaz personalizable desde títulos de página hasta colores de la interfaz.</p>

<p>2. Actualización en tiempo real de los mensajes.</p>

<p>3. Notificación en tiempo real de notificaciones.</p>

<p>4. Posibilidad de chat directo con otros usuarios o moderadores y administradores de la página. Esto es importante para la resolución de dudas y evitar que conflictos suban de tono innecesariamente.</p>

<p>5. Posibilidad de asignar reputación a usuarios de una forma justa y democrática para todos los usuarios.</p>

<p>6. Posibilidad de ""seguir"" a ciertos usuarios y sus propuestas así como mensajes. Podrás recibir en tiempo real una notificación cuando un usuario cree un tema... siempre que seas un seguidor suyo.</p>

<p>7. Elección de un avatar personalizado de forma sencilla a través de un gestor de subidas actualizado y plenamente funcional.</p>

<p>8. Grupos: podrás pertenecer a grupos y debatir en zonas privadas acerca de vuestros intereses conjuntos.</p>

<p>9. Edición de texto y previsualización en tiempo real. ¿Cuántas veces habéis escrito en un sitio y no sabíais como se iba a visualizar el mensaje? NodeBB es la solución ya que evitará que tus hilos queden descuadrados.</p>

<p>10. Facilidad de uso de markdown: trucos sencillos fáciles de aprender durante los primeros minutos de uso.</p>

<p>11. Uso de Pushbullet e incluso Telegram (mediante un bot) para recibir actualizaciones en tiempo real del foro en caso de que no dispongas una conexión a internet de banda ancha o se te hayan agotado tus ""megas"".</p>

<p>12. Destacamos sobre muchos aspectos la disposición de un buscador avanzado y personalizado capaz de filtrar a través de etiquetas y, evidentemente de palabras y términos relacionados.</p>

<p>13. Gestor de imágenes avanzado: podrás indicar dónde subir tus imágenes sin tener que pasar por páginas de subida que hacen tediosa su gestión.</p>

<p>14. Inserción fácil y sencilla de vídeos de casi cualquier plataforma solo con incluir el enlace desde, por ejemplo YouTube o Vimeo y otras plataformas.</p>

<p>15. Hemos detectado por ejemplo Exo.do es una plataforma que lleva NodeBB desde casi el primer día con resultados espléndidos.</p>

<p> </p>

<p>Por todas  estas razones creo que deberíamos migrar a esta plataforma y ayudar a los usuarios a tener una mejor experiencia de uso.</p>

<p>RAPIDEZ / INMEDIATEZ / CONTACTO DIRECTO / PRODUCTIVIDAD / NODEBB</p>

<p>Hagamos que las propuestas sean siempre visibles y podamos estar actualizados en todo momento.</p>
";"08/09/2015 21";"21";"11";"10";"5";"860725989";"52"
"2338";"Remodelacion del Barrio Numancia (Puente Vallecas)";"<p>Haria falta una remodelacion del barrio entero de Numancia (Puente Vallecas) Se encuentra en pesimas condiciones aceras pequeñas, coches subidos, parques sucios, solares vacios sin utilidad y llenos de basura, Mejorar transporte y poner BiciMad. Diferencias sociales etc</p>

<p> </p>
";"08/09/2015 21";"51";"42";"9";"4";"871725862";"2717"
"2340";"Puente Vallecas Soterramiento o Remodelacion";"<p>Haria falta que el Puente Vallecas se soterrara o se remodelara dando algo mas de luz a ese punto que es oscuro, sucio etc</p>

<p> </p>
";"08/09/2015 21";"43";"32";"11";"5";"869178315";"1562"
"2341";"Devolución del casco";"<p>Volver a poner la devolucion de los cascos de los embases, como se hacia antes y como se hace actualmente en otros paises europeos como Alemania y Holanda, botellas de vidrio, latas de aluminio y algunas de plastico.</p>

<p>La devolución podria ser en el propio supermercado y se favoreceria asi el reciclaje y la limpieza de la ciudad</p>
";"08/09/2015 21";"40";"31";"9";"0";"869523010";"1705"
"2343";"Via Verde Casa de Campo - Parque Regional del Curso Medio del Guadarrama";"<p>Queria proponer una via verde desde la casa de campo que una los municipios de Alcorcón y Móstoles hasta el Parque Regional del Curso Medio del Guadarrama. Móstoles es además el principio del ""Camino Real a Guadalupe"".</p>

<p>Realmente este camino ya existe, transcurre por de trás de Colonia Jardin, Casas Cuartel de Cuatro Vientos, Venta de la Rubia, Tres Aguas y enlaza con el carril bici en Alcorcón - Móstoles. Tan solo sería necesario adecuar los apenas 14 km del camino y señalizarlo debidamente.</p>

<p>De este modo se ampliarian las zonas de esparcimiento y ocio, se mejoraria las conexiones entre municipios, se mejoraria el tráfico al dar una alternativa a la colapsada A5 al permitir el desplazamiento en bici entre municipios de la periferia, se crearia un gran corredor verde entre la casa de campo y el parque natural del guadarrama, se multiplicarían las posibilidades de rutas y km ciclables pudiendo desde el centro  enlazar Madrid Rio, Casa de Campo, Cuatro Vientos, Alcorcón, Móstoles, Via Verde y el Parque Regional del Curso Medio del Guadarrama.</p>

<p>Y además podría servir de reclamo turistico al ser Móstoles el principio del camino de peregrinación conocido como ""Camino Real a Guadalupe"".</p>

<p> </p>
";"08/09/2015 21";"51";"45";"6";"1";"873192085";"3441"
"2345";"Demoler el Bernabeu como monumento fascista";"<p>Eso mismo</p>
";"08/09/2015 21";"63";"24";"39";"1";"854666800";"-571"
"2348";"que las empresas de limpieza no hagan chantaje en fechas para negociar sus tarif";"<p>Que las empresas que limpian Madrid en ciertas fechas (navidad es, etc) no limpien las calles aludiendo a los acuerdos monetarios con el ayuntamiento. Creación de contrataciones directas del ayuntamiento por medio de ett de parados sin prestación para la limpieza y mayores de 40 años y por haber trabajado tres o seis meses en esta situación, obligación de la empresa de admitirlos en su plantilla, como especie de castigo.</p>

<p>Bajaría el paro y las empresas no harían tantos secuestros de la ciudadanía de Madrid, pues se lo pensarían dos veces</p>
";"08/09/2015 22";"28";"20";"8";"2";"867060072";"857"
"2352";"Tasa por posesión de perros";"<p>Todos sabemos que los perros cuestan dinero a la ciudad, bien sea para retirar los excrementos que los dueños con gran falta de civismo no retiran, o bien por la distribución de bolsitas para aquellos con más sentido de la limpieza. Esta tasa a este problema, podría ayudar a las arcas de la ciudad a sufragar este gasto que tienen que hacer todos los madrileños, tengan o no tengan perro, y con el dinero recaudado emplearlo en la limpieza directa de la ciudad.</p>
";"08/09/2015 22";"80";"35";"45";"4";"854999935";"-437"
"2358";"Prohibir que los taxis circulen vacíos ";"<p>Se les podría coger en paradas o pedir por teléfono o mediante una aplicación. </p>

<p>Es una medida que ya se aplica en ciudades como San Sebastián y que contribuiría a reducir la contaminación, descongestionar el tráfico y disminuir la peligrosidad de la circulación (se evitaría que los taxistas circulasen mirando hacia la acera en búsqueda de clientes en lugar de estar pendientes del tráfico, que frenasen bruscamente sin señalizar la maniobra al encontrar un nuevo cliente y se reducirían sus horas de conducción, con la fatiga que ello conlleva).</p>
";"08/09/2015 22";"47";"25";"22";"3";"862321176";"159"
"2362";"REFORESTAR ZONAS VERDES HISTÓRICAS";"<p>en la casa de campo se necesita un plan para repoblar con encinas jóvenes, alcornoques, etc.</p>

<p>árboles autoctonos que regeneren el terreno.</p>

<p>no sólo el pino.</p>
";"08/09/2015 22";"66";"62";"4";"0";"875910913";"5448"
"2363";"No a los graffitis";"<p>Me gustaría utilizar esta oportunidad que nos da el ayuntamiento para expresar la indignación y desesperacion que me produce ver todas nuestras fachadas llenas de graffitis. Entiendo que deberíamos buscar una solución a este tema ante la total indiferencia mostrada hasta ahora por el ayuntamiento. Estos actos vandálicos se producen a plena luz del día, lo que demuestra el nulo temor que los ""grafiteros""(no creo que ni se les pueda considerar así ya que la inmensa mayoría se dedica a poner una firma y ya) a una sanción. </p>

<p>considero necesario que el ayuntamiento limpie estas pintadas con la frecuencia que sea necesaria ( entiendo que en los contratos que se suscriben con las empresas de limpieza están incluidos) así como que aumente el control policial y apliquen sanciones más duras con objeto de persuadir a estos vándalos de sus actos.</p>
";"08/09/2015 22";"53";"45";"8";"2";"872724484";"3141"
"2365";"Inmovilizar los vehículos municipales de 6:00 a 10:00 en días laborables";"<p>Uno de los motivos principales  de los problemas de tráfico en Madrid durante las horas punta son, precisamente, los vehículos municipales. </p>

<p>Propongo que se 6:00 a 10:00 de la mañana, no se muevan la vehículos destinados a ""parques y jardines"", Calle 30, recogida de basura..... en definitiva, que durante esas 4 horas no se muevan esos vehículos dedicados a labores de mantenimiento para no saturar, todavía más, las vías de comunicación de la capital.  </p>
";"08/09/2015 22";"29";"16";"13";"1";"862162444";"165"
"2368";"CONTINUAR MADRID RÍO POR EL NORTE Y SUR";"<p>sería estupendo aprovechar el carril bici para terminar de unir MADRID RÍO con El Pardo.</p>

<p>por el sur unirlo con villaverde y el parque lineal</p>
";"08/09/2015 22";"72";"64";"8";"5";"875026707";"4977"
"2369";"Sacrificio cero de animales en madrid.";"<p>Se irrebersibles. podria establecer el sacrificio cero de mascotas abandonadas que no sufrieran enfermedades. Para que no supusera un aumento de gasto para el ayuntamiento se podria fomentar los voluntarios , protectores.....</p>
";"08/09/2015 22";"56";"42";"14";"0";"870251265";"2100"
"2373";"LOS ANUNCIOS DE PROSTITUCIÓN INUNDAN LA CIUDAD DE MADRID";"<p>Es inadmisible que las calles de Madrid estén inundadas por anuncios para consumir sexo sin que sea necesario acudir a internet o a los periódicos. Sólo tienes que bajar a la calle para ver mujeres cosificadas, enseñando sus cuerpos, con fotografías muy explícitas a la vista de tod@s y también de menores. Consodero que hay que tomar medidas al respecto pues la proliferación de este tipo de octavillas ha aumentado en los últimos años ante la pasividad de las autoridades y el malestar de l@s vecin@s.</p>
";"08/09/2015 22";"50";"40";"10";"4";"871434521";"2400"
"2375";"Obras de mantenimiento en las vías de comunicación de noche y fines de semana. ";"<p>Ante el acuciante problema de movilidad que hay en la capital, es importantísimo que las obras de mejora y mantenimiento de las vías de comunicación, se realicen por las noches o los fines de semana e intentar que duren el mínimo tiempo imprescindible. </p>
";"08/09/2015 22";"12";"9";"3";"0";"865319421";"450"
"2376";"Trabajar en Madrid";"<p>Para los profesionales no puede ser que solo podamos estar aparcados en zona azul 4 horas y en verde 2 horas sin contar con las zonas restringidas. ¿Como podemos trabajar en centro?</p>
";"08/09/2015 22";"17";"6";"11";"3";"857071155";"-176"
"2377";"Murales artísticos que llenen de color un distrito abandonado.";"<p>Me gustaría proponer utilizar los muros de los solares abandonados y llenos de basura el distrito de puende de vallecas y de algunos edificios muy deteriorados. Mediante consursos o propuestas vecinales o de asociaciones vecinales poder dar la oportunidad a artistas y vecinos de transformar su barrio y darle un poco de luz a un barrio realmente golpeado por la crisis y con un altísimo indice de paro. El distrito de puente de vallecas como otros tantos ha estado abandonado a su suerte durante más de 2 décadas y necesita urgentemente devolver la dignidad a sus vecinos. Otras ciudades de españa como Zaragoza, Malaga o Getafe están realizando acciones de este tipo y el resultado es muy positivo, no sólo embellece el barrio, la gente que vive en el se siente más segura y alegre, lo que hace que cuiden más su entorno y mantengan la limpieza. En paralelo se podría crear una escuela de muralistas y grafiteros que fueran cantera de artistas reales y no de ""pinta firmas"", que podría atraer a una juventud con un futuro incierto y con mucho que decir pero sin medios para hacerlo. Gracias por valorar mi propuesta. Saludos.</p>
";"08/09/2015 22";"382";"345";"37";"73";"882242725";"27816"
"2380";"Que los vehículos públicos apaguen el motor cuando estacionan";"<p>Furgonetas, coches del ayuntamiento, policia, deberían dar ejemplo y apagar el motor al estacionar, a no ser que mantenerlo encendido sea necesario para alguna de sus labores o por exceso de frío o calor. Normalmente no lo apagan, ellos no pagan el combustible, se ahorra y se mejora el medio ambiente.</p>
";"08/09/2015 22";"39";"34";"5";"3";"872357273";"2528"
"2382";"PROBLEMAS GESTION ACCESOS EN AREAS RESTRINGIDAS";"<p>Aquí propongo un debate sobre el nuevo sistema de acceso a las zonas de area restingida en las que ahora no podremos desarrollar con normalidad nuestro trabajo. Me dedido a trabajos de rehabilitación en los que participan numerosos oficios y proveedores. La única solución que nos indican es que cada proveedor se gestione su acceso. ??????</p>

<p>Cuando tengamos un aviso de un apuntalamiento de urgencia, por ejemplo y tenga que entrar varios véhículos, operarios, herramientas, materiales, etc.... ¿Como se gestiona eso?</p>
";"08/09/2015 22";"13";"6";"7";"0";"859504635";"-46"
"2383";"Proteger los contenedores de papel reciclado para evitar ensuciar las calles";"<p>En mi barrio (Arganzuela) los contenedores de papel reciclado de las calles son sistemáticamente vaciados ilegalmente varias veces a la semana por personas en camioneta, que tiran al suelo todo aquello que no les interesa, contribuyendo aún más a la suciedad provocada por la falta adecuada de limpieza. Resultado: calles y jardines muy sucios en los que pronto en otoño las hojas caídas y los papeles arrojados al suelo crearán de nuevo una masa muy desagradable que cubrirá el pavimento. Además del problema de higiene pública que genera, contribuye a disuadir a la gente en cuanto al reciclaje, ya que a menudo ves cómo la bolsa que cuidadosamente has estado preparando en casa para llevar al contenedor está poco después despanzurrada en la acera, ensuciando con su contenido a todo el barrio. </p>
";"08/09/2015 22";"46";"40";"6";"4";"872949720";"2956"
"2385";"Expropiar los 19 pisos de El Gran Wyoming y dárselos a los refugiados";"<p>Todos los días podemos ver en antena a El Gran Wyoming, un personajillo televisivo, cuya máxima es 'lo tuyo es mío y lo mío es mío'. Para quien no lo sepa, José Miguel Monzón Navarro, más conocido por su nombre artístico El Gran Wyoming, en ocasiones abreviado como Gran Wyoming o Wyoming (Madrid, 15 de mayo de 1955) es un humorista, presentador de televisión, actor, músico, escritor, columnista y médico español. Actualmente es el presentador del programa de televisión El intermedio, emitido en La Sexta.</p>

<p>Como todos sabemos, los refugiados provenientes de Oriente Medio están llegando a Europa Occidental poco a poco. Pronto, las cuotas impuestas desde la Unión Europea harán llegar a España miles de ellos. Ya el Ayto. ha puesto un cartel de 'Welcome refuggies', pero eso no es bastante.</p>

<p>Mi idea es expropiar a todos aquellos que se manifiestan a favor de los refugiados sus bienes inmuebles y compartirlos entre estas pobres personas que, sin documentación ni identificación alguna, van a llegar pronto a nuestras ciudades.</p>

<p>Pues bien, personas como El Gran Wyoming tienen auténticos pisazos en Madrid que han de ser expropiados. En pocas palabras, el barrio de Salamanca debe de convertirse en el barrio Sirio.</p>

<p>Un saludo y muy buen foro.</p>
";"08/09/2015 22";"97";"52";"45";"2";"864195716";"375"
"2387";"Multar a los conductores que aparcan ocupando 2 sitios";"<p>Por vagancia, impericia o egoismo, todos estamos hartos de dar vueltas y ver como en sitios donde se podia aparcar no se puede porque alguien por ahorrar 1 minuto en maniobrar y encajar bien el coche  o porque se ha hipotecado 10 años para pagarlo y teme que se lo rallen aparca cogiendo 2 plazas provocando gasto de tiempo y gasolina a los demas conductores. Mucha gente harta se toma la justicia por su mano rayando el coche mal aparcado pero tampoco hay que rebajarse a su incivismo.</p>

<p>Propongo multar con una cuantia similar a una multa de aparcamiento a los coches aparcados en plazas señalizadas y delimitadas por lineas que sobrepasen alguna linea, de esta forma ganamos mas plazas de aparcamiento desaprovechadas y el ayto de madrid recibe un buen dinero de personas incivicas.</p>

<p>Incluso se podria hacer una o web en la que la gente pueda mandar fotos de esos coches mal aparcados pero que se vea claramente que no hay nadie dentro y la matricula, luego al infractor se le manda la multa a casa y la foto como prueba.</p>
";"08/09/2015 22";"47";"37";"10";"0";"870794222";"2125"
"2388";"Que los camiones de basura pasen a horas razonables y con menos ruido";"<p>En mi barrio (Arganzuela) los distintos camiones de basura para los distintos tipos de recogida llevan pasando en los más de diez años que vivo aquí de madrugada, a la 1 o las 2, añadiendo al ruido de las máquinas grandes gritos de los operarios, de manera que sistemáticamente despiertan a los vecinos. Si la hora punta en Madrid acaba hacia las nueve como mucho, debe ser posible organizar la recogida de basura de manera que pasen antes y pedir al personal que modere el volumen de voz con que trabajan. Mil gracias. </p>
";"08/09/2015 22";"56";"46";"10";"3";"872406535";"2957"
"2390";"Acabar con el consumo excesivo de torrijas en Semana Santa";"<p>Ya esta bien! Las torrijas, aunque no muchos, tambien tienen derechos</p>
";"08/09/2015 22";"36";"15";"21";"1";"856335591";"-250"
"2391";"Evitar derroche de luz y gas";"<p>En numerosos lugares públicos se mantienen encendidas las luces permanentemente y conectada la calefacción incluso en días tan calurosos, que se hace imprescindible abrir las ventanas mientras los radiadores arden. Por ejemplo, en la piscina municipal de San Blas, a pesar de tener unas enormes cristaleras a cada lado, están siempre encendidos los potentes focos. Y así días tras día, mes tras mes, año tras año... derrochando para nada.</p>
";"08/09/2015 22";"37";"31";"6";"0";"871254530";"2094"
"2393";"Evitar que las motos aparquen en la acera.";"<p>Aparcar las motos en las aceras es algo que beneficia al que aparca, que sabe que no le van a multar, pero perjudica a todos los demás. Hace incómodo transitar por la vía pública, a veces hay que bajarse de la acera porque hay una moto aparcada. Es peligroso para los niños pequeños que cuando las motos están calientes se pueden quemar. En fin, es una norma lógica que no se respeta en Madird e incomoda nuestro día a día.</p>
";"08/09/2015 22";"43";"24";"19";"1";"863567904";"279"
"2395";"Que el bono de 10 viajes del Cercanías no tenga caducidad de un mes";"<p>El servicio de Cercanías de Madrid es una buena opción para moverse por la ciudad si se tiene cerca una estación, pero el hecho de que su bono de 10 viajes deba ser consumido dentro de un mes desde la primera validación disuade a mucha gente de usarlo. El metro y el autobús, mucho más llenos a todas horas, tiene un metrobus de 10 viajes que no caduca más que cuando cambia la tarifa. Sería buena idea, para fomentar el uso del Cercanías y descongestionar el metro, que su bono tuviera el mismo sistema de no caducidad. De hecho, lo ideal sería que para las zonas A y O el metrobus sirviera también para el Cercanías, como ya ocurre en muchas ciudades europeas. Lo anterior, por supuesto, no se aplica a aquellos con abono transportes, que si pueden usar el Cercanías. Mil gracias. </p>
";"08/09/2015 22";"65";"60";"5";"2";"875673141";"5076"
"2396";"Multar a los bicicletas que interrumpen el tráfico";"<p>A las bicicletas que ralentizan el tráfico sin preocuparle los coches y que se saltan el semáforo.</p>

<p>No les importa ir lento porque siempre se saltan el semáforo.</p>
";"08/09/2015 22";"52";"28";"24";"0";"862823087";"215"
"2397";"Correccion a la Ley de Perros de Asistencia aprobada en Marzo";"<p>Mi pareja es una persona con discapacidad y tenemos una perrita de asistencia que le ayuda a quitarse la ropa, sacar la ropa de la lavadora, llevarla en un cubo al tendedero, abrir las puertas, etc.</p>

<p>Pero oh! Resulta que nuestra perra, que también ejerce como Perra de Terapia es un American Staffordshire, es decir, una supuesta perra peligrosa. </p>

<p>Dejando de lado que NO HAY ningún estudio etnológico y veterinario a nivel mundial que demuestre que la agresividad está en una raza determinada (no confundamos genotipos con fenotipos) resulta que la ley aprobada en Marzo nos deniega ese derecho. Derecho que recogía una ley a nivel estatal y que esta nueva disposición deniega.</p>

<p>Ahora un perro ppp, no puede ser ni prepararse como perro de asistencia....luego ¿que es nuestra perra que está debidamente certificada????</p>

<p>¿Qué hacemos las personas que como Antonio Casado, bombero de profesión y cuyo pitbull estuvo en Nepal salvando vidas, tenemos perros a los que ahora se les niega el derecho de ser lo que actualmente son?</p>

<p>Muchas gracias</p>
";"08/09/2015 22";"28";"25";"3";"0";"871568071";"1964"
"2399";"Utilizar letreros led del metro";"<p>En la estaciones de metro, en el acceso exterior hay un letrero led en el que sólo se puede leer ""Metro de Madrid"", están inutilizados. Estaría bien que mostrasen el tiempo para el próximo tren y así saber cuánto queda desde el exterior antes de entrar a la estación.</p>
";"08/09/2015 23";"25";"20";"5";"0";"868993115";"1200"
"2401";"Idear una estrategia para incentivar el uso de transporte público y bicicleta.";"<p>Hablar de la importancia que tiene hoy en día la responsabilidad medioambiental es hablar del presente y el futuro, debería ser un asunto de estado. Varias universidades prestigiosas de EEUU hablan ya de ""la sexta extinción"".Según la UICN <strong>cada año se extinguen en el planeta entre 10.000 y 50.000 especies</strong>. Y ninguno tiene duda de que el factor determinante para que esto suceda ha sido la huella del hombre.</p>

<p>Dejar el coche en casa, es una magnñifica idea para ayudar a contrarrestar el problema medioambiental y geológico.</p>

<p>Madrid no se encuentra ni en el top 10 de ciudades donde más se usa la bicicleta, habría que mejorar en este sentido, invirtiendo más en un anillo que recorra el centro urbano con estaciones para bicicletas, educando a la ciudadanía de la importancia de este asunto, usar la tecnología para desarrollar web o app para incentivar mediante gamificación al usuario y mil ideas más que se le puede ocurrir a cualquiera y no tiene porque ser caro.</p>
";"08/09/2015 23";"46";"30";"16";"1";"867125124";"913"
"2402";"Construir parkings disuasorios en estaciones de Cercanias.";"<p>De cara a reducir la contaminación, el trafico, mejorar la vida en la ciudad, sería muy positivo el construir parkings disuasorios en las estaciones de cercanias que no las tengan, como la estación  de Santa Eugenia, que está justo pegado a la A3 y hay un solar para construirlo.</p>
";"08/09/2015 23";"58";"53";"5";"1";"874980103";"4386"
"2403";"Comida halal en los colegios.";"<p>En Madrid a pesar de que exista ya una pequeña comudidad musulmana en muchos servicios públicos no se ve. Me gustaría que mis hijos pudiesen crecer siguiendo de manera correcta el Islam y me gustaría que en los comedores de los colegios la comida fuera halal cumpliendo así el Coran.</p>
";"08/09/2015 23";"103";"26";"77";"8";"855133772";"-1287"
"2404";"Permitir los comercios abiertos 24 horas";"<p>Los que trabajamos de noche o a turnos no podemos descansar el fin de semana, porque tenemos que hacer todas las compras que no podemos durante la semana.</p>
";"08/09/2015 23";"46";"24";"22";"1";"861398466";"104"
"2405";"Servicio de Estacionamiento Regulado - Parquímetros - Zona Única";"<p>El Servicio de Estacionamiento Regulado (SER) en Madrid, puede que resulte necesario en muchos barrios, por eso no propongo eliminarlo, pero sí adaptarlo a la realidad de cada barrio y de sus vecinos. No tiene sentido que siendo residente, no puedas aparcar en tu propia calle habiendo sitio libre, porque es zona azul. En algunas zonas, las plazas de zona verde (residentes) son claramente insuficientes. Entre semana, a partir de las 19.00 hrs, es imposible encontrar un sitio libre en algunos barrios en zona verde (Ej. Embajadores, Atocha, etc). Es habitual ver a los vecinos los sábados a las 9.00 hrs de la mañana, cambiando de sitio los coches porque sino tienen que pagar (no olvidemos que <u>ya pagamos</u> la cuota anual).</p>

<p>Por eso, sería más razonable que el servicio SER constara de una única zona, la de residentes. Los que sean residentes podrán aparcar en cualquier sitio, manteniendo el aparcamiento de pago para los no residentes de ese barrio.</p>

<p>También sería interesante poder contar con invitaciones para familiares de visita (ahora además en Agosto también hay parquímetro, hace unos años no); o para los profesionales que tengan que ir al domicilio. Sobre todo para ellos no tiene ningún sentido tener que bajar cada 2 horas a poner un papelito; y ahora no sólo eso, ¡sino además tener que cambiar el coche de sitio! </p>

<p>Debería revisarse el funcionamiento actual de los parquímetros porque actualmente no supone un beneficio para los ciudadanos, sino para las arcas.</p>

<p>Muchas gracias.</p>

<p>María.</p>
";"08/09/2015 23";"31";"22";"9";"5";"867847875";"922"
"2406";"Crear industría";"<p>Si quieren crear empleo (gobierno, ayutamientos..) por que no crean alguna fabrica de televisones, moviles... algo que venda. Algo que no sea para hacernos ricos, sino para mantener la empresa, pagar nominas... en defitiva, crear empleo. Marca made in spain, bueno bonito y barato, y los beneficios para seguir creciendo y creando industria. ¿Es una locura?, yo si es marca españa y con calidad, lo compraría.</p>
";"08/09/2015 23";"43";"35";"8";"10";"871635042";"2197"
"2407";"Soterrar el tramo de A6 entre el Palacio de Moncloa y el Arco de la Victoria ";"<p>Este proyecto debido a sus dimensiones dbeería hacerse en dos fases. Actualmente vemos como la A6 ha dividido completamente la ciudad universitaria y la zona en general, degradando mucho todo lo que existe a su alrededor. Por ejemplo el parque del Oeste se corta abruptamente, las escaleras que debían ser las principales del museo de América están destrozadas por el desuso y la no conservación y dirigen al vianante o hacia un terraplén en su subida al museo o en su bajada hacia la antigua via del tranvía también en mal estado y a continuación a la carretera de más de 6 carriles que se despliega ante él. Lo mismo con las facultades. Historia, estadística y veterinaria están pegadas a los lados de la carretera y el palacio de Moncloa también. Si bien esto lleva así mucho tiempo creo que con un plan de soterramiento progresivo de la A6 podríamos eliminar el problema y devolver también la zona a los madrileños, sobretodo a los universitarios. La primera fase se podría estender desde el arco de la victoria hasta la glorieta del cardenal Cisneros. Es un tramo corto y en parte ya está soterrado, con lo que no sería tan caro. Se podría ajardinar toda la superficie desde la rotonda hasta moncloa dejando una gran avenida verde para pasear e ir sin problemas desde Moncloa a Ciudad Universitaria y desde el Museo de América o del decanato al rectorado y al parque del Oeste. La segunda fase sería la más larga y costosa, pero con tiempo sería estupendo. Son apenas unos 2 kilómetros a soterrar (Nada comparable a los 35 kilómetros de la M 30) y se podría habilitar una calle con un carril por sentido en superficie para acceder a las calles que lo necesitasen. Si se repuebla la zona con árboles y se adecentan los márgenes podríamos estar hablando de una preciosa entrada a Madrid.
Esta reforma podría ir de la mano de otras, como la recuperación del Tranvia a Ciudad Universitaría o la completa reforma de Ciudad Universitaría de la que hablaré en otro momento en otro debate.
Una ciudad también se hace creando buenos espacios para los ciudadanos. Y yo no me conformo con bajar un poco el Metro y ver un huerto ecológico más. Quiero ver las grandes reformas que importan en Madrid.</p>
";"08/09/2015 23";"43";"26";"17";"11";"866164773";"544"
"2408";"Recogida de Basuras con empresas privadas";"<p>Para que nos bajen el precio y la recojan con más frecuencia y que podamos elegir al que mejor lo haga.</p>
";"08/09/2015 23";"46";"13";"33";"2";"855888921";"-565"
"2410";"Prohibir que se repitan las manifestaciones en el mismo sitio";"<p>Para que los comercios y en especial los pequeños no se vean bloqueados todos los dias y no les pongan al borde de la quiebra</p>
";"08/09/2015 23";"53";"21";"32";"0";"855515194";"-435"
"2411";"Aravaca Distrito Independiente";"<p>Debido al incremento de poblacion del distrito aravaca, y a sus condiciones diferenciales, tanto de demografia, como de urbanismo; sumado a la distancia que separa la zona de moncloa del barrio de aravaca, parece logico que este ultimo sea un distrito independiente.</p>

<p>Esto tendria como beneficios el mejor mantenimiento del barrio, el incremento de la seguridad, al depender la policia del distrito de aravaca, y la mejor distribucion de los recursos generados en este barrio.</p>

<p> </p>
";"08/09/2015 23";"46";"30";"16";"2";"867231000";"913"
"2412";"Señalar adecuadamente las cámaras del SER (Residentes). Multas trampa";"<p>Las cámaras que controlan las áreas de acceso restringido a residentes están en muchos casos señalizadas con señales pequeñas, justo antes de las cámaras, con mucho texto minúsculo e incuso detrás de árboles.</p>

<p>Ante esta situación, en muchas ocasiones cuando es posible su lectura no es posible cambiar de dirección o dar la vuelta, por lo que el conductor se ve obligado a sufrir una sanción a sabiendas.</p>

<p>No es difícil hacer una búsqueda en Google ""multa calle del león"" para observar que son muchas las personas que han sido multadas injustamente. ¿Todos son conductores malvados, viles y tienen un interés especial en ser multados?</p>

<p>Propongo señalizar estas cámaras con señaes simples, grandes, de fácil lectura y a una altura de la calle en la que se pueda realizar un cambio de dirección para evitar la multa.</p>

<p>Asimismo, propongo que el ayuntamiento de madrid audite, saque estadísticas de dichas cámaras, las publique y actúe en consecuencia, puesto que si existe alguna que cace a más de 50 vehículos al día y de ellos el 85% son vehículos matriculados fuera de Madrid, es evidente que el problema proviene de cómo está señalizada la cámara y no de que los conductores sean unos malvados.</p>
";"08/09/2015 23";"36";"26";"10";"1";"868395934";"1155"
"2413";"comunidades de vecinos autosuficientes";"<p>Cada comunidad de vecinos puede convertirse en generadora de materias primas para su reciclado (vidrio, papel, metal, materia orgánica,....) vendiendolas directamente a las empresas sus residuos. Para ello se pueden instalar en zonas comunes contenedores que sean recogidos por estas y generar un ingreso a la comunidad. Instalación de paneles solares en azoteas, biodigestores de materia orgánica para producir biogás, circuitos de agua reciclada para riego de jardines en zonas comunes,.......esto y mucho más haría más sostenibles las ciudades y ahorraría dinero a los vecinos.</p>
";"08/09/2015 23";"22";"14";"8";"1";"864717603";"381"
"2414";"Reforma Ciudad Universitaria";"<p>De todos es sabido el estado en el que se encuentra la Ciudad Universitaria. La dejadez de los sucesivos rectores y ayuntamientos ha hecho que muchos de los edificios estén viejos y a punto de caerse (En muchas facultades se caen trozos de techo incluso) o no hay ni lo básico que se necesitaría hoy en una universidad que se supone de prestigio como la complutense. Por tanto es muy urgente una reforma entera de Ciudd universitaria y de muchas de sus facultades, sobre todo las de ciencias puras y letras. Por ello se debería hacer una reforma para reorganizar todas las facultades mejor, así como un sistema de calles y espacios publicos ma´s razonable y que sea posible cuidar, ya que actualmente casi todos los espacios ""verdes"" de la zona son pastizales más que otra cosa. Pido por favor al ayuntameinto que se implique en esta tarea, ya que la Universidad no lo va a hacer.</p>
";"08/09/2015 23";"30";"21";"9";"2";"867347235";"839"
"2415";"Buho Metro: de 3:00 a 5:30";"<p>Es una realidad que Madrid está creciendo cada vez más con mas servicios nocturnos(restaurantes, vigilantes, limpieza urbana, etc) muchos de los cuales se realizan en horas de la noche, a esto hay que añadir el flujo de gente que sale por la noche y que en muchos casos no puede retirarse a tiempo por la falta de alternativas de movilidad. Todo esto, sólo por citar algunos aspectos de la realidad nocturna de Madrid. Mi propuesta es que de lunes a domingo exista un""búho metro"" de 03:00 a 05:30, cada 15 ó 20 minutos. Esto además de solucionar los problemas de transporte, generarían más puestos de trabajo (controladores, conductores, vigilantes, servicio de limpieza, etc) , reactivaría muchos comercios dentro del metro que están abandonados y evitaría el uso del coche y los posibles accidentes y por supuesto colocaría a Madrid a la vanguardia de las ciudades de nuestro entorno, reforzando la imagen de ciudad que no duerme. Quizás se me escapen algunos aspectos, pero confío en su equipo de gobierno para solventar las carencias de esta propuesta/debate.</p>
";"08/09/2015 23";"26";"15";"11";"0";"863130636";"230"
"2416";"ANTONIO PALACIOS, arquitecto de Madrid";"<p>Seria bueno dar a conocer a los madrileños, la figura del gran arquitecto gallego, ANTONIO PALACIOS: Recordemos la grandes  obras</p>

<p>que hizo en la cápital:</p>

<p>*Ayuntamiento de Madrid (antes Correos9</p>

<p>*Hospital de Maudes</p>

<p>*Marquesina del metro de la Red de San Luis (desmontada y llevada a Porriño, lugar de nacimiento de él) </p>

<p>*Instituto Cervantes (antes Banco Central,  y Banco del Rio de la Plata)</p>

<p>*Circuo de Bellas Artes</p>

<p>*Colaboro con el Metro (lLa estación de Chamberi, nos queda como recuerdo)</p>

<p>Esperemos alguna iniciativa.</p>
";"08/09/2015 23";"37";"21";"16";"3";"863963484";"283"
"2417";"Cubrir madrid de banderas de Asturias para bajar la temparatura en verano.";"<p>En Madrid no hay quien respire ni se mueva en verano por culpa del calor! Cómo en Asturias en verano se está más fresco, si llenamos Gran Vía, Castellana y el resto de las principales vías de Madrid con banderas gigantes del Principado conseguiremos dos cosas, que la capital del Reino esté más bonita y lucida y que con tantas banderas se haga un poco más de sombra y no haga tanto calor durante el verano, con lo cual la gente podrá salir más a la calle.</p>

<p> si además de las banderas, abrimos unas cuantas docenas de sidrerías tambén mejoraríamos la calidad del ocio de los madrileños, que podrán saborear lo mejor de la gastronomía española </p>
";"08/09/2015 23";"70";"25";"45";"2";"855014270";"-714"
"2418";"Ascensor en metro Begoña ""Hospital la Paz""";"<p>Trabajo en el Hospital la Paz y a diario en mi consulta (una de las más de 300 que tiene el hospital) gestionamos una media de 6-7 solicitudes de ambulancia para trasladar a pacientes a las revisiones correspondientes, más de la mitad de dichas ambulancias (y su gasto económico) se podrían evitar con la implantación de un ascensor en la parada de metro Begoña que lleva directamente al hospital, si bien es cierto muchos de nuestros pacientes externos requieren traslados de este tipo, otros muchos son llevados en ambulacia exclusivamente por la imposibilidad de subir los tres tramos de escaleras que tiene la estación de metro.</p>

<p>No logro entender que una parada de metro que da acceso a uno de los hospitales más grandes de España no tenga ascensor, es lamentable ver a diario cientos de pacientes y acompañantes subiendo sillas de ruedas y cochecitos de bebé por las escaleras, he trasladado esta misma petición a metro y me contestaron que no tenían jurisprudencia al ser los terrenos del hospital.</p>

<p> </p>
";"08/09/2015 23";"53";"48";"5";"5";"874598929";"3894"
"2419";"Oficinas del Inem";"<p>SInceramente...y desde mi experiencia..creo que las oficinas del Inem para segun que personas no ayuda nada a encontrar trabajo..no cumplen su funcion....no dan salida  a los parados....colas interminables..... tener que esperar tu turno para que que te atiendan de forma desagradable y poco educada...actualizas tu curriculum..sellas la cartilla y poco mas..espero que tengan esto en cuenta .. </p>
";"08/09/2015 23";"21";"15";"6";"1";"866597975";"642"
"2420";"No a la discriminación de funcionarios para nombramientos como altos cargos.";"<p>Que los <strong>funcionarios</strong> que <strong>no sean familiares </strong>de la nueva <strong>casta Podemita </strong>tengan las misma oportunidades de tener un alto cargo publico que algún otro individuo discriminado positivamente por ser familiar, querido, vecino, mascota o deudor de gobernarte o alto cargo de la cúpula de Podemos / Ahora Madrid y solamente sean elegidos por su capacidad de desempeñar su función publica lo que tambien implica independencia y etica total tanto para su función como para su gestión por superiores y subordinados. Ya que no solo es su capacidad de realizar la acción si no la resposabilidad de transparencia total con la ciudadanía.</p>
";"08/09/2015 23";"41";"25";"16";"0";"865512090";"548"
"2421";"¿ Cuántos refugiados va a acoger Doña Manuela?";"<p>Estimada alcaldesa Carmena: Usted que es tan solidaria, ¿Cuántos refugiados va a acoger en su domicilio particular?. Si la respuesta es cero, haga el favor de quitar esa pancarta. Sea coherente. No sea como el capitán América que embarca a la gente y luego se baja del barco.</p>
";"08/09/2015 23";"65";"37";"28";"1";"865202375";"512"
"2422";"Que el Ayuntamiento indique qué propuestas del foro han salido adelante.";"<p>Esta muy bien que todos escribamos, pero va a servir para algo?. El Ayuntamiento debe responder a cada propuesta indicando su estado de implantación. Si esto no se va a hacer, mejor que eliminen este foro, ya que sería inútil.</p>
";"08/09/2015 23";"70";"59";"11";"3";"873948468";"4045"
"2423";"Multar a la gente que come bollería o palomitas en la calle.";"<p>Todos hemos visto al mítico anciano que está dando pan a las palomas en juan carlos. Muchas veces, las palomas solo lo saborean y lo echan. Al cortar el pan, tiran migas al suelo que luego los demás pisamos, arrastramos, y hacemos a los servicios de limpieza recoger muchas horas más tarde, porque los incívicos escogen la primera hora de la mañana, justo cuando los barrenderos ya se han ido. Esto tiene que acabar YA.</p>

<p>Podemos poner zonas habílitadas, dentro de un horario, para todos ellos que quieran tirar migas a los animales. También podríamos poner ocas, y patos, para que disfruten de mayor variedad. Traer especies exóticas, o autóctonos como el lince ibérico no está descartado. De esta manera, todos ganamos, ellos disfrutan más del lecer y se hace en zonas controladas donde los barrenderos pasarán después y hay felpudos para limpiarse los zapatos.</p>

<p>Hay que llevar madrid verde a los extremos, tenemos que aprender de asturias.Los madrileños no podemos consentir vivir sobre un suelo de palomitas y alcohol. Una multa ligera, con un máximo de 400</p>

<p>Por supuesto, los bancos y zonas permitidas estarían bien reguladas por la guardia civil, como en los rallys, porque no queremos que los viejos se pasen de atrevidos mientras nosotros les seguimos pagando la seguridad social. Concentraciones de más de 3 personas serán permitidas, de manera extraordinaria, para que nuestros padres y abuelos no incumplan la ley de protección ciudadana. Esto requerirá dotar de permisos especiales a la policia nacional.</p>

<p> </p>
";"08/09/2015 23";"90";"24";"66";"2";"855348410";"-1120"
"2424";"Sonia y Selena para las Fiestas del Año Que Viene";"<p>Hola,</p>

<p>En realidad querria entablar varios debates, pero me da miedo que esto acabe siendo el Forocoches Gatuno o de la Capital.</p>

<p>El asunto que más me intriga o mejor que anhelo que suceda es que el gran dueto como es Sonia y Selena tengan cabida en la ciudad del Café con Leche y que sean pregoneras de algun barrio como Chueca o Malasaña o que caray, CABEZAS DE CARTEL de las fiestas mayores de Madrid que nunca se cuando son, que todo los meses tenemos algun dia festivo.</p>

<p>Pues lo dicho y un beso a los organizadores, que deben de ser los mismos que opinan en forocoches que deberia ser un canal en abierto.</p>
";"08/09/2015 23";"52";"18";"34";"1";"855539315";"-553"
"2425";"0 euros para la Iglesia";"<p>Que ni un solo euro de los impuestos se use para mantener esta institución.</p>
";"08/09/2015 23";"89";"43";"46";"4";"858060001";"-144"
"2426";"Reforma de fachadas en el centro de Madrid y barrios adyacentes";"<p>Actualmente vemos como en muchos edificios (Públicos y privados) del centro de la capital rompen completamente con la zona donde se encuentran por su estilo, mayoritariamente de los años 60, 70 y 80. Por poner ejemplos el juzgado contencioso administrativo de la Gran Vía (Al lado del oratorio del caballero de Gracia), consejería de economía y haciendo de Madrid de la carrera de san jerónimo, el numero 11 de la calle Cedaceros, numero 7 de la calle sacramento así como otros muchos en barrios tan dispares desde algunas iglesias terriblemente feas del Barrio de Salamanca a los bajos de arguelles o el edificio Galaxia pasando por Princesa donde ahora está el Corte Inglés y la nueva Iglesia de Princesa y terminando en la estación de Cercanías de Atocha o en el colegio virgen de Atocha. Creo firmemente que el Ayuntamiento debería estudiar muchos de estos edificios e intervenirlos con ayuda privada de vecinos o empresas si es posible para transformar muchos de estos adefesios por fachadas al menos que respeten la zona donde se encuentran. Así mismo debería entrar en conversaciones con instituciones como la Iglesia o empresas como el Corte inglés para que en sus respectivas propiedades reformen sus fachadas en caso de romper con el entorno para hacerlas más amables a la vista. Igual que esto se ha hecho en muchas ciudades y en el propio Madrid ya no se puede reformar una tienda alterando su fachada y ornamentos exteriores básicos en el centro se  debería exportar a los edificios donde ya se hizo para deshacer en parte en entuerto.</p>
";"08/09/2015 23";"35";"21";"14";"1";"864905687";"420"
"2428";"Legalizacion de las drogas";"<p>Que las drogas se vendan en las farmacias con un cierto control, a titulo de evitar abuso, con ello se podrian recaudar unos suculentos impuestos, que gran parte irian destinados a la prevencion del consumo y a rehabilitacion de adictos. Cambiarla recomendacion por la prohibicion, recuperando el espiritu del 68 de prohibido prohibir.Con esta medida nos quitamos a todas las bandas criminales que ee dedican al narcotrafico.</p>
";"08/09/2015 23";"57";"32";"25";"8";"865102191";"392"
"2429";"Mas calles peatonales";"<p>Limitar el acceso de vehículo privado (excepto residentes y servicios) en zonas históricas de los barrios y calles comerciales. Recuperar estos espacios para los vecin@s con vegetacion, bancos,... </p>
";"08/09/2015 23";"39";"25";"14";"1";"866490451";"705"
"2430";"Mejorar los accesos del Hospital Infanta Leonor.";"<p>Conexión con la A3 y con el barrio de Santa Eugenia y su estación.</p>
";"08/09/2015 23";"78";"65";"13";"0";"874053422";"4333"
"2433";"Apropiar debates inapropiados";"<p>Que sea posible marcar un debate como apropiado cuando otros usuarios han marcado como inapropiados.</p>

<p>No a la censura</p>

<p>Son reflotes sanos</p>
";"08/09/2015 23";"44";"26";"18";"4";"865412920";"472"
"2434";"Mas líneas de autobuses express";"<p>Incrementar líneas rápidas de autobús entre periferia y centro. Abrir líneas de bus que conecten barrios periféricos entre si,</p>
";"08/09/2015 23";"31";"25";"6";"0";"870096420";"1532"
"2436";"Recuperar la Red de San Luis";"<p>Creo que este edificio que ha sido tan icónico para los madrileños de varias generaciones debería volver al lugar donde le pertenece, y estar en la calle Montera y servir de entrada al Metro de Gran vía. Sería genial contar de nuevo con este monumento que si se reemplaza de nuevo espero que viniera con añadidos decorativos modernos. Sus ascensores servirían además para el acceso de personas con movilidad reducida.</p>
";"08/09/2015 23";"23";"16";"7";"0";"866430658";"626"
"2437";"Reapertura de fuentes de agua en verano";"<p>Es ilógico que se estén cerrando sistemáticamente las fuentes de agua que han caracterizado a nuestra ciudad durante lustros por el simple hecho de hacer negocio con Canal de Isabel II. Ahora que se respiran nuevos aires en nuestro Ayuntamiento, propongo que se reabran, acondicionen y vigilen éstas emblemáticas fuentes.</p>
";"08/09/2015 23";"36";"28";"8";"1";"869961525";"1555"
"2438";"Instalación de más Puntos Limpios en los barrios.";"<p>Como vecino del barrio de Carabanchel, llevo años presenciando la defectuosa calidad de la limpieza en el barrio y en otros más. </p>

<p> </p>

<p>He de agradecer el refuerzo de limpieza que el Ayuntamiento de Madrid está llevando a cabo en la ciudad en estos tres meses. Sí, han conseguido limpiar gran parte de la suciedad, pero no es suficiente. Nada más pasar el camión de refuerzo de limpieza, aparecieron muebles y cajas al lado de los contenedores de basura normales.</p>

<p> </p>

<p>Echando un ojo a los puntos limpios de Carabanchel, por ejemplo, se puede observar que apenas hay más de un punto limpio y unos pocos puntos limpios móviles. Pero en las zonas más sucias como Abrantes, Puerta Bonita y Opañel no hay ninguno.</p>

<p> </p>

<p>Por ello<u><strong> propongo la instalación de más Puntos Limpios para mejorar la limpieza y la calidad de nuestros barrios</strong></u></p>
";"08/09/2015 23";"131";"120";"11";"5";"878508976";"9984"
"2439";"Organizar otra forma de compartir el coche. Crear líneas de autobuses virtuales.";"<p> Actualmente las propuestas de <strong>compartir coche</strong> para acceder a la ciudad se basan en que los usuarios se tienen que poner en contacto entre ellos,  en  un modelo ""one to one"".</p>

<p>Otra alternativa sería basarlo en <strong>trayectos comunes</strong>. Especialmente en los casos de acceso desde la periferia, se podrían definir multiples trayectos, a modo de<strong> lineas virtuales de autobús</strong>, en las que los usuarios que realizan ese trayecto en coche podrían transportar a otros usuarios que esperarían en las paradas. En este caso, el conjunto de usuarios que comparten el trayecto, es probablemente de centenares, y no tienen que ponerse de acuerdo, sino que sencillamente ""coinciden"" en el trayecto, unos esperando y otros desplazandose con su coche.</p>

<p>La potencia de este sistema es que desde cualquier ciudad se podrian definir <strong>cientos de lineas virtuales</strong>, ya que no necesitan de autobús real. El hacer un largo recorrido en el coche compartido evitando tormar varios medios de transporte publico consecutivos puede hacer interesante para muchos usuarios el dejar de usar el coche. </p>

<p>Se podria estudiar el sistema que aparece en en la pagina web:</p>

<p>http://virtubus.blogspot.com.es</p>
";"08/09/2015 23";"27";"14";"13";"0";"859802281";"51"
"2440";"Madrid limpio y verde. ";"<p>Lo único que le falta a Madrid para ser mas maravillosa, es un poco de limpieza, mas árboles y menos coches. Sería la ciudad perfecta.</p>
";"08/09/2015 23";"25";"15";"10";"1";"864137318";"300"
"2441";"Cumplimiento Normativas Municipales ";"<p>Exigir el cumplimiento de la normativa existente municipal de civismo, seguridad , limpieza y resto que multiples ciudadanos exigimos y ya contemplados en diversos debates abiertos y que está regulado por la normativa existente y es tan fácil como hacerla cumplir como por ejemplo:</p>

<p>Limpieza en vía publica</p>

<p>no orinar o defecar en vía pública </p>

<p>ruidos </p>

<p>mendicidad y delincuencia</p>

<p>perros peligrosos. </p>

<p>Etc. </p>

<p> </p>

<p>Esta ta todo lo suficientemente reglado y es tan sencillo como hacer cumplir la ley. </p>
";"08/09/2015 23";"38";"33";"5";"0";"872386041";"2431"
"2442";"Los cierres del centro no deberian afectar a algunos sectores de servicios. ";"<p>Explico la situacion.</p>

<p>Desde agosto, la zona madrid centro ha sufrido un cierre a vehiculos que no sean de vecinos, el cual me parece correcto para liberar de trafico esa zona. Entrar con un vehiculo supone una multa, pero se deberian conceder permisos a empresas que realicen un servicio urgente. En mi caso, trabajo arreglando ascensores, y hay que realizar rescates, y hay que realizarlos en la mayor brevedad posible.</p>

<p>Si hay un rescate en el centro, antes podias llegar con la furgoneta, aparcar al lado y sacar a la persona. Ahora, entrar a esa zona supone una multa que va para el conductor, ningun trabajador va a ir hasta el portal en coche si le supone un coste, por lo que tendrá que aparcar mas lejos, ir hasta alli a pie, y eso es tiempo que una persona permanece encerrada.</p>

<p>Creo que deberia haber un registro de vehiculos de empresa que puedan acceder al centro sin sufrir una multa cuando realicen un servicio importante para el ciudadano.</p>
";"08/09/2015 23";"26";"12";"14";"4";"859440690";"-92"
"2443";"Reformar Estación Metro Sol";"<p>La estación de metro de Sol lleva mucho tiempo abandonada y descuidada. Sería lógico que se reorganizase en su interior y se convirtiera en la estación icónica del metro de Madrid, decorandola como se merece (Opto por motivos clásicos estilo estación de chamberí pero hasta lo que se puede ver hoy en los metro de estocolmo o Helsinki me parece mejor que lo que hay ahora. Se podría plantear debido al volumen se pasajeros unirla bajo tierra por medio de corredores con la Estación de Gran vía (Linea 5) para que los viajeros pudieran cambiar en menos tiempo de lineas. Si se hace por favor, especial cuidado a la decoración. Luego todos cuando vamos a moscú nos sorprendemos del Metro, por algo será. Con las técnicas actuales se puede hacer algo clásico, bonito y por mucho menos dinero que algo moderno que un arquitecto de ""moda"" te saque.</p>
";"08/09/2015 23";"34";"13";"21";"4";"856422781";"-305"
"2446";"Bicis a toda velocidad en Madrid Rio";"<p>Habría que poner carteles con velocidad maxima en Madrid Rio, van a toda velocidad .</p>
";"08/09/2015 23";"36";"22";"14";"1";"865439202";"488"
"2449";"Cambiar el Euro por una nueva moneda en Madrid : la Carmena. ";"<p>Dado que el Euro ha sido una imposición de los mercados y las oligarquías financieras capitalistas y neoliberales propongo la creación de una nueva moneda para la ciudad de Madrid, la Carmena. Funcionarios como el padre de Rita Maestre, el sobrino político de Manuela Carmena y otros menos preparados se encargarían de los detalles. </p>
";"08/09/2015 23";"81";"38";"43";"4";"856889328";"-234"
"2451";"Delimitar las terrazas (veladores) de la restauración";"<p>Muchas veces paso por calles de Madrid en las que me da la sensación de que están invadidas por las mesas y sillas de los bares/restaurantes/cafeterías. En muchas ocasiones a mi parecer ponen demasiadas. Me parece perfecto que haya veladores y terrazas donde disfrutar del buen tiempo en Madrid, pero lo que no puede ser es que salga a una calle y tengas que esquivar mesas, sillas de bares o tardar en cruzar porque se acumula gente.

Me gustaría que se delimitase de alguna forma (en el suelo poniendo alguna marca por ejemplo) para evitar el abuso del mismo de forma visual..</p>

<p> </p>
";"08/09/2015 23";"52";"43";"9";"0";"872516507";"2811"
"2452";"PARADOS - Descuento Abono Transporte";"<p>El Ayuntamiento debe impulsar junto con la Comunidad de Madrid un abono mensual reducido para los parados dados de alta como demandantes de empleo.</p>

<p>Es un gasto necesario el tener que desplazarse para ir a entrevistas de trabajo, recoger a los hijos, etc. y sin embargo pagan el elevado coste de un abono normal.</p>

<p>Debería de costar un precio similar al del abono joven o de tercera edad.</p>

<p> </p>
";"08/09/2015 23";"85";"72";"13";"0";"874863057";"4997"
"2454";"Decidir entre todos los destinatarios de la cooperación madrileña al desarrollo";"<p>Madrid ha sido siempre una ciudad solidaria. Hoy lo estamos constatando una vez más con la crisis de los refugiados. Sin embargo los últimos gobiernos municipales eliminaron de su presupuesto la cooperación al desarrollo. <strong>Es preciso que volver a tener un sistema municipal de cooperación</strong> que ayude a canalizar la solidaridad de los madrileños.</p>

<p>Plataformas como ésta nos dan por primera vez la oportunidad de opinar y de <strong>decidir entre los vecinos quiénes queremos que sean los destinatarios de esa ayuda </strong>y en qué procesos nos gustaría participar como Madrid para contribuir a hacer del mundo un lugar menos injusto. Y una vez que los ciudadanos lo hayamos decidido podremos pedir apoyo a las ongs o a los expertos municipales para que nos ayuden en lo técnico a plantear esa cooperación de la mejor manera posible. </p>
";"08/09/2015 23";"27";"12";"15";"1";"857871191";"-133"
"2456";"Para que los políticos pida PUBLICAMENTE a países àrabes a acoger refugiados";"<p>Y cuando me refiero a países àrabes me refiero a los que destinan tantos millones de petro-dolares para ayuda humanitaria (hay noticias en distintos medios, solo hace falta buscarlo en internet y salen articulos a montones)</p>

<p>Que mejor ayuda humanitaria que acogerlos en tu casa?</p>

<p>Si tienen dinero para construir sus propias islas y rascacielos enmedio del desierto, no podrían darle refugio a los refugiados hasta que se resuelva el conflicto en sus países de origen?</p>

<p> </p>

<p>A ver si <strong>algún político </strong>con suficiente <strong>repercusión mediática</strong> tiene la suficiente <strong>valentía para hacer un comunicado al respecto</strong>. Que lo lleve a los <strong>medios</strong>, al <strong>congresos de diputados</strong>, a la <strong>unión europea</strong>. De hacerlo, le doy gracias de antemano.</p>
";"08/09/2015 23";"60";"40";"20";"1";"868610206";"1333"
"2457";"Reserva de Espacios Deportivos";"<p>Desde el Ayuntamiento de Madrid, como municipio con mayor número de ciudadanos dentro de la Comunidad de Madrid, se debería de impulsar una web única en la que se puedan reservar y pagar cualquier espacio deportivo de la Comunidad de Madrid como pistas de fútbol, pádel, etc.</p>

<p>Es un despropósito que la Comunidad de Madrid, Madrid, Alcorccón, Las Rozas, etc. tengan su propia web para reservar los espacios deportivos que le pertenecen con el coste de mantemiento que supone esta web y la dificultad para los usuarios de manejar 200 páginas distintas teniendo que darse de alta en cada una de ellas.</p>

<p>Se deberáin unificar todas en una sóla.</p>

<p> </p>

<p> </p>
";"08/09/2015 23";"22";"15";"7";"0";"866052485";"545"
"2458";"INSPECCIONES SANITARIAS EN LOCALES DE OCIO NOCTURNO POR USO DE GARRAFÓN.";"<p>Buenas noches.</p>

<p>Se que el titulo puede parecer de cachondeo, pero no es la primera ni la última vez que en el 85% de las discotecas de Madrid, se cobra consumición de alcohol de garrafón a precio de alcohol de marca.</p>

<p>Esta tomadura de pelo tan extendida y generalizada por toda la capital, hace uqe sea inevitable la realización del botellón, no es causa única pero si una muy influyente.</p>

<p>Por eso pido y solicito el apoyo para que los locales de ocio nocturno en Madrid no sigan ganando dinero engañando y estafando a costa de sus clientes y sobre todo a costa de su salud.</p>
";"08/09/2015 23";"70";"59";"11";"2";"874110958";"4045"
"2459";"SERVICIOS PUBLICOS MÁS BARATOS PARA LOS MADRILEÑOS";"<p>En todos los pueblos los empadronados pagan menos por los servicios municipales como las piscinas o los polideportivos municipales. Ocurre lo kismo con las visitas a determinados edificios.</p>

<p> </p>
";"08/09/2015 23";"33";"21";"12";"1";"866049737";"572"
"2464";"Imponer medidas de limitación del tráfico privado en la almendra central";"<p>Se podría imponer una tasa a los usuarios de transporte privado en el centro de la ciudad, de la misma manera que hacen en otras ciudades europeas, y ha resultado ser bastante efectivo para reducir la congestión de tráfico en dichas ciudades. Además haría bien a la red de autobuses públicos y taxis.</p>
";"08/09/2015 23";"54";"31";"23";"2";"865270431";"459"
"2467";"Biblioteca 24 horas abierta";"<p>Debería existir en Madrid una biblioteca pública 24 horas abierta, a la que pudieran acudir en cualquier momento del año estudiantes de todo tipo.</p>
";"08/09/2015 23";"49";"36";"13";"0";"869958582";"1689"
"2472";"Fomentar la creación de centros para acoger a ciudadanos sorianos";"<p>Hay que tomarselo en serio.</p>
";"08/09/2015 23";"40";"17";"23";"2";"856752708";"-254"
"2474";"Busto de Don Manuel en Cibeles";"<p>Propongo quitar la cibeles y en su lugar poner un busto o una estatua ecuestre de Don Manuel Ruiz De Lopera para honrrar a esa gran hombre que tanto ha sufrido por mi Betis.</p>

<p> </p>
";"08/09/2015 23";"72";"24";"48";"2";"855351947";"-800"
"2476";"Promocionar - El Museo de Cera de Madrid ";"<p>No sé si es una empresa publica o privada o concertada, pero veo el mal uso que se esta dando, o mejor dicho la imagen de este Museo que parece que sea el TOP 1  de los cutres, suerte que el de Benidorm esta cerrado que, sino, estariamos como segundones.</p>

<p> </p>

<p>La cosa es que, ahora mejorar es una tonteria, ya hay mucho activo alla y destruir y hacer de nuevos provocaria un coste dificil de recuperar, por lo que propongo que sea el <u>peor museo de cera de mundo</u></p>

<p> </p>

<p>Un Fernando Alonso con los ojos Azules? No me vendais la milonga que los tiene asi, hombre</p>
";"09/09/2015 00";"41";"7";"34";"2";"857467316";"-460"
"2478";"Asesores";"<p>Con el ""título"" de asesores se han colado en las administraciones españolas, en todas, miles de elementos que son una auténtica sangria para las arcas públicas y una forma de colocar a cuñados, amiguetes y coleguitas partido y Madrid no es una excepción. ¿Cuando se va a meter mano a esta situación largando por via de apremio a los ""beneficiarios"" de relleno  y dejando únicamente los estrictamente necesarios y a ser posible, personas profesionales y eficaces?</p>
";"09/09/2015 00";"23";"18";"5";"1";"868819744";"1017"
"2479";"Calles de madrid";"<p>Me parece de vergüenza que nadie se haya preocupado por el estado de las calles de madrid. Yo personalmente soy del barrio de Tetúan. En la mayoría de las aceras están las baldosas con rajas, o incluso rotas creando huecos. Esto a mi modo de ver es bastante peligroso para cualquier persona que vaya caminando ya que puede provocar una caida o incluso la rotura de laguna pierna o brazo. No hay dinero para arreglar las aceras del barrio, pero sí que lo hay para que año tras año se reforme el Centro Deportivo Municipal Playa Victoria, cosa que canta mucho. Hay dos opciones o que las obras no se hagan bien y haya que cambiarlas cada año o que alguien se este llevando dinero...</p>
";"09/09/2015 00";"37";"30";"7";"2";"871159821";"1864"
"2480";"Parquimetro solo en el distrito centro";"<p>Me parece una barbaridad la extensión del S.E.R, que ya afecta hasta a ciudad universitaria. Creo que los precios y restricciones son muy elevados al igual que opino que ya que pagamos impuesto de circulación no deberíamos pagar por aparcar en la calle. Desde mi punto de vista solo se debe mantener en el distrito centro por el volumen de circulación. Y retirarlo de los demás lugares o en su defecto reducir notablemente el precio del mismo.</p>
";"09/09/2015 00";"44";"22";"22";"4";"860038412";"0"
"2483";"Abrir el tramo restante Av Sainz de Oiza";"<p>Soy una vecina del barrio madrileño de Valdebebas y creo muy necesario la apertura del trozo restante de la Av Sainz de Oiza que conecta el norte de Valdebebas con Sanchinarro.</p>

<p>Es una vía que se encuentra completamente acometida, a falta de la iluminación, que según parece fue sustraida. Esta vía lleva finalizada un año y nos ahorraría a los vecinos un trayecto de unos 8km cada vez que vamos hacia el norte (ya sea Sanchinarro o hacia la A1) con el consiguiente ahorro en tiempo y dinero.</p>

<p>Me parece bastante absurdo que se mantenga cerrada (excepto para eventos como carreras o beatificaciones en las que se abre) con el consiguiente perjuicio que nos causa a todos los vecinos, cuando es sólo cuestión de tiempo que se acabe abriendo.</p>

<p>Muchas gracias.</p>
";"09/09/2015 00";"326";"308";"18";"44";"883496472";"27398"
"2484";"El centro de Madrid da vergüenza  a sus  residentes y perjudica al turismo ";"<p>En el centro hay calles, como Fuencarral, Caballero de Gracia, Virgen de los peligros, entre otras muchas, que tienen las fachadas, cierres, escaparates y puertas de portales llenas de garabatos impresentables, no son artísticos graffitis, sino actos vandalicos impunes que ensucian todo ello y degradan muchas calles.</p>

<p>Como no se baldea, las calles mencionadas y muchas otras están llenas de orines secos y mugre en abundancia, que hace necesario no solo baldear, sino limpiar con cepillos las aceras. Las papelera manifiestamente con una abertura insufiente y pequeñas son incapaces de contener las grandes cantidades de basura que se produce en calles de mucho tránsito. Sin perjuicio de que deben vaciarse insuficientemente con lo que muchos residuos quedan esparcidos junto a ellas, al igual que los contenedores, muchos rotos y sucios e insuficientes con lo que habitualmente están rodeados de residuos que no caben.</p>

<p>En muchos sitios nadie revisa las aceras y durante mucho tiempo permanece baldosas rotas y levantadas con riego de que los peatones  tropiecen. Alcorques de arboles sin arboles desde hace mucho tiempo que nadie se ocupa de remplazar o de cubrir. Señales de trafico o indicadoras cubiertas de pegatinas que impiden verlas, que nadie limpia ni repone, incluso torcidas que obviamente dan un aspecto de abandono.</p>

<p>Calles emblemáticas como Montera o Desengaño degradadas por la prostitución callejera desde hace muchos años sin que nadie lo remedie.</p>

<p>Es urgente ponerse manos a la obra para solucionar el abandono, impunidad y suciedad existente</p>
";"09/09/2015 00";"52";"42";"10";"1";"872266230";"2584"
"2489";"Aparcamiento para motos";"<p>Las motos invaden las aceras de Madrid, no sólo aparcando sino circulando por ellas a todas horas del día, algo que está prohibido pero que la Policía Municipal de Madrid se ""olvida"" de hacer cumplir la Ley y nunca multa a los motoristas que circulan por las aceras, lo que ya ha causado más de un atropello, por tanto, propongo la creación de aparcamientos de motos fuera de las aceras, suprimiendo plazas de coches o que se creen en las esquinas de las manzanas aparcamientos sólo para motos, como en la mayoría de las ciudades españolas civilizadas, véase Alicante capital.</p>
";"09/09/2015 00";"38";"25";"13";"0";"867196655";"789"
"2491";"Establecimiento de baños públicos con personal de mantenimiento";"<p>Como se puede observar en otros países europeos, la existencia de baños públicos es una constante. Sin embargo, debido a la falta de higiene de muchos conciudadanos pienso que sería buena idea mantener a una persona limpiando el baño después de cada uso, pagando una cantidad pequeña como 20cent por uso para la sostenibilidad del empleado. </p>

<p>Quizás con el tiempo y el aumento del civismo, esta tasa podria ser eliminada, manteniendo unos baños limpios y cuidados con el esfuerzo de todos.</p>
";"09/09/2015 00";"44";"32";"12";"1";"869628117";"1454"
"2492";"Referendum para votar quien quiere gastarse los 10 millones de euros";"<p>Veo que Manuela Carmena ya ha decidido por todo Madrid lo que quiere hacer con esos 10 millones pero yo propongo que entre todos decidamos lo que queremos estais de acuerdo?</p>
";"09/09/2015 00";"57";"38";"19";"2";"868734284";"1266"
"2498";"Iluminación";"<p>Es de sobra sabido que hay barrios que tienen mala fama, como por ejemplo el barrio de Vicálvaro. Yo no estoy a favor de esa mala fama, pero evidentemente la falta de iluminación en la calles por la noche pues no ayuda. Y ojo que yo pienso que Vicálvaro es un barrio muy seguro.</p>
";"09/09/2015 00";"22";"11";"11";"2";"860176185";"0"
"2500";"Dia oficial de la masonería";"<p>A VER SEÑORES, pido, que digo pido, exigo un dia en honor a los mejores hombres que han existido en la historia de la humanidad, los masones (Pero los buenos tipo Giner de los ríos eh no los malos) aquellos que han intervenido tanto en la política española cargandose a Cánovas para que nuestro querido DON TANCREDO le diera cuba a los yankees y luego esta llevara a cabo una revolución comunista (Menuda visión la de los masones), eso si que los actos festivos se celebren por la tarde para que Azaña EL DURMIENTE pueda asistir, pero eso si, sin uniformes raros.</p>

<p>Aconsejo tambien que se haga una réplica del CAPITOLIO y cambiar los CIRCULOS de podemos a TRIANGULOS al menos durante ese día y elegir a un FOTORAFO para presidente del gobierno por honor a los masones.</p>

<p>Un afectuoso saludo a todos los ANTIFAS de pro que lean esto.</p>

<p> </p>
";"09/09/2015 00";"51";"17";"34";"1";"856072761";"-566"
"2501";"Bicimad para los barrios periféricos";"<p>Madrid no sólo es el centro. Miles de personas se desplazan diariamente hasta el centro de Madrid o entre barrios. Si queremos que en Madrid se utilice la bicicleta 100% y sea una alternativa al tráfico rodado y contaminante, debería llegar la bicicleta eléctrica a los barrios periféricos, Hortaleza, Villaverde, Moratalaz, Fuencarral, Vallecas, etc....
Hay una petición en Change.org para esto: https://goo.gl/KVjHiZ
Fírmala</p>
";"09/09/2015 00";"183";"158";"25";"6";"878591524";"11483"
"2503";"VALLECAS enterrada por la basura";"<p> Mande las fotografia de mi calle hace 3 dias hoy he recibido este correo La incidencia #1984882 ha sido resuelta , sorpresa ha sido que lo unico que han echo es pasar un camion de riego para regar la calle , pero sin limpiarla , sigue habiendo la misma basura ,pero ahora mojada, la calle esta llena de cucarachas , tengo las fotografias y la basura se acumula desde las aceras hasta la carretera , una papelara de las del ayuntamento lleva 1 semana tirada en el suelo y nadie a recogido ni la basura que hay en esa papelera y ha colocado la papelera tirada en su sitio , Vallecas es un barrio obrero y por desgracia guarro,muy guarro  en la calle santa cruz de retamar todas las noches se pone un grupillo de chicos a beber y a fumar sus cositas , pero en vez de recogerlo todo ,lo dejan lleno de cristales de botes y de toda clase de cosas , hace falta mas limpieza en la calle ,mucha limpieza ,pero tambien hay que concienciar a la gente que las papeleras y cubos estan para eso , falta educacion , si tdos tiramos un papel al suelo y somos en madrid 3.000.000 millones de madrileños pues son 3.000.000 de papeles que hay en el suelo , tenemos que avergonzar a la gente que veamos que tira las cosas al suelo, pero no se la forma de hacerlo,la basura nos invade y la sangre me arde.</p>
";"09/09/2015 00";"37";"32";"5";"3";"872710044";"2335"
"2504";"TARJETA AZUL PARA PARADOS";"<p>La tarjeta azul de transporte, que actualmente tiene como principales beneficiarios a jjubilados y minusválidos dentro de unos márgenes económicos, podría poder ser también utilizada por los parados de largo duración con pocos recursos, ¿ya que como vas a una entrevista si no puedes pagar el metro y llegar al lugar donde te han citado?</p>
";"09/09/2015 00";"33";"17";"16";"1";"860631301";"51"
"2506";"Plaza Calle lo que sea a Ruiz Mateos";"<p>Madrid siempre se ha caracterizado porque persona celebre que ha muerto persona que al dia siguiente tiene algo en su honor al dia siguiente, y, como esta muerto, no esta de mas recordar la vieja tradicion de: una vez muertos todo el mundo es una grandiosa y bellisima persona, por lo que, ¿que menos que dedicarle una calle, pasaje, paseo, plaza, avenida lo que sea  Ruiz Mateos?</p>

<p>El hizo mucho por Madrid, por el pais:</p>

<p>- Construir Rumasa</p>

<p>- Creador de Galerias Preciados</p>

<p>- Disfrazarse</p>

<p>- No tener sentido del Ridiculo</p>

<p>- Ser una mosca cojonera a los politicos de aquel entonces</p>

<p>- Mimetizarse tan bien con su esposa que no sabes quien ha muerto</p>

<p>- Crear Nueva Rumasa</p>

<p>- Que esa nueva sociedad fuera tan bien como la anterior</p>

<p>- Crear Nueva Nueva Rumasa</p>

<p>- Propulsor del timo de la estampita 2.0 con las acciones de esta nueva sociedad en un mercado no secundario sino raro raro raro</p>

<p>- Por ponerse mofletes de hamster</p>

<p>- Por tener como animal preferido al conejo</p>

<p>- Por ser Marques y Señor y ni dios lo sepa</p>

<p>- Por ser el propulsor de los anuncios rancios </p>

<p>- ¿Hace falta mas explicaciones del por que este mafias se merece una calle o algo?</p>
";"09/09/2015 00";"69";"20";"49";"1";"855968353";"-840"
"2507";"Que todo lo que salga de propuestas de aqui lo pague quien lo proponga y apruebe";"<p>Dado que la gente solo pide y no ofrece nada yo propongo que la gente que quiera mejorar la ciudad cubra el coste de los servicios y no obligue a otros a correr con los gastos. Estoy hasta arriba de trabajar para pagar impuestos.</p>

<p>Gracias</p>
";"09/09/2015 00";"77";"27";"50";"6";"855407373";"-806"
"2509";"Becas deportivas a niños en riesgo de pobreza y exlusión social";"<p>Según la OMS todo niño necesita 60 minutos de actividad física al día para un correcto desarrollo. Además el deporte educativo, en las manos de profesionales cualificados, actúa como integrador social, favoreciendo la interacción positiva entre niñ@s de cualquier condición.</p>

<p>Es por ello que, desde mi punto de vista, permitir la práctica deportiva de niñ@ con pocos recursos o inadaptados junto a otr@s chic@s de su edad beneficiaría:</p>

<p>La reducción del sedentarismo, la obesidad y sus enfermedades asociadas, causando a su vez un ahorro en el sistema sanitario gracias a los efectos preventivos del deporte (LOPEZ MIÑARRO, 2010).</p>

<p>La inclusión de jóvenes que por motivos étnicos o culturales pueden ser aislados de la sociedad, reduciendo su contacto a compatriotas en lugar de la integración en un Madrid plural.</p>

<p>Relacionar el mantenimiento de las becas con informes educativos favorables del centro de estudios de los beneficiarios.</p>
";"09/09/2015 00";"42";"27";"15";"1";"867247959";"771"
"2510";"Sistema de reciclaje que devuelve dinero por los envases";"<p>Para facilitar el reciclaje de los envases de vidrio, plástico y las latas de aluminio o latón, disponer máquinas que devuelven dinero por cada envase introducido al estilo del sistema de reciclaje retorna:</p>

<p>http://www.retorna.org/es/retorna/quees.html</p>

<p>Facilitaría a limpieza de las calles y la gente podría incluso ganar dinero extra con la recogida de los envases y latas que se tiran actualmente a la vía pública. No existe ningún incentivo para que la gente recicle y todos sabemos que los beneficios se los llevan unicamente las empresas de reciclaje. Debemos cambiar esto para facilitar el reciclaje, tener las calles más limpias y que la gente pueda ganarse dinero con los envases abandonados en la calle.</p>
";"09/09/2015 00";"65";"59";"6";"2";"875945615";"4810"
"2512";"Parques madrileños.";"<p>Bueno a ver, todos tenemos parques cerca de nuestras casas, en mayor o menos medida, y están hechos un vertedero. Deberían controlarse más los parques, su limpieza y cuidado, y si alguien se pone a echar basura por ahí, pues se le pone una multa, porque donde acaba tu libertad empieza la mia, y es una hartura no poder andar tranquilo por un parque y llevar a los más pequeños. Un ejemplo claro de esto es la Casa de Campo, o el Parque de Caramuel, pero sin duda habrá más. Si hiciera falta, una campaña de civismo para los más pequeños y adolescentes, ya que muchos de ellos son los que lo ensucian y les da igual (lo he visto y tenido que soportar). </p>
";"09/09/2015 00";"26";"21";"5";"1";"870061498";"1292"
"2514";"Sustituir libros de texto por tablets o similares";"<p>Creo que sería muy útil el ir sustituyendo poco a poco los distintos libros de texto por tablets o dispositivos electrónicos similares. Se conseguiría que el peso de la mochila se reduzca notablemente; el coste de los libros se vería reducido, al no ser necesario imprimirlos o comprando el colegio los derechos del libro en cuestión y poniendolos a disposición de los estudiantes; se consumiría mucho menos papel... Veo todo ventajas, y pocos o ningún inconveniente.</p>
";"09/09/2015 00";"34";"11";"23";"3";"856736073";"-388"
"2515";"MÁS SERVICIOS EN LOS BARRIOS NUEVOS";"<p>Me gustaría que en los barrios nuevos de Madrid, los denominados PAUS, hubiera más servicios públicos, nosotros también pagamos impuestos, y a cambio el barrendero pasa como mucho cada 6 meses en el mejor de los casos.</p>

<p>Esto está suponiendo que se empiecen a llenar de traficantes y yonkis, ya que el aspecto de estos  barrios es de total abandono</p>
";"09/09/2015 00";"26";"16";"10";"4";"865509359";"369"
"2517";"Incentivar con dinero público a empresas de Cataluña para que se vengan aquí";"<p>La realidad es la que es. En estos momentos hay muchas empresas importantes que tienen su sede principal en Cataluña y que no se sienten totalmente ""seguras"" debido al legítimo movimiento inpedendentista por posible problemas con la Unión Europea y tal.</p>

<p>Entonces, propongo que se intente atraer a muchas de estas empresas mediante <s>el soborno</s> incentivos económicos directos o bien a través de ventajas fiscales. No por fastidiar a Cataluña, para nada, sino para fortalecer nuestra economía y que haya más dinero en una ciudad siempre atenta para con sus ciudadanas y ciudadanos.</p>

<p>¡¿Quién está conmigo?!</p>
";"09/09/2015 00";"50";"31";"19";"2";"867108823";"744"
"2521";"Transparencia en la listas de profesores de la Agencia para el Empleo";"<p>Desde hace muchos años, siempre se contrata a los mismos profesores para la Agencia para el Empleo del Ayuntamiento de Madrid (AEMadrid). Habría que revisar en profundidad el sistema de elección. Además, la publicación de los convocatorias de contratación de profesores, de las listas provisionales de admitidos y excluidos y de las definitivas no es nada transparente. Debería hacerse a través del boletín oficial del ayuntamiento. Por otra parte, en algunas ocasiones pasan varios meses entre la publicación de las listas provisionales y definitivas. Por último, cuando se va a contratar a un profesor, no se publica ni el puesto libre ni las fechas de duración del contrato,... por lo que el resto de candidatos no saben cuándo se producen vacantes ni la transparencia en la contratación.</p>

<p>Como pueden ver, una tremenda opacidad envuelve a AEMadrid. Además de lo grave por tratarse de una entidad pública, se está jugando con los cursos orientados a desempleados, colectivo muy vulnerable.</p>

<p>Hagan algo.</p>

<p>Me gustaría que nos dieran respuesta directa a los temas planteados. En este caso concreto, pueden contactar conmigo en mi e-mail por si tienen dudas concretas.</p>
";"09/09/2015 00";"31";"26";"5";"0";"871413359";"1761"
"2525";"Enchufismo";"<p>Agradecería en cuando antes explicaciones convincentes del nuevo enchufismo de la alcaldesa. También el significado de esta chapuza de web que solo hace que despilfarrar enormemente nuestros impuestos. </p>

<p> </p>

<p>Gracias</p>
";"09/09/2015 00";"43";"32";"11";"2";"870319013";"1562"
"2526";"Monumento al dedo";"<p>Piedra angular de la política madrileña.</p>
";"09/09/2015 00";"50";"28";"22";"1";"864838729";"336"
"2530";"Rampas pistas de Skite Patinaje";"<p>Existen arcones de metal huecos de varios metros de largo x alto a pocos metros de las viviendas para que los patinadores los golpeen incesantemente día y noche, colocados por los anteriores gobernantes. Es horrible para los vecinos que los tienen en su ventana. Propongo trasladarlos a zonas más lejanas de los domicilios como El Retiro, Parque Juan Carlos, Casa de Campo, Parque de Valdebebas,... Compatibilizando el deporte del skite con la salud de los madrileños y su descanso y el medioambiente y la contaminación acústica que tanto sufrimos y nos enferma en Madrid.</p>
";"09/09/2015 00";"56";"26";"30";"1";"857708193";"-185"
"2531";"Racionalización de los puntos rojos de tráfico";"<p>Hay puntos de Madrid (José ""Atascal""), nudo manoteras, Doctor Esquerdo, entrada A3... que son puntos de tráfico muy conocidos y muy mal regulados. Llevan 30 años siendo así.  Por favor,  soluciones a estos problemas conocidos</p>
";"09/09/2015 00";"17";"10";"7";"3";"863764881";"176"
"2536";"Parque Beatriz Boadilla con Almansa. Limpieza ";"<p>Hay un parque en el cruce de Almansa con Beatriz de Bobadilla al que van muchos niños y está en un estado deplorable: colchones rotos, suciedad por doquier, terraplenes con porquería nunca limpiada, bancos rotos y mugrientos. No parece que haya sido limpiado rn mucho tiempo. </p>
";"09/09/2015 01";"13";"7";"6";"5";"862159686";"53"
"2538";"Hacer obras continuamente en Calle Génova";"<p>Si el equipo de gobierno de este Ayuntamiento quiere agotar a sus rivales políticos debería ponerse en acción.</p>

<p>No me digáis que no es buena idea (a no ser que viváis en dicha calle).</p>
";"09/09/2015 01";"37";"20";"17";"0";"863034952";"162"
"2540";"Carriles taxi usados por listillos";"<p>Tanto el carril taxi de doctor esquerdo esquina o'donell como el de la bajada dr doctor esquerdo a castellana son usados sin multa por listillos que no siguen las normas de tráfico. A nadie nos gustan los atascos en esos puntos pero no dejamos de actuar correctamente.  Se debería multar o eliminar el carril. Es más razonablr multatr conductas contra el código de circulación que por el derecho a aparcar</p>
";"09/09/2015 01";"27";"14";"13";"2";"861235617";"51"
"2543";"Control a los empresarios que no contratan a sus empleados";"<p>En Madrid, como en tal vez todas las ciudades españolas, es una práctica habitual que algunos empresarios paguen total o parcialmente a sus empleados en dinero negro. Esto ocurre incluso dentro de empresas que están avaladas por instituciones públicas, como es el caso de algunas academias de español para extranjeros acreditadas por el Instituto Cervantes. La consecuencia es que hoy muchos de los trabajadores que llevamos casi dos décadas activos, apenas hemos cotizado a la Seguridad Social. </p>
";"09/09/2015 01";"45";"36";"9";"2";"872015664";"2160"
"2546";"Multas por conducción temeraria";"<p>La conducción de Madrid es muy agresiva y temeraria: adelantamientos inapropiados,  saltarse semáforos, maniobras arriesgadas, no uso del intermitente,  intimidación cuando se está aparcando con varias maniobras....  se deberían multar estas conductas por civismo vial y por el riesgo que suponene</p>
";"09/09/2015 01";"80";"65";"15";"4";"874383790";"4062"
"2547";"Stop VICE";"<p>Pedimos al ayuntamiento de madrid que prohiba poner al blogger fino filipino enlaces a VINE. Mas concretamente solo nosotros, los habitantes de madrid, porfavor creen un script o algo para que nosotros, ciudadanos ejemplares podamos disfrutar de la pagina sin tener que ver esos posts. Te lo agradeceria muchisimo Pablito o quien este en el gobierno.</p>

<p>Pagina web: finofilipino.org</p>

<p> </p>
";"09/09/2015 01";"30";"11";"19";"1";"857188739";"-293"
"2549";"Rehabilitación ";"<p>apoyar la rehabilitación de edificios y medidas de ahorro energético como las fachadas. Restituir el ARI de Manoteras que con la crisis no se pudo aprovechar y soterrar los cables de electricidad como decían en su programa electoral.</p>
";"09/09/2015 01";"28";"18";"10";"0";"866315206";"514"
"2554";"DESPEJAR CALLE DE ENSANCHE DE VALLECAS";"<p>¿Hasta cuándo vamos a tener cortada la Gran Avenida del Sureste, a la altura de la ya famosa Torre Negra?.Llevamos  casi 10 años, teniendo esta calle cortada para q echen escombro, cosa q sólo sucede de manera esporádica en la actualidad. La gente q va de paso muchas veces lo usa como basurero y es un nido de insalubridad. ¿ Hasta cuando vamos a tener q vivir separados de la civilización por un montón de tierra?</p>
";"09/09/2015 01";"59";"50";"9";"3";"874295122";"3474"
"2555";"Sugerencias para mejorar la plataforma Decide Madrid";"<p>Todavía me enteré hoy de la existencia de esta plataforma, y me ha alegrado ver que el ayuntamiento de Madrid ha abogado por una herramienta que acerque a los ciudadanos a poder decidir sobre su ciudad. Un paso más para una democracia colectiva, en lugar de la representativa de la que tan cansados estamos.</p>

<p>No obstante, creo que esta plataforma debería cumplir unos estándares más altos de los que actualmente cumple. Es por esto, que voy a sugerir una serie de cambios que, desde mi criterio y perspectiva personal, mejorarían más la experiencia de los ciudadanos y la presencia de sus acciones a través de esta plataforma, en decisiones reales que podamos ver hechas realidad.</p>

<ul>
	<li>
<strong>El ayuntamiento de Madrid debería pronunciarse cada cierto tiempo para decidir una serie de criterios de elección de las propuestas más votadas. </strong>Básicamente, si una propuesta alcanza cierta cantidad de votos (la cual habría que analizar en base a la participación ciudadana en la pataforma), debería entrar a una lista de propuestas sobre las cuales el Ayto. de Madrid debe establecer unos criterios de elección. Por ejemplo:

	<ol>
		<li>Un usuario abre una propuesta. Gusta entre la gente, por lo que termina recabando muchos votos positivos.</li>
		<li>A final de mes, el Ayto. de Madrid debate dicha propuesta y las demás que hayan pasado el criterio inicial de selección de ese mes. Analiza la propuesta, y en base a sus detalles, establece un nuevo criterio de elección que ha de cumplir para llevarse a cabo.</li>
		<li>La petición pasa a un segundo nivel, en el cual trabajan tanto el ayuntamiento, como los ciudadanos. El primero, pide presupuestos, planes de realización, y en base a ellos, un análisis de la propuesta a economistas (y/o ingenieros, abogados... en base a la naturaleza de la propuesta), el cual se colgará en la página asociada a la propuesta, para que todo ciudadano pueda verla. También habría un nuevo panel con los comentarios más votados, de modo que antes de votar, cada ciudadano pueda conocer las opiniones más populares, así como un análisis profundo de la situación.</li>
		<li>Si la propuesta consigue el número de votos estipulado por el Ayto. de Madrid, deberá ser puesta en marcha.</li>
	</ol>
	</li>
</ul>

<p>Si bien no tiene por qué ser exacto a lo propuesto, creo que queda clara la intención: que esta plataforma tenga peso, pero de una forma sensata, en la cual los expertos tienen la primera palabra, los ciudadanos la segunda, y los políticos sólo deban aplicarla.</p>

<p> </p>

<ul>
	<li>Si un comentario consigue un número alto de votos (este número podría variar en función de la participación que dicha propuesta reciba), debería marcarse como destacado y aparecer encima del resto de comentarios. Podrían haber hasta -diría yo- 5 comentarios destacados como máximo, siendo éstos los 5 más votados, siempre y cuando cumplan dicho mínimo de votos.</li>
</ul>

<p> </p>

<ul>
	<li>Para evitar multicuenta, trolls, o simplemente el uso de bots, debería existir un control más riguroso de las cuentas. Establecer un DNI por cuenta (no visible al público, claramente) que pertenezca a un residente o nativo madrileño, sería una forma que, lejos de ser perfecta, sería suficientemente eficaz para evitar usos abusivos de la plataforma. Cabe destacar, que los códigos CAPTCHA ya son fácilmente reconocibles por muchos algoritmos, por lo que están lejos de ser un método fiable para detectar bots.</li>
</ul>

<p> </p>

<ul>
	<li>Debería re-hacerse completamente la parte de los ""temas"". Ahora mismo tenemos mezclados temas de interés general, con las zonas sobre las cuales afectan las propuestas. Propongo que los debates se partan en dos: los genéricos (para toda la ciudad/comunidad) y los locales (para propuestas específicas de una zona), y que en ""Temas"" sólo queden aquellas palabras clave que se refieran a la naturaleza de la propuesta, y no a la localización.</li>
</ul>

<p> </p>

<ul>
	<li>Más herramientas de edición para que nuestros comentarios y propuestas queden mejor formados. Esta propuesta, por ejemplo, de dejar con el interlineado simple entre punto y punto, es ilegible, y ahora en cambio existe demasiada separación. Con las herramientas correctas, sería más fácil de formar (y por tanto de leer).</li>
</ul>

<p> </p>

<ul>
	<li>Todos sabemos que hay ciertas personas que saben más de un tema que otras. Por ejemplo, el criterio de un ingeniero de caminos, será más importante en una propuesta sobre creación de una carretera nueva, que el de un abogado. O que si queremos poner bancos de madera de caoba en el centro del Retiro, un carpintero tendrá más idea que un fontanero (por ejemplo). Por tanto, estaría bien que cada usuario pudiera validar sus titulaciones en la página, para tener un peso ligeramente mayor en su voto, que el de alguien que no cumple dicha especialidad. De ser así, se necesitaría más personal revisando la plataforma para asegurarse de que cada propuesta tiene una categoría correcta (y así establecer el criterio de validez de cada voto en función de la especialidad del votante, de forma correcta). Esto quizás daría bastante <em>curre, </em>pero mejoraría ligeramente el criterio de los votos de la población en cada propuesta.</li>
</ul>

<p> </p>

<p>Me gustaría saber qué pensáis de estas propuestas, para hacer de esta plataforma algo mucho mejor, y que la voluntad de los ciudadanos de Madrid se vea reflejada en las acciones de su ayuntamiento.</p>
";"09/09/2015 01";"35";"16";"19";"7";"859573587";"-137"
"2556";"Ayudas investigación";"<p>Buenas noches. El motivo de este debate es proponer que el Ayuntamiento de Madrid presente una convocatoria de ayudas a la investigación en forma de contratos pre y post doctorales. Estas ayudas podrían estar dirigidas para trabajar tanto en Universidades y Centros de Investigación públicos así como en empresas privadas.</p>
";"09/09/2015 01";"29";"15";"14";"2";"861317028";"51"
"2559";"Rebautizar Madrid";"<p>Madrid es un nombre obsoleto. Propongo que se llame Carmengrado.</p>
";"09/09/2015 01";"65";"30";"35";"2";"857559531";"-230"
"2562";"Que el Madrid juegue en el Calderón y el Atleti en el Bernabéu.";"<p>De esta forma cada equipo empatizaría más con el contrario y se superarían odios atávicos con la mejora de convivencia ciudadana que ello supone.</p>
";"09/09/2015 01";"60";"24";"36";"0";"856331900";"-480"
"2563";"ITVM, aparcamiento de pago y transporte público";"<p>Hola conciudadanos, cada dia es más complicado cicular por Madrid. Zonas de aparcamiento ""regulado"" o mejor dicho pagado, areas de prioridad residencial o ""si pasas 90"" y mientras, los que tenemos coche, seguimos pagando religiosamente el dichoso ""Impuesto de Vehiculos de Tracción a Motor"" el antiguo ""numerito"" que te da derecho a.......nada. Ni circular, ni aparcar, ni....bueno, si, a pagar.</p>

<p>Propongo que, con el fin de no sentirnos ""tontos"" y pagar solo por no poder utilizar el coche nada más que fuera de la m-30, junto al dichoso ITVM se entregue a cada propietario de coche, ciudadano de Madrid, un abono familiar para poder desplazarse en transporte público, solo hacia o desde o dentro de la m-30, de esta forma, podremos movernos por Madrid sin necesidad de pagar dos veces y retirariamos gran cantidad de coches del centro de Madrid. Pagado ya está....</p>
";"09/09/2015 01";"21";"10";"11";"1";"860652091";"-47"
"2568";"Eliminar toda calle franquista o de ""mártires de la fé"". ";"<p>Cambiar callejero franquista al completo (generales franquistas, adoradores del régimen, etc.). Sustituit los nombres franquistas por intelectuales, científicos, activistas de derechos humanos, nombres que simbolicen la paz, la cultura y el progreso, en sustitución de reminiscencias bíblicas o religiosas.</p>

<p>Asimismo, eliminar toda presencia de simbología franquista de Madrid, sobretodo de la zona de Moncloa. Quitar cruces y elementos religiosos del espacio público laico que son las calles de Madrid. Eiminar monumentos como el arco de la ""Victoria"" o el de Calvo Sotelo, el aguila de la plaza de Moncloa, etc.</p>
";"09/09/2015 01";"95";"39";"56";"8";"855728126";"-697"
"2569";"Propuesta para prohibir fumar en espacios públicos";"<p>Si bien se debe aceptar la libertad de que cada persona haga con su cuerpo lo que quiera, incluso consumir sustancias nocivas, no se tiene la libertad de, con su consumo, atacar la libertad y el derecho de otro individuo a respirar aire limpio (al menos libre del molesto humo de tabaco).</p>

<p>Partiendo de esa base, en la que prima la libertad y los derechos del no fumador debido a que es el individuo increpado y afectado y no la del sujeto originario del problema, pedimos el endurecimiento de esta ley con el fin de garantizar las respectivas libertades individuales y la salud de los ciudadanos que eligen vivir de forma saludable.</p>

<p>Para esto se propone la prohibición total del consumo de tabaco y otras sustancias que generen humo en la vía pública (paradas de bus, parques, etc.).</p>

<p>Recordemos también que, como toda droga (aunque ésta sea menos ""mala"" ese es el problema, es la más banalizada), es un instrumento más de control del poder.</p>
";"09/09/2015 01";"58";"36";"22";"1";"867896380";"868"
"2572";"Devolver la vida a los barrios. ";"<p>Crear ""cursos socioculturales y cívicos en los barrios de Madrid. FOmentar sobretodo que la juventud se mueva y una a esos centros, donde se hagan cursos de formación, hobbies, conferencias de interés, asambleas vecinales, espacios para colectivos, etc.</p>

<p>Que se hagan jornadas abiertas en los mismos y sean verdaderos motores de cambio social, que sean las verdaderas ""parroquias"" de los barrios y los revitalizen</p>
";"09/09/2015 01";"81";"68";"13";"4";"875440230";"4617"
"2574";"INCIDIR EN LA VIABILIDAD Y MOVILIDAD CICLISTA.";"<p>Madrid tiene un gran deficit de viabilidad y movilidad en bicicleta. Apenas hay carriles bici, el sistema de Botella de BiciMad es una estafa y funciona de forma muy precaria. </p>

<p>Se deben poner, al menos en vias principales, o paralelas a estas, un carril bici propio para bicicletas, que conecten los barrios de forma acorde.</p>

<p> </p>

<p>Los carriles deben estar bien señalizados, ser del tamaño adecuado y respetados por el resto de ciudadanos y vehículos.</p>
";"09/09/2015 01";"43";"28";"15";"3";"868213456";"846"
"2577";"Más y más identificados los puntos limpios y de regocida de ""trastos""";"<p>Cuando camninas por Madrid se ve que las zonas para reciclar (contendores de papel, plásticos, etc.) están rodeados por muebles, aparatos electrónicos, ropa, etc. que NO deberían estar ahí. Asimismo, hay que poner contenedores o zonas habilitadas y cercanas a las viviendas para reciclar el aceite usado.</p>
";"09/09/2015 02";"27";"22";"5";"1";"870926340";"1385"
"2581";"Cómo acabar con la corrupción . ";"<p>Hay 3 ministerios que deberían actuar totalmente independientes del gobierno para ser votados por el pueblo y que miren por todos.     1) Ministerio de Hacienda:  Que debería investigar a todos por igual sin excepciones .        2) Ministerio de Justicia: Que imparta la ley para todos por igual sin importar quien seas ni el cargo que ostentes.                                                  3) Ministerio del interior: Para intervenir cualquier situación y actuar rápidamente .</p>

<p>Estos tres ministerios deberían mirar por los derechos de todos en total sincronización .</p>

<p> </p>

<p> </p>

<p> </p>

<p> </p>

<p> </p>

<p> </p>

<p> </p>
";"09/09/2015 02";"21";"11";"10";"0";"860876351";"52"
"2583";"Por el voto de los españoles de Cuba";"
Compartir
Embajadores
Seguir
Widget
Contacta



Gracias a la ley de nietos, 300 mil cubanos lograron recuperar la nacionalidad de sus abuelos. Sin embargo, en las pasadas elecciones Autonómicas sólo el 0.04 de los inscritos en las listas logró ejercer su derecho al voto desde Cuba.

Sin embargo, un pasaporte no hace a un ciudadano. Los españoles de Cuba hoy son 300 mil personas ignoradas no sólo por el régimen cubano sino también y, es lo que nos parece más doloroso, por el gobierno español. El voto rogado, sumado a las infraestructuras inadaptadas de telecomunicaciones y viales de la isla, vuelve imposible el ejercicio de los derechos civiles que les corresponden.

Muchos son los impedimentos  que deben enfrentar españoles residentes en Cuba. El primero de ellos es la desinformación y el segundo, la falta de medios materiales para poder ejercer sus derechos ciudadanos.

Nos gustaría que para las próximas elecciones generales todos los españoles inscritos en los registros electorales en el Consulado español de La Habana puedan votar. Para lograr este objetivo la Asociación Autonomía Concertada para Cuba desea organizar una campaña de información dentro de Cuba. Ir al encuentro de cada español y cada española para darle a conocer las informaciones necesarias, así como facilitarles concretamente el ejercicio del voto para la cita electoral de 2015 y siguientes.
";"09/09/2015 02";"23";"12";"11";"1";"861298023";"52"
"2585";"No permitir construir cualquier cosa. Votación y concursos reales.";"<p>Como tantos proyectos urbanos y de edificación que suceden en Madrid, la practica totalidad d ellos el ciudadano tiene apenas espacio para debatirlos y incluso votar por ellos. Asi pasa que Madrid nunca tiene edificios emblemáticos.</p>

<p>Un ejemplo, el Edificio España gusta a muchos y horroriza a otros, y nadie parece poder decicir su mantenerlo, derribarlo y hacer uno totalmente nuevo o dejar la fachada, etc...</p>

<p>Asi pasa con los PAUs y edificios en zonas emblemáticas, las constructoras hacen lo que quieren.</p>
";"09/09/2015 02";"38";"24";"14";"2";"867349612";"631"
"2586";"Trenes nocturnos";"<p>Aunque sé que esta competencia no es del Ayuntamiento de Madrid, me parece correcto exponer una idea que muchas personas de la periferia tenemos: <u><strong>habilitar trenes nocturnos en los horarios 0:00-05:00</strong></u><strong>, </strong>las ventajas son claras:</p>

<ul>
	<li>Se favorece la movilidad de las personas que tienen <strong>trabajos en horarios nocturnos.</strong> Los buhos son muy tediosos, suponiendo en muchas ocasiones 1,5h más del trayecto habitual.</li>
	<li>Se disminuiría la tasa de <strong>accidentes de tráfico</strong> por altos índices de alcoholemia. Sencillamente porque la gente de la periferia se plantearía usar el tren para moverse a otras zonas.</li>
	<li>Se aumentaría el nivel de <strong>ocio y consumo nocturno </strong>a nivel de la comunidad. Es frecuente encontrar personas que salen a tomar algo por la noche, y que expongan  'He de irme porque cierra la renfe', esas personas muy probablemente seguirían consumiendo de tener más facilidades en el transporte.</li>
	<li>...</li>
</ul>

<p>Hablo de una frecuencia de paso de 1h, eso ya sería mucho más de lo que tenemos. Espero que os parezca una buena idea. </p>

<p>Un saludo y que comience el debate.</p>
";"09/09/2015 02";"36";"29";"7";"1";"871753812";"1772"
"2587";"Aparcamiento mas lógico";"<p>Vivo en Barajas, normalmente inicio mi trabajo en Pozuelo de Alarcón, pero suelo que tener que desplazarme al cenro.</p>

<p>Cuando llego al centro no siempre se que tiempo voy a estar aparcado, por lo que suelo poner dinero de mas, por aquello de las multa, por lo que a diario regalo dinero al Ayuntamiento, pero lo peor el si me retraso, antes abandonaba mi puesto y corría cada 2 o 4 horas a poner más. Ahora tengo que cambiar de zona ¿?. No sería posible una modalidad que registrse la hora de llegada y abonase el importe al irme, por supuesto sin tener que cambiar de zona cada 2 o 4 horas.</p>

<p>Hagamos la vida más facil, que ya es complicado vivir, trabajar y desplazarse por Madrid</p>
";"09/09/2015 02";"19";"11";"8";"5";"864537560";"173"
"2591";"Por el derecho al voto de los españoles de Cuba";"

 
<p>Gracias a la ley de nietos, <strong>300 mil cubanos lograron recuperar la nacionalidad de sus abuelos</strong>. Sin embargo, en las pasadas elecciones Autonómicas sólo el<strong> 0.04</strong> de los inscritos en las listas logró ejercer su derecho al voto desde Cuba.</p>
<strong>Sin embargo, un pasaporte no hace a un ciudadano</strong>. Los españoles de Cuba hoy son 300 mil personas ignoradas no sólo por el régimen cubano sino también y, es lo que nos parece más doloroso, por el gobierno español. El voto rogado, sumado a las infraestructuras inadaptadas de telecomunicaciones y viales de la isla, <strong>vuelve imposible el ejercicio de los derechos civiles que les corresponden.</strong>

<p>Muchos son los impedimentos  que deben enfrentar españoles residentes en Cuba. <strong>El primero de ellos es la desinformación y el segundo, la falta de medios materiales para poder ejercer sus derechos ciudadanos</strong>.</p>
Nos gustaría que para las próximas elecciones generales todos los españoles inscritos en los registros electorales en el Consulado español de La Habana puedan votar. Para lograr este objetivo la Asociación Autonomía Concertada para Cuba desea organizar una campaña de información dentro de Cuba. Ir al encuentro de cada español y cada española para darle a conocer las informaciones necesarias, así como facilitarles concretamente el ejercicio del voto para la cita electoral de 2015 y siguientes.


";"09/09/2015 02";"38";"22";"16";"8";"866230476";"347"
"2593";"Colaborar con los que recogen comida de la basura";"<p>Tristemente es frecuente ver que gente que no tiene recursos rebusca comida entre la basura, tanto en la de los supermercados como en la de las viviendas privadas, y me pregunto si ya que esto ocurre no podríamos facilitarselo. Me refiero a que separemos los alimentos que tiramos a la basura y que están en buen estado para que no se contaminen de suciedad y, sobretodo, que los supermercados no aplasten y ensucien alimentos que podrían ser útiles.</p>

<p>Quizá el Ayuntamiento podría habilitar un servicio de recogida de alimentos de los supermercados o colaborar con los bancos de alimentos, o simplemente habilitar ""repisas"" o algún lugar en la vía pública donde despositar esos alimentos que no vamos a comer pero que están en buen estado.</p>

<p>No sé, es una idea muy ambigua y que habría que elaborar, pero la idea sería habilitar alguna forma de que todos esos alimentos que tiramos no los tengan que coger de entre basura maloliente.</p>

<p> </p>

<p>Un saludo.</p>

<p> </p>

<p> </p>

<p>   </p>
";"09/09/2015 02";"38";"19";"19";"3";"860993757";"0"
"2597";"Apostar por la juventud de Madrid.";"<p>Madrid se ha convertido en uan ciudad totalmente envejecida. Los jovenes huyen literalmente ya que apenas hay empleo, pero ademas no hay ofertas culturales ni espacios de reflexión, activismo y asociacionismo juvenil.</p>

<p>Se debería hacer una Red Joven con carnet incluido que de ventajas a los jovenes, hacer mejores bibliotecas para ellos, ofertarles movilidad, deporte y cutura, otorgar premios a la innovación joven, a jovenes comprometidos civica y culturalmente, premios a la ciencia y al deporte municipales, etc.</p>

<p>Mejorar el ocio, que ellos puedan participar en cursos, talleres, actividades gratuitas, etc.</p>
";"09/09/2015 02";"49";"27";"22";"4";"865323979";"275"
"2598";"Convertir todas las azoteas de todos los edificios en jardines.";"<p>La gran mayoría de las edificaciones de Madrid tienen sus azoteas sin ningún uso, y solo se suelen visitar cuando hay una gotera en casa del vecino del último piso, todas las azoteas deberían ser visitables por sus vecinos, y estar dedicadas a jardín, en principio el tema podría incentivarse voluntariamente, para más adelante (dentro de unos años) obligar a que todas las azoteas se reconviertan en jardín.</p>

<p>Saludos.</p>
";"09/09/2015 02";"47";"31";"16";"3";"868994653";"989"
"2600";"Polideportivo La Latina";"<p>Hace 6 años nos derruyeron el Polideportivo de La Latina con la intención de volverlo a construir. Pues bien, seguimos igual que hace 6 años. Con un solar que no sirve para nada. Bueno sí sirve, para crear ruido de jueves a domingo y molestar a todos los vecinos.</p>

<p>Creo que es hora de que se nos devuelva lo que se nos arrebató.</p>
";"09/09/2015 02";"45";"36";"9";"3";"872665867";"2160"
"2601";"Plantar pequeños árboles en las calles de ""los arrabales"". ";"<p>Son los barrios de peor calidad urbanística de la ciudad, los más humildes. Puente de Vallecas, Usera, Tetuán, Carabanchel... esos barrios que crecieron sin orden ni planificación, en torno a los caminos de salida de Madrid, más allá del ensanche de Castro. Calles estrechas, casas apiñadas, escasez de zonas verdes... son los barrios más duros de la ciudad. Por eso creo que se debería intentar humanizarlos un poco y que se podrían plantar árboles de pequeño porte en sus calles. Ya hay algunas que los tienen, pocas, y el resultado ha sido muy exitoso. Por ejemplo, la calle Almansa en Alvarado.</p>

<p>Como son calles estrechas se ha aprovechado el espacio que hay entre coche y coche aparcado para plantar los árboles, y como son calles estrechas se ha hecho con especies de pequeño porte, del mismo modo que en las calles del centro.</p>

<p>Con una inversión no demasiado alta se humanizarían los peores barrios de Madrid.</p>

<p> </p>

<p>Un saludo</p>

<p> </p>
";"09/09/2015 02";"64";"52";"12";"1";"874165904";"3250"
"2604";"Que una ley obligue a las empresas a habilitar aparcamientos de bicis";"<p>Es dificil ir en bici al trabajo si cuando llegas no hay donde aparcar. En ese sentido hay que habilitar plazas de aparcamiento para bicis pero también sería muy útil que una ley obligara a las empresas, a partir de cier to tamaño, a habilitar un cuarto o una zona del aparcamiento donde dejarlas hasta la salida del trabajo. Supongo que habilitar duchas sería mucho pedir, aunque para las grandes empresas no debería de ser mucho problema.</p>

<p>Bueno, la propuesta sería esa, que una ley obligara a las empresas a dejar que los empleados guardaran la bici en un cuarto o en una zona del aparcamiento.</p>

<p> </p>
";"09/09/2015 02";"49";"27";"22";"1";"865131907";"275"
"2605";"Limpiar Madrid ya";"<p>Es responsabilidad del ayuntamiento limpiar Madrid de toda la basura que se acumula en las aceras. Parece un pueblo del Oeste. Madrid es todo Madrid. Tetuan, Carabanchel, Arganzuela...</p>

<p>Da mucha vergüenza!!</p>

<p>A ver si diciéndolo muchas veces se enteran </p>
";"09/09/2015 03";"40";"35";"5";"3";"874286905";"2625"
"2607";"Que vuelva el Frente Atlético";"<p>Que vuelva la pancarta de frente atlético al fondo sur del Vicente calderón</p>
";"09/09/2015 03";"138";"20";"118";"2";"858470352";"-1420"
"2609";"Polideportivos abiertos todos los días hasta las 23 horas";"<p>La gente trabaja en oficinas, nos dicen que la vida sedentaria no es buena pero cuando tenemos tiempo de hacer deporte, al finalizar la jornada laboral que a veces es hasta muy tarde o los fines de semana y festivos nos encontramos que muchos polideportivos tienen horario de banco.</p>

<p>no tiene sentido un centro de ocio y deporte cerrado durante las horas en las que la mayoría de la gente está disfrutando de su tiempo libre</p>
";"09/09/2015 03";"43";"33";"10";"2";"872106104";"1765"
"2611";"Cerrar al trafico el centro de Madrid los domingos";"<p>Ya se hace en multitud de ciudades europeas y americanas para que la gente pueda disfrutar de andar en bici, correr, jugar sin que pasen coches por la calle. Contribuiria a reducir la contaminacion y el ruido.</p>

<p>Saludos</p>
";"09/09/2015 04";"86";"55";"31";"1";"870626871";"1534"
"2612";"Renovar la flota de buses de la EMT";"<p>Es avergonzante ir en la EMT desde hace un tiempo, lo que antes era uno de los orgullos de la ciudad, junto al Metro, ahora es una vergüenza absoluta. </p>

<p>Empezando por las frecuencias de paso que doblan las indicadas en las marquesinas, prosiguiendo por el mantenimiento deficiente de los autobuses (sin aire acondicionado cuando más castiga el sol, haciendo unos ruidos tremendos y hasta quemarse el motor, en este año ya van más de 30 unidades calcinadas) y terminando por la limpieza y antigüedad de los mismos, que si al menos tuviesen un óptimo mantenimiento esto no sería problema.</p>

<p>En definitiva, los usuarios de la EMT exigimos autobuses de calidad y no antiguallas, que no vamos gratuitamente, sino que abonamos nuestro billete religiosamente, así que el que paga tiene derecho a reclamar y exigir un servicio digno.</p>
";"09/09/2015 04";"50";"37";"13";"5";"872389134";"1775"
"2613";"Eliminar la discriminación por razón de sexo o edad d las normativas municipales";"<p>Pese a la ley general vigente, el Ayuntamiento mantiene, dentro de la normativa de su potestad, reglamentos que atentan gravemente contra la prohibición que la ley hace de discriminación por razón de sexo y edad en concreto, sin menoscabo de otros conceptos en los que también pudiere haber discriminación (credo, raza, etc.).</p>

<p>En concreto, y pese a reestructuraciones más o menos recientes, continúa vulnerándose este sagrado principio en los cuerpos de bomberos y policía municipales, en los que se privilegia el acceso a las personas de género femenino, en frontal colisión con la Constitución española. Tanto las condiciones de acceso como los requisitos son distintos y beneficiosos respecto a los exigidos a las personas de género masculino. Elimínese esta injusticia.</p>

<p>De igual manera, ciertos grupos de edad (adolescentes, tercera edad) tienen privilegios a la hora de obtener subvenciones públicas municipales (viajes, reducción del precio en transportes, etc.) en patente e indiscutible discriminación por razón de edad, tan execrable como contraria a la Constitución Española hoy vigente. Cámbiese, derrúmbese esta barbaridad.</p>
";"09/09/2015 04";"35";"18";"17";"1";"862419197";"51"
"2614";"Para que el Ayuntamiento de Madrid tenga un alcalde/alcaldesa seria";"<p>El desconcierto y la desesperanza que se cierne sobre la sociedad inician una nueva búsqueda de alternativas políticas, pero realmente, ¿Es esto a lo que aspiramos?, ¿Deseamos a una alcaldesa que prometa renovar la vida política y que enchufe a un familiar?, ¿Acaso queremos miembros de la corporación que insinúen la muerte de otros políticos por internet?, ¿El cambio que propone esta formación es estético y estéril o se fundamenta en una verdadera revolución ética? </p>

<p> </p>

<p>Los ciudadanos de Madrid deberíamos no permitir mediante nuestro no voto que esta gentuza no nos vuelva a gobernar jamás por la salvaguarda de nuestras libertades.</p>
";"09/09/2015 04";"67";"24";"43";"1";"857438786";"-680"
"2615";"Abandonar el modelo puritano americano y apostar por la libertad sexual";"<p>Una vuelta atrás, una rectificación en las cavernícolas y completamente represivas medidas impuestas por el Ayuntamiento al respecto de la prostitución en Madrid, que penan la libertad sexual y anteponen la opresión a la libertad, la coacción a la responsabilidad, la consideración de la población como grey o súbdita a la ciudadanía y la madurez, es precisa, más allás de deseable. Sea.</p>
";"09/09/2015 04";"49";"15";"34";"3";"858068347";"-581"
"2616";"Instalación URGENTE de urinarios públicos";"<p>Es insultante que una gran urbe tan turística como es Madrid no disponga de urinarios públicos y se dependa de los establecimientos privados como ""baño de circunstancias"".</p>

<p>También es insultante que la Policía Municipal te multe con 751 por miccionar en la calle porque no hay una alternativa por parte del consistorio para evitar estas actuaciones, no contento con eso, la propia Policía conmina al ciudadano a que entre a un establecimiento PRIVADO para realizar sus necesidades. </p>

<p>Es comprensible que haya una sanción administrativa para estas practicas, pero a una cantidad comedida, o que instalen urinarios públicos para evitar estos problemas. Sinceramente da la impresion que lo que buscan es la recaudación por todos medios. Confío que esto último que manifiesto sea un error.</p>
";"09/09/2015 04";"71";"57";"14";"3";"875244908";"3452"
"2617";"Bicicletas: queda mucho por hacer";"<p>Considero la bicicleta un medio ideal para la moviloidad urbana y de hecho la uso siempre que puedo. El problema es cuqando se intenta que un medio fragil y vulnerable como es la bicicleta comparta espacio con coches, camiones, autobuses y demás. Alguien piensa que con pintar un ""30"" y una figura de bicicleta en el asfalto es suficiente? Se puede circular en bicicleta por Madrid sin ir pensando si será nuestro último desplazamiento porque algún salvaje se nos lleve por delante? Por favor, querfemos una política de movilidad realista, espacios para bicicletas separados del resto del tráfico, promoción de la movilidad sostenible y restricción del coche. Hay muchos ejemplos en Europa,  Ojalá Madrid deje de ser una ciudad hostil a la bicicleta. No basta con habilitar servicios de bicicletas (Bicimad) hay que proporcionar erspacios seguros y amigables para poder desplazarse en ellas.</p>
";"09/09/2015 06";"42";"23";"19";"3";"866452715";"219"
"2618";"ASFALTO DE LAS VIAS DE CIRCULACION DE MADRID";"<p>El asfalto de las vías de circulación de Madrid está muy deteriorado, lo que no solo ocasiona incomodidad al conducir, sino también averías en los vehículos (neumáticos, dirección), y aumenta el riesgo de accidentes. Debe realizarse con urgencia una campaña de asfaltado, empezando por las vías de mayor circulación de vehículos.</p>
";"09/09/2015 07";"22";"14";"8";"0";"867915798";"381"
"2619";"Convertir Madrid en la capital cultural de los países hispanohablantes";"<p>Es innegable que los países donde se habla español tienen una cultura común y que esa cultura se originó en España. Durante muchos años hemos renunciado a ese legado, en parte porque parece que queremos percibirnos a nosotros mismos únicamente como europeos y en parte por el sentimiento de culpa de haber impuesto nuestra cultura muchas veces con la espada. Pero lo cierto es que en los países hispanohablantes nos ven como modelo cultural, no en vano llaman a España con cariño 'la madre patria' y nosotros parece que no nos damos por aludidos. Creo que ya es hora de olvidar complejos y sentimientos de culpa paralizantes (sin caer en el chovinismo ni en el colonialismo cultural) y aprovechar para nuestro país y nuestra ciudad un activo que no está explotado y que además tiene mucho futuro. Convertir Madrid, como capital de España, también en la capital cultural de los países hispanohablantes, fomentando que sea un lugar de encuentro de toda la cultura surgida en ellos y reforzando los lazos que nos unen. Es una pena que el papel de 'capital cultural latina' lo esté ocupando Miami, que pertenece a un país anglosajón, mientras nosotros estamos desperdiciando ocupar ese papel que puede dar prestigio y dinero a nuestra ciudad. Para este fin propongo las siguientes ideas:</p>

<p> - Música: Uno o varios festivales de música donde se den a conocer las propuestas más vanguardistas surgidas ese año en el campo del pop-rock alternativo, electrónica, hip hop, fusión, etc. en los países hispanohablantes.
 - Cine: Un festival de cine con las mejores películas rodadas en los países latinos. Se puede barajar incluso unos premios tipo Oscar o Goya para la industra de cine latina (antes de que lo inventen en Miami, que lo harán tarde o temprano).
 - Artes escénicas: Que nuestros teatros recojan las obras de teatro, danza, etc. más representativas que se hayan visto ese año en Mexico DF, Buenos Aires, Santiago y el resto de las principales ciudades latinas.
 - Artes visuales: Creación de un museo de referencia dedicado exclusivamente a la producción de los mejores artistas latinos (pintura, fotografía, escultura, video-arte, etc.)</p>

<p>Estas medidas posicionarían a Madrid como el punto de referencia natural de todos los artistas latinos y su puerta de entrada a Europa y permitiría a su vez el florecimiento de una industria cultural en nuestra ciudad enormemente beneficiosa. La producción cultural de los países hispanohablantes cada vez tiene más fuerza en el mundo y no deberíamos desaprovechar una oportunidad con tanto futuro.
 </p>
";"09/09/2015 07";"42";"33";"9";"0";"873997787";"1885"
"2620";"Trafico en los nuevos PAUs";"<p>Se debería intensificar la vigilancia del tráfico en los PAUs.</p>

<p>Por ejemplo, el PAU de Las Tablas es la ciudad sin ley: coches en doble fila permanentemente para ir a desyunar o comer, aparcados en las aceras, esquinas, en los pasos de peatones, entre los carriles...es un caos que provoca la gente que viene a trabajar a diario en la parte norte cerca de Tele 5, y no es por falta de metro, buses o parkings públicos, es que es mejor tirar el coche donde sea antes que andar 5 minutos y porque, a fin de cuentas, nunca pasa nada ya que la policía municipal o los agentes de movilidad brillan por su ausencia. Eso sin contar los que circulan a 100 km/h como si nada, lo mismo en Motecarmelo o en San Chinarro.</p>
";"09/09/2015 07";"21";"14";"7";"0";"868828590";"466"
"2621";"Tala o poda de árboles";"<p>El último fin de semana de agosto, con las tormentas de viento y agua muchos árboles en la capital se vieron afectados, se han troncahdo y caido ramas que en mas de un caso deberían haber sido podadas con antelación. Creo que la cantidad de trabajo acumulado o por el cambio de criterio, muchos árboles están siendo talados, cuando con una simple poda, podría arreglarse. Debemos tener en cuenta que nuestra ciudad, debe mucho a los árboles que en ella existén y antes de tomar decisiones de poda de árboles con mas de diez años de existencia, se barajen otras posibilidades. </p>

<p>Para evitar accidentes provocados por nuestros árboles, debemos mantener una vigilancia en su conservación, recuerdo siendo un niño jugar todos los años en mi barrio con las ramas que podaban a los árboles. Este procedimiento ahora no se da, </p>

<p>Nuestros árboles son seres vivos que merecen el debido respeto y atención.</p>
";"09/09/2015 08";"27";"22";"5";"1";"873618836";"1385"
"2622";"No a los Guardarrailes!!!!";"<p>En teoría, es un elemento de protección de los que forman la ""seguridad pasiva"", sin embargo está más que demostrado que para ciertos sectores o colectivos, entre los que nos encontramos los motociclistas e incluso ciclistas, dichos elementos representan una GRAVE AMENAZA a la integridad física en caso de una caída, incluso a bajas velocidades por diferentes motivos:</p>

<p>- El cuerpo impacta contra los postes del guardarraíl produciendo gravísimas lesiones en las personas, como traumatismos, amputaciones y en muchos casos la muerte.</p>

<p>- El cuerpo se cuela por debajo del guardarraíl (no realizando la labor para la que está diseñado) pudiendo acabar en el carril contrario o fuera de la carretera.</p>

<p>Para evitar este tipo de accidentes se propone la instalación de guardarraíles con protecciones SPM. Es la solución más efectiva y probada para la protección de motoristas y ciclistas ya que ha quedado más que demostrada su eficacia. Consiste en una placa de material deformable instalada delante de los postes que sustentan las biondas y que evita que los cuerpos pasen por debajo de los guardarraíles o impacten contra las sujeciones. (guardarrailesasesinos.net)</p>
";"09/09/2015 08";"34";"23";"11";"0";"870839627";"811"
"2623";"Macetones en las calles para no permitir aparcar";"<p>No entiendo porqué no retiran las grandes macetas que propietarios de lujosos inmuebles situan a la puerta de sus garajes.</p>

<p>Ello obliga al conductor que se la encuentra de frente a invadir la calzada contraria y si chocara con otro vehículo que viniera de frente la culpa sería suya.</p>

<p>Pero claro la policía municipal ni da parte ni los retira. En la zona de puerta de hierro están por doquier. Y que se aparten los demas.</p>
";"09/09/2015 08";"22";"9";"13";"0";"861119658";"-163"
"2624";"Ley de arrendamientos urbanos sin abuso de comisiones de agencia";"<p>Dentro de la ley de arrendamientos urbanos no existe ninguna indicación sobre cuál debería ser el importe de los honorarios de los agentes inmobiliarios. Así como tampoco existe ninguna ley que establezca quién debe pagar la comisión del alquiler de la vivienda a la inmobiliaria. </p>

<p>Esto implica que cada agencia tiene total libertad para exigir esta comisión a quién ellos crean oportuno según su modelo de negocio creando escenas ridículas en las que algunas agencias exigen cantidades abusivas para el inquilino ya que casi siempre es quien acaba pagando dicha comisión.</p>

<p>Las medidas que se han tomado hasta ahora en Madrid para regular los alquileres no siempre han sido justas. Van por buen camino pero creo que es necesario crear una ley o modificar la actual para regular este tipo de trámites a través de agencias.</p>

<p> </p>
";"09/09/2015 08";"21";"10";"11";"4";"863595047";"-47"
"2625";"Enhorabuena por el trabajo bien hecho";"<p>Solamente quería dar las gracias por esta herramienta que permite la participación directa de la ciudadanía.</p>

<p>Mucho ánimo.</p>
";"09/09/2015 08";"28";"10";"18";"2";"860384952";"-285"
"2626";"Control de la población de gatos ";"<p>Vivo en el barrio de la Asamblea de Madrid y hay una población de gatos callejeros que va aumentando exponencialmente con el tiempo. Son gatos sin ningún control veterinario que entran en los patios donde defecan y pueden suponer un peligro de transmisión de enfermedades, principalmente para los niños, además hay ciudadanos que con buena voluntad y gran ignorancia, los alimenta. Contacté con el ayuntamiento hace unos 18 meses y la solución era que yo me encargara de una jaula que ellos me suministraban y cuando el gato estuviera dentro les llamara, siendo yo la responsable de la jaula...</p>

<p>Propongo que se haga una campaña de castración y desparasitación o que se asuman medidas de control.</p>

<p> </p>
";"09/09/2015 08";"33";"25";"8";"5";"873242220";"1287"
"2627";"Que las calles vuelvan a ser baldeadas por el servicio de limpieza";"<p>A parte de barrer, se debería volver a baldear las calles, al menos las del centro. Con eso se eliminaría, en gran parte, los malos olores que hay, en especial en el centro, y las calles tendrían mucho mejor aspecto.</p>

<p>Ahora las calles huelen a orines (humanos y de animales) y excrementos (menos de humanos y más de animales, espero), dando una imagen lamentable de la zona más turistica de Madrid.</p>
";"09/09/2015 08";"36";"33";"3";"2";"877261430";"2750"
"2628";"Recuperación del Palacio de la Música como espacio cultural ";"<p>Creo de vital importancia la recuperación de un espacio icónico de la Gran Vía como es el Palacio de la Música por parte del Ayuntamiento. A día de hoy no hay ni un solo espacio público entre los edificios de Gran Vía y sería un escenario perfecto para la realización de conciertos de todos los estilos en un entorno maravilloso. Junto a los usos meramente musicales o escénicos se podría realizar una tienda cultural o de productos  madrileños... Albergar una sala de exposiciones... Y en la azotea una cafetería-terraza para el disfrute de todos los madrileños.</p>

<p>Es una pena que un edificio como este acabe convertido en otra tienda de moda low cost. </p>
";"09/09/2015 08";"38";"32";"6";"0";"875575658";"2189"
"2629";"MODIFICACIÓN LÍNEA 110/210 EMT";"<p>Prolongar alguna de estas dos líneas hasta el hospital de la Princesa.</p>
";"09/09/2015 09";"8";"5";"3";"0";"865684862";"125"
"2630";"Remunicipalizar los servicios funerarios por el doble de lo que se vendió 1,2 ";"<p>Los servicios funerarios de Madrid se vendieron por 0,6 . Remunicipalicemoslo por un precio ""justo"", justo el doble 1,2 </p>
";"09/09/2015 09";"28";"19";"9";"1";"870681573";"678"
"2631";"subcontratación";"<p>A mi me gustaria que desapareciera la subcontratación para dar servicio en el sector publico o por lo menos que la empresa que licite no pueda subcontratar a otra, tambien me gustaria que las empresas que ganaran los concursos publicos tuvieran la obligación por el pliego de crear empleo indefinido y sin poder hacer eres ni despidos .</p>
";"09/09/2015 09";"30";"23";"7";"2";"873198690";"1226"
"2632";"Más soportes para atar bicis";"<p>Aunque la puesta en marcha de BiciMAD ha supuesto un avance muy significativo para el impulso de este medio de transporte en nuestra ciudad, todavía queda mucho trabajo por hacer. Para aquellos que disponemos de nuestra propia bicicleta, se echa mucho en falta soportes donde podamos atarla en la calle. Más U's invertidas en el suelo o incluso soportes en las fachadas (si esto último fuese legalmente viable) nos evitarían perder tiempo recorriendo la manzana buscando una señal de tráfico, ventana, etc, para poder atar malamente la bici.</p>
";"09/09/2015 09";"46";"38";"8";"1";"876086326";"2478"
"2633";"CLAUSULAS SOCIALES EN LA CONTRATACION PUBLICA MUNICIPAL";"<p>Nuestro Ayuntamiento debe ponerse al día en la incoporación de cláusulas sociales en los contratos públicos para que determinados servicios de próximidad de atención a las personas,de medio ambiente, reciclaje, culturales,etc... pueden ser realizados por entidades sociales, empresas de inserción, cooperativas sociales, autónomos/as,etc.. en general favorecer que la economía social y solidaria preste sus servicios y aporte  sus servicios a la ciudadanía, existen experiencias y legislación muy contrastada en otros AYUNTAMIENTOS que vienen aplicando cláusulas sociales, también existen referentes desde el punto de vista técnico en el marco de la Ley de Contratos Públicos  de nuestro país y a  nivel Europeo. Me gustaría que el Ayuntamiento  abriese una mesa de trabajo sobre este tema con las entidades sociales y de la economía social y solidaria de nuestro municipio.</p>
";"09/09/2015 09";"24";"17";"7";"0";"870938180";"708"
"2634";"Cambio de nombres de calles: Ley de Memoria Histórica";"<p>Solicito que se cambien los nombres de las calles del barrio que conserven el de criminales franquistas, por personas de reconocida calidad humana y/o artística o profesional. Para empezar, la calle donde vivo,  Paseo Muñoz Grandes, podía pasar a denominarse Paseo de José Luis Sampedro.</p>
";"09/09/2015 09";"80";"41";"39";"8";"866769039";"102"
"2635";"BiciMad incluida en la Tarjeta de Transporte Público";"<p>Creo que el servicio de BiciMad debería integrarse en la Tarjeta de Transporte Público, de esta manera se ampliaría enormemente el uso de la bicicleta sin tener que pagar por dos abonos diferentes.</p>

<p>Esto beneficiará especialmente a los ciudadanos que vienen del extrarradio en transporte público, que son los que pagan un precio más alto por la TTP. </p>

<p>Asimismo la movilidad y flexibilidad que ofrece BiciMad, hará que mucha gente deje el coche fuera de Madrid.</p>
";"09/09/2015 09";"67";"54";"13";"1";"876891887";"3304"
"2636";"Incentivar compartir vehículos diariamente";"<p>La presencia de carriles o ventajas para vehículos de alta ocupación en Madrid es casi anecdótica. Mientras, en nuestros atascados accesos, un poco de observación nos permitirá ver que un porcentaje absurdo de los coches están ocupados únicamente por su conductor.</p>

<p>En otros países incentivan que la gente comparta coches para ir a trabajar, no solo con un carril VAO si no con plazas de aparcamiento específicas para gente que comparte coche.</p>

<p>Un aumento de los viajes compartidos para temas rutinarios tendría un gran impacto positivo en la economía (menor consumo de gasolina y por tanto menos dependencia de la importación de crudo), en el tráfico (menos vehículos = menos atascos) y en la salud y el medio ambiente y en la felicidad de la gente al ver reducidos sus tiempos de desplazamiento al evitar atascos.</p>
";"09/09/2015 09";"42";"32";"10";"2";"874270033";"1676"
"2637";"crear una oficia donde realmente te busquen un empleo";"<p>Creo que deberian crear a modo de copia de las empresas privadas de busqueda de empleo de otros paises una oficina de empleo donde la gente deje su cv y se ha la propia oficina la que distribuya ese cv por empresas del sector donde mas pueda cuadrar ese cv. y  dando subenciones a las empresas que sin destruir empleo acudan a este tipo de oficinas para contratar gente.</p>
";"09/09/2015 09";"49";"39";"10";"3";"875721032";"2308"
"2638";"Mejorar señalización de la M30 hacia la A3";"<p>Si no se conoce bien la ruta y se siguen los carteles indicadores, en la M30 sentido sur, los que quieren ir a Valencia, acabarán en la radial de peaje ya que la salida que viene indicada es la de O'Donnell (R3) y no la de Conde de Casal (A3, gratuíta). Para la gente que quiere ir a la zona de Conde de Casal y creen que la M30 está bien señalizada (Valencia) es un fastidio ya que al salir del túnel en O'Donnell se encuentran con que se han pasado y tienen que buscar la manera de retroceder.</p>

<p> </p>

<p> </p>
";"09/09/2015 09";"30";"26";"4";"0";"875633719";"1906"
"2639";"Billete electrónico transporte público + transbordos bus-bus y metro-bus y +";"<p>Creo que hay mucho espacio de mejora en el transporte público madrileño, mis propuestas son:</p>

<ul>
	<li>1) Un billete tipo tarjeta electrónica que funcione como una tarjeta monedero. Con este tipo de tarjetas que ya se usan en muchas ciudades del mundo puedes cargar dinero para pagar billetes sencillos, cargar el abono mensual o anual, puedes tener descuentos en museos, incluso hay en ciudades en las que puedes hasta pagar en los comercios con ellas. Con esto se ahorra tiempo en la compra del billete, se deja de gastar en emitir los metrobuses y puedes fomentar su uso con descuentos tanto en el propio transporte como cines, museos, tiendas...</li>
	<li>2) cuando entras en el metro puedes cambiar todas las veces que quieras de línea, de hecho te puedes pasar el día en el metro haciendo transbordos pagando sólo el acceso pero no ocurre lo mismo entre autobuses o entre metro y autobús, creo que es bastante injusto. Por eso creo que debería de poderse hacer transbordo entre dos, tres o más autobuses y entre metro y autobús (siempre con un límite claro, podría ser tener 30 minutos para hacer este transbordo). Con una tarjeta tipo electrónica además podrías evitar el mal uso que la gente pueda hacer en esto de los transbordos.</li>
	<li>3) Pagar por kilómetro recorrido. No se por que cuesta lo mismo ir por ejemplo de fuencarral a villaverde que de villa de vallecas a pacífico. No hablo de cobrarte 1 en el recorrido corto y 2 en el largo, hablo de cobrarte por ejemplo 30 céntimos en el corto y 1 en el largo. La idea es la de tratar de calcular el coste/km por usuario y en base a eso cobrar en los desplazamientos, pero no para subir las tarifas, la idea es que el máximo que se pague sea lo que ahora se paga por un sencillo y que para desplazamientos cortos se abarate para así fomentar su uso.</li>
</ul>
";"09/09/2015 09";"63";"58";"5";"3";"879933539";"4879"
"2640";"Bicicletas fuera de las aceras.";"<p>Bicicletas fuera de las aceras.</p>
";"09/09/2015 09";"69";"55";"14";"2";"876915503";"3268"
"2641";"Prado-Recoletos-Castellana. Por Atocha y Chamartín";"<p>Madrid no tiene una línea de metro que viniendo desde el sur, pase por la estación de Atocha, suba por el gran eje cultural de Madrid (Paseo del Prado y Recoletos), Castellana, estación de Chamartín, y continue hacia el norte. </p>

<p>No hay una estación de metro para ir al Museo del Prado ni al Thyssen.</p>

<p>No hay una línea de Metro que una las dos estaciones de ferrocarril. </p>
";"09/09/2015 09";"26";"13";"13";"2";"864068504";"0"
"2642";"Pasos peatonales diagonales en cruces muy transitados.";"<p>En algunas ciudades se puede cruzar de esquina a esquina de una sola vez en cruces que tienen mucha densidad peatonal. Se trata de una fase del semáforo que deja libre de coches <strong>todo el cruce.</strong> y así los peatones (y bicis) pueden cruzar en todas las direcciones.</p>

<p>Un caso piloto podría ser el cruce de El Corte Inglés en Goya. En el peor de los casos hacen falta esperar 3 semáforos para cruzar andando. Con este sistema, se podría atajar por en medio del cruce y llegar al otro lado de una sola vez.

Aquí podéis verlo en funcionamiento con un video:
https://www.youtube.com/watch?v=0VkejRjA1nA</p>

<p>
 </p>

<p> </p>
";"09/09/2015 09";"62";"49";"13";"5";"876515983";"2845"
"2643";"Intervenciones low-cost para unir Madrid y Periferia para ciclistas y peatones";"<p>Aunque muchos barrios de Madrid son ya colindantes con los municipios más cercanos, es muy complicado salir de Madrid si no es en coche, aunque en muchos casos la distancia es inferior a 2 km.

Haciendo pequeñas intervenciones como semáforos, carriles-bici puntuales o reparaciones de caminos existentes se puede dar una alternativa a esos trayectos.

Aquí se listan todos los puntos donde habría que actuar y las soluciones posibles:</p>

<p>
http://www.enbicipormadrid.es/2014/06/propuestas-de-acupuntura-urbana-para.html</p>
";"09/09/2015 09";"63";"51";"12";"5";"877115595";"3157"
"2646";"viviendas a personas necesitadas";"<p>Pienso que seria bueno poner viviendas a disposición de personas necesitadas porque las que se solicitan en la comunidad de Madrid tardan muchisimo y no hay una respuesta inmediata a esas personas.</p>
";"09/09/2015 09";"21";"11";"10";"0";"864145451";"52"
"2647";"MUERTES Y SECUELAS EVITABLES si Samur y Summa112 se coordinaran";"<p><u><strong>HECHOS</strong></u></p>

<p>-<strong>Samur</strong>, dependiente del ayto, solo atiende en <strong>via pública</strong> y algunos casos mediáticos en domicilios.</p>

<p>-<strong>Summa112</strong>, dependiente de la Comunidad de Madrid, solo atiende <strong>domicilios </strong>y accidentes laborales en la capital</p>

<p>-Ambos servicios son independientes y <strong>estan totalmente descoordinados</strong> salvo raras excepciones.</p>

<p>-La inmensa mayoría de los ciudadanos desconoce esta realidad, y las administraciones públicas no han hecho nada en todos estos años para solucionarlo, amparándose en <strong>ese desconocimiento que evita que se genera alarma social.</strong></p>

<p>-El ayuntamiento siempre se ha empeñado en mantener la gestión del Samur por el gran <strong>impacto mediático y buena imagen</strong> que le supone (y por sus buenos profesionales, todo hay que decirlo) que por desgracia no subirán a tu casa si te estas muriendo, aunque estén a 100 metros de tu domicilio.</p>

<p>- En el Summa112 es un médico el que decide si hay que enviar una UVI movil, o bien una ambulancia convencional (solo con técnicos). En el Samur es un técnico de emergencias, con una mínima formación sanitaria, el que decide que recurso hay que enviar (recuerden la tragedia de la sala Arena en 2012)</p>

<p> </p>

<p><u><strong>CONSECUENCIAS</strong></u></p>

<p>-<strong>El recurso santiario que acude a una emergencia NO es el más cercano</strong>. Si te da un infarto o un ictus, tu vida puede depender de si te sucede en la calle o en tu casa, por absurdo que suene.</p>

<p>-Esto, sobre todo en las horas de mayor tráfico, <strong>supone demoras absolutamente inaceptables</strong> en una sociedad moderna cuyas consecuencias son unas veces graves y otras funestas, pero los familiares de los enfermos o fallecidos no tienen posibilidad de saberlo para denunciarlo.</p>

<p>-<strong>Si tienes un accidente de tráfico y te estas desangrando, da igual que haya una base del Summa112 a 100 metros</strong>. Tendrás que esperar a que venga el Samur aunque en ese momento esten saturados y vengan desde muy lejos.</p>

<p>-<strong>Si a tu madre le da un ictus en su casa, no servirá de nada que en ese momento pase por la zona una uvi movil del Samur</strong>. Irá el Summa112 aunque tenga que atravesar todo madrid en hora punta.</p>

<p>-<strong>Desmoralización </strong>de los profesionales de ambos servicios que llevan años viendo de cerca esta situación absurda y las graves consecuencias que conlleva, cuando <strong>las verdaderas emergencias dependen totalmente del tiempo de llegada</strong></p>

<p>-Pésima gestión de recursos, ya que en ocasiones se juntan dotaciones del Samur y del Summa para un mismo suceso.</p>

<p> </p>

<p><u><strong>CONCLUSION</strong></u></p>

<p>-Es urgente que <strong>ambas administraciones públicas se pongan de acuerdo</strong> y determinen unir los servicios o por lo menos que tengan un único centro coordinador para terminar con esta situación absurda e increible que provoca muertos y graves repercusiones médicas por los <strong>demoras facilmente evitables</strong>.</p>

<p>-<strong>El ayutamiento no parece estar por la labor</strong>, según declaraciones del concejal de Seguridad Ciudadana y Salud, Javier Barbero.</p>

<p>http://www.lavanguardia.com/local/madrid/20150714/54433395938/ayuntamiento-madrid-no-considera-fusion-de-servicios-emergencia-summa-y-samur.html</p>

<p>-<strong>La Comunidad de Madrid se ofrece a asumir las emergencias de todo Madrid... </strong>ya sólo falta que el ayuntamiento no cierre los ojos como ha hecho cuando estaba el PP.  </p>

<p>http://www.lavanguardia.com/local/madrid/20150902/54435075391/la-comunidad-propone-asumir-la-atencion-de-emergencias-en-madrid-capital.html</p>

<p> </p>

<p>ABRA LOS OJOS, SRA. CARMENA!!!</p>

<p> </p>

<p>Alvaro</p>

<p> Enfermero de emergencias </p>

<p> </p>

<p> </p>

<p> </p>
";"09/09/2015 09";"73";"45";"28";"50";"873638574";"1047"
"2648";"BONOMETRO PARA FAMILIAS";"<p>Somos una pareja con dos hijas, vivo en puente de vallecas y cuando quiero trasladarme al centro, me sale mas barato coger el coche y meterlo en un parking que coger el metro. Es absurdo, debería existir algun descuento para familias, de tal manera que fuera mas atractivo el uso del transporte público.</p>
";"09/09/2015 10";"42";"30";"12";"2";"873243564";"1285"
"2649";"Medios de transporte a la terminal de carga de Barajas";"<p>Actualmente, sólo un autobús de la EMT tiene servicio en la terminal de carga de Barajas. La duración de su recorrido es de 45 minutos desde Avenida de América, y ni siquiera recorre toda la Avenida Central de la terminal. En la terminal de carga hay muchos trabajadores, entre los que me encuentro, y para poder tardar menos en venir tenemos que coger un autobús en Avenida de América (alguno de los que van hacia Alcalá de Henares) que nos deja en la carretera de Zaragoza (A2). Desde ahí, los más afortunados sólo tienen que cruzar el puente para llegar a su trabajo; pero otros muchos tenemos que caminar al menos veinte minutos.</p>

<p>Considero que con la cantidad de personas que trabajan aquí, la EMT podria hacer algún servicio lanzadera (parecido a servicios como el E1, de Atocha a Plaza Elíptica) desde Avenida de América para facilitar la llegada de trabajadores a sus puestos de trabajo. Con recorrer la Avenida Central de la terminal de carga en su totalidad, mucha gente podría quizá estar en su trabajo en unos 20 minutos y no en 45, además de no tener que caminar desde la carretera de Zaragoza.</p>
";"09/09/2015 10";"23";"10";"13";"2";"862406562";"-130"
"2650";"Ayudas al alquiler para todos los que lo necesiten de verdad";"<p>Al igual que los refugiados Sirios van a recibir una casa y 400 euros de gastos entre otros beneficios, no estaría mal que a los madrileños que pagamos nuestros impuestos se nos diera una ayuda al alquiler sin limite de plazas, a todo el que lo necesite, al igual que se hace con los refugiados de guerra. </p>
";"09/09/2015 10";"30";"18";"12";"0";"868956282";"359"
"2652";"Desacuerdo con recientes nombramientos en el Ayuntamiento de Madrid.";"<p>Voté a Manuela Carmena por muchas razones que ahora no voy a enumerar, pero se podrían resumir en una idea: creía (y quería) que las cosas fueran diferentes, pensé que empezarían a cambiar en Madrid. Nunca he estado involucrada en política, ni en movimientos de una u otra parte o índole. Reconozco que me apasionó la historia de la señora Carmena, su bagaje profesional.
 Hoy en día sigo admirando en ella esa parte, pero quería decir aquí que me ha decepcionado como alcaldesa desde muy pronto. Tanto con declaraciones que me han parecido desafortunadas como, sobre todo, por los nombramientos absolutamente inexplicables que cada mes se están produciendo en su gobierno.</p>

<p>¿No se suponía que con ella las cosas iban a ser diferentes? ¿No se suponía que ""nosotros no éramos como ellos""? Primero fue su cuñado (creo que recordar que ese era el parentesco) y ahora es el padre de Rita Maestre. En muchas empresas existe una norma, tal vez no escrita, de que no está permitido contratar a familiares, aunque su valía profesional sea enorme (cosa que no dudo de estas dos personas).</p>

<p>No sé, sinceramente, si será por el equipo que la está rodeando, o porque el ayuntamiento es un reto diario, pero he de decir que a mí, como madrileña y votante suya, me ha decepcionado. Creo, de verdad, que hacer política de forma diferente es algo más que ir a trabajar en metro o en bici. Es algo más que símbolos. Tampoco me pregunten lo que es, porque yo no sé de política ni de técnica. Sólo sé que es algo más, y cada día estoy más indignada con todo este asunto de poner el disfraz de política nueva a algo que sigue siendo igual de antiguo, lo de siempre.</p>

<p>Gracias.</p>

<p> </p>
";"09/09/2015 10";"41";"24";"17";"2";"869434770";"409"
"2653";"Reforma del Eje Genova - Alberto Aguilera";"<p>Durante la tramitación del nuevo PGOU de la ciudad de Madrid se hizo hincapié en los denominados boulevares de Madrid, que se correspondian con el Eje Goya - Alberto Aguilera, pues historicamente este eje estuvo configurado como los tipicos boulevares parisinos, desapareciendo para dar paso a la movilidad de los automoviles y los autobuses. </p>

<p>Hoy en dia ese eje, además de soportar un intenso trafico para ser el centro de la ciudad, considero que necesita de una reforma estructural por la cual, se reduzca la capacidad de trafico de dicho eje para dar un mayor soporte a la movilidad peatonal y ciclista. </p>

<p>Este eje además actua como una barrera social y de movilidad muy intensa que limita el trafico peatonal y de comunicación entre la zona de Malasaña y Conde duque con la Zona de Chamberi. Vivo ejemplo puede ser la Calle Carranza donde existen 4 carriles por sentido y ningun tipo de paso peatonal. </p>

<p>Por ello, sugiero e inicio el debate de la reforma de este eje, reduciendo los carriles de calzada en uno por sentido en cada tramo, ampliando las aceras existentes y con la implantación de un carrible bici separado de calzada y zona peatonal para el flujo de este nuevo transporte. Asimismo, cabria la renovación de la Glorieta de Bilbao asi como en las nuevas ampliaciones implantan nuevo moviliario y zona ajardinada para el descanso. </p>
";"09/09/2015 10";"42";"30";"12";"3";"873445922";"1285"
"2654";"Parques Infantiles";"<p>Buenos días,</p>

<p>Tengo un bebé de un año, y creo que los parques infantiles están muy mal diseñados. Por ejemplo, los toboganes de los parques para los más peques tienen unos escalones exageradamente altos, a los que los niños tan pequeños (que es para quienes están pensados estos toboganes) casi tienen que escalar. Debería haber columpios más bajitos que puedan utilizar los niños más pequeños por si mismos sin que los padres tengan que estar subiéndoles. Se me ocurre alguna estructura a ras de suelo a la que los niños pudieran sujetarse o subirse con facilidad. También hay pocos parques en Madrid que cuenten con columpios para bebés. Por otro lado, hay muchos parques infantiles con arena que está llena de colillas y otros desperdicios. Debería haber más limpieza en los parques infantiles, y quizás poner carteles de sensibilización para que la gente fuera más limpia. </p>

<p>Gracias.</p>
";"09/09/2015 10";"17";"8";"9";"3";"864341516";"-47"
"2655";"Valdebebas";"<p>Buenos días,</p>

<p>quería exponer la mala situación del barrio de Valdebebas en relación al equipmaiento para el reciclaje de vidrio, cartón... ya que no existen apenas contenedores para este uso, y espero que el Ayuntamiento pueda poner remedio a esto.</p>

<p>Está además el problema de los accesos al barrio que, a día de hoy, no están todos habilitados y sería importante que se pusiese solución a este tema.</p>

<p>Saludos.</p>
";"09/09/2015 10";"119";"109";"10";"2";"882646049";"9068"
"2656";"Eliminar la cuota del SER a los residentes, y las plazas para no residentes";"<p>Es injusto que los vecinos de unos barrios tengan que pagar por aparcar en su propio barrio, y otros no. Y tampoco es justo que en unos barrios se reserven plazas para los no residentes, y en otras no. Estoy a favor de desincentivar el aparcamiento a los no residentes, mediante tarifas que distingan a los vehículos de gasolina y diesel (viejos o nuevos) de los vehículos de gas natural o eléctricos, incluso prohibiendo el aparcamiento a los gasolina y diesel (viejos o nuevos) los días de mayor contaminación ambiental. Pero no estoy de acuerdo en impedir el paso a los vehículos a ciertas calles (APRs) a los no residentes, o por tener un vehículo de gasolina o diesel más viejo (que son los habituales de las clases más desfavorecidas socialmente), y sería injusto hacer esta distinción social.</p>
";"09/09/2015 10";"26";"7";"19";"0";"861444121";"-323"
"2657";"Limpiar las calles de Chamberí";"<p>Que aunque sea, como la llaman, un barrio de casta, sigue estando bastante sucio. Solicito que se limpie y rápido. Voté a la señora Carmena porque se dijo que se limpiaría todo (entre otros motivos) y ahora mi voto ha cambiado, lo siento.</p>
";"09/09/2015 10";"48";"42";"6";"12";"878327711";"3150"
"2658";"ELIMINAR LOS COMPRESORES DE LOS JARDINEROS POR EL RUIDO Y LA CONTAMINACIÓN";"<p>Los trabajadores de limpieza o jardineros que utilizan unos compresores de gasoil provocan un ruido infernal además de sufrir los chutes de gasoil cuando pasas a su lado y todo para una eficacia mínima, solo espantan las hojas con el aire para echarlas a un lado.</p>

<p>Mucho ruido, mucha contaminación y poca eficacia</p>

<p> </p>
";"09/09/2015 10";"38";"31";"7";"4";"875820365";"1957"
"2659";"PUENTE DE VALLECAS";"<p>Como vecino de puente de vallekas, me gustaría denunciar deficiencias existentes en el barrio y posibles soluciones.</p>

<p>- Venta ambulante. Es inaceptable ver la calle de monte igueldo o el bulevar, lleno de gente vendiendo basura ocupando toda la acera. A pesar de la presencia de la policía municipal, sigue existiendo el problema en el momento en el que se van. Debe aumentar la presión policial para evitarlo.</p>

<p>- Limpieza de las calles. No lo responsabilizo únicamente a la poca limpieza, sino a lo sumamente guarra que es la gente. Es inadmisible ver como la gente ha cogido la costumbre de tirar las bolsas de basura directamente a la acera sin hacer uso de los cubos de basura que deben tener todos los portales. Vigilancia y sanción.</p>

<p>- Se reformaron algunas calles, arreglando las aceras y colocando alcorques. Muchos de esos árboles han muerto, sin haber una reposición. Perder sitio para aparcar para tenerlo vacio es inadmisible.</p>

<p>- En un barrio con tan alto nivel de edificación, echamos de menos zonas verdes o peatonales. Me duele ver como en retiro disfrutan del parque de martin luther king y en vallecas en un descampando que había cerca de la m30 han hecho un aparcamiento. Propongo aumentar las zonas peatonales. ¿por qué no hacer peatonales monte igueldo y formar un triangulo peatonal entre monte igueldo, el bulevar y la plaza vieja?</p>

<p>- Movilidad en el puente de vallecas. Bajar por ciudad de barcelona e intentar coger la m30 dirección zaragoza es imposible, si se lo tienes que explicar a alguien se vuelve loco. Igualmente cuando vienes de la m30 dirección sur y tienes que ir a la av. albufera. ¿por qué no modificar el puente para poder realizar esos giros?</p>

<p>- Ayudas a la rehabilitación de los edificios. Sería interesante que el ayuntamiento ayudase a mejorar los edificios del barrio, por ejemplo para la instalación de ascensores.</p>

<p>- Existen varios edificios vacios en vente o alquier. ¿por qué todos los edificios municipales tienen que estar en el centro pagando alquileres muy caros? Se pueden trasladar a barrios periféricos, los significaría un ahorro en alquiler y un empujón para los barrios humildes del sur.</p>

<p>- Presencia policial. Aunque no considero mi barrio peligroso, si que considero que es necesaria la presencia policial que evite comportamiento incívicos en la calle (basuras, botellón, gente orinando, etc.). Reconozco que tener el barrio lleno de policía no me hace mucha gracia, pero menos gracia me hace ver la calle hecha un asco.</p>

<p>- Estación de abroñigal. Tener una estación de contenedores en el centro de la ciudad es absurdo. Por qué no intentar trasladarla fuera de la ciudad? parte de esos terreno se podrían vender para la construcción de edificios de oficinas, lo que significaría un empujón a la economía del barrio (restaurante, bares, tiendas, etc.) y con ese dinero ampliar el parque de enrique tierno y soterrar el puente de vallecas, que es un auténtico muro que separa dos barrios.</p>

<p>No me enrollo más, muchas gracias por dejarme proponer cosas.</p>
";"09/09/2015 10";"39";"31";"8";"6";"875488591";"1828"
"2660";"Creación de pasarela peatonal Las Tablas-Estación de tren Fuencarral";"<p>Una zona como Las Tablas en la vive tanta gente, en la están establecidas tantas empresas y con las perspectivas de crecimiento que tiene, debería tener una acceso seguro y directo a la estación de tren de Fuencarral de la que sólo le separa las vías del tren. La actual solución pasa por dar una vuelta bastante grande para atravesar las vías por un paso subterraneo que hay en la parte alta de Las Tablas y que cuando menos y a partir de ciertas horas del día no parece la mejor opción para niños y/o mujeres.</p>

<p>Una solución rápida, económica y muy rentable para el usuario sería construir una pasarela metálica.</p>
";"09/09/2015 10";"67";"63";"4";"6";"881188046";"5547"
"2661";"Optimizar uso de edificios / instalaciones municipales.";"<p>Como ciudadano próximo a iniciativas sociales, asociaciones y fundaciones que se ocupan de determinadas discapacidades, verifico la dificultad de obtener la cesión del uso público de salas, sedes, .... incluso estando prácticamente desocupadas, y todo ello, hasta ahora, por trabas administrativas o desidia de los responsables.</p>

<p>Entiendo que lo indicado sería centralizar la ""explotación"" abierta para todos aquellos que lo necesiten y aporten un valor añadido a la ciudad y a sus ciudadanos a través de un canal único que de respuestas, pues en muchos casos ante peticiones ya cursadas se da la callada por respuesta.</p>
";"09/09/2015 10";"28";"23";"5";"1";"874813364";"1478"
"2662";"Un madrileño un árbol....";"<p><strong>Promover desde el ayuntamiento que cada ciudadano de la ciudad de Madrid plante un árbol. </strong></p>

<p>Colaborando en la plantación, en el material, dando charlas informativas, con publicidad; para que de esta manera la gente tome conciencia y en Madrid (y en el mundo) haya más árboles.</p>

<p>Plantando un arbol cada madrileño, conseguiriamos 3.165.000 árboles plantados, con lo que se reduciría significativamente el CO2 emitido a la atmósfera por la masa forestal. </p>

<p>Con esta propuesta a la larga ayudaría a las demás medidas de reducción de la contaminación en la ciudad de Madrid (coches eléctricos, bicicletas, etc...)</p>

<p><em>El que antes de su muerte ha plantado un árbol, no ha vivido inútilmente, Proverbio indio.</em></p>

<p>Veamos que dice la Dr. Elaine Soloway una experta en el tema:</p>

<p><em>El único modo de revivir un área que sufre de desertificación es sembrando árboles, para permitir que otras plantas, animales, insectos y aves regresen a la zona. Los árboles son el elemento fundamental del ecosistema.</em></p>

<p><em>Los árboles son una cura para muchos problemas ambientales. No sólo son los pulmones del mundo, son el aire acondicionado del mundo. Enfrían los suelos, permiten que la lluvia regrese, pues el aire frío que se eleva, equivale a que las nubes no se vuelen, sino que dejen caer la lluvia.</em></p>

<p><em>Los árboles también estabilizan los suelos que se están erosionando. Paran las tormentas de arena. Se plantan como fajas protectoras, alrededor de ciudades, aldeas y granjas. Almacenan carbón, y con eso, contrarrestan los efectos del recalentamiento global. Si un tercio del planeta estuviera cubierto de bosques, muchos de nuestros problemas disminuirían y hasta desaparecerían.</em></p>

<p>Fuente: EARTH FROM ABOVE Defending Water Is Defending Life de Yann Arthus Bertrand.</p>

<p>http://www.un.org/climatechange/blog/2014/08/plant-planet-billion-tree-campaign/</p>
";"09/09/2015 10";"57";"43";"14";"1";"875537297";"2187"
"2664";"Cargos Publicos";"<p>Una propuesta indecente y hasta imposible. Si podria ser que los cargos publicos no sean para familiares y amigos del partido en el poder. Un ejemplo es el de Rita Maestre y su papa. </p>

<p>Muchas gracias</p>
";"09/09/2015 10";"45";"35";"10";"3";"875476297";"1944"
"2665";"Mayor frecuencia del metro en hora punta";"<p>A mi juicio se trata de un problema capital en Madrid. </p>

<p>Antes del último trimestre de 2007, la periodicidad de las líneas de metro en las horas punta (entre 07:30 y 10:00) oscilaba en torno a los 4 minutos; desde entonces, y junto con un incremento en el precio del billete del 50% se ha reducido de tal manera que en líneas como la 7 he llegado a sufrir regularmente esperas de entre 7-9 minutos si tenía la desgracia de ver marcharse el metro que esperaba.</p>

<p>Líneas tradicionalmente mejores en frecuencia, como la 10, también tienen esperas cercanas a los 7 minutos en diversas fases.</p>

<p>Las comparaciones son odiosas, pero ciudades como París no presentan estos intervalos no ya en hora punta, si no, ni siquiera en las tardes de domingo.</p>

<p>Para mayor razón, he observado (padecido) que los intervalos en hora punta han aumentado todavía más en los últimos dos meses. No me alarmé en exceso en Agosto ya que, aunque es laborable (parece que al Ayuntamiento se le olvida que muchos madrileños trabajamos en Agosto), puede entenderse una disminución de la frecuencia. Sin embargo, a día 9 de septiembre, esto no ha mejorado.</p>
";"09/09/2015 10";"64";"59";"5";"0";"880456531";"4978"
"2666";"Dedicatoria de una plaza a Iker Casillas";"<p>Ha hecho muchisimo por Madrid, es una persona que merece nuestro reconocimiento</p>
";"09/09/2015 10";"94";"31";"63";"0";"859529084";"-1055"
"2667";"Que ningún familiar de un miembro del gobierno pueda obtener un cargo público.";"<p>Por higiene política, y por cumplir con lo anteriormente criticado y tan bien calificado como ""casta política"", ningún familiar debería ser nombrado en ningún cargo público. Por ahora el sobrino de la Alcaldesa (89.000 euros), el padre de Maestre.... por muy cualificados que estén existe lo que se llama conflicto de intereses y por higiene política no deben ser parte del gobierno. </p>
";"09/09/2015 10";"55";"37";"18";"3";"873238183";"1278"
"2668";"Paso Peatonal y Carril Bici a Casa de Campo desde Colonia Jardin";"<p>Desearía que hubiese un paso peatonal con carril bici para acceder a la casa de campo desde Colonia Jardín (Campamento) sin tener que cruzar las carreteras de Carabanchel a Pozuelo, ni la carretera de Boadilla. Actualmente el acceso a la casa de campo entrada del Centro Cultural Sara Montiel se realiza cruzando las dos carreteras que son puntos de entrada a la ciudad. Son muchos los ciclistas, deportistas y ciudadanos que disfrutan de este recorrido diariamente y muchos más a los que se acercaría este precioso tesoro de la Ciudad que es la Casa de Campo siguiendo el cauce del Arroyo Meaques.</p>

<p>Con esta medida se establecería una ruta peatonal desde Principe Pío hasta Villaviciona y Alcorcón sin coincidirr con ningún vehiculo motorizado, creando una ruta verde de gran recorrido.</p>
";"09/09/2015 10";"46";"32";"14";"0";"873236708";"1252"
"2669";"CONCIENCIACIÓN PROBLEMA DE RUIDO - GENTE RUIDOSA";"<p>Vecino de Madrid en General.</p>

<p>- No sabía que el tren tuviera hilo musical. Porque crees que en el metro y en el tren nos gusta escuchar en alto la musica de tu movil, yo tambien tengo pero uso cascos.</p>

<p>- Ya sabemos que tu coche tiene un equipo de música bastante chulo, pero insistes en hacerte notar.</p>

<p>- los bloques  de edificios de viviendas suelen contar con un portero automático, no es necesario que llames al vecino del 5º a voces.</p>

<p>- bares y terrazas ( incluidas los que se habilitan en fiestas) a ciertas horas impiden el sueño de los madrileños que madrugamos para trabajar, tu te lo estarás pasando bien, pero a mi me cuesta una noche en blanco.</p>

<p> </p>

<p>Mi barrio es Villaverde....</p>
";"09/09/2015 10";"62";"54";"8";"4";"879091234";"4006"
"2670";"Que el gobierno de Madrid apueste por energías limpias y sea un referente europe";"<p>Es una vergüenza que en España tengamos un impuesto para producir energía limpia (solar), el gobierno de Madrid podría intentar ayudar a los ciudadanos para que en un futuro próximo todos podamos disfrutar de los beneficios de no destruir nuestro planeta por culpa de los intereses de algunos.</p>

<p>Propongo también una educación que sea consecuente con el bienestar de nuestro planeta y la importancia de invertir en la investigación de energías limpias.</p>
";"09/09/2015 10";"42";"37";"5";"0";"877776637";"2819"
"2671";"contemplar a la gente mayor";"<p>El centro de Madrid,en cocreto la zona donde vivo C/ Noviciado, es un barrio de gente mayor, aunque por las noches se llena de gente mas ó menos joven para armar jaleo, pasan hablando en voz alta y gritando, los bares, como no permiten fumar dentro tienes preparados taburetes para que la gente esta fuera con el consiguiente escandalo y para acicalar más el ambiente la gente pasa con coches y motos con música puesta a tonos escandalosos y tocando el claxón, a cualquier hora (Igualmente por la mañanas,la gente se pone nerviosa por los atascos y nos dan serenatas) Todo esto ocurre a la vista de la policia en multiples ocasiones. Pero parece ser que la juventud es lo que cuenta y los vecinos de toda una vidan no tenemos que aguantar sin dormir, escuchar música ó leer tranquilamente porque los ruidos son terribles.</p>

<p>Estas quejas las hemos expuesto en multiples ocasiones pero nunca han hecho el mínimo caso.La verdad  es que tampoco espero nada ahora,porque la ""progresía"" marca que nuestro barrio es para divertirse, ponerse, dar la lata, ensuciar y mearse.</p>

<p>Espero que tomen nota que hay mucha gente que solo quiere que se respete su descanso y poder estar en su casa tranquilamente, sin molestar a nadie pero que tampoco nos molesten los demás.</p>
";"09/09/2015 10";"22";"13";"9";"1";"868237147";"236"
"2674";"Hablar más despacio";"<p>Propongo que se obligue a hablar más despacio, de este modo las personas se entenderían mejor independientemente del acento que tengan, haciendo de Madrid una ciudad más acogedora para los foráneos. He hecho unos cálculos y estimo que con no sobrepasar una velocidad de 25 palabras por minuto la comprensión sería la máxima.</p>

<p>Podría estudiarse la construcción de palabrómetros, y multar a quien sobrepase las 25 palabras/minuto.</p>
";"09/09/2015 10";"78";"20";"58";"2";"860453204";"-974"
"2675";"Aumento del límite de velocidad en el túnel de la M-30 y retirada de radares";"<p>Como cualquier conductor o usuario de Taxi madrileño sabe bien, el límite de velocidad existente en el túnel de la M-30 (70 Km/h) es un límite innecesariamente reducido para las características de la vía (tres o cuatro carriles), fijado con fines exclusivamente recaudatorios (fin este que queda meridianamente cuando se comprueba el ridículamente elevado número de radares existentes en tan pocos kilómetros de vía).</p>

<p>Dado que el fin de los límites y controles de velocidad debe ser exclusivamente garantizar la seguridad de los usarios de la vía, cosa que poco o nada tiene que ver con arrastrarse a 70 Km/h por una autovía de cuatro carriles, creo que procede elevar el mencionado límite igualandolo al menos al del resto de la M-30 (90 Km/h, que ya es bastante reducido para una vía de esas características).</p>

<p>Asimismo, y dado que los radares deben utilizarse exclusivamente con fines de seguridad y no con fines recaudatorios, slicito también la retirada de todos los existentes cuya instalación no esté justificada por su localización cercana a un ""punto negro"" o lugar con altas estadísticas de siniestralidad.</p>

<p>Creo que cualquiera que haya utilizado el túnel de la M-30 madrileña, ya sea como conductor o como pasajero de un taxi estará de acuerdo en que esta petición es lógica y justificada.</p>
";"09/09/2015 10";"96";"43";"53";"26";"861326557";"-447"
"2676";"Sistema de evaluación a funcionarios de cara al público";"<p>Estoy un poco cansado que cada vez que voy a un hospital o tengo que hacer algún tramite a alguna administración hay funcionarios que te tratan bien y otros que te tratan mal o bien la información que te dan no es verdadera y sales perjudicado o bien enfadado por el trato que te han dado, me refiero por ejemplo a malas contestaciones o ver que el funcionario no está motivado por dar un buen servicio al ciudadano o que alguna información que te han dado no este bien y tengas que ir varias veces hasta que te atiende un funcionario que hace bien su trabajo.</p>

<p>Sugiero que en cada ventanilla o puesto de funcionarios que dan servicio de cara al público tengan o bien un sistema de evaluación individual que por parte del ciudadano pueda indicar si se ha atendido bien o mal y si el tramite ha sido bueno o malo como hay en algunas administraciones. </p>

<p>No me parece de credito tener que pasar un mal día porque alguien te ha tratado mal y no haya consecuencias bien en forma de curso de formación para mejorar su calidad de atención al cliente o en casos más graves la expulsión de ese puesto.</p>
";"09/09/2015 10";"38";"27";"11";"4";"873351110";"1136"
"2677";"Horario perros";"<p>Buenos días, actualmente las horas para poder soltar a un perro en un parque son de 19:00 a 10:00 del día siguiente o si es verano de 20:00 a 10:00. Yo propondría crear una especie de horas valle debido a que a determinadas horas algunos parques estan vacios, por ejemplo en el parque emperatriz de Austría en carabanchel de 14:30 a 17:00 mas o menos esta vacio, y se podría soltar a los perros sin molestar nadie. Todo esto con todas las medidas de seguridad y en sitios que se pueda.</p>

<p>Seria ver el parque, que horas fuera de las horas legales actuales esta sin gente, etc.</p>

<p>Muchas gracias.</p>
";"09/09/2015 10";"46";"19";"27";"5";"860975775";"-330"
"2678";"ABONO TRANSPORTE GRATIS PARA LOS PARADOS";"<p>Renovación mensual gratuita del abono transporte para gente en situación de desempleo que demuestre periódicamente que están buscando empleo de forma activa.</p>
";"09/09/2015 10";"67";"33";"34";"2";"864575733";"-49"
"2680";"Abono deportivo JOVEN hasta los 27 años.";"<p>Actualmente el abono deportivo joven es solo hasta los 20 años lo cual es insuficiente. deberían unifircarse criterios de tarifas para jóvenes en todo Madrid. Además abrir al menos hasta las 22 o 23 los polideportivos (mínimo 1 por barrio o distrtito) y los fines de semana hasta las 21. (Hay personal de sobra). También recuperar el abono deportivo anual y permitir el acceso a los centros de gestión privada.</p>

<p>Muchas gracias.</p>
";"09/09/2015 11";"75";"35";"40";"1";"861472082";"-233"
"2681";"Tasa especial limpieza heces caninas";"<p>Debido al incivismo de muchos propietarios de perros, vemos como muchas aceras, y parques, de nuestros barrios se llenan de heces caninas con la consecuencias sanitarias que puede suponer. El que quiera tener un perro que lo tenga, y que pague la limpieza de las heces de las aceras.</p>
";"09/09/2015 11";"65";"41";"24";"4";"872613543";"1072"
"2682";"Construir aparcamientos para residentes allí donde el SER no es suficiente.";"<p>Promover la <strong>construcción de aparcamientos subterráneos para residentes</strong> en zonas con pocas plazas.</p>

<p>Muchos tardamos más de media hora en aparcar el coche cada día, con la contaminación, al desesperación y el gasto que supone.</p>

<p>Se liberarían las calles de cientos de vehículos aparcados o buscando aparcamiento.</p>
";"09/09/2015 11";"44";"26";"18";"4";"870321859";"472"
"2683";"Vota por un ""PALACIO DEL BAILE DE MADRID""";"<p>En el mes de junio de 2015, ENCUENTROSCONELBAILE.COM presentó una propuesta al AYUNTAMIENTO DE MADRID para crear ""EL PALACIO DEL BAILE DE MADRID"". El proyecto consiste en recuperar un inmueble público no utilizado, en el que se puedan impartir clases de baile y organizar bailes de salón, salsa, tango y todo tipo de modalidades de baile, con precios populares.</p>

<p>Ahora te pedimos a ti que votes afirmativamente este proyecto porque en un espacio con 10 aulas y una gran pista de baile, acondicionado todo ello adecuadamente, se proporcionaría un gran disfrute a los madrileños y a los visitantes de nuestra ciudad y se daría trabajo a más de 150 personas, entre profesores de baile y personal de servicio, mantenimiento y limpieza.</p>

<p>Además, aún aplicando precios populares a las actividades, este proyecto se puede autogestionar sin suponer cargas a los madrileños.</p>
";"09/09/2015 11";"99";"79";"20";"6";"878916715";"4708"
"2684";"Bono de 500 horas/año de aparcamiento gratuito SER al pagar el IVTM";"<p>Es evidente que por razones medioambientales, hay que desincentivar el uso urbano y diario de los vehículos de gasolina y diesel (viejos o nuevos). Pero sus usuarios, deben tener el derecho a utilizarlos de forma esporádica, sin tener que pagar recargo alguno por ello. 500 horas/año de aparcamiento, supone unas 10 horas semanales, suficientes para realizar trámites burocráticos, compras, o ir al trabajo algún día entresemana por alguna razón especial.</p>
";"09/09/2015 11";"41";"11";"30";"0";"861244387";"-509"
"2686";"Que el ayuntamiento contrate con compañias éticas.";"<p>El ayuntamiento debería contratar compañias éticas.</p>

<p>En el caso de la electricidad, la debería contratar, por ejemñlo, con Somm Energia, pues toda la enegía que venden es producida por renovables, además de intentar crear ellos mismos enegía (paneles solares en los propios tejados del ayuntamiento, etc)</p>

<p>La linea de telefono las podrían contratar a Eticom-Som Connexió, y en caso de que un funcionario necesite un teléfono móvil para ejercer su trabajo, y se decide comprarle un, creo que debería ser un Fairphone.</p>

<p>En caso de tener cuentas bancarias, recomendaría que fueran en Triodos o en Coop57.</p>

<p>Si conocéis otras compañias éticas comentadlo, pues cualquier idea es bienvenida ;-).</p>

<p>Un saludo.</p>
";"09/09/2015 11";"52";"38";"14";"5";"874974015";"1753"
"2687";"Domingos no laborables en comercio";"<p>Buenas. Como trabajador del sector del comercio me gustaría que los domingos no se pueda abrir ningún comercio, sea la zona que sea ( trabajo en plena C/ Gran Vía ) o si el empresario decide abrir que se considere jornada extraordinaria como antes de la última reforma laboral y que se paguen las horas que se trabajen como horas extraordinarias; no que actualmente los contratos que se ofrecen son de lunes a domingo.</p>

<p>Entiendo que en una zona con tanta atracción de turismo se deba/pueda abrir el comercio, pero los trabajadores iríamos más motivados de esta manera un domingo a trabajar.</p>
";"09/09/2015 11";"59";"30";"29";"2";"865439489";"50"
"2688";"Potenciar el transporte público y grabar la entrada de coches a Madrid";"<p>Con esta propuesta solucionaríamos en gran medida la contaminación ambiental y acústica que padecemos los madrileños.</p>
";"09/09/2015 11";"46";"27";"19";"4";"870302059";"469"
"2689";"Registro obligatorio de perros";"<p>Creo que sería buena idea que para sacar a pasear una mascota por las calles y parques de Madrid (perros principalmente), fuera obligatorio que estos tuvieran una especie de DNI donde se indicara que dispone del chip correspondiente así de si se trata de una raza peligrosa. De esta forma la policía municipal podría saber si un perro tiene que llevar bozal por ejemplo (no tienen porque conocer todas las razas existentes) y se podría tener un mayor control para evitar animales perdidos, robados, etc. Eso sí, habría que implementar un sistema de sanciones para los dueños que no dispongan de dicho DNI.</p>

<p> </p>

<p> </p>
";"09/09/2015 11";"64";"43";"21";"2";"873801830";"1478"
"2690";"Interpelo a Pablo Carmona.";"<p>Como vecino de Moratalaz, estoy viendo que se da mucha más informacióon sobre el trabajo que estás haciendo en el distrito de Salamanca que el que estás haciendo en el de Moratalaz. Creo que ambos se merecen un reconocimiento público. Me gustaría que trabajaras para ello. Un saludo y gracias por tu trabajo.</p>

<p> </p>
";"09/09/2015 11";"19";"4";"15";"0";"862538537";"-231"
"2692";"Cigueñas en el cielo de Madrid";"<p>En Villa de Vallecas un sello de identidad surca el cielo en forma de cigueñas.</p>

<p>Tan solo propongo acomodar las rotondas para que las cigueñas blancas posen durante la noche (en vez de las gruas y pararrayos).  </p>

<p>El parque de la Gavia, las rotondas del PAU son todos lugares aptos para habilitar un espacio.  </p>

<p> </p>
";"09/09/2015 11";"36";"28";"8";"0";"874870108";"1555"
"2693";"No libre designación de cargos para familiares de los Concejales y Alcaldes";"<p>La propuesta es que no sea posible designar en un cargo del Ayuntamiento a un familiar directo de los Concejales y Alcaldes de la ciudad.</p>
";"09/09/2015 11";"54";"42";"12";"1";"876278982";"2333"
"2694";"Más vigilancia policial";"<p>Si no es mucho pedir me gustaría más presencia policial en nuestras calles para vigilar entre otras cosas que se cumpla la ley, como controlar la velocidad máxima permitida de los vehículos en los barrios, que se respeten los pasos de cebra, los aparcamientos para minusválidos, etc. Soy de Villaverde y no se respeta nada, no sé en otros distritos pero aquí no se ven coches de policía, y cuando los hay no hacen lo que deberían.</p>
";"09/09/2015 11";"77";"56";"21";"2";"876052224";"2545"
"2695";"BiciMad en todos los grandes intercambiadores de transporte público";"<p>Los <strong>intercambiadores</strong> de transportes reciben cada día miles de pasajeros.</p>

<p><strong>Plaza de Castilla / Avenida de América / Aluche </strong></p>

<p><strong>Plaza Elíptica / Méndez Alvaro / Chamartín</strong></p>

<p>El servicio de alquiler de bicicletas <strong>BiciMad debe </strong>llegar a estos puntos.</p>

<p>Estudiantes, trabajadores y público en general podrían beneficiarse de esta medida.</p>
";"09/09/2015 11";"113";"100";"13";"5";"882011459";"7699"
"2696";"Prohibir el voseo";"<p>Creo que debería obligarse a que se utilice exclusivamente el tuteo en Madrid. El voseo me confunde.</p>
";"09/09/2015 11";"49";"15";"34";"1";"860856654";"-581"
"2698";"Señora Carmena, esta web sera util ? o simplemente para que la gente se desahoge";"<p>Señora Carmena, esta web sera util ? o simplemente para que la gente se desahoge</p>
";"09/09/2015 11";"58";"19";"39";"4";"860477794";"-655"
"2699";"Crear nuevos parques eólicos para eliminar contaminación y poner placas solares ";"<p>Tengo una nueva iniciativa que a vosotros os puede gustar: ""<strong>Para eliminar la contaminación, se necesita crear nuevos parques eólicos para ventilar la ciudad y así, eliminar el polvo en suspensión que proviene de la contaminación de los vehículos. Además, se puede instalar placas solares para iniciar un proyecto de energías renovables '100%' (ER100%). Se trata de una reforma que sirve para que los problemas del cambio climático no se intensifiquen en Madrid y en otros distritos"". Además, se reemplazarán las energías nocivas por las energías renovables para hacer que Madrid sea una ciudad limpia de residuos, limpia de impurezas y limpia de excesos de polvo que hacen que la ciudad siempre tenga unos niveles de contaminación asfixiantes"" ""También, se puede instalar la reforma NMBS (No más basura al suelo) que multará con 100 a las personas que tiren muchas cosas al suelo. Luego, se agrandará y se pondrán más cubos de basura en la calle para así tener papeleras en cualquier lugar. El problema que reina es que mucha gente que está en algún lugar no tiene a disposición una papelera, y por eso, la gente tira cosas al suelo. Por último, la gente no podrá mear en las calles, ya que ensuciaría la ciudad mucho y olería mal""</strong></p>

<p>Espero que os guste.</p>
";"09/09/2015 11";"43";"36";"7";"1";"877079213";"2427"
"2700";"Carné de refugiados";"<p>La ciudad de Madrid debería crear una red de refugiados extenta de participación política, mostrado la verdadera fe por la humanidad y no basarse méramente en lo políticamente correcto. Es por ello que propongo:</p>

<p> </p>

<p><strong>CARNÉ POR PUNTOS DE A.A.R. (acoja a refugiados)</strong></p>

<ul>
	<li>Creación de carné individual para cada uno de los habitantes mayores de 18 en el municipio. Cada cual comenzará con 0 puntos.</li>
	<li>Aumento de puntos por cada Sirio refugiado en casa dependiendo del tiempo acogido. 15 puntos por cada 3 meses.</li>
	<li>Sistema de canjeo de puntos por bonos de descuento en metro, cercanías, burocracia pública...</li>
	<li>Bonus por niños y embarazadas (x2).</li>
	<li>Sistema de referidos para la invitación a otros ciudadanos a la participiación en el programa (exponencial).</li>
</ul>
";"09/09/2015 11";"42";"17";"25";"1";"861189181";"-323"
"2701";"140 coches patrulla menos?";"<p>Buena decision señora alcaldesa, como ahora se utilizan segways, usted decide no renovar los renting de los coches patrulla? Jajajajj me parto...</p>

<p>140 unidades menos... Cacos de Madrid, a ponerse las botas...</p>
";"09/09/2015 11";"36";"21";"15";"6";"869957165";"350"
"2702";"POSIBILIDAD DE DONAR LA COMIDA SOBRANTE DE LOS SUPERMERCADOS";"<p>Que se obligue a los supermercados a donar la comida sobrante en buen estado, y no tirarla a los contenedores a las puertas de los supermercados en la que los indigentes rebuscan con el consecuente riesgo para la salud y la suciedad que produce.</p>
";"09/09/2015 11";"76";"62";"14";"6";"878693094";"3915"
"2703";"BiciMad: Ajustar la primera fracción de tiempo a la distancia recorrida";"<p>Actualmente la primera media hora de uso de BiciMad cuesta 0,50, la siguiente fracción de tiempo 0,60</p>

<p>Creo que la duración de esta <strong>primera fracción debería depender de la distancia entre la estación de origen y destino</strong>. No es lo mismo ir de Moncloa a Plaza de España que a O' Donnell. Por no hablar de futuras ampliaciones.</p>

<p>Las prisas por no superar esa media hora pueden llevar a muchos usuarios a saltarse semáforos o realizar maniobras peligrosas. Queremos poder ir en bici tranquilamente, no en una contrarreloj</p>

<p>No entro en el debate de si esta primera fracción debería ser gratuita. Eso ya se hace en otros debates.</p>

<p> </p>
";"09/09/2015 11";"40";"21";"19";"4";"867248785";"105"
"2704";"Por una ITV sana. Si al TÜV no a pago continuo por reformas";"<p>Lo dicho, que se acepte incluir elementos al vehículo como suspensiones, turbos, barras de torretas, llantas más anchas o separadores o lo que sea sin tener que pagar el pastizal que se paga siempre y cuando el elemento añadido o sustituido esté sellado con TÜV Reihnland o certificación europea.</p>

<p>Cada vez que se quiere hacer una mejora en el vehículo tenemos que luchar con ""ingenieros"" que no dan el visto bueno si no sacas tus cochinos billetes porque son ""reformas de importancia"".</p>

<p>No a los abusos en las ITV pero sí a la seguridad. Si TÜV es un órgano regularizador de Europa en cuanto a estas cosas, ¿por qué en España y por extensión Madrid no disfrutamos de esas ventajas?</p>

<p>Un saludo a Griso y a delitos telemáticos.</p>
";"09/09/2015 11";"26";"7";"19";"0";"862012867";"-323"
"2705";"Bicimad accesible para ""acoplar"" sillitas de niños y niñas";"<p>¿Sería posible que algunas de las bicis del servicio de BiciMad estuvieran preparadas para incorporarles las sillitas de niños/as?</p>

<p>No puedo utilizar el servicio si tengo que desplazarme con mi hija y supongo que a muchas familias os pasará lo mismo.</p>

<p> </p>
";"09/09/2015 11";"44";"26";"18";"1";"870336934";"472"
"2706";"Iluminación en las canchas del Parque Cubillo.";"<p>Al salir a correr en invierno por el parque Cubillo, veo una escena un poco absurda. Un grupo de chavales intentan jugar a baloncesto en las canchas, pero como es de noche y las luces de las pistas están apagadas, tienen que agolparse todos en la única canasta que está cerca de una farola. Es estúpido porque en invierno anochece a las 18:00 que es prácticamente cuando los adolescentes han salido de clase. Además, todas esas canchas tienen iluminación, es solo que está apagada.</p>

<p>Mi sugerencia es bien sencilla. Que se use la iluminación de las canchas hasta una hora razonable -¿Las 23:00, tal vez?-. Así conseguimos que se puedan usar. De lo contrario, esas pistas están muertas. Por el día nadie las usa y por la tarde-noche, que es cuando podrían usarse, no se puede ver ni torta.</p>

<p>Las únicas canchas cuya luz funciona por la noche son las del campo de futbol cesped. Sin embargo el resto de canchas del parque (futbol sala, baloncesto) permanecen apagadas.</p>
";"09/09/2015 11";"15";"7";"8";"0";"864925206";"-46"
"2707";"No al Segway turístico.";"<p>Más control sobre las empresas que hacen tours guiados con segway por el centro de Madrid.</p>

<p>Muchos de los usuarios no controlan el vehiculo y ponen en riesgo la integridad de los peatones.</p>

<p>En la Plaza de Conde de Barajas he visto grupos de hasta diez personas ""practicando"" provocando situaciones de mucho riesgo en un entorno que se supone peatonal.</p>

<p>El uso que estos vehiculos hacen de las aceras debería de estar limitado.</p>
";"09/09/2015 11";"55";"41";"14";"4";"875758728";"2012"
"2708";"Identificación por radiofrecuencia (RFID) a los vehículos que pasan por zona SER";"<p>Aplicando las nuevas tecnologías (TIC) y la RFID a los vehículos, cuando acceden a una vía o calle, se podría optimizar la regulación del tránsito rodado, y el aparcamiento. Los conductores podrían disponer de información actualizada de las rutas menos congestionadas, con menos paradas (semáforos inteligentes), de las plazas de aparcamiento libres cercanas,...</p>
";"09/09/2015 11";"15";"2";"13";"0";"863575202";"-146"
"2709";"Recintos participativos";"<p>No puede ser que en Madrid, una vez sí y otra también, se vea colapsada al estar sus calles y plazas cortadas por expansiones de cual clase y tipo: protestas, deportivas, celebraciones   Va siendo hora de buscar soluciones y fijar o dotar de uno o varios lugares para realizarlo, con sus debidas instalaciones de medicina, seguridad, higiénicas, limpieza  Al tiempo, y para evitar recaiga el costo sobre únicamente el municipio de esta ciudad, podríamos ir pensando en la participación de gasto a cargo de los promotores del acto.   Como ejemplo, tenemos los creados en últimos años de los llamados Recintos Feriales, que acotan y condicionan adecuadamente las verbenas en muchos lugares.</p>
";"09/09/2015 12";"25";"7";"18";"1";"862070027";"-308"
"2710";"Prohibición de llevar perros sueltos";"<p>Lo primero, yo tengo perro y siempre lo llevo con la correa.</p>

<p>Cuando saco de paseo al perro, tengo que ir esquivando a todo tipo de perros sueltos (unos más tranquilos y otros más nerviosos), algún otro propietario de perro me ha comentado que a su perro le ha atacado un perro suelto.</p>

<p>Hay gente a la que les da miedo los perros, y que pasa esa gente no va a salir a la calle en ""las horas permitidas de perros sueltos"", o familias que pasean sus hijos (a más de uno he visto gritar y llorar y abrazarse a la pierna de su padre).</p>

<p>Los perros son impredicibles, por muy ""bueno que sea"" no sabemos como puede reaccionar. Por eso a mi perro que el más tranquilo del mundo nunca le llevo suelto. Lo primero es el respeto a los demás.</p>
";"09/09/2015 12";"103";"69";"34";"10";"875636595";"2344"
"2711";"Implantación de listas abiertas, al menos para el ayuntamiento.";"<p>Una verdadera democracia se basa en que los ciudadanos son los encargados de elegir a nuestros gobernantes, pero como pasa en las nacionales, municipales, autonómicas...son los partidos políticos los que deciden quienes encabezan sus listas, ya sea por medio de dedazo o por medio de unas primarias en las que sólo votan los que pertenecen a dicho partido....o en el mejor de los casos en unas primarias abiertas pero con un nivel de mediatización extremo (porque al final SIEMPRE salen elegidos los que salen más por la televisión). Los ciudadanos deberían ser capaces de elegir a sus propios representantes entre TODOS los posibles...y si alguien no quiere al número 1 de determinado partido, pero considera que el resto pueden ser buenos gestores, se le diera pié a ello....y de paso empezar a ser ejemplo para sustituir el actual modo de gobierno general.</p>
";"09/09/2015 12";"39";"30";"9";"3";"875397706";"1615"
"2712";"Zona azul para residentes";"<p>No entiendo por qué a los residentes solo se nos permite aparcar en zona verde. Si eres del barrio lo eres de toda la zona y sin embargo en la zona azul no se te permite aparcar. Creo que esta bien dividirlo en dos para que a los que no son residentes les salga mas barato aparcar en una zona u otra pero no que se haga lo mismo con los que vivimos en el barrio.</p>

<p>Me gustaría que los residentes también pudieran aparcar en la zona azul y no guardarnos 5 sitios para 20 vecinos.</p>
";"09/09/2015 12";"36";"18";"18";"2";"865104230";"0"
"2713";"El ayuntamiento de Madrid debería dejar de consumir combustibles fósiles";"<p>Tanto para los vehículos del ayuntamiento como de las empresas con servicios subcontratados (limpiezas, mantenimiento urbano...) y otros ""elementos"" menores, como motores para limpiezas de hojas caídas deberían ser eléctricos, o hasta solares (lo cierto es que ignoro si esto es posible). Serían (mucho) menos ruidosos y muchísimo más ecológicos y económicos.</p>

<p>La inversión inicial se amortizaría en el tiempo, y todos ganaríamos algo en salud (y en el ejemplo que daría el ayuntamiento) y, sobre todo, ruidos.</p>
";"09/09/2015 12";"36";"25";"11";"2";"873191154";"972"
"2714";"Planes para Madrid";"<p><strong>Reformas </strong></p>

<p><strong>1. INUNDACIONES Y PROBLEMAS DE CIUDAD: </strong></p>

<p><strong>- Desbordamiento de ríos: ""Poner protección en los ríos para evitar desbordamientos (sobre todo vallas)</strong></p>

<p><strong>- Cortes de luz: ""Proteger los cacharros eléctricos con llaves, telas duras y sobre todo </strong></p>

<p><strong>- Seguridad para anti-inundaciones</strong>: <strong>Policías, guardias civiles, equipo especializado en inundaciones en los ríos y lugares más propensos a desbordamientos en día de inundaciones.</strong></p>

<p><strong>2. SANIDAD, EDUCACIÓN Y ALIMENTACIÓN: </strong></p>

<p><strong>- Sanidad: ""Construir centros sanitarios gratuitos para que la gente con menos recursos pueda acudir""</strong></p>

<p><strong>- Crear establecimientos de medicamentos gratuitos para familias con problemas económicos que no puedan comprar medicamentos</strong></p>

<p><strong>- Construir hospitales gratuitos para que la gente con menos recursos pueda hacerse operaciones sin gastarse dinero.</strong></p>

<p><strong>- Educación: Poner los libros gratis, así la familias no tendrán que gastarse mucho dinero</strong></p>

<p><strong>- Tienda de ropa muy barata si es necesario para las familias con pocos recursos.</strong></p>

<p><strong>- Centros de comida y alimentación para evitar que alguien esté en desnutrición.</strong></p>

<p><strong>3. TRABAJO, SEGURIDAD Y VIVIENDA: </strong></p>

<p><strong>- Empleo: ""Crear planes de empleo, campañas de empleo cada semana"" y ""destinar dinero para empleo""</strong></p>

<p><strong>- Desahucios: ""Los policías no podrán desahuciar a alguien"" ""Las familias que no tengan dinero para pagar la vivienda no podrán ser desahuciadas, dada la situación de extrema pobreza""</strong></p>

<p><strong>- Centros grandes de inmigrantes: ""Hacer centros para inmigrantes, para que ellos estén sanos y salvos""</strong></p>

<p><strong>4. MEDIOAMBIENTE Y PROTECCIÓN: </strong></p>

<p><strong>- Medioambiente: Proteger todos los parques que tengan:</strong></p>

<p><strong>* Animales</strong></p>

<p><strong>* Plantas, hierbas</strong></p>

<p><strong>* Conservaciones</strong></p>

<p><strong>* Pescados.</strong></p>

<p><strong>- Anti-contaminación:</strong></p>

<p><strong>* Crear centros especializados en anti-contaminación para hablar sobre ella y cómo solucionarla</strong></p>

<p><strong>* Instalar placas solares en mayoría de las energéticas y mayoría de los centros, para que se produzca luz renovable.</strong></p>

<p><strong>* Instalar parques eólicos grandes para que la contaminación disminuya</strong></p>

<p><strong>* Crear carriles para bicicletas...</strong></p>

<p><strong>5. LIMPIEZA:</strong></p>

<p><strong>* Los barrenderos tendrán que limpiar cada día la ciudad para que la ciudad siempre esté limpia</strong></p>

<p><strong>* Contratar el número mayor de barrenderos para que la ciudad esté aún mejor</strong></p>

<p><strong>* Crear sanciones a las personas que tiren cosas grandes a la basura</strong></p>

<p><strong>* No se permite tirar comida que no esté mala o caducada, ya que sería un ""gasto de comida"". Si no la quiere, lo mejor que puede hacer es donarla a centros como UNICEF, centros de alimentación...</strong></p>

<p><strong>* Las personas no podrán mear en las calles, ya que afectaría a la limpieza de la ciudad. Para evitar eso, se necesita crear servicios de urgencias en las calles para que las personas que están en viajes largos puedan hacer sus necesidades en esos servicios.</strong></p>

<p><strong>6. CRECIMIENTO EMPRESARIO:</strong></p>

<p><strong>* Se pueden crear más empresas para que el crecimiento sea sostenible</strong></p>

<p><strong>* Hacer nuevos planes de empredimiento y planes de empleo empresarial para que las empresas crezcan.</strong></p>

<p><strong>7. TELEVISIÓN, MEDIOS DE COMUNICACIÓN:</strong></p>

<p><strong>* Poner nuevos canales para que la comunicación esté disponible</strong></p>

<p><strong>* Instalar nuevas emisoras para informarse más fácilmente</strong></p>

<p><strong>8. DEPORTES:</strong></p>

<p><strong>* Se pueden crear nuevas pistas de deporte para que las personas puedan hacer deporte</strong></p>

<p><strong>* Se puede crear un carril-correr para que las personas que quieran hacer deporte corriendo, puedan correr sin coches ni vehículos.</strong></p>

<p><strong>9. MEDIOS DE TRANSPORTE:</strong></p>

<p><strong>* Se pueden crear transportes baratos para gente que no tenga recursos.</strong></p>

<p><strong>10. CULTURA, ARTE:</strong></p>

<p><strong>* Se pueden crear nuevos museos para que la gente pueda ver la arte española.</strong></p>

<p><strong>11. AYUNTAMIENTO:</strong></p>

<p><strong>* La gente puede ver las cuentas del ayuntamiento.</strong></p>

<p><strong>* Se puede crear un plan de transparencia para que la gente pueda ver lo que hace el ayuntamiento</strong></p>

<p> </p>

<p> </p>

<p> </p>
";"09/09/2015 12";"28";"8";"20";"1";"862041037";"-342"
"2715";"Mas idiomas en las escuelas";"<p>Dado que en España tenemos una riqueza linguistica con un total de siete diomas, uno de ellos, el Castellano, oficial en todo el estado, cuatro de ellos oficiales en diferentes comunidades (Gallego, Euskera, Catalan y Aranes) y dos de ellos no oficiales (Aragones y Asturleones), porque limitar la enseñanza a un idioma, mas idiomas extrangeros, y dejar relegados el resto?</p>

<p>Entendiendo que un conocimiento de estas lenguas puede crear un acercamiento entre las partes, en lugar de el distanciamiento que esta viviendo la sociedad actual, creo que seria positvo dar la opcion de aprender estas lenguas en las escuelas, aunque fuesen como activididades extraescolares dado el apretado horario lectivo actual, y entender asi mejor la plurailidad de las gentes y culturas de el Estado Español. </p>

<p>Gracias por permitir esta plataforma de debate y poder hablar de estos temas. </p>
";"09/09/2015 12";"31";"17";"14";"11";"869300597";"164"
"2716";"Monumento al Monstruo Espaguetti Volador";"<p>En Madrid hay, como mínimo, 300 monumentos religiosos y lugares de veneración y culto a la religión cristiana (según TripAdvisor), así como otros tantos de otras religiones, incluída la Cienciología.</p>

<p>Dentro de este alegre espíritu de convivencia y libertad religiosa, me gustaría solicitar la construcción y colocación de un monumento-escultura con la figura del Monstruo Espaguetti Volador (también conocido como Monesvol o FSM), divinidad e icono del Pastafarismo. El pastafarismo es una religión cuyo libro religioso, el Evangelio del Monstruo del Espagueti Volador, fue descubierto en 2006 y desde ese momento ha iluminado a muchas personas en todo el mundo sobre la auténtica naturaleza del mundo que nos rodea.</p>

<p>La Iglesia Pastafari se encuentra en proceso de legalización en España (https://iglesiapastafari.wordpress.com/2015/06/10/estado-del-proceso-de-reconocimiento-de-nuestra-sabrosa-iglesia-junio-de-2015/) y ya tiene muchos fieles en el territorio.</p>

<p>Por todo esto, remarco mi petición de construcción y colocación de un monumento en un lugar céntrico de la ciudad, para asegurar la igual representación de todas las religiones.</p>

<p>Ramén hermanos.</p>
";"09/09/2015 12";"70";"26";"44";"3";"860514003";"-668"
"2717";"Mejora de las vías publicas";"<p>Hay muchos barrios, como El Carmen, donde han asfaltado de nuevo la parte de la Calle Alcalá, pero... Que pasa con los barrios adyacentes? Las vías están destrozadas y sucias, basura en las aceras y agujeros en las calzadas. Las motos y bicis corren un grave peligro circulando por el barrio con riesgo a caerse. El barrio huele a orina de perro, hay excrementos de perros por las esquinas, bolsas de basura rotas, papeles por las aceras de publicidad...</p>

<p>Los impuesto son los mismos para todos los madrileños pero sin embargo no se tratan ni se cuidan todos los barrios por igual. </p>

<p>Pongo el ejemplo del Carmen, pero estoy segura que como este hay otros muchos barrios.</p>
";"09/09/2015 12";"26";"23";"3";"2";"876808595";"1769"
"2718";"Multar / obtener recursos de obras ilegales de cerramientos de áticos";"<p>Todos somos conscientes de multitud de obras ilegales en áticos, bajos, etc. (me estoy refiriendo principalmente a los cerramientos definitivos y no movibles que cualquiera puede ver). Quizás por la prescripción de los plazos no se puedan demoler. Pero se podría cobrar o multar o incrementar el IBI por dichos espacios ampliados ilegalmente. Cómo es posible que yo pueda ver por mi calle o desde mi casa multitud de estas obras ilegales, y nadie del ayuntamiento haya tomado cartas en el asunto jamás?</p>

<p>Desde luego, actuar contra estas ilegalidades supondría una facilísima forma de incrementar los recursos económicos. E insisto hay tantas de ellas que se ven a simple vista desde la calle que no puede ser difícil tomar medidas.</p>

<p>Gracias!</p>
";"09/09/2015 12";"25";"13";"12";"0";"865238132";"52"
"2719";"Reposición inmediata de los árboles en calles y bulevares de Madrid";"<p>Si recordais, recientemente los medios de comunicación han publicado la noticia de que  ""la humanidad ya ha destruido la mitad de todos los árboles del planeta"".</p>

<p>Lamentablemente, la desidia de los gobiernos municipales anteriores ha provocado no se haya ido reponiendo el arbolado que por distintas causas ha ido desapareciendo de muchas de nuestras calles y bulevares.</p>

<p>Por ello, sería necesario que el nuevo gobierno municipal acometiera un plan de reposición de árboles en la ciudad de Madrid.</p>

<p> </p>
";"09/09/2015 12";"32";"28";"4";"0";"877327614";"2100"
"2720";"Transporte público - Viaje en familia - Gratuito para niños.";"<p>El transporte público de Madrid se olvida de las familias con niños.. Un desplazamiento de unas pocas paradas de metro no sale rentable si se trasladan los progenitores y los niños; actualmente se traduce en coger el coche y llevarlo a un parking o zona SER. Contaminando inutilmente y ocupando una plaza de aparcamiento.</p>

<p>Para evitar coger el coche, contaminar y ocupar plazas de aparcamiento,<em> </em><strong><em>sugiero transporte público gratuito para los niños (acompañados siempre de un mayor)</em>. </strong>Los seis años es un límite ridiculo. </p>

<p>Las políticas de natalidad y en apoyo a la familia brillan por ausencia en este país.</p>

<p>Ejemplos de acciones:</p>

<p>Valencia. 
http://www.elmundo.es/elmundo/2013/07/01/valencia/1372664796.html
http://www.metrovalencia.es/wordpress/?page_id=332</p>

<p>Londres </p>

<p>https://tfl.gov.uk/fares-and-payments/fares?intcmp=1648
http://visitorshop.tfl.gov.uk/help/travelling-with-children/</p>

<p>Berlin (con discount fare)</p>

<p>http://www.visitberlin.de/en/article/berlin-s-local-transport </p>

<p> </p>
";"09/09/2015 12";"49";"35";"14";"2";"874784946";"1500"
"2721";"Limpieza y mantenimien en el Parque del Casino de la Reina y calles conlindantes";"<p>Desde hace cierto tiempo, diferentes vecinos de Lavapies y aledaños nos hemos percatado del estado de <strong>abandono y suciedad</strong> de las calles menos transitadas del Barrio de Lavapies y, en especial, del<strong> parque del Casino de la Reina.</strong> Especialmente, denunciamos la abundancia de jeringuillas, basura, mobiliario urbano deteriorado e incluso bicicletas de BiciMad abandonadas o en mal estado (algunos de nosotros hemos vuelto a poner las bicicletas en sus estaciones de carga o notificado la incidencia para evitar el robo o vandalismo), que se dejan tiradas como si fuese un vertedero.</p>

<p>Muchos de los vecinos y usuarios nos hemos visto en la necesidad y en la costumbre de tener que recoger diferentes residuos: envases, colillas, jeringuillas, etc. Lo cual supone un peligro para nosotros mismos, los niños y los animales que se desplazan por la zona.</p>

<p>Desde la empresa municipal y los servicios municipales se nos comunica que,supuestamente, todos los días un operario se desplaza al parque y a los aledaños para retirar la suciedad y mantenerlo limpio, pero a las pruebas nos remitimos,<strong> no es así. Sólo se hace limpieza los sábados,</strong> cuando una operaria <strong>de otra empresa privada de limpieza</strong> (no la que tiene la licitación de los días de diario y que según las autoridades municipales se personan allí para retirar la suciedad) intenta mantener el mayor cuidado posible al retirar la suciedad. Lo hace, en la medida de lo posible pero una sola persona a la semana no puede retirar la suciedad de 6 días anteriores con lo cual, demandamos</p>

<p><strong>- </strong>que se cumpla la ordenanza de mantenimiento y limpieza, es bueno reconocer la dejadez del barrio y la falta de interés por adecentar la zona</p>

<p><strong>-</strong> que no se diga que somos los vecinos y usuarios del parque los que ensuciamos, ya que utilizamos las papeleras pero, cuando están llenas, obviamente no hay dónde retirar la suciedad.</p>

<p><strong>-</strong> que se considere zona de verde de verdad: mejora de las tomas de regadío (hay zonas embarradas y zonas resecas), adecentar el césped, sequedad en los árboles y arbustos, etc. </p>

<p><strong>-</strong> el mismo trato como sucede en otros barrios cercanos como en las zonas verdes del Paseo del Olmo o en la cercana Calle Argumosa.</p>
";"09/09/2015 12";"33";"28";"5";"0";"876819077";"1951"
"2722";"Actuación inmediata y contundente contra las terrazas ilegales";"<p>Duplican o triplican las legales, invaden el espacio público robándonos las aceras y el dinero que no pagan. En el centro de la ciudad es un problema más que grave, y cuesta entender que no se pueda hacer nada al respecto. A incumplimiento reiterado, retirada de la licencia de actvidad. Más inspecciones, y acabar con los chivatazos. </p>
";"09/09/2015 12";"71";"64";"7";"1";"881119561";"5138"
"2723";"Protección de especies cinégeticas en los parques forestales de Madrid";"<p>Los parques forestales de Madrid han sido reconquistados por especies cinegéticas tales como Perdiz Roja, Conejo común y liebre Ibérica.</p>

<p>Por ejemplo en el PAU de Vallecas, Los Berrocales, Ahijones, Valdebebas, terrenos del PAU de Valdecarros y  parque de Entrevias se pueden observar estas especies sin problema.</p>

<p>Son joyas de la fauna ibérica, que en el caso de Madrid, mantienen poblaciones de predadores, ejemplo halcón peregrino, aguila perdicera, zorros,...,etc.</p>

<p>En Madrid no esta regulada la caza de dichas especies pero sus poblaciones se ven sometidas a la presión de la caza furtiva ilegal, los paseantes y perreros incivicos.</p>

<p>Se ven ""galgeros"" ilegales en plena acción de caza por estos lugares tanto en época de veda como en época de caza.</p>

<p>Se ven paseantes que azuzan a sus perrros contra conejos o perdices con sus polladas.</p>

<p>Se ven perreros que pasean en época de cria sus canes sin bozal ni correo entre los lugares de nidificación y cria de la perdiz</p>

<p>Ante esta situación se debería regular para garantizar su cria y evitar dichos desmanes de desaprensivos</p>

<p> </p>

<p>Si los cazadores cumplen las lezes de caza TODOS los ciudadanos también.</p>
";"09/09/2015 12";"109";"101";"8";"0";"883514465";"8617"
"2724";"abrir las bocas del metro que cierran a las 21:40";"<p>Hay muchas estaciones con más de un vestíbulo que cierra a las 21:40.</p>

<p>Creo que hoy en día, en el que la mayoría de los vestíbulos carecen ya de personal, ya no supone un ahorro muy grande que dichos vestíbulos permanezcan cerrados y por el contrario si los abrieran darían un mejor servicios a todos los usuarios, especialmente en algunas estaciones donde puede haber más de 500 metros de un vestíbulo a otro.</p>
";"09/09/2015 12";"41";"33";"8";"3";"876682897";"2012"
"2725";"El Sur existe";"<p>Querida Alcaldesa,</p>

<p>Usted sabe que los barrios del Sur de Madrid no son tratados en igualdad de condiciones al de la mayoria de los barrios de Madrid. Han pasado gobiernos de derecha y de izquierda y la situación no mejora excesivamente. Se conceden actuaciones de poco calado que sirven para maquillar la situación y conseguir un puñado de votos antes de las elecciones. Pero NUNCA un alcalde se ha puesto en serio a trabajar por revertir esta situación. Villaverde era un barrio industrial hace 50 años. Hoy no. No se estimula la instalación de empresas en nuestro distrito, y así es normal que sigamos siendo considerados como un barrio ""marginal"" en multitud de ocasiones. Estamos olvidados en cuanto a grandes infraestructuras, las calles están sucias por naturaleza, la fractura que provocó la M40 hace 30 años sigue sin querer curarse, los mayoría de los parques están medio abandonados, la mejora de la movilidad no existe (bicimad? aparcamientos disuasorios en Cercanía o Metro?), una biblioteca pública para 150.000 personas, ya no existen farmacias de guardia salvo una de 24 horas, etc. etc.</p>

<p>Por favor, si realmente quiere hacer una ""política diferente"" como ha proclamado en su campaña electoral, actúe con energía y decisión para cambiar las cosas en Villaverde y Usera. Devuélvanos la ilusión por vivir en nuestro barrio. Veámosla más trabajando en Villaverde, orgullosa también de este barrio de Madrid.</p>

<p>Todos los habitantes de Villaverde, tanto los que le han votado (una gran mayoría) como los que no lo hemos hecho, se lo agradeceremos. NO es cuestión de hacer política con este debate, sino justicia.</p>

<p>Muchas gracias.</p>
";"09/09/2015 12";"113";"100";"13";"18";"882709461";"7699"
"2726";"Liberar a los taxistas del pago de licencias e impuestos municipales. ";"<p>Los taxistas están ahogados en impuestos (que se suman a los pagos como autónomos). Esto repercute en altos precios, largas jornadas y baja competitividad. Propongo liberarles de pagos municipales, pues prestan un servicio público que genera riqueza e incentiva el turismo (lo que claramente interesa a la ciudad). Este descanso permitiría bajar precios (también sería ideal liberalizarlos) y la entrada en igualdad de condiciones de empresas privadas dedicadas a la misma labor (blablacar, grabcar, etc), con lo que la competencia haría bajar los precios y todos ganaríamos. </p>

<p>Gracias.</p>
";"09/09/2015 12";"68";"2";"66";"3";"864637784";"-188"
"2727";"Liberar a los taxistas del pago de licencias e impuestos municipales. ";"<p>Los taxistas están ahogados en impuestos (que se suman a los pagos como autónomos). Esto repercute en altos precios, largas jornadas y baja competitividad. Propongo liberarles de pagos municipales, pues prestan un servicio público que genera riqueza e incentiva el turismo (lo que claramente interesa a la ciudad). Este descanso permitiría bajar precios (también sería ideal liberalizarlos) y la entrada en igualdad de condiciones de empresas privadas dedicadas a la misma labor (blablacar, grabcar, etc), con lo que la competencia haría bajar los precios y todos ganaríamos. </p>

<p>Gracias.</p>
";"09/09/2015 12";"77";"5";"72";"3";"864015699";"-435"
"2728";"acabar con los limpiacristales de los semaforos";"<p>Ensucian el cristal más de lo que lo tienes. Y encima te arriesgas a que te roben.</p>
";"09/09/2015 12";"27";"21";"6";"2";"874608804";"1166"
"2730";"Zona Peatonal Pueblo de Vallecas.";"<p>Es una lástima que la zona peatonal de Puerto de Porzuna - Calle Revoltosa - Peña Cavero, con placas de prohibido circular, excepto vados y autorizados, esté abierta al tráfico y se permita el aparcamiento sin ningún tipo de penalización en los laterales de los edificios. He pedido a la junta municipal que se coloquen bolardos durante más de 5 años y nada, todo sigue igual. Me gustaría adjuntar las fotos que tengo de coches aparcados impidiendo abrir las puertas de las estaciones de gas y luz de las viviendas. Creo que merecemos que nos pongan bolardos en toda la calle y no sólo en la entrada a los portales. Muchas gracias.</p>
";"09/09/2015 12";"27";"13";"14";"3";"865357746";"-48"
"2731";"Carril Bici y peatonalizar carriles del Paseo de las Delicias";"<p>El Paseo de las Delicias es la calle más contaminada del Municipio de Madrid. Para hacer un madrid más amigable estaría genial peatonalizar 3 de los 6 carriles y hacer un carril bici que una desde la Glorieta de Legazpi hasta la de Atocha.</p>

<p> </p>
";"09/09/2015 12";"67";"49";"18";"2";"876332004";"2267"
"2732";"Asfixia del taxi, olvidados por su Ayuntamiento...";"<p>No se quien llegara a leer esto, pero me gustaría saber cual es el motivo por el cual desde el Ayuntamiento de Madrid no solo no se protege a los taxis de la Comunidad, sino que se les va asfixiando y reduciendo el nicho de mercado cada vez mas.</p>

<p>Entiendo que el metro, el bus, el tren cada vez lleguen a mas sitios y en menos tiempo, tenemos bicis en una ciudad que desde mi punto de vista no esta preparada para ellas, ahora también quieren meter coches eléctricos... Permiten que hoteles y particulares tengan sus propios vehículos para el trasporte de pasajeros sin verificar en ningún momento si cumplen al 100% la legalidad, y de las VTC ya ni voy a comentar...por que roza la vergüenza...</p>

<p>Yo no quiero dar pena a nadie, pero detrás de cada volante hay un taxista, y detrás una familia... ¡¡Como todo el mundo vamos!!</p>

<p>Nos hemos reinventado, hemos dejado se subir los precios, hemos asumido las dos subidas de IVA, eliminado suplementos, recortado las horas de trabajo con sus 15 días de vacaciones obligados...y mas cosas que me dejo seguro.</p>

<p>¿Que esta haciendo el Ayuntamiento por los taxis de la comunidad?? Van a permitir que nos sigan asfixiando hasta que desaparezcamos?? ¿¿Nos van a obligar a competir con empresas que solo han venido a imitar nuestro modelo de negocio sin mejorarlo en absoluto?? ¿¿ Y luego que?? No se, tengo tantas preguntas, y como he comentado al principio no se quien llegara a leer esto, ni si le importara...</p>

<p>Somos imagen de la Comunidad de Madrid, un garante de servicio y calidad, y tenemos que andar suplicando y mendigando derechos...sencillamente no lo entiendo.</p>
";"09/09/2015 12";"95";"21";"74";"14";"861229144";"-1171"
"2733";"Vodafone Sol";"<p>En mi opinión y creo que de todos mis conciudadanos chulapos, creemos que ha sido un gran cambio para la ciudad la llegada de los anuncios a la Red de metro y por eso propongo que rellamemos alguna estación más según los colores de las compañías; Telefónica Bernabeu, Orange Pitis o La Latina amena serían unas de mis proposiciones pero me gustaría saber la opinión del mis vecinos. </p>

<p>Si convencemos a las compañías de plasmar sus anuncios en el metro quizá podamos volver a tener el bonobús a 10 euros como antaño cuando teníamos trabajo.</p>
";"09/09/2015 12";"42";"13";"29";"4";"861569469";"-495"
"2734";"Vodafone Sol";"<p>En mi opinión y creo que de todos mis conciudadanos chulapos, creemos que ha sido un gran cambio para la ciudad la llegada de los anuncios a la Red de metro y por eso propongo que rellamemos alguna estación más según los colores de las compañías; Telefónica Bernabeu, Orange Pitis o La Latina amena serían unas de mis proposiciones pero me gustaría saber la opinión del mis vecinos. </p>

<p>Si convencemos a las compañías de plasmar sus anuncios en el metro quizá podamos volver a tener el bonobús a 10 euros como antaño cuando teníamos trabajo.</p>
";"09/09/2015 12";"50";"19";"31";"1";"861288881";"-456"
"2735";"Monumento a Hugo Chávez";"<p>Me gustaría poseer la elocuencia necesaria para glosar adecuadamente las virtudes de este incomparable estadista de la revolución bolivariana que consiguió arrumbar a los nefastos representantes de la casta, mandando a la cárcel a los supervivientes, igual que pronto lo harán aquí sus homólogos contrarios a la llamada ""democracia occidental"" que sólo conduce a la corrupción más degenerada.</p>

<p>¡Viva Chávez! ¡Viva Maduro! ¡Viva Evo! etc.etc.</p>

<p>El monumento se financiaría con un impuesto a los ricos.</p>
";"09/09/2015 12";"129";"22";"107";"9";"861896495";"-1449"
"2736";"Rebaño municipal para el aprovechamineto de pastos y lucha contra incendios";"<p>Todas las primaveras los diferentes parques forestales de Madrid producen una ingente cantidad de pasto que al comenzar Junio se seca. No hay mas que ver la casa de Campo</p>

<p>En el mejor de los casos los operarios municipales, cortan dicho pasto para evitar posteriores incendios.</p>

<p>Ese pasto es un recurso aprovechable por ganado ovino o caprino, utilizando alguna de las razas autoctonas, mas emplematicas de Madrid como la oveja Rubia del Molar o la cabra del Guadarrama.</p>

<p>La idea es que exista un rebaño en un lugar fijo pero que con ayuda de un par de camiones traslade parte de los animales a pastar a dichos lugares. En el lugar de pastoreo, se instalarian vallas moviles o pastores electricos durante los dias o semanas que se produzca el aprovechamiento. Así se iria rotando por los distintos parque forestales</p>

<p>Ventajas:</p>

<p>- Lucha ecologíca contra incendios</p>

<p>- Abonado orgánico de los parques</p>

<p>- Creación de puestos de trabajo</p>

<p>- Producción de carne y queso que se podria vender o subastar</p>

<p>- Promoción de especies autóctonas y la biodiversidad</p>

<p> </p>
";"09/09/2015 12";"60";"44";"16";"4";"876152855";"2053"
"2737";"Opción para unir o vincular propuestas iguales o similares.";"<p>Me parece que para mejorar la valoración de debates, sería genial poder vincular o unir propuestas que sean iguales o se asemejen.
De no ser así, se dividen los votos, y puede que una propuesta genial y con muchos votos a favor, pase desapercibida.</p>

<p> </p>
";"09/09/2015 12";"61";"58";"3";"1";"881966252";"5229"
"2738";"""CableMad"" - empleo urbano de telefericos integrados a red de transporte público";"<p>Esta propuesta no es ni de lejos una prioridad, pero quizas uan posibilidad a medio-largo plazo que igual merece la pena estudiar. la idea consiste en introducir en algunas zonas de la ciudad líneas de teleférico para la conexión entre puntos para los cuales ni el bus ni el metro es una alternativa del todo satisfactoria por topografía, trazado u obstáculos que haya que sortear.</p>

<p>Hoy en día sólo contamos con un teleférico que conecta un área céntrica de la ciudad (Pintor Rosales) con la Casa de Campo. Se trata fundamentalmente de una atracción turística, pero no deja de ser quizás el mejor medio para pasar en 15 de una realidad a otra totalmente distinta. La posibilidad de cargar las bicicletas en las cabinas además ha ampliado las potencialidades de este teleférico.  </p>

<p>Quizás en futuro se podría negociar con esta concesión privada para que integrase la red de transporte público de Madrid (y así viajar en el teleférico con el bono mensual), y probablemente existen otras zonas de la primera periferia que podrían mejor conectarse al centro de la misma manera. Por ejemplo, en una línea que uniera Parque de Pradolongo -  Hospital 12 Octubre  Caja Mágica  Entrevías  Tierno Galván  Méndez Avaro).</p>

<p>El uso de teleféricos para objetivos de transporte público ya tiene algunos precedentes de éxito en ciudades de América Latina, principalmente en Medellín (Colombia), donde funciona el Metrocable. Es un medio más silencioso, probablemente de menores impactos, y además panorámico y poético. Podría servir también para aumentar las opciones turísticas de la ciudad, convirtiéndose en un nuevo icono.  </p>
";"09/09/2015 12";"43";"14";"29";"2";"861545115";"-488"
"2739";"Regularizar la prostitución. ";"<p>Siendo considerado el oficio más antiguo del mundo, resulta sorprendente que aún siga siendo el más tabú y subrepcticio que existe. </p>

<p>Todos los que vivimos en la zona centro o que pasamos por la casa de campo vemos a diario y a todas horas infidad de personas ejerciendo la prostitución, y a otros tantos, solicitando sus servicios. </p>

<p>Creo que es vivimos en una sociedad lo suficientemente moderna como para que dicha actividad se realice de una forma regularizada con respecto a los convenios laborales vigentes, y que se garantice de esta forma la seguridad, salud y bienestar de estas personas. </p>

<p>El ocultar esta práctica no hace más que fomentar las aparición de mafias y la imposibilidad para denuncair irregularidades. Cuanto más transparente sea, más sencillo será acabar con estos problemas. </p>

<p>Ahí queda mi proposición para debatir. </p>

<p>Un saludo. </p>
";"09/09/2015 13";"92";"71";"21";"12";"878796487";"3858"
"2741";"Reducción de la administración a un mínimo indispensable";"<p>Propongo una reducción de las AAPP presentes en Madrid a un mínimo indispensable, esto supondría mayor <strong>libertad y autonomía del ciudadano</strong>, así como un abaratamiento desde el punto de vista impositivo. Madrid debería ser pionera en el anarcocapitalismo.</p>
";"09/09/2015 13";"39";"25";"14";"0";"872169528";"705"
"2742";"Adelantar a ciclistas a una velocidad similar, si no hay carril lateral ";"<p>La relación entre vehículos de cuatro ruedas y bicicletas debe mejorarse notablemente, para evitar situaciones incómodas o peligrosas para los ciclistas. Los vehículos de cuatro ruedas deberían adelantar a los ciclistas, cambiando de carril, igual que hacen con otros vehículos lentos. Y si no hay carril lateral para realizar la maniobra de adelantamiento, los vehículos de cuatro ruedas deberían frenar, y adelantarles a una velocidad similar (5 km/h mayor como mucho, algo habitual en las competiciones deportivas).</p>
";"09/09/2015 13";"34";"14";"20";"1";"862335340";"-247"
"2743";"¿Vehículos más controlados?";"<p>La verdad es que no creo que esto entre en las atribuciones del ayuntamiento, pero creo que alguien debería empezar a mirar y quizás, promover esto:</p>

<p>No entiendo cómo los camiones llevan taquígrafo digital y todo lo que hacen queda controlado (exceso de velocidad, descansos...) y sin embargo, los vehículos particulares (además de, por supuesto, buses y taxis), no. Voy por la M40 y me adelantan a bastante más de ciento y muchos tanto coches como buses y a veces me sorprende que también camiones, que deberían llevar limitador...</p>

<p>Y pregunto: ¿no se puede implantar una forma similar en los vehículos particulares? Ahora, tal y como está, solo te multan si te cazan. Si no, eres libre de adelantar y correr todo lo que quieras. De esa forma, como con el taquígrafo digital, se te pide la tarjeta, se revisa y se te puede multar si te has pasado.</p>
";"09/09/2015 13";"21";"9";"12";"1";"863569104";"-128"
"2746";"Impuesto por la tenencia de perros y/o gatos";"<p>En algunos paises y ciudades europeas se pagan impuestos por la tenecia de perros.</p>

<p>El impuesto varía en función del tamaño y raza del perro, a mayor tamaño mayor impuesto, según el uso (compañia, seguridad, trabajo,..),y con reducciones por situación socio-económica, (personas mayores, baja renta)</p>

<p>Se evitaría asi que se tengan perros como quien colecciona cromos, que se tengan perros que necesitan espacio y libertad, (galgos, dogos,...) en mini pisos y se fomentaria la responsabilidad de los dueños.</p>
";"09/09/2015 13";"120";"58";"62";"14";"865134967";"-193"
"2747";"no limitar el uso del coche";"<p>Una de las partes importantes de Madrid como ciudad es su movilidad y esta consiste no sólo en el transporte público, sino en la facilidad de moverse en coche por la ciudad. No quitemos mas plazas de aparcamiento, ni limitemos el tráfico en las grandes vías. Facilitemos el uso de las grandes vias y demos alternativas a todo el mundo, Madrid es de los madrileños, incluidos los que usan el coche</p>
";"09/09/2015 13";"83";"23";"60";"3";"861130238";"-1025"
"2748";"Programa de voluntariado azoteas frescas para reducir consumo energético";"Me gustaría que se implantara en Madrid el programa de voluntariado Cool Roofs o Azoteas Frescas de la ciudad de Nueva York.

Este programa que ayuda a mitigar el cambio climático consiste en que a través del voluntariado se pinten las azoteas de color blanco de alta reflectancia para reducir el consumo energético en climatización entre un 10 y un 20%. La pintura sería proporcionada por el ayuntamiento.

Algo sencillo, eficaz y barato. ¿Y por qué el color blanco? Muy sencillo poniendo un ejemplo. ¿En verano una persona está más fresca con ropa negra o con ropa blanca? Pues esto es lo mismo solo que aplicado a la arquitectura de un edificio.

Se puede ahorrar según estudios 10 toneladas de co2 por cada 100 m2 de superficie pintada de blanco al año. Además de ser mucho mayor el ahorro en climatización en verano que la pérdida al ser blanco en invierno (en invierno hay menos horas de sol y el sol está más bajo, con lo que el incremento en la factura de la calefacción sería muy poco, en cambio el ahorro en verano es significativo). Otra gran ventaja es que reduce el efecto isla de calor urbano y refleja la luz ayudando un poco a mantener la zona más fresca pudiendo bajar la temperatura hasta 3°C de la ciudad en verano si todas las azoteas se pintaran.

El secretario de Energía de EEUU, premio novel de física, defiende y fomenta esta medida que es clave para luchar contra el cambio climático, ya que el blanco además de reducir la temperatura interior del edificio y reducir la temperatura en la zona, también refleja los rayos del sol al espacio ayudando a mantener un poco más fresco el planeta. Este programa, al igual que el de NY, sería voluntario y gratuito para los edificios que se quisieran beneficiar. También estoy a favor de las azoteas vegetales pero esto es más caro.

Según un estudio de 2011, si 100 grandes ciudades del mundo tuvieran sus azoteas pintadas de blanco, sería igual que compensar las emisiones de todos los coches del mundo durante 11 años.";"09/09/2015 13";"40";"33";"7";"4";"877375021";"2145"
"2750";"Jazztel SOL";"<p>Ahora mismo creo que Vodafone está sobreexplotado y hay que cambiar de patrocinador. El color naranjita de Jazztel y su gran servicio técnico por fin alojado en España será una buena manera de ganar dinero. Además, leí en un artículo que Jazztel instalaría routers Wifi N de última generación para que los madrileños pudieran disfrutar de sus servicios mientras estuvieran en el metro sin cobertura alguna.</p>

<p>Por un madrid sostenible, contectado, comunicado, global y pionero en las nuevas tecnologías. Favorezcamos el éxodo de Vodafone y vayámonos con Jazztel.</p>

<p>
De hecho, según estadísticas, el 59 % de la población de Madrid prefiere Jazztel frente a Vodafone (19,7 %). Así, como podéis ver, es una propuesta que debería al menos debatirse con tranquilidad y sosiego. Mi duda entra ahora en si poner la cara de Pablo Motos o Jesús Vázquez.</p>
";"09/09/2015 13";"67";"16";"51";"1";"861935009";"-835"
"2751";"Funcionarios estan obligados a brindar Información en Instituciones Publicas";"<p>Cuando una persona común y silvestre va a cualquier organismo municipal se encuentra con una respuesta continua:</p>

<p>vaya a una gestoría., aquí no damos información ya le citaran. , espere que le comuniquen..</p>

<p>Y uno se queda sin saber qué hacer, a donde ir y donde resolver el asunto que nos motiva ir a algún organismo municipal.</p>

<p>En ese sentido, es importante recordar algunos derechos establecidos en el Articulo 35 de la  Ley 30/1992, de 26 de noviembre, de Régimen Jurídico de las Administraciones Públicas y del Procedimiento Administrativo Común regula como un d<em>erechos de los ciudadanos</em></p>

<p>A conocer, en cualquier momento, el estado de la tramitación de los procedimientos en los que tengan la condición de interesados, y obtener copias de documentos contenidos en ellos.</p>

<p>A identificar a las autoridades y al personal al servicio de las Administraciones Públicas bajo cuya responsabilidad se tramiten los procedimientos.</p>

<p> A obtener copia sellada de los documentos que presenten, aportándola junto con los originales, así como a la devolución de éstos, salvo cuando los originales deban obrar en el procedimiento.</p>

<p> A no presentar documentos no exigidos por las normas aplicables al procedimiento de que se trate, o que ya se encuentren en poder de la Administración actuante.</p>

<p>A obtener información y orientación acerca de los requisitos jurídicos o técnicos que las disposiciones vigentes impongan a los proyectos, actuaciones o solicitudes que se propongan realizar.</p>

<p> Al acceso a la información pública, archivos y registros.</p>

<p> A ser tratados con respeto y deferencia por las autoridades y funcionarios, que habrán de facilitarles el ejercicio de sus derechos y el cumplimiento de sus obligaciones.</p>

<p>A exigir las responsabilidades de las Administraciones Públicas y del personal a su servicio, cuando así corresponda legalmente.</p>

<p>Sin embargo, pese a estar respaldado en el ordenamiento, No se cumple y no hay manera de hacerlo cumplir de manera efectiva. Por lo que, es necesario que se FORME a los funcionarios sobre los procedimientos a su cargo y la obligación que tienen hacia los ciudadanos. Obligación de brindar información y orientación sobre los procedimientos a su cargo, mejorar el trato con los ciudadanos.</p>
";"09/09/2015 13";"18";"14";"4";"0";"873430931";"777"
"2752";"Poner WC's públicos en las calles";"<p>Los que vivimos en Madrid, muy especialmente en el centro, sabemos que prácticamente todas las esquinas por la noche, especialmente los fines de semana se llenan de meadas.</p>

<p>Esto que es un asco en sí, obedece a la imperiosa necesidad de hacer pis en una ciudad que, a diferencia de la mayoría en Europa carece prácticamente de WC's públicos (amén de los escasos que hay situados en sitios de poco tránsito que en la mayoría de ocasiones ni siquiera funcionan)</p>

<p>Creo que necesitamos este servicio como así las papeleras o las bolsas para recoger la caca de los perros mas no entiendo como una ciudad como Madrid puede carecer de un servicio tan básico que beneficiaría a todo el mundo.</p>

<p>Creo que sería una buena inversión y que en principio podría no tener un coste elevado comparado con otras obras de diversa índole. </p>
";"09/09/2015 13";"69";"57";"12";"6";"879476737";"3717"
"2753";"Oposiciones";"<p>Hola, buenos dias</p>

<p>Como quizás alguno sepa, al poner nuestro nombre en google, pueden aparecer datos provenientes como nuestra dirección, teléfono o matrícula del coche. Mi propuesta es la siguiente: no me parece bien que terceras personas sepan o se enteren de tus datos personales. Entonces propongo que salga únicamente como dato personal nuestro DNI  en páginas como acceso a oposiciones, dirección general de tráfico y otras páginas que dependan del ayuntamiento.</p>

<p>Muchas gracias</p>
";"09/09/2015 13";"14";"6";"8";"0";"864393432";"-85"
"2754";"Zona Azul hasta las 19h";"<p>Propongo que la zona azul se cobre hasta las 19 horas, los sábados hasta las 14 y que se unifiquen la zona azul y la verde.</p>
";"09/09/2015 13";"52";"30";"22";"1";"870973447";"461"
"2755";"Accesibilidad para minusválidos en todas las estaciones de metro y cercanías";"<p>Aunque en esto se ha avanzado bastante en los últimos años, todavía quedan bastantes estaciones de metro y tren de cercanías sin accesos para minusválidos. Esto afecta a mucha gente puesto que no sólo los minusválidos tienen problemas para acceder a estas estaciones si no que también los ancianos, los carritos de bebé, las embarazadas o cualquier persona que eventualmente haya tenido un accidente y vaya con muletas. Por poner un caso puedo hablar de la estación de tren de Santa Eugenia en la que no hay escaleras mecánicas, ascensores o rampas para acceder a los andenes, la única opción son unas escaleras. Este es un ejemplo pero hay más, estaciones tan conocidas como Retiro, Colón, Gran Vía, La Latina, etc. o en los barrios en los metros de Puente de Vallecas, Estrella, Méndez Álvaro (Que tiene la estación de autobuses Madrid Sur), Carabanchel, Fuencarral, Canillejas y así un largo etcétera de estaciones que no pueden usar minusválidos y tienen muy difícil utilizar otros colectivos de personas que no siéndolo, también sufren esta falta de accesibilidad.</p>
";"09/09/2015 13";"85";"81";"4";"13";"883837871";"7337"
"2756";"Cerrar el tráfico los domingos en las calles del centro de Madrid ";"<p>A raíz de la reciente (y excelente por cierto) decisión del Ayuntamiento de Madrid de cerrar el tráfico de vehículos en la calzada este del paseo del Prado (un único carril) de manera permanente los domingos por la mañana, entre las 9.00 y las 14.00 horas, proponemos extender (o sustituir) esta decisión a otras zonas de Madrid, especificamente zona centro.</p>

<p>De esta forma, lxs peatones y ciclistas podrán moverse de forma más segura y menos contaminada por las arterias históricas neurálgicas de su ciudad durante unas horas, sin suponer una merma en la movilidad de muchxs cuidadnxs en coche los días de mayor afluencia.</p>
";"09/09/2015 13";"72";"42";"30";"4";"872215686";"700"
"2757";"BRECHA DIGITAL-";"<p>Ante la impotencia que sufre, determinada ciudadanía: mayores de 55 en adelante, que no han tenido acceso a formación en nuevas tecnologías TIC, se hace necesario, pues lo merecen y se cuenta con recursos suficientes para poder restablecer las salas REDINT (comunidad de Madrid), en las que se impartan conocimientos suficcientes y de forma gratuita, para eliminar de una vez por todas esa brecha digital, que genera desigualdad, impotencia, e injusticia.</p>

<p>Sería bueno que desde las propias instituciones como el Ayuntamiento de Madrid, tuvieran en cuenta la situación de esta parte de la ciudadanía, que por desgracia suele ser la más humilde de la ciudad.</p>
";"09/09/2015 13";"20";"12";"8";"1";"869471111";"240"
"2758";"Sustitución de la corporación municipal por gestora";"<p>Sustitución de la corporación municipal por una gestora que seá evaluada cada 4 años en función de las cuentas presentadas y los servicios prestados a los ciudadanos.</p>

<p>Necesitamos gestores que trabajen para quien les paga, nosotros, los madrileños.</p>

<p>Como en cualquier trabajo si lo hacen mal, en función de unos objetivos a la calle.</p>

<p>¿Para que queremos colores políticos si lo que interesa es el servicio?</p>

<p>No quiero que me vendan la moto, quiero que la calle este asfaltada, vigilada y limpia y poder elegir yo si voy en moto, en bici o en coche</p>
";"09/09/2015 13";"39";"6";"33";"2";"863395687";"-415"
"2759";"Más plazas para sin techos y prohibir dormir en parques infantiles";"<p>Si bien este debate puede crear controversia, creo que sería interesante elaborar un plan de acogida para los sin techo de la capital, y que a su ves se prohiba o restrinja el uso de parques infantiles como provisional espacio donde ""acampar y dormir"".</p>

<p>Soy vecino de prosperidad, y es muy dificil acudir a ciertos parques infantiles con mis hijos, ante la acumulación de basura, heces, orinas y restos de las provisionales camas que usan. </p>

<p>Si las personas sin hogar rehusan utilizar este tipo de albergues, creo que se debería velar por el desmantelamiento sistemático de estos campamentos que se levantan cada noche.</p>

<p> </p>

<p>Saludos</p>
";"09/09/2015 13";"44";"32";"12";"3";"875316201";"1454"
"2760";"Más medidas para acoger refugiados y menos banderas ";"<p>¿Cuánto ha costado la bandera colocada en la fachada del Ayuntamiento? ¿Cuántas medidas se han anunciado para acoger a los refugiados? menos demagogia y más lógica. Y con esto...todo. Se han propuesto muchas cosas que luego se echan atrás. Por no hablar de que no creo que quede un euro público para ponerlas en marcha. Gracias.</p>
";"09/09/2015 13";"49";"9";"40";"5";"862781606";"-569"
"2761";"Restringir a largo plazo (diez años) el tráfico de vehículos contaminantes";"<p>La idea consiste en que dentro del cinturon de la M30 solo puedan entrar vehículos que tengan menos de X emisiones de CO2.</p>

<p>El objetivo es reducir la contaminación en Madrid y quitar del medio a los vehículos más contaminantes.</p>

<p>Para ello, propongo se establezcan unos topes cada año de tal forma que en diez años en Madrid solo pueda haber coches que consuman poco. Así quitariamos del medio tanto los coches viejos como los todoterrenos que más contaminan y no tienen cabida en la ciudad.</p>

<p>Funcionaria así:</p>

<ul>
	<li>2017: Solo pueden entrar dentro de la M30 vehículos que emitan menos de 200gr CO2/100kms.</li>
	<li>2018: Solo pueden entrar dentro de la M30 vehículos que emitan menos de 180gr CO2/100kms.</li>
	<li>2019: Solo pueden entrar dentro de la M30 vehículos que emitan menos de 160gr CO2/100kms.</li>
	<li>2020: Solo pueden entrar dentro de la M30 vehículos que emitan menos de 150gr CO2/100kms.</li>
	<li>2021: Solo pueden entrar dentro de la M30 vehículos que emitan menos de 140gr CO2/100kms.</li>
	<li>2022: Solo pueden entrar dentro de la M30 vehículos que emitan menos de 130gr CO2/100kms.</li>
	<li>2023: Solo pueden entrar dentro de la M30 vehículos que emitan menos de 120gr CO2/100kms.</li>
	<li>2024: Solo pueden entrar dentro de la M30 vehículos que emitan menos de 110gr CO2/100kms.</li>
	<li>2025: Solo pueden entrar dentro de la M30 vehículos que emitan menos de 100gr CO2/100kms.</li>
</ul>

<p>Se que puede parecer ambicioso, pero es una de las pocas formas de restringir el tráfico.</p>

<p>También se debería analizar si prohibir la entrada de vehículos Diesel que son uno de los factores que aumentan el riesgo de infarto al corazón.</p>

<p>Gracias.</p>
";"09/09/2015 13";"56";"33";"23";"5";"871997669";"589"
"2762";"Accesibilidad en Valdezarza";"<p>En Valdezarza hay muchas escaleras debido a la topografía del barrio, sobre todo en las inmediaciones de c/ Alcalde Martín de Alzaga, c/ Ochagavía y Pza. De Alcira. Aunque hay algunas rampas estas son impracticables para sillas de ruedas, ancianos con carros de la compra, sillas de bebés, etc en ciertos casos ni siquiera cubren todo el tramo de escaleras. Me gustaría se mejorasen y completasen dichas rampas para que sean realmente útiles y no bromas de mal gusto.</p>

<p> </p>
";"09/09/2015 13";"14";"10";"4";"2";"871618286";"428"
"2763";"TRANVIAS EN MADRID COMO EN TODA EUROPA";"<p>me gustaria que madrid se pusieran tranvias estan en toda europa y en parte d españa valencia barcelona sevilla no entiendo como madrid la capital no tiene tranvias un medio de trasporte  barato y eficiente ecologicamte y que no contamina y mucho mas barato que hacer metro creo que madrid tiene que ser una ciudad europea y los tranvias le harian una ciudad mas europea seguro,</p>
";"09/09/2015 13";"56";"25";"31";"8";"862840612";"-267"
"2765";"Derecho a la diversión ¿Y al descanso?";"<p>Hola, vivo en Canillejas y a 50 metros alrededor de mi casa hay 3 terrazas a cual mas ruidosa. No entiendo como es posible que se den licencias para colocar mesas justo debajo de las viviendas. ¿Acaso alguien piensa que los vecinos no sufren molestias por el ruido?. Nos pasamos todo el verano con las ventanas cerradas y con el aire acondicionado puesto y aun asi el ruido es importante dentro de la vivienda.</p>

<p>¿La unica manera de arreglar esto es a base de denunciar? </p>

<p>¿Acaso no tenemos derecho al descanso mi familia y todas las de los bloques colindantes?</p>
";"09/09/2015 14";"47";"41";"6";"3";"879422593";"3053"
"2766";"Multas por ruido";"<p>Poner multas por ruido, ya sean particulares, negocios, o la propia administración.</p>

<p>Se lleva un medidor y si se pasa de 70 db, multa en el acto, y luego a reclamar y alegar tras el pago.</p>

<p>A ver si aprendemos a respetar a los demás y dejar de ser tan carpetovetonicos.</p>
";"09/09/2015 14";"109";"101";"8";"9";"884232451";"8617"
"2768";"Vertidos de muebles viejos, escombros, etc. en Moratalaz";"<p>Desde Hace años se vienen realizando vertidos de escombros, muebles viejos, restos de obras y todo aquellos enseres viejos que sobran en las reformas de las casas. Cada cierto es limpiado : ""n relación con su escrito de 6 de julio de 2015, en primer lugar nos gustaría informarle que, dado que hace referencia a diversos temas, desde esta DIRECCION GENERAL DE SERVICIOS DE LIMPIEZA Y RESIDUOS, se va a dar respuesta en relación al asunto arriba indicado.

Realizado seguimiento al lugar de referencia, se ha procedido a su limpieza por parte del SELUR y de la empresa adjudicataria del Distrito de Moratalaz, con la colaboración de Policía Municipal, quedando la zona en buen estado tras la prestación del servicio. 

Aprovechamos esta oportunidad para agradecerle la utilización del Sistema de Sugerencias y Reclamaciones, así como su interés en la mejora de los servicios públicos prestados, quedando a su disposición por si en el futuro detectase alguna incidencia que hiciera necesaria la intervención de los Servicios dependientes de esta Dirección General.

Atentamente,. Pongo esta respuesta del servicio de LIMPIEZAS Y RESIDUOS,  hace unas semanas fue limpiada la zona, y YA ESTA OTRA VEZ EN UN ESTADO LAMENTABLE. </p>

<p>Los responsables de esta situacion son aquellas personas que de manera incivica vierten aqui todo tipo de residuos, Pero hay que destacar que las caracteristicas de esta zona se prestan para que de manera anonima la gente haga este tipos de vertidos. Pues se trata de un agujero de amplia extension, oculto a la vista de viandantes y vecinos, con facil acceso de vehiculos pesados, que descargan con toda tranquilidad y ocultos de la vista del resto de ciudadanos.</p>

<p>Esta zona esta desntro de la denominada Cuña Verde de Moratalaz (oficialmente llamada de O'Donell). Propongo que si por problemas economicos, no se puede terminar la construccion de la citada Cuña Verde, Alrededor de este ""Agujero"" existen grandes monticulos de tierra, que con un par de maquinas excavadoras y allanadoras, seria facil y barato, rellenar y poner a nivel de las Calles Av.Dr. Garcia Tapia y Arroyo de la Media Legua, el terreno y asi quedaria a la vista de todos. Aunque lo ideal seria tarminar la Cuña Verde en esta zona comprendida entre los Colegios Rey Pastor, y Pasamonte, Las Calles Avda. del Dr. Garcia Tapia,Arroyo de la Media Legua, y la incorporacion a la M-23 (Prolongacion de O'Donell).</p>

<p> </p>
";"09/09/2015 14";"23";"17";"6";"1";"873708910";"813"
"2770";"Exterminar las cotorras y otras especies invasoras";"<p>Desde hace ya años venimos asistiendo a la expansión de las cotorras.</p>

<p>Si, esos pajaricos verdes, ruidosos, que construyen grandes nidos colonia en nuestros parques y que carecen de enemigos naturales en nuestro ecosistema.</p>

<p>Por ello se hace necesario, exterminarlos para que dejen de afectar a la fauna autoctona, ya sea eliminando nidos, con trampas, escopetas,...., estan destruyendo poblaciones de otras aves con su agresividad.</p>

<p>Idem de Mapaches y tortugas de Florida</p>

<p> </p>
";"09/09/2015 14";"69";"44";"25";"13";"874638660";"1211"
"2772";"Cuidado de parques y zonas peatonales";"<p>Por favor que como hace 10 años se hacía, haya multitud de jardineros y basureros limpiando, que se contraten tanto de fijos como por temporadas, en tres turnos que cubran las 24horas del día, y luego unos de fin de semana, y con las condiciones que había antes, que no se deje en manos privadas todo esto que están los parques por lo menos de Usera, Carabanchel, Latina, Villaverde llenos de mucha basura que se tardara mucho tiempo en recoger</p>

<p> </p>

<p>por ejemplo un barrendero en el 2006 de finde semana y festivos, habia 3 horarios diferentes que no eran rotatorios, osea que eran 3 equipos de personas, 00-07  7-14  14-21, descanso de media hora, poder cambiarse de ropa dentro del horario, y mas o menos se cobraba 52euros, como caegoria de peon</p>
";"09/09/2015 14";"41";"36";"5";"1";"879122075";"2721"
"2773";"Baños públicos gratuitos";"<p>Se pueden hacer como algunos que hay en Bilbao, de cemento que tienen limpieza automatica de chorro con un poco de lejia, sirven mas de urinario que para otra cosa, cualquier otro modelo serviria</p>
";"09/09/2015 14";"46";"33";"13";"1";"875388629";"1434"
"2774";"CONDICIONES SALAS DE MUSICA EN VIVO";"<p>Por favor, es de maxima urgencia que se revisen las condiciones que se le exigen a las salas de musica en vivo de la ciudad. La mayoria de las salas mas míticas de la ciudad, las que guardan nuestros mayores recuerdos de los tesoros musicales que por ellas han pasado, se están viendo obligadas a cerrar sus puertas, por motivos que solo puede entender el Ayuntamiento de Madrid. La última: ""La Boca Club"", situada en la calle echegaray. Una enorme pérdida para los aficionados a la música, melómanos y músicos. Junto a ella estan la sala Caracol, que se ha visto obligada a cerrar unas cuantas veces ya, Soul Station, y un largo etc. Queremos oportunidades musicales y culturales en Madrid!!</p>
";"09/09/2015 14";"28";"18";"10";"0";"871820355";"514"
"2775";"Habiliar un telefono más ágil para colaborar con Bicimad";"<p>A pesar de no ser usuario de BiciMad simpatizo enormemente con este proyecto, me alegra que cada vez más gente utilice la bicicleta por Madrid. Me enerva el mal trato y poco respeto que se les tiene a las bicicletas que se dejan en la calle, esto incluye el vandalismo contra BiciMad.</p>

<p>He llamado ya tres veces para avisar de bicicletas de BiciMad abandonadas, avisos que se tienen que hacer a través de un 902 (de pago) con una tramitación que considero farragosa, a través de una centralita, con tiempos de espera largos, vamos, que para avisos de este tipo te tienes que armar de paciencia y tener mucho interés.</p>

<p>Sería bueno anunciar y publicitar un teléfono gratuito,  para colaborar y comunicar este tipo de incidencias.</p>

<p>Muchas gracias por abrir este tipo de sistema de Gobierno Abierto, pese a correr el riesgo de verse desbordado, lo considero una buena iniciativa de este Ayuntamiento.</p>
";"09/09/2015 14";"36";"20";"16";"3";"869756655";"222"
"2776";"Asociaciones sin animo de lucro-Espacios disponibles para utilizar";"<p>Multitud de centros culturales y otros públicos, tienen espacios que no se utilizan, muchas asociaciones tanto privadas como públicas inscritas como tal en el Ministerio de interior precisamos a veces algún ligar para reuniones, actividades, eventos.</p>

<p>El anterior ayuntamiento solo permitía ese uso de espacios por concurso que era un chantaje al final y no dejaba que otros lo utilizasen. Creo que es algo que beneficiaria si se pudieran pedir (no con mucho tiempo anticipado) su uso directamente en el ayuntamiento.</p>
";"09/09/2015 14";"36";"20";"16";"1";"869511099";"222"
"2778";"Restringir el paso a los coches en el centro para bajar la contaminación.";"<p>Hace muchos años que nadie hace nada para bajar los altísimos niveles de contaminación en Madrid. Más de la mitad de madrileños estamos enfermos por ello. Habría que restringir el paso a los coches particulares al centro. Crear parkings y autobuses gratuítos a cambio. La flota de buses municipales deberían ser no contaminantes al 100%. </p>

<p>FELICIDADES POR ESTA INICIATIVA : "" El Ayuntamiento cerrará al tráfico el Paseo del Prado todos los domingos por la mañana.""</p>

<p> </p>

<p>Recuperemos las ciudades para las personas.GRACIAS.</p>
";"09/09/2015 14";"83";"48";"35";"0";"872518048";"751"
"2780";"Barrios";"<p>Buenas tardes,</p>

<p>Reivindico que haya más actividades culturales en los barrios de Madrid y que no esté todo tan centralizado. En Madrid hay muchos parques en los que se podrían hacer cosas muy sencillas y con poco dinero. ¿Por qué sólo hay títeres en verano en el Retiro? ¿Por qué no poner espectáculos de títeres, cines de verano u otras actividades en los parques de los barrios? Al final todo el mundo va a mismo sitio y las actividades se saturan, como ocurre con los títeres del Retiro y con los pocos cines de veranos que hay en la ciudad. Creo que hay que dar más vida a los barrios, y no que sólo sean ""barrios dormitorio"".</p>

<p> </p>
";"09/09/2015 14";"22";"13";"9";"0";"869648036";"236"
"2781";"Eliminar publicidad de los parabrisas de los coches";"<p>Básicamente sería hacer cumplir la ordenanza ya existente. Mucha de la suciedad que puedes encontrar en Madrid son papeles de publicidad, envoltorios y colillas. Si bien es cierto que la culpa es del propietario del vehículo que la tira al suelo, es algo ya regulado y es relativamente sencillo recopilar teléfonos de estos anunciantes para darles aviso primero y ejecutar sación si reinciden.</p>

<p>Basta con que Policía Municipal o inspección municipal paren en un par de calles durante el turno y recoja publicidad. </p>
";"09/09/2015 14";"54";"43";"11";"1";"878113777";"2548"
"2783";"Metalocracia de una vez por todas";"<p> </p>

<p>EL Nuevo Orden obliga a tomar una decisión, solo puede haber dos bandos: uno heavy y otro malo... Y los malos han mandado demasiado. Poned el mundo del revés, joder, dando hostias a la vez mientras todas las campanas repican el Hells Bells.</p>

<p>Cada hombre y mujer tienen derecho a yacer, a un bocata, a una birra y a un CD de AC/DC.</p>

<p>El rock gobierna y es legítimo, porque todo estaba escrito: en las fundas de los vinilos, en los tigres de los garitos.</p>

<p>¡Mira! Randy Rhoads se acerca en tren, ¡coño! John Bonham y Cliff Burton van con él. ¡Flipa! Sherpa y Hermes vuelven a Barón. Dio vuela en un dragón y en su grupa Bon Scott. Kai, Bruce, Udo y Rob, Peter, Ace, Gene y Paul. Cronos, Mantas y Abaddon; Ozzy, Lemmy, Yngwie, Peavy... ¡Se han colao Milli Vanilli!</p>

<p>¡Revolución! ¡Desgobierno! ¡Rock and Roll por decreto! ¡Fumigación parlamentaria! ¡METALOCRACIA para las masas!</p>

<p> </p>
";"09/09/2015 14";"33";"11";"22";"0";"862640033";"-366"
"2784";"Suciedad de Madrid";"<p>Madrid está sucisima y huele mal, creo que el ayuntamiento debe contratar directamente a sus operarios para la limpieza y especializarlos en recogida de papeleras, muebles viejos, botellas del suelo los fines de semana, heces de perros etc, y otros que limpien con agua los orines de perro y personas que llenan el centro de un olor pestilente</p>
";"09/09/2015 14";"39";"33";"6";"3";"878354695";"2284"
"2785";"Permitit tráfico rodado todos los días de la semana";"<p>La calefacción contamina mucho más que los coches si la gente se queda en casa.</p>

<p>Los trabajadores tienen muchos problemas para la cesta de la compra con el tráfico cortado</p>
";"09/09/2015 14";"43";"9";"34";"0";"863206678";"-523"
"2786";"TERRAZAS EN EL CENTRO DE MADRID";"<p>De toda la vida he vivido y vivo en el centro de Madrid y he visto el cambio que ha sufrido con los años. Desde que se puso de moda peatonalizar las calles y ensanchar las aceras, creo que es más difícil andar por la zona, ya que hay multitud de bares y todos ellos con sus terrazas, y en cada terraza muchísimas mesas que seguro que son más de las que les permite la licencia. Creo que esto se debería controlar bastante más, no sólo el número de mesas de cada terraza, sino también el horario, ya que los vecinos tenemos derecho a descansar y por lo menos en mi calle, muchas veces son las 2 de la madrugada y las terrazas están a rebosar.</p>
";"09/09/2015 14";"55";"41";"14";"6";"877025031";"2012"
"2787";"Arreglar la calle principal";"<p>La calle principal de nuestra ciudad está llena de socavones.</p>

<p>Nosotros mismos la hemos destrozado conduciendo con el coche cargado y las cadenas puestas.</p>
";"09/09/2015 14";"20";"2";"18";"3";"864639665";"-160"
"2788";"Controlar el ruido en los centros comerciales";"<p>Hola Ciudadanos,</p>

<p>Primero felicitar la iniciativa de este portal de participación.</p>

<p>Creo que el ruido ambiental en los grandes centros comerciales y de ocio es excesivo, de la misma manera que se instalan aparatos para informar de la temperatura y humedad relativa tambien deberia haber informacion sobre el nivel de contaminación acústica en estos espacios que tan frecuentemente visitamos todos los Madrileños.</p>

<p>saludos.   </p>
";"09/09/2015 14";"28";"11";"17";"2";"863152583";"-235"
"2789";"Chabolismo en Moratalaz";"<p>Entre las Calles de Arroyo de la Media Legua, Incorporacion a la M-23, Los Colegios IES Rey Pastor, CEIP Pasamonte y la Avda del Dr. Garcia Tapia, se encuentra una zona oculta a la vista de viandantes y vecinos, (que en teoria deberia ser parte de la Cuña Verde de Moratalaz), se alojan entre 10 a 15 personas en chabolas, levantadas con tablas de madera, plasticos etc..etc.. Algunos de ellos llevan varios años viviendo alli, y da la impresion que cada dia va a mas el numero de estas personas que viven en estas condiciones. Teniendo en cuenta que en el distrito existen bastantes viviendas sociales, como el Ruedo, la Herradura etc etc.. seria muy complicado alojar a estas personas en viviendas dignas?</p>

<p> </p>
";"09/09/2015 14";"39";"33";"6";"1";"878315457";"2284"
"2790";"Centro ACUÁTICO";"<p>Buenas. Quisiera solicitar al ayuntamiento de Madrid la terminación del Centro Acuático que se estaba construyendo y que actualmente están paralizadas sus obras. Dicho Centro se sitúa próximo al Estadio Olímpico de la Peineta y a la parada de metro Estadio Olímpico. Si se lleva a término el proyecto tal y como se ideó en principio, podría suponer una importante ""cantera"" de deportistas de deportes acuáticos y un importante Centro para la promoción y difusión de los deportes acuáticos para todos los vecinos de Madrid, aparte de poder albergar en un futuro campeonatos mundiales o europeos de natación. Esto es lo que ya sucede con el tenis en la Caja Mágica, donde los vecinos ya podemos disfrutar de sus instalaciones a la vez que la instalación es capaz de albergar grandes eventos como la Mutua Madrid Open. </p>

<p>Muchas gracias y un saludo.</p>
";"09/09/2015 14";"45";"32";"13";"4";"875456681";"1351"
"2791";"Controlar el ruido en los centros comerciales";"<p>Hola Ciudadanos,</p>

<p>Primero felicitar la iniciativa de este portal de participación.</p>

<p>Creo que el ruido ambiental en los grandes centros comerciales y de ocio es excesivo, de la misma manera que se instalan aparatos para informar de la temperatura y humedad relativa tambien deberia haber informacion sobre el nivel de contaminación acústica en estos espacios que tan frecuentemente visitamos todos los Madrileños.</p>

<p>saludos.   </p>
";"09/09/2015 14";"29";"12";"17";"1";"863329014";"-206"
"2793";"LIMPIEZA YA, NO MÁS EXCUSAS!!!";"<p>Madrid necesita un cambio completo. La limpieza de al ciudad es una verdadera verguenza. Los   viernes no se  limpian las calles hasta el lunes, se acumulan días y días de suciedad, esto no es aceptable. Ya está bien de decir lo que se hará, que se discuten soluciones. Se está pagando por un servicio de Limpieza, si las calles no estan limpias entonces por que se paga??? Sino  limpian  entonces el contrato es esta incumpliendo. NO mas excusas, Votamos a un nuevo gobierno para que arregle los problemas, no para que se queje del anterior. No se a que esperan, es un tema sencillo, solo se necesita determinación! LIMPIEZA YA</p>
";"09/09/2015 14";"58";"52";"6";"5";"881238963";"4124"
"2794";"""Dar el pecho"", un derecho.";"<p>Seguir el ejemplo de Euskadi y que dar el pecho en lugares públicos sea un derecho.</p>
";"09/09/2015 14";"59";"47";"12";"15";"878964734";"2788"
"2795";"Ser o no ser";"<p>La alcaldesa de Madrid declara en el foro esta mañana que no es comunista,pero quien era el numero 23 del partido comunista de Madrid en las elecciones del 77?</p>

<p>que no reniegue de su antepasado y asuma lo que hizo</p>
";"09/09/2015 15";"39";"12";"27";"2";"862602933";"-461"
"2796";"Permiso para poder dejar entrar ALGUIEN en un coche en Zona de Lavapies";"<p>Hola</p>

<p>Desde que habeis empezado a gobernar HABEIS cambiado la normativa para dejar entrar a alguien con un coche a mi barrio (Lavapies - Distrito centro). </p>

<p>Si por ejemplo quiero comprarme una nevera y que me la lleven a casa YO TENGO QUE HACER EL TRÁMITE PARA QUE PUEDAN ENTRAR!!!....</p>

<p>Esto es de locos ya que además tengo que ir FISICAMENTE a las oficinas de la calle Atocha. Es decir, perder media mañana.</p>

<p>Antes los instaladores podían entrar en mi barrio pero ahora dicen que NO PUEDEN.</p>

<p>Esto es una chapuza teniendo en cuenta que existe internet y otros médios para resolverlo.</p>

<p>Estais haciendo todo lo posible para que acabemos dejando el centro.</p>

<p> </p>
";"09/09/2015 15";"47";"22";"25";"2";"864321513";"-140"
"2797";"Campaña de protección de cotorras";"<p>Muchas propuestas pretenden la eliminación de las cotorras, estos simpáticos loritos que desde hace unos años abundan en nuestras zonas verdes. Las cotorras argentinas han dado un giro gracioso a la fauna con la que coexistimos, con sus vivos colores que son atracción para propios como foráneos, niños y ancianos, profesiones liberales y subvencionados.</p>

<p>A pesar de los ruidos que generan, no resulta más insoportable que el generado por el propio tráfico de la ciudad. Además, es raro ver a estas aves aventurarse muy lejos de grandes parques, por lo que su presencia no está repartida por toda la geografía de la ciudad. No podemos decir lo mismo de las palomas, que ensucian ubicuamente nuestra maravillosa urbe.</p>

<p>Por tanto, pedimos y suplicamos al Ayuntamiento que no haga caso a estos malnacidos que pretenden dilapidar a esta nueva fauna, símbolo del progreso y de la aldea global. Si el precio es que desaparezcan especies autóctonas, como las palomas (conocidas por su infinito encanto) o los gorriones (sin ninguna clase de carisma), así sea.</p>

<p>Un saludo ciudadanos.</p>

<p> </p>

<p> </p>

<p>Excmo. Secretario General del I.E.E. José de Acero.     Excmo. Director del I.E.E. José de Acero.</p>
";"09/09/2015 15";"67";"10";"57";"16";"863199464";"-701"
"2798";"Debates Duplicados: poder identificar y terminar debates duplicados en esta Web.";"<p>Hay debates en esta web que están repetidos (extensión de Bicimad, Fuentes, baños públicos, metro...)
No sería mejor <strong>marcar y terminar los debates duplicados</strong>, y tener un solo debate concreto con  1000 votos, a cinco debates, con 200 votos cada uno?</p>

<p>Cuando <strong>muchas </strong>personas identifiquen un debate como duplicado, debería indicarse el debate original y cerrar el otro. Y si el autor considera que tiene algo que aportar, que quite la parte ya redundante y cree un nuevo debate diferente.</p>
";"09/09/2015 15";"90";"81";"9";"9";"883137618";"6480"
"2799";"Paneles informativos en Madrid Río para la correcta convivencia usuarios";"<p>Habiendo empezado a comprobar estadísticamente la relación causa efecto entre la incorrecta circulación por el viario de Madrid Río y los accidente (reales y poteciales) entre diferentes usuarios me parece que sería una buena idea informar con claridad de cuál es el lado correcto por el que se debe ir, como abandonar la vía o incorporarse a ella, cruzar, etc. La circulación incorrecta (generalmente por la izquierda, zinzagueante o anárquica) genera no solo estos accidentes sino amagos de accidentes y conatos de incomprensión entre las diferentes tipologías de usuarios. Una correcta información ayudaría a la cordialidad y convivencia entre todos así como a evitar estos accidentes que ocurre a diario por los 14km de vias. Tan solo sería necesario financiar un estudio estadístico completo y una campaña informativa correcta.</p>
";"09/09/2015 15";"38";"28";"10";"7";"875944217";"1326"
"2800";"Limpieza";"<p>Como residente del barrio Salamanca les informó la llegada de nuevos vecinos.se trata de unos roedores,para los niños ratatouille,que se pasean por las calles del barrio ya que la limpieza de las calles es muy escasa y las papeleras las cambian cada 7-10dias.varios técnicos me confirmaron que había un equipo de 21 personas y que ahora mismo son 3 por lo que les resulta imposible atender todas las necesidades.del tema roedores me dijeron que es normal ya que mucha basura esta por el suelo de las papeleras desbordada y que lo mejor era desratizar la casa ante una posible plaga.la oficina de atención al ciudadano me dice que gracias por la queja pero de momento no hay mucho que hacer,que de aquí a 3 meses recibiré una respuesta escrita por parte de la junta municipal</p>
";"09/09/2015 15";"36";"26";"10";"4";"875286688";"1155"
"2801";"Puerta del Sol sin mimos ni muñecotes";"<p>La puerta del sol parece un circo, con tanta dora la exploradora, bart simpson, bob esponja, etc. Resulta imposible hacerle una foto al oso y al madroño sin que aparezca un personajillo de estos. </p>

<p>Creo que perjudica seriamente la imagen del centro de Madrid. </p>
";"09/09/2015 15";"71";"47";"24";"0";"875389434";"1522"
"2802";"comedores escolares y sus menús";"<p>Propongo hacer inspecciones de la comida que se da en los comedores escolares, es una vergüenza las raciones que se dan en mucho colegios y como los castuzos se llevan el dinero que debería ser para alimentar a nuestros hijos.</p>

<p>Por ejemplo han quitado el chorizo y la morcilla de los platos de alubias. Los macarrones con tomate... que menos que llevar chorizo, no voy a pedir salsa boloñesa, que menos que chorizo y salchichas que no sean una guarreria de a saber que animal.</p>
";"09/09/2015 15";"27";"18";"9";"0";"872737654";"600"
"2803";"Reducir la excesiva iluminación en los túneles de la M30";"En mi opinión, la iluminación de los túneles de la M30 me parece excesiva. Estos túneles tienen 27.000 luminarias para iluminar día y noche.

Si uno se fija cuando va conduciendo, hay tubos fluorescentes puestos en línea recta durante todo el recorrido, iluminando de forma excesiva.

Propongo que la disposición de los fluorescentes estén iluminando uno sí, el siguiente no, el siguiente sí, el siguiente no... y así sucesivamente. También se podría mirar si desconectar uno y los siguientes dos estén encendidos, y el siguiente desconectado, etc.

Mientras no afecte a la seguridad del túnel y de los conductores, seguro que algo de eso se puede estudiar. En otros túneles como muchos se habrán fijado, se han desconectado muchas luminarias estos años y se seguía viendo perfectamente, pues esto es lo mismo.";"09/09/2015 15";"55";"29";"26";"2";"869220822";"158"
"2804";"No a la publicidad de luna";"<p>Actualmente uno de factores de la basura que puebla la ciudad es el cada vez más abundante número de panfletos publicitarios que muchos anunciantes dejan en las lunas de los coches de la calle. La mayor parte de la población ignora esos papeles y terminan cayendo al suelo.</p>

<p>Ademas de feo de verse en el suelo, de los desperfectos que generan en las lunas de los coches al adherirse el papel tras unos días de lluvias; este tipo de publicidad es un gasto enorme de papel.</p>

<p>Por ello, propongo hacer como con los carteles de la calle y multar a los anunciantes, para que abandonen esta práctica.</p>
";"09/09/2015 15";"52";"41";"11";"3";"878176927";"2365"
"2805";"Transporte publico gratuito para ""todos los parados"".";"<p>Recientemente desde la comunidad de madrid anunciaban que van a poner un abono transporte por 10 euros durante 6 meses, para parados de larga duracion (12 meses en esa situacion).</p>

<p>Me parece  indignante que hagan distinciones entre parados de larga duracion y el resto de los parados , es como si hubiera parados de primera  y parados de segunda categoria.</p>

<p>Los parados necesitan movilidad para realizar entrevistas ir a cursos y moverse en definitiva.</p>

<p>A parte de que es una medida muy temporal y yo diria que populista por que dentro de poco tenemos elecciones. </p>

<p> </p>
";"09/09/2015 15";"44";"20";"24";"8";"864632077";"-181"
"2807";"Cercanias Valdebebas - MAS TRANSPORTE";"<p>Es vital poder disponer de más opciones de transporte público en el barrio de Valdebebas.</p>

<p>Para cuando la apertura de la YA CONSTRUIDA ESTACION DE CERCANIAS?</p>

<p>No se pueden extender las líneas de Sanchinarro? 150 / 174 ? y no a la entrada del parque en Niceto Alcalá Zamora... Donde Están los vecinos en la parte alta de Valdebebas</p>
";"09/09/2015 15";"179";"169";"10";"8";"887298700";"15011"
"2808";"Solucion para Cuidar a los niños en Festivos, vacaciones, etc...";"<p>Que colegios, y guarderias abran todos los dias del año atendidos por Monitores de tiempo libre, y/o profesores. Cada año es el mismo calvario para todos los padres ¿Donde dejar  a los  niños a primeros de Septiembre, o los 15 dias de vacaciones escolares de Navidad, o a finales de Junio y demas dias festivos?</p>

<p>No todo el mundo tiene abuelos, cuñados, o amigos o dinero para pagar cuidadores o los abuelos a veces son muy mayores y no estan en condiciones fisicas de cuidar a los niños. No podemos depender de caridad y favores. Si de verdad nos importan los niños y son el futuro es necesario ayudar.  Creo que podemos estar de acuerdo todos los padres/madres de todas las ideologias</p>
";"09/09/2015 15";"37";"17";"20";"1";"864395680";"-137"
"2809";"Abaratar el bonometro de 10 viajes, para beneficiar a los usuarios frecuentes.";"<p>Abaratar el bonometro para que cueste por ej. 10 ,  mientras que el usuario esporádico de metro (visitante o turista), puede pagar por una vez un poco más, pero no contribuye en esa ciudad.</p>

<p> </p>
";"09/09/2015 15";"53";"41";"12";"2";"877867715";"2243"
"2810";"¿Se puede dar  Habitabilidad a los Discapacitados  sin vivienda";"<p>Me refiero de dar HABITABILIDAD    Digna y duradera  a los Discapacitados que carezcan de vivienda estable y digna</p>
";"09/09/2015 15";"22";"13";"9";"0";"870046782";"236"
"2811";"PARQUES INFANTILES SIN SOMBRA";"HAY MUCHOS DEBATES SOBRE EL TEMA DE LA SOMBRA EN LAS CALLES DE MADRID, A LOS QUE HAY QUE AÑADIR QUE ES MUY TRISTE IR CON UN NIÑO PEQUEÑO A UN PARQUE INFANTIL Y DECIRLE QUE NO PUEDE UTILIZAR LOS COLUMPIOS POR QUE QUEMAN, YA QUE COMO NO TIENEN NINGUN ARBOL NO HAY UNA SOMBRA QUE LES PROTEJA DEL SOL. LOS NIÑOS NO SE PUEDEN TIRAR POR EL TOBOGAN, NI AGARRARSE A LAS CADENAS DE LOS COLUMPIOS. NO LO HE VISTO EN UN SOLO DISTRITO. SOLO 1 DE CADA 10 PARQUES QUE VISITO TIENE SOMBRA Y PUEDEN LOS NIÑOS DISFRUTAR DE LOS COLUMPIOS (ESO SI, HACIENDO TURNOS PORQUE ESTAN HASTA ARRIBA). ES MUY TRITE QUE MI NIÑA DE 20 MESES ME DIGA QUE NO QUIERE PARQUE PORQUE QUEMA.";"09/09/2015 15";"43";"38";"5";"3";"880022454";"2916"
"2812";"Gratuidad teléfono 010 atención al ciudadano y 092 policía local";"<p>Buenos días,</p>

<p>Hace unos días me lleve la sorpresa que estos números no eran gratuitos (atención al ciudadano y policia local) y venía reflejado en la factura un coste extra, muchos ciudadanos seguro lo desconocen.</p>

<p>Que llamar a la policía cueste dinero no tiene mucho sentido y pienso que no es ético.</p>

<p>Por eso presento esta propuesta.</p>
";"09/09/2015 15";"141";"136";"5";"6";"886986770";"12635"
"2815";"REDUCCIÓN DLÑEL IMPUESTO DE CIRCULACIÓN";"<p>Imagino que, ya que cada vez son menos las calles por las que podemos circular con nuestros vehículos libremente, no estaría mal que los impuestos de circulación para los mismos se viesen reducidos de manera proporcional. No es normal que los que circulamos en transporte privado (que ya hemos pagado aparte) tengamos que financiar con los impuestos pagados  (combustible, seguros, circulación, etcétera) el transporte de los demás. </p>

<p> </p>
";"09/09/2015 15";"38";"24";"14";"2";"873039510";"631"
"2817";"Acabar con la mafia del sector del TAXI ";"<p>¿Creen ustedes que es normal que se haya especulado hasta más no poder con unas licencias que no son más que concesioned municipales? </p>

<p> </p>

<p>¿Se imagina usted revendiendo la licencia de su bar por 300.000 euros?</p>

<p> </p>

<p> </p>

<p>¿Cree usted que es normal que algunas fsmilias y empresas tengan en su poder decenas de licencias o que una sola persona pueda tener más de una sin explotarlas? </p>

<p> </p>

<p> </p>

<p>Yo no. </p>

<p> </p>

<p> </p>

<p>¿Se imagina usted un negocio en el que la competencia está prohibida?</p>
";"09/09/2015 15";"79";"69";"10";"3";"882142329";"5153"
"2819";"Ciclovia Recreativas - Domingos y Festivos de 07:00 a 14:00";"<p>Con el fin de generar más espacios recreativos y deportivos, propongo que cada domingo y festivo de 07:00 a 14:00, se cierre un carril de las principales vías como la castellana, Gran Via, etc.  Y que este pueda ser usado por bicicletas, patinadores, personas que quieran correr o caminar con su mascota, etc. A lo largo de la ciclovía, también se podría llevar a cabo otro tipo de eventos recreativos y de entretenimiento como son clases y campeonatos de ejercicios aeróbicos, deporte extremo, yoga y eventos musicales y artísticos, etc.</p>

<p>Y en navidades se podrían organizar ciclovias nocturnas para disfrutar de las luces de navidad por la ciudad.</p>

<p>Todo esto sería beneficioso para nuestra salud, para reducir los niveles de contaminación en la ciudad, para empresas que se involucren en el proyecto (Alquiler y reparación de bicis, restaurantes, bares, empresas de fitness, etc.) y como atracción para aquellos turistas que quieran conocer la ciudad de una manera sana y divertida.</p>

<p>Hay otras ciudades en el mundo que lo hacen con excelentes resultados, una de ellas y pionera en este concepto es Bogotá desde 1975.</p>

<p>Si tenéis más propuestas son bienvenidas.</p>
";"09/09/2015 16";"55";"39";"16";"3";"876501676";"1630"
"2820";"Mejorar el aire que respiramos, más espacios verdes, restringir la circulación";"<p>Soy vecino de Madrid (zona Retiro), y quería compartir mi preocupación por los altos niveles de polución en nuestra ciudad, creo que el Ayuntamiento de Madrid se lleva lavando las manos en el aspecto de Medio Ambiente mucho tiempo y me gustaría que reaccionara cuanto antes.</p>

<p>Demasiado trafico, demasiado asfalto, pocas o nulas zonas verdes, ojalá algún día alguna persona competente se pare a pensar de la importancia de esta situación, que nos afecta negativamente a todos principalmente en el tema de la salud</p>

<p>Mi opinión es que se pueden llevar a cabo muchas medidas para revertir esta situación pero por alguna razón nadie da el paso.</p>

<p>Medidas como ampliar aceras, aumentar el número de zonas verdes por toda la ciudad, reducir carriles de tráfico, crear una autentica red de carril bici, apostar de una vez por todas por una red de transporte público movidos por tecnología hibrida-ecológica (autobus y taxi), ayudas a la hora de comprar vehículos pequeños y ecologicos al desecharnos de coches más grandes y contaminantes, limitar el acceso al centro en coche mediante peajes, matriculas, días, etc...</p>

<p>Ojala que las personas que nos gobiernan se tomen en serio este tema de la polución y la falta de espacios verdes ya que se esta llegando a niveles muy desagradables.</p>

<p>Dejo un enlace de alguna noticia relaccionada con este tema en la prensa escrita.</p>

<p>http://www.20minutos.es/noticia/1273132/0/boina-madrid/contaminacion/aire/</p>

<p>Un saludo.</p>

<p> </p>
";"09/09/2015 16";"53";"36";"17";"5";"875638571";"1290"
"2821";"Una plaza en honor a las víctimas de ETA ";"<p>El Ayuntamiento retirará los nombres franquistas de las calles pero ¿qué pasa con las víctimas de ETA?</p>
";"09/09/2015 16";"68";"49";"19";"3";"877482442";"2161"
"2824";"vivienda social";"<p>Mi familia y yo vivimos en una habitación de  9 m2 y dentro esta la cocina y el baño todo en el mismo espacio tengo un bebe de 9 meses, la cocina no tiene ni salida de humos ni ventilación, tampoco tenemos persiana y toda la pared es ventana entra muchísimo polvo que nos afecta a todos, la niña no tiene ni en donde dormir , no tenemos ingresos y la RMI tarda muchísimo, hemos solicitado ayuda en todos lo organismos y nadie nos ayuda, no me creo que no haya una vivienda donde se nos pueda alojar.</p>

<p>Señora alcaldesa cuánto mas debe sufrir mi familia para que nos ayuden.</p>

<p>yo entiendo el drama de ciudadanos Sirios pero también tienen que ver por la gente de aqui.</p>
";"09/09/2015 16";"32";"11";"21";"3";"863299116";"-343"
"2825";"Exigir el CV a los altos cargos";"<p>¿Están bien formados nuestros gobernantes? quienes nos gobiernan deberían de presentar su CV y demostrar su preparación. No estaría de más, ahora que somos todos muy transparentes, ver la formación de nuestros políticos, inclusos de aquellos que no hemos elegido y ascienden por sus propios méritos</p>
";"09/09/2015 16";"49";"43";"6";"0";"880525492";"3246"
"2826";" Un programa integral contra el sinhogarismo en las calles de Madrid";"<p>Estamos acostumbrados, por desgracia, a ver en nuestras calles personas y colectivos en situación de calle y ejerciendo  la mendicidad,desde aquí propongo que se planifique y trabaje para solucionar esta situación.</p>
";"09/09/2015 16";"29";"12";"17";"2";"863976908";"-206"
"2827";"monumento a los 95 millones de víctimas del comunismo";"<p>No estaría de más un monumento que rindiera honor a los 95 millones de víctimas del comunismo.</p>
";"09/09/2015 16";"60";"28";"32";"1";"864064256";"-186"
"2828";"Conversion de farolas en puntos de recarga de vehiculos eléctricos";"<p>Para reducir los graves problemas de contaminación que tiene Madrid es necesario incentivar el uso de vehículos no contaminantes.</p>

<p>El mayor problema para la implantación del vehículo eléctrico a nivel mundial es la escasez de puntos de recarga, con un coste muy reducido, sin necesidad de penalizar al coche tradicional, aprovechando infraestructuras ya creadas como las farolas dispondriamos de una buena red de puntos de recarga.</p>

<p>Convertir las farolas en puntos de recarga tiene numerosas ventajas, no solo económicas, <strong>democratizan el punto de recarga</strong> al poder ser instalado cada pocos metros sin una instalación muy costosa, pero sobre todo porque lo harían un elemento más de la urbe.</p>

<p>Pekín, ha sido la primera ciudad en abordar este problema planteando esta situación, pero también Beijing, Berlín y ahora Madrid si quiere.</p>

<p>En Madrid todavía no se ha afrontado el cambio de iluminación pública a LED, por lo que con la sustitución de las bombillas convencionales por las de tipo LED, para ahorrar, se aprovecha para preparar la farola para soportar la carga de un vehículo eléctrico. Con el ahorro que se producirá por el cambio de bombilla, se aprovechará esa potencia necesaria para acometer la carga del coche eléctrico.</p>

<p>El coste estimado de esta operación es de 400 euros por cada farola, es decir se podrian adaptar 1200 farolas con menos de medio millon de euros y conseguir que la gente no vea al coche eléctrico como algo raro sino como una solución a un problema para la salud como es la contaminación de Madrid.</p>

<p><strong>Solo deberían adaptarse las que están al lado de una plaza de aparcamiento y deberían reservarse estas plazas para que solo aparquen y carguen este tipo de vehículos</strong>, como las plazas para minusválidos.</p>

<p>http://elperiodicodelaenergia.com/berlin-convierte-las-farolas-en-puntos-de-recarga-de-vehiculos-electricos/</p>

<p>La empresa contratada en el caso de Berlín ha sido Ubitricity, en BMW han presentado ""Light and Charge<strong>""</strong> una farola LED que tiene la función de punto de recarga para coches eléctricos.</p>
";"09/09/2015 16";"68";"58";"10";"7";"881288321";"4094"
"2830";"Psiquiatras de guardia que actúen de oficio";"<p>A ver si alguno toma medidas con la señora Aguirre, que (desde la ignorancia, que no soy profesional) desde finales de Mayo está peor de lo suyo.</p>
";"09/09/2015 16";"9";"3";"6";"0";"865223419";"-100"
"2831";"COMUNICACIÓN ZONA ESTE MADRID";"<p>En el 2008 se aprobó una parcela destinada a mejorar los accesos de Ribera del Loira. Todos los días laborables, cerca de 25.000 personas sufren los atascos para llegar hasta allí o poder acceder por la m40 a sus lugares de trabajo. La parcela estaba destinada a la construcción de una parada de tren que comunicaría Chamartín con Coslada, una especie de CIVIS parando en Manoteras, barrio de san antonio ( el cual sólo dispone de un autobús que lo comunica con mar de Cristal), campo de las naciones, canillejas y Coslada.</p>

<p>Esta ruta descongestionaría tanto la A2 como la m40 así como mejorar la vida de todos los vecinos tanto de hortaleza como de San Blas-Canillejas y el corredor del Henares.</p>
";"09/09/2015 16";"33";"27";"6";"1";"877690758";"1718"
"2832";"Valdebebas, rotonda en el cruce de Ada Fuerzas Armadas con C/Carmen Rico Godoy ";"<p>Los vecinos de la zona norte de las Cárcavas tenemos que hacer muchos kilómetros para poder llegar a Sanchinarro a través de los puentes que unen Valdebebas con Sanchinarro. Es importante e incluso hace la vía más segura la construcción de una rotonda en esa intersección. Hay varios pasos de peatones y la visibilidad es muy mala, por lo que será sitio para accidentes si no se hace algo.</p>
";"09/09/2015 16";"82";"73";"9";"1";"882936042";"5697"
"2833";"Eliminar la unidad antidisturbios de la Policia Municipal";"<p>No estÁ justificado esta unidad, sus funciones las puede realizar la Policia Nacional</p>

<p>La Policia Municipal  debe estar para ayudar al ciudadano no para darles palos cuando se manifiesta de forma pacifica </p>
";"09/09/2015 16";"89";"35";"54";"12";"861872191";"-747"
"2834";"Compensación de Deudas con el Ayuntamiento de Madrid";"<p>La compensación de deudas es hoy posible gracias a la innovación técnologica que permite la automatizacion de procesos. La compensación de Deudas es una manera sencilla, a través de la economia colaborativa, de reducir la dependencia de los sistemas bancarios. En entornos de elevados endeudamiento y con escasez de credito resulta un modelo a tener muy en cuenta. </p>

<p>¿Cómo nos puede ayudar la compensación de deudas? </p>

<p>Las entidades locales están altamente endeudas. Esto penaliza a sus prveedores, que trasladan esas penalizaciones a pequeñas empresas y autónomos, que en muchas ocasiones no pueden hacer frente al pago sus deudas incluyendose entre ellas tasas a las entiedades locales. Estas deudas podría ser compensadas. </p>

<p>Investigando he descubierto una plataforma española que ha sido premida por la Comisión Europea por un modelo similar a este llamada deudae. Propongo que el Ayto permita este tipo de compensaciones. </p>
";"09/09/2015 16";"17";"7";"10";"1";"865011873";"-123"
"2835";"Financiación del metro de Madrid.";"<p>A sabiendas de que el uso del metro es deficitario para nuestra Comunidad y nuestra ciudad, y siendo éste responsabilidad no sólo del Ayuntamiento propongo que:</p>

<p>1.- Es un populismo bajar el abono de metro y significa pasar la patata caliente de la ciudad al gobierno central. Ya nos sacarán el dinero por otro lado. Que lo expliquen.</p>

<p>2.- Es tercermundista que la parada de metro ""Sol"" reciba el nombre de una compañía (en este caso Vodafone). Pido no renovar la concesión.</p>

<p>3.- Ante la falta de ideas, sería bueno, por ejemplo, colocar publicidad en los vagones, al estilo de otros metros europeos, para buscar financiación.</p>

<p>4.- Es absolutamente irrisorio, y aunque no quede popular, que el servicio del metro sea ""tan barato"" y a cambio recorten en número de trenes, conductores, limpieza y aire acondicionado. ¿Qué es eso de esperar 10 minutos en un día entre semana para un tren?</p>
";"09/09/2015 16";"28";"15";"13";"9";"870152755";"107"
"2836";"Acabar con los gorrillas (por ejemplo los de alrededor del hospital la Paz)";"<p>Es una autentica molestia, en varias zonas de Madrid, que tengas que pagar además del estacionamiento regulado a esta gentuza que no hace nada más que sacarte dinero bajo amenaza.</p>

<p>Se encuantran varios en los alrededores del hospital de la Paz aprovechando la situación. No es posible que vaya a llevar a mi hija de tres años la semana pasada a urgencias infantil y me tengan que someter a esta forma cotidiana de extorsión.</p>
";"09/09/2015 16";"114";"108";"6";"6";"885976793";"9663"
"2837";"Instalar semáforo y paso de peatones en Calle Numancia con la Rábida";"<p>La calle La Rábida da comienzo en el interior de un tramo curvo de la calle Numancia [1] . Dicho cruce no cuenta con señalización luminosa o  pasos de peatones, careciendo de visibilidad cuando se cruza la calle Numancia desde la acera de los pares a la de los impares . Son muchas las personas que atraviesan la calle Numancia a esa altura, bien porque vienen de la calle La Rábida o bien porque salen de la parroquia situada en la intersección de las citadas calles.</p>

<p>Sería conveniente dotar a la calle Numancia de un semáforo y un paso de peatones a dicha altura. Muchas de las personas que cruzan la calle lo hacen al salir de la parroquia, siendo personas de avanzada edad y con problemas de movilidad. Con ello se evitarían muchas situaciones de riesgo para el peatón que se dan de forma habitual.</p>

<p>[1] https://goo.gl/maps/i3FtP</p>
";"09/09/2015 16";"23";"17";"6";"1";"874678875";"813"
"2838";"democracia directa";"<p>Me gusta mucho la reivindicación que el 15-M hace de la democracia directa. Por cierto fue Fraga quien defendió una iniciativa popular y referendum abrogativos y propositivos parecidos a lo que hoy reclama el 15-M. La defensa de las instituciones de democracia directa corrió a cargo de las fuerzas políticas más conservadoras de la transición (AP)siendo en nuestras Cortes constituyentes estas fuerzas conservadoras las más acérrimas defensoras de las mismas (Fraga). Por otro lado el gran déficit democrático español es la inexistencia de la posibilidad de un referéndum por iniciativa ciudadana. Suiza, Baviera, Uruguay, California, Floridapermiten esta forma de democracia directa.</p>
";"09/09/2015 16";"27";"13";"14";"4";"866934097";"-48"
"2839";"Nombres de las calles de Madrid";"Mi propuesta viene porque las ciudades japonesas no tienen nombres para sus calles y me parece una medida muy inteligente para acabar con el eterno debate de si hay que cambiar el nombre de esta calle, esta plaza, etc... y alejarnos de las ideologías para tener un sistema más eficaz. Evidentemente, hay espacios que seguirían manteniendo su nombre (La Castellana, Gran Vía, Puerta del Sol, etc...); pero en lugar de ir a la Calle Elfo ¿por qué no ir a la calle 17 del distrito de Ciudad Lineal?";"09/09/2015 16";"44";"12";"32";"15";"863039141";"-545"
"2841";"Instalas Maquinas Reciclaje de Teléfonos Moviles";"<p>En paises avanzados hay maquinas que te  ""compran "" el movil para reciclarlo y te lo pagan al instante. Tu colocas el movil viejo en la maquina. Esta te lo valora. Si estas de acuerdo con el precio que te ofrecen, la maquina se queda con el movil y por una ranura te salos los Euros acordados.</p>
";"09/09/2015 16";"47";"33";"14";"1";"875999820";"1334"
"2842";"Mantenimiento zonas verdes en Sanchinarro";"<p>Hola. Abro este debate pq llevo un tiempo viviendo en sanchinarro y suelo frecuentar el parque que está enfrente del Colegio el Valle (calle Vicente Blanco Ibañez) con mis hijos. Hay una especie de charca, por llamarlo así, arboles, cespe y zona infantil. El mantenimiendo de la misma es pésimo. Pienso que es una zona verde donde podían mantenerla en mejores condiciones ya que la usan muchas personas.</p>

<p>Espero que si hay votos a favor, consigamos algo.</p>

<p> </p>

<p> </p>
";"09/09/2015 16";"49";"42";"7";"3";"880298237";"3000"
"2843";"Hacer cumplir ordenanzas municipales llevando atados a los perros en los parque";"<p>Pese a que es obligatorio, casi ningun pero es paseado en los parques convenientemente atados. Esto trae consigo algunas situaciones peligrosas con bebes y ninos y ninas pequenos, con bicicletas, patines, etc. Ademas, dificulta el que el dueno recoja siempre los excrementos.</p>
";"09/09/2015 16";"92";"62";"30";"21";"877703936";"2156"
"2845";"Eliminar multas botellón por tomar una lata de cerveza";"<p>Estoy totalmente de acuerdo en que se pongan multas por hacer botellón, entiendase beber en la calle en grupo, una gran cantidad de alcohol, haciendo ruido y ensuciando, pero no creo que se deba multar y menos con la misma cantidad a quien consume una simple lata de cerveza o producto con alcohol, ya sea paseando tranquilamente o en un parque o un banco.</p>

<p>He vivido en mis propias carnes y en la de varios amigos y conocidos el ser multado con nada más y nada menos que 600 simplemente por beber una lata de cerveza caminando por la calle, sin hacer ningún tipo de ruido ni molestar a nadie.</p>

<p>Creo que son multas desorbitadas, con un simple fin recaudatorio y que causan perjuicio a una gran cantidad de ciudadanos que simplemente les apetece tomar una cerveza en cierto lugar o no pueden permitirse tomarla en un local.</p>

<p>Es una multa que considero injusta y que además no se aplica en la mayor parte del mundo y en muchas partes de España, dónde permiten beber una cerveza como lo que es, algo normal, no botellón.</p>
";"09/09/2015 16";"74";"49";"25";"1";"876164860";"1589"
"2848";"INFRAESTRUCTURAS DEFICIENTES EN BARRIOS DE SEGUNDA";"<p>Hola buenas!</p>

<p>Vivo en Carabanchel, uno de los muchos barrios de la periferia madrileña que la mayoría de los políticos solo se acuerdan que existen en época de elecciones. Bien, mi debate radica en la falta de infraestructuras deportivas en este barrio, pues, no puede ser que un distrito de 150.000 habitantes, equivalente a la población de la ciudad de Badajoz, tenga solamente 3 polideportivos, todos ellos, situados a largas distancias uno del otro, dejando a la Calle Antonio Leyva sin infraestructuras (2km las más cercanas). Por esta razón, propongo construir donde se ubicaban en las antiguas piscinas de Hermandades, una piscina. El presupuesto no tendría porque ser muy grande, pues, el hueco de la piscina, ya esta hecho.</p>

<p>Espero que les guste mi propuesta.</p>
";"09/09/2015 16";"40";"34";"6";"2";"879365562";"2380"
"2849";"Acelerar la construccion de huertos urbanos en el barrio de Salamanca";"<p>Es necesario por la falta de este tipo de espacios en el barrio. Aparte de suponer una alternativa saludable y ecologica que en la actualidad no existe el el barrio, ayudaria a suministrar a los comercios de la zona de productos ecologicos de calidad, cuya oferta ahora mismo es practicamente inexistente. Igualmente, ayudaria a dar un uso comunitario a algunos solares de la zona en aparente abandono.</p>
";"09/09/2015 16";"46";"23";"23";"1";"867005616";"0"
"2850";"Creación de las Juventudes Podemitas";"<p>Esta mañana me dijeron nuestros hombres del tiempo que para hoy tendríamos una situación atmosférica borrascosa. Bien, mis muchachos y muchachas, esta situación atmosférica la ha tenido España durante 15 años y también el Partido la ha tenido. Por encima de un decenio, sobre el movimiento no ha lucido el sol, era una lucha en la cual sólo la esperanza podía salir victoriosa. La esperanza de que al final en España luciría por fin el sol. Y el sol ya luce. A vosotros hoy no os sonrie el sol, pero no es ningún problema, porque nosotros hemos querido educar una nueva juventud, no sólo para los días de sol, sino también para los días de tormenta.</p>

<p>Yo daría por fracasada toda la educación que el Comunismo está prestando si el resultado de esta educación no fuera una Nación que en todo momento, inclusive en los más difíciles días, no permaneciese unida. Esta Nación, mi juventud, sois vosotros, en el futuro. La juventud hoy tiene unos ideales distintos a los que poseía en tiempos anteriores. En lugar de una juventud que antaño era educada para el placer, crecerá una juventud que es educada para la entrega, para el sacrificio; pero en especial, para el fortalecimiento de un cuerpo sano, con facultades de resistencia. Por eso, para nosotros, los comunistas podemitas, aquellos tiempos de lucha, a pesar de que el sol no luciera, eran bonitos. Nosotros queremos luchar una y otra vez por esto y pedirle a la Providencia que mantenga Madrid sano y firme y que le de a Madrid el sentido para una verdadera libertad y que mantenga en él, siempre despierto, el sentimiento del honor. Nosotros no queremos pedir a la Providencia el que nos haga libres, o el que nos regale la libertad, sino sólo que haga de nosotros un pueblo como debe ser, de forma que nosotros mismos podamos en cualquier tiempo conquistar nuestra posición que nos corresponde en el mundo. Posición que es la que necesita un pueblo libre. Nosotros no queremos ningún regalo, sólo pedimos la gracia de poder entrar en un combate honrado. Entonces, la Providencia, podrá decidir si Madrid se ha ganado esta vida o no y cuando yo os veo a vosotros, yo pienso que este pueblo también en el futuro se habrá ganado su libertad y con ello su honor y su vida.</p>

<p>Nunca la dirección de esta juventud estará en manos de otros que no hayan salido de la Idea y del Movimiento. Él os ha formado, de él tenéis el uniforme y a él serviréis. Así como vosotros hoy estáis frente a mí, de esta manera las jóvenes generaciones se encontraran, año tras año durante siglos, frente a los Líderes venideros. Y siempre demostrara su adhesión a esta España que hoy nosotros hemos ganado. Carmena, Presente !! Hugo Chávez Comandante, Presente !! Kin Jong Un, Presente !!</p>
";"09/09/2015 16";"78";"13";"65";"3";"864066305";"-866"
"2851";"Pintadas Madrid";"<p>Buenas tardes,</p>

<p>A pesar de las (supuestas) sanciones que existen en relación a los 'graffiti'  y a las pintadas en <strong>Madrid</strong>, por mucho que se limpien túneles, muros y puentes, estas pintadas vuelven a aparecer.</p>

<p>Me parece un<strong> gasto innecesario</strong> contratar a <strong>empresas</strong> para pintar (o quitar el graffiti a) una pared que va a volver a ser pintada días después, y más costando una media de más de<strong> 30/m²</strong> de pared.</p>

<p>En otras ciudades del mundo, los alumnos de las facultades de Bellas Artes han recibido permiso para dar vida a sus ciudades y pintar murales en estas zonas llenas de graffitis, llegando incluso a hacer concursos con un pequeño premio económico a la mejor obra.</p>

<p>Así pues, considero que hacer concursos o permitir a estos estudiantes dibujar en estas zonas podría ser una forma de<strong> ahorrar dinero </strong>al mismo tiempo de dar una mejor <strong>imagen</strong> a la ciudad</p>
";"09/09/2015 16";"47";"37";"10";"11";"878715432";"2125"
"2852";"Valdebebas-Cambio de sentido en Avenida de las Fuerzas Armadas";"<p>Actualmente, hay que hacer 2 km para hacer el cambio de sentido. La movilidad dentro de un barrio o zona residencial, debe ser lógica, cómoda y segura. La situación actual provoca que muchísimos conductores opten por cruzar por los pasos de peatones y realizar cambios de sentido peligrosos.</p>
";"09/09/2015 16";"84";"74";"10";"2";"882998198";"5638"
"2854";"Renta básica a todos los ciudadanos en paro.";"<p>Creo que el establecimiento de una renta básica a todos los madrileños en paro que han agotado sus prestación animaría el consumo interno, además de mejorar la situación de malnutrición y pobreza propias de un país tercermundista que ha sufrido esta ciudad a raíz de la crisis. </p>

<p>Aunque en otros foros se ha hablado de 600, las necesidades y los precios de la capital harían imprescindible que en un plazo breve de tiempo esa prestación fuese no inferior a 800  para personas con hijos y 650  para quien no tiene cargas familiares. </p>

<p>Un impuesto especial solidario al 5 o 7 % de las mayores fortunas de Madrid lo harían perfectamente viable. </p>

<p>Es momento de mojarse para salir de esta crisis y que sean quienes la provocaron los que más aporten para solucionarla. </p>
";"09/09/2015 16";"69";"17";"52";"4";"863160201";"-862"
"2856";"Linea circular C1 y C2 Emt";"<p>Muy buenas!</p>

<p>soy asidua a esta linea porque particulamente me va fenomenal y porque pasa con bastante frecuencia.</p>

<p>Aun así me quejo porque los conductores, sobretodo por la noche, van muy rápido. Impacientes, frenan bruscamente, pitan, groseros...</p>

<p>No veo la necesidad de correr. Hay personas mayores.</p>

<p>Con que vayan un poco mas despacio, es suficiente</p>

<p>muchas gracias</p>
";"09/09/2015 17";"17";"7";"10";"1";"865214366";"-123"
"2857";"Una calle para Cipriano Mera en Tetuán";"<p>Entre las calles Almansa y Doctor Santero en el barrio de Tetuán, en el solar de las antiguas cocheras del tranvía, se están terminando de un puñado de bloques de pisos que darán origen a una nueva calle o callejón. En vista de que el barrio tiene un montón de calles dedicadas a militares fascistas, me gustaría proponer que la nueva calle se llame <strong>Cipriano Mera</strong>, albañil, vecino del barrio y anarquista que peleó en la Guerra Civil española.</p>

<p>* Propuesta de Antonio Beltrán en twitter: https://twitter.com/abeltranmoreno/status/641606615192465410</p>

<p> </p>
";"09/09/2015 17";"40";"22";"18";"2";"870672988";"220"
"2858";"Una pagina para escraches";"<p>Donde podamos subir libremente fotos de los vecinos que tiran colillas a la calle, que no recogen el escremento de los perros, que tiran basura fuera de hora, que se saltan los semaforos, que les tiran el coche encima a las bicicletas, etc, etc.</p>

<p>Como no siempre va a estar el guardia para reprenderlo o multarlo, siempre podemos estar todos de alguna manera denunciando a los que hacen mas dificil convivir en Madrid</p>

<p> </p>
";"09/09/2015 17";"39";"9";"30";"0";"864075232";"-484"
"2859";"Metro en el barrio de Las Aguilas";"<p>Este barrio, próximo al de Aluche, ha sido ignorado por todos los gobiernos municipales y regionales desde la llegada de la democracia. Las únicas paradas de metro cercanas se encuentran en el Parque Europa y en Aluche, debiendo usar Cercanías o autobuses, que tienen un horario de cierre mucho más temprano que el del Metro. La puntilla se dio cuando se decidió ampliar la línea 11 directamente hasta el PAU de Carabanchel y el Barrio de la Fortuna, olvidándose de este barrio y dejándolo desconectado de la red de Metro. Otras actuaciones, como la eliminación de la línea 117 los domingos, también han degradado el trasporte de la zona. ¿De verdad no se puede pensar en una ruta alternativa, por calles que no tienen servicio de bus, para hacer llegar a Aluche esta línea? Esto haría que esta línea fuese usada por más personas, y que no se pudiera esgrimir la poca utilización de la misma (han hecho coincidir la mitad de su trayecto con el de la línea 17 ) para su eliminación en domingo.</p>

<p>Otro asunto es la frecuencia de paso del 17 por las mañanas para conectar el barrio con los metros de Aluche y Aviación Española, que es a todas luces insuficiente.</p>
";"09/09/2015 17";"32";"22";"10";"11";"875313825";"825"
"2860";"Implementar una nueva tarifa de HORA para coches de empresa o de trabajadores";"<p>Es necesario dar una solución a los vehiculos de los trabajadores que necesitan entrar a Madrid para una obra, para una reparación. Que estará toda la jornada laboral con ello ... y su vehiculo solo puede estar cuatro o dos horas en esa zona de aparcamiento.</p>

<p>No es fácil ... pero según esta organizado ahora es de locos ...</p>
";"09/09/2015 17";"26";"12";"14";"0";"865772507";"-92"
"2861";"Apoyo y promoción del deporte minoritario.";"<p>En un país en el que el baloncesto y, especialmente, el fútbol acaparan por completo el ámbito deportivo, una ciudad que en su día incluso intentó ser olímpica como Madrid, debería dar apoyo al resto de deportes, ya que estos también cuentan con muchos practicantes entre nuestra población.</p>

<p>Actualmente, prácticamente en cualquier barrio de Madrid sólo existen campos municipales gratuitos de fútbol y de baloncesto. Creo que esto debería cambiar y empezarse a construir otro tipo de pistas que fomenten los deportes algo más minoritarios.</p>
";"09/09/2015 17";"31";"22";"9";"0";"875069122";"922"
"2862";"AUTOBÚS Express  desde Pza DE CASTILLA a al AEROPUERTO Madrid ";"<p><strong>Propuesta de Autobús Express desde PLAZA DE CASTILLA AL AEROPUERTO DE BARAJAS</strong></p>

<p>Actualmento solo existe este servicio desde Atocha y Colón </p>

<p>No entiendo como estando la plaza de Castilla y la estación de chamartín a  menos de 10 minutos del aeropuerto no haya Autobús directo.</p>

<p>¡ Autobús YA !</p>

<p> </p>

<p> </p>

<p> </p>
";"09/09/2015 17";"34";"21";"13";"2";"872928468";"494"
"2863";"Hacer pública la verdadera edad de Íñigo Errejón";"<p>Pues eso, estamos hartos de que los dirigentes de Podemos nos engañen a todas horas con mentiras que no cumplen. Y si nos engañan incluso con la edad, quién va a confiar en ellos?</p>

<p> </p>

<p>Queremos saber la edad de Íñigo, que no debe alcanzar los 19 años.</p>
";"09/09/2015 17";"54";"28";"26";"0";"868748883";"103"
"2865";"¿Seria Posible establecer  las MINUSCAPACIDADES  ALIMENTARIAS  como tema de deba";"<p>Me refiero a las Minuscapacidades Alimentarias  (  determinadas por los medicos)  ---- Diabetes , Intolerancias ,  Dietas hiposodicas,  etce, etc</p>
";"09/09/2015 17";"13";"0";"13";"0";"867208450";"0"
"2866";"Basura subterránea, suciedad y malos olores en las calles para mejorar la ciudad";"<p>Buenas,</p>

<p>Creo que muchas de las calles de Madrid están muy sucias alrededor de la zona habilitadas para lo cubos de basura organica, cubos de basura plásticos, contenedores de Cristal, contenedores de carton/papel.</p>

<p>La gente no tiene educación y tira las bolsas de basura fuera de los cubos, los vidrios se estallan en las mismas aceras, los cartones y papeles se dejan de pie juntos a los contendores, por no hablar por otros ""trastos"" que la gente deja junto a los contenedores, todo esto hace que cualquier personas que viva en las inmediaciones de la zona de basura vivan verdaderos problemas de suciedad, olor y salud. Seria estupendo ir por las calles de madrid y encontrarnos con un entonro más agradable y limpio.</p>

<p>El sistema de recogida de basuras es fundamental para una ciudad y por eso me gustaría proponer los benficios que llevaria a cabo un sistema de recogidas de BASURA SUBTERRANEA, beneficia el aspecto de la ciudad, por ejemplo con las altas temperaturas de la temporada de verano se hubieran evitado olores insoportables en aquellos lugares donde la basura queda depositada, hablo de suelos, paredes, aceras, etc...</p>

<p>Como caso practico en Majadahonda ya esta funcionando la recogida neumatica de basuras.</p>

<p>Con este tipo de funcionalidad se evitan malos olores, suciedad por las calles, gases, riesgos higiénicos y ruidos provocados por los camiones de basura.  </p>

<p>Entiendo que dar calidad de vida para los ciudadanos siempre debe ser la prioridad de cualquier ayuntamiento y la recogida de basura dependen directamente de la gestión del ayuntamiento.</p>

<p>Muchas gracias.</p>

<p> </p>
";"09/09/2015 17";"38";"33";"5";"1";"879838298";"2431"
"2867";"los baches";"<p>Madrid esta llenita de baches, cosa que alegrará a los talleres de toda la ciudad por los palos que meten, pero a nosotros no nos hace gracia. Hay tramos que estan horriblemente mal (todos tenemos alguno en mente).</p>

<p>No solo basta con tapar ahi, y venga, no pasa nada, para eso pagamos impuestos y no precisamente pocos. </p>

<p> </p>

<p>Vamos Manuela confiamos en ti, viva Juanfran "" Zeppelin"" Torres.</p>
";"09/09/2015 17";"196";"193";"3";"5";"889701903";"18709"
"2868";"100 dias";"<p>Aunque no me sienta concernado,me gustaría abrir un debate sobre quien de los votantes de Ahora Madrid se siente ""decepcionado""con la gestión de este nuevo ayuntamiento.estaria bien la sinceridad y saber si volverían a votar o cambiarían.</p>
";"09/09/2015 17";"38";"12";"26";"6";"863530463";"-442"
"2869";"Animales de compañía en transporte público";"<p>Sería interesante que se pudieran meter en todo tipo de horarios a los animales de compañía, en su correspondiente ""transportin""</p>
";"09/09/2015 17";"72";"36";"36";"10";"868811910";"0"
"2870";"Transporte público más barato en verano";"<p>Sería interesante que el transporte público fuera más barato en verano, a cambio de que haya menor frecuencia de servicio. Esto se puede hacer extensible a EMT, Metro, Cercanías...</p>
";"09/09/2015 17";"29";"8";"21";"2";"864132730";"-358"
"2871";"Carril bici entre Madrid y Rivas";"<p>El ayuntamiento de Madrid debería construir un bicicarril que una el Ensanche de Vallecas con el municipio de Rivas, teniendo como objetivo la seguridad de los biciusuarios que frecuentemente tienen que desplazarse entre las dos localidades poniendo en riesgo su seguridad al transitar por la A3 o por caminos maltrechos que atraviezan la Cañada Real. Al existir una vía segura para el transito de bicicletas Madrid-Rivas, y viceversa, muchas personas se animaría a tomar la bicicleta para ir a sus lugares de estudio o trabajo de forma rápida y ecológica, ahorrandose el costo del billete de metro o cercanías o evitando los embotellamientos de las horas punta.</p>
";"09/09/2015 17";"61";"47";"14";"5";"879169779";"2542"
"2872";"Que quiten a Rita maestre del ayuntamiento ya ";"<p>solo por respeto a la sociedad madrileña , Rita maestre debería irse del ayuntamiento </p>

<p>muchas gracias </p>
";"09/09/2015 17";"64";"28";"36";"4";"863516262";"-350"
"2873";"Traslado del ayuntamiento de Madrid  y otros servicios a Villaverde Alto";"<p>El ayuntamiento de Madrid está situado en un local costosísimo para todos, sinembargo la mayor parte de los servicios se ofrecen online o través de las juntas de distrito. </p>

<p>Actualmente el barrio de Villaverde Alto está muy bien comunicado con el centro de Madrid y es posiblemente el que mejores precios inmobiliarios tiene.  El precio del medio del alquiler de oficinas en el barrio Jeronimos es de unos 20/m2 al mes, mientras que en Villaverde Alto es de unos 5/m2 al mes. </p>

<p>El traslado de las oficinas centrales del ayuntamiento de Madrid supondría un enorme ahorro de costes para todos los madrileños, no perjudicaría las gestiones que ya se hacen en proximidad y supondría un gran beneficio para uno de los barrios más deprimidos de Madrid. </p>

<p> </p>
";"09/09/2015 17";"35";"13";"22";"6";"863837866";"-334"
"2874";"Tasa sobre la propaganda";"<p>Me gustaría escuchar la opinión general sobre la posibilidad de establecer una tasa sobre los emisores de la propaganda que recibimos los ciudadanos a diario en nuestros buzones, en nuestros coches y paseando por las calles.</p>

<p>En mi opinión sería justo que las empresas y personas que se benefician de esa publicidad contribuyan a subsanar el problema de basuras que ocasionan con sus comunicaciones. A este problema hay que añadir el enorme gasto energético que esta actividad lleva asociada.</p>

<p>Entendiendo la posible utilidad de la publicidad en papel como elemento dinamizador de la economía local creo que sería interesante plantear alguna medida de control sobre esta actividad con el fin de promocionar otras alternativas menos intrusivas y más respetuosas con las personas, con nuestra ciudad y con el medio ambiente.</p>
";"09/09/2015 17";"41";"36";"5";"0";"880444630";"2721"
"2875";"No a los papeles pegados en papeleras, farolas, árboles, fachadas, etc.";"<p>Sería facilísimo evitar esta forma de prpaganda privada en sitios públicos, que pagamos todos con la limpieza que produce, para beneficio de unos pocos.</p>

<p>En todos los papeles, carteles, placas, etc. aparece el teléfono del responsable de esta práctica incívica y totalmente egoista</p>
";"09/09/2015 17";"33";"27";"6";"2";"878280657";"1718"
"2876";"Casa de Campo - Aravaca";"<p>La entrada a la Casa de Campo desde Aravaca ( Urb. Rosa de Luxemburgo) es nefasta para peatones y ciclistas e imposible para personas con discapacidad. Urge una rampa que salve la Vía de las Dos Castillas o por lo menos, si no hay presupuesto, la reparación de las escaleras de madera que suben desde la vía del tren. Ya han provocado varias caídas y cualquier día provocarán algún accidente más grave. También sería necesaria la limpieza de la tierra que se acumula en el paso paralelo a las vías del tren así como algún tipo de murete que impidiera cuando llueve el paso se llene de agua y barro.</p>
";"09/09/2015 17";"30";"22";"8";"2";"875907544";"1026"
"2877";"No a los papeles pegados en papeleras, farolas, árboles, fachadas, etc.";"<p>Sería facilísimo evitar esta forma de prpaganda privada en sitios públicos, que pagamos todos con la limpieza que tenemos que hacer de la suciedad que produce, para beneficio de unos pocos.</p>

<p>En todos los papeles, carteles, placas, etc. aparece el teléfono del responsable de esta práctica incívica y totalmente egoista</p>
";"09/09/2015 17";"57";"52";"5";"2";"882685844";"4287"
"2880";"Municipalizar las clínicas veterinarias";"<p>La salud de los animales debe estar tan protegida como la de los humanos y si para estos hay un seguro de enfermadad gratuito, también debería implantarse para aquellos. La mejor forma, a mi juicio, sería expropiando las clínicas veterinarias, haciendo funcionarios a los empleados y mejorando la caidad del servicio. Estoy seguro que algún concejal aceptaría organizar el sistema, igual que han sido capaces de crear una página web tan fantástica como esta del gobierno abierto.</p>
";"09/09/2015 17";"59";"22";"37";"7";"863008308";"-559"
"2881";"UNA VERGUENZA Q TARJETA FUNDACION CONSTRUXION COBREN A LOS PARADOS 200e o mas.";"<p>Q VERGUENZA Y ASCO Q LA TARJETA D CONSTRCCION COBREN DESDE 140e 160 180 200 300 Y ASI SI LA UNION EUROPEA LOS DIO MUCHO DINERO PARA ESTO QUIEN ESTAN LUCRANDOSE CON ESTO APARTE LOS DEL SOCIALISTAS DE LOS ERES.ASCO LOS GOBIERNOS INUTILES NADIE DICE NADA,SI UN PARADO NO TIENE NI PARA COMER COMO VA PAGAR TANTO DINERO.PIENSEN UN POQUITO SENTIDOCOMUN.</p>
";"09/09/2015 17";"19";"2";"17";"1";"866064005";"-157"
"2882";"Carril Bici de Moncloa a Somosaguas";"<p>Los estudiantes de la UCM del Campus de Somosaguas apenas tenemos transporte público eficiente, salvando los autobuses municipales, y muchxs demandamos carril bici a traves de Casa de Campo y que inicie desde Moncloa hasta acabar el el campus, que tengamos más viabilidad para not ener que perder tiempo cambiando de vias y buscando la forma de llegar sanos y salvos</p>
";"09/09/2015 17";"40";"30";"10";"0";"877173334";"1500"
"2883";"Badenes en calles";"<p>Propongo sustituir los badenes en suelo por postes verticales con pantalla indicadora de la velocidad del vehículo en ese momento. Mejor para el vehículo y oncienciación del conductor.</p>
";"09/09/2015 17";"25";"9";"16";"3";"864412911";"-252"
"2884";"Buena educación dentro transporte público";"<p>Señalización adecuada dentro de los autobuses principalmente recordando a la gente que sus conversaciones por teléfono no nos interesan en absoluto. </p>

<p>No utilizar los auriculares e imponer  tu música, videos o jueguecitos sonoros a los demás me parece una señal de que el prójimo no te importa nada. Si vas leyendo es una tortura.</p>

<p>! Menos ruido por favor!</p>
";"09/09/2015 17";"34";"30";"4";"4";"880086756";"2294"
"2885";"No a que las personas escupan o hagan las necesidades en la vía pública";"<p>En el barrio de Usera, quienes escupen en la calle es un colectivo tan grande que el ruído que hacen produce verdaderas nauseas en la gente de bien. También hay otro que hace sus necesidades, todas, entre coches, en las esquinas, etc.</p>

<p>Creo que multar por algo que seguro está prohibido en alguna ordenanza, acabaría con esa práctica tan deleznable</p>
";"09/09/2015 17";"67";"61";"6";"4";"883376438";"5007"
"2886";"Que las Bases del SAMUR siempre tengan dotación";"<p>He observado que en  las bases como las de Vallecas Villa, Hortaleza, Barajas, Fuencarral entre otras por las noches  y muchos dias no tienen  hay ambulancias. creo que se debian dotar de este servicio no solo de un edificio vacio.</p>
";"09/09/2015 17";"88";"84";"4";"14";"885809952";"7636"
"2887";"Ya que van a repartir ceniceros...";"<p>... nos podrían dar un puro los domingos con el dominical de los periódicos.</p>
";"09/09/2015 17";"34";"11";"23";"2";"863953213";"-388"
"2888";"Transporte público en el Encinar de los Reyes";"<p>Aprovecho esta gran iniciativa del ayuntamiento para solicitar transporte público en el Encinar de los Reyes. Para quien no lo conozca esta al lado de Sanchinarro, pertenecez a Madrid capital, no es Alcobendas, y no tenemos ni un solo autobús de la EMT. Pasa únicamente uno de los verdes, el B155 creo que es. Este autobús tiene mayor precio que los de la EMT, menos frecuencia de paso y esta fuera de la zona A (mayor importe del abono transporte). Es algo que no entendemos los vecinos del barrio, no pedimos metro, con un par de línea de autobús nos conformaríamos, una que vaya hacía valdebebas y otra a sanchinarro, de esta forma podríamos coger el metro ligero, cercanías, aprovechar el parque de Valdebebas...</p>

<p>Gracias por la atención.</p>

<p> </p>
";"09/09/2015 18";"55";"50";"5";"1";"882567463";"4090"
"2890";"Reconstrucción del Templete del Metro Gran Vía de Antonio de Palacios";"<p>En épocas recientes la ciudad de Madrid ha perdido muchas de sus pequeñas joyas arquitectónicas y de movilidad. Aquellas que por su diseño calidad, valores estéticos y funiconales las hacía únicas y daban un fuerte carácter propio a Madrid. Muchas de ellas se eliminaron por hacer el flaco favor a políticas de movilidad cenradas en convertir la ciudad en una autospista sólo para el coche. Así, se perdieron algunos elementos originales del Metro de Madrid, diseñados por el arquitecto Antonio Palacios, para dejar sitio a los coches, como fue el templete de ascensores de la Estación de Gran Vía.</p>

<p>En la actualidad esta estación carece de acceso por ascensores y es un buen momento para instalarlos, darle el acceso que corresponde según las normas de movilidad y podríamos tener la oportunidad de recuperar este hito urbano perdido.</p>

<p>Mas info:</p>

<p>https://es.wikipedia.org/wiki/Templete_del_Metro_%28Red_de_San_Luis%29</p>

<p>http://www.elpais.com/especial/gran-via/red-de-san-luis/</p>

<p> </p>
";"09/09/2015 18";"79";"71";"8";"17";"883985822";"5662"
"2892";"Motos en las aceras";"<p>Me gustaría que las motos no aparcasen en las aceras pero si esto fuese inviable inmediatamente, me gustaría que por lo menos y mientras tanto, hubiese un lugar delimitado para que aparcasen y que toda moto que estuviese aparcada fuera de ese lugar fuese multada como lo son los conductores de coches. No puede ser que aparquen donde quieran, invadan las aceras, los paseos y que no puedas sentarte en un banco público sin estar rodeada de motos. Tampoco entiendo que una bici sea multada por ir por la acera, con lo que estoy de acuerdo, pero que si pueda ir una moto en marcha hasta el punto donde quiera aparcar.</p>
";"09/09/2015 18";"46";"22";"24";"4";"867160532";"-95"
"2894";"Prohibir fumar en las marquesinas de las paradas de autobús";"<p>¿A quién no le ha pasado de estar esperando en una marquesina de una parada de autobús y que haya una, dos, tres personas agobiándole con el humo de sus cigarrillos? Me parecería una medida muy positiva el prohibir a la gente que lo haga, ya que desde mi punto de vista no es muy diferente de en interiores (puesto que no puedes irte de la parada te acabas tragando el humo igual). Sería una medida muy positiva de cara a mejorar la convivencia entre ciudadanos, y además contribuiríamos a mantener los entornos de las paradas de autobús libres de colillas.</p>
";"09/09/2015 18";"67";"46";"21";"11";"877633467";"1716"
"2896";"Que no se repitan los temas de los debates";"<p>O bien que exista un moderador, que no deje entrar temas repetidos</p>

<p>O que haya una manera de poder averiguar si un tema que vamos a proponer ya existe</p>
";"09/09/2015 18";"51";"48";"3";"6";"883335694";"4235"
"2897";"Mejorar la accesibilidad de la línea 9 de metro";"<p>Tras la venta de los trenes de la serie 6000 al metro de nuevos aires, la línea 9 ha reducido su accesibilidad para personas discapacitadas. Actualmente el servicio se presta principalmente con unos trenes antiguos (serie 5000), sin megafonía para anunciar las estaciones, sin paneles luminosos, sin plazas para sillas de ruedas y sin rampas para que estas últimas puedan subir al tren y unos pocos trenes más nuevos (serie 9000) que si cuentan con estos avances.</p>

<p>Estaría bien realizarles una pequeña reforma interior a los trenes más antiguos para solventar estos problemas al mismo modo que la recibieron algunos trenes de esta misma serie que circulan por la línea 6.</p>
";"09/09/2015 18";"32";"28";"4";"4";"879899236";"2100"
"2898";"Mejorar el trabajo del profesor de música";"<p>Me gustaría hacer una propuesta al sistema actual de formación musical. Mi propuesta está relacionada con la educación artístico/musical, actualmente la titulación que se obtiene al finalizar los estudios de Grado Profesional (Grado Medio en el plan del 66 de la LOGSE y Título Profesional de Música en la especialidad estudiada en la LOE) es Profesor de música en la especialidad estudiada, lo lógico sería que se valorara por igual a los que estudiaron con el plan del 66, ya que la ley actual (LOMCE) solo contempla que con el (Título Profesional de Música) que se obtiene al finalizar los estudios de Grado Medio (LOGSE) o Grado Profesional (LOE) solo pueden enseñar en escuelas de música cuyos estudios no son reglados, dar clases de música en colegios privados o tocar como miembro en una orquesta, mientras que con el plan del 66 (Título de Profesor) que se obtenía al finalizar los estudios de Grado Medio si, (estudios que tenían diferente duración que la ley LOGSE o LOE, porque dependiendo de los años estudiados se te daba una cualificación para ejercer de profesor en diferentes ramas) estos si competen al titulado ejercer la docencia reglada tanto en centros públicos como privados, reglados o  no y equipara dicha titulación a la obtenida en el Grado Superior en la especialidad de instrumentista puesto que se podría ejercer la docencia en las enseñanzas superiores de música en la especialidad tuya.</p>

<p>Mi propuesta es que se modifiquen los requisitos que se solicitan para ejercer de profesor en las enseñanzas regladas de música tanto en centros públicos como privados. Ya que esta modificación facilitaría a todos los que se titularon con la ley (LOGSE, LOE y LOMCE) poder incorporarse como profesor de música en centros de enseñanza primaria, secundaria y bachillerato tanto públicos como privados y en conservatorios públicos y privados. A esta modificación se le podría añadir como estaba antes con los del plan del 66 que para poder ejercer de docente necesites un título de capacitación psicopedagógica o lo que se conocía como CAP sin que para obtener dicho título tuvieses que tener un título universitario, solo tendría que ser suficiente que cumples los requisitos para cursas los estudios superiores de música.</p>

<p> Además estos cambios harían que muchos músicos pudiesen tener un trabajo con lo cual las listas del paro disminuirían. Y además destaco que estos cambios de ley lo que hicieron fue degradar los estudios de música.</p>
";"09/09/2015 18";"23";"13";"10";"1";"870560707";"169"
"2899";"Centro de Salud";"<p>Ya somos muchos vecinos los que vivimos en el barrio de Valdebebas,y necesitamos un centro de salud,pues nos han colocado ,mar de cristal, o sanchinarro,que están colapsados, necesitamos un centro de salud en el barrio para poder ir andando y estar bien atendidos.</p>

<p>Muchas gracias </p>

<p>Un  saludo</p>
";"09/09/2015 18";"133";"127";"6";"1";"887588230";"11554"
"2900";"COLARSE METRO 30e TU CREES Q SI TUVIERA 30E SE COLAR";"<p><strong>Colarse en metro por que cobran 30e q estudien cada caso si es un parado de donde va pagar un parado sin ningun ingresos deberian por derecho tener todos los cursos gratuitos FUNDACION LABORAL DE RIESGOS LABORALES INFORMATICA COMEDORES SOCIALES,Q NO TARDEN MUCHO EN DAR,NO ES Q PODEMOS OFRECE 600E DE RENTA YO SOLO PIDO ESTAS COSAS AL MENOS PERO YA NO SOLO DE VOCA LLEGAN AL PODER Y NO SE VE NADA mejor la cifuentes va dar bono de 10e para parados.va ser q cifuentes es mejor q carmena.</strong></p>
";"09/09/2015 18";"31";"4";"27";"2";"865800833";"-296"
"2901";"Ampliación horario Parque del Retiro";"<p>Ampliar el horario de apertura del parque del Retiro hasta las 02.00 a.m. (o no cerrarlo) tanto en invierno (actualmente cierra a las 10p.m.) como en verano (actualmente cierra a las 00a.m.).</p>

<p>Evitaría que los vecinos tuvieramos que dar la vuelta, para volver a casa, permitiría a las personas con peores horarios laborales seguir saliendo a correr sea invierno o verano, y no aumentaría costes, ya que la iluminación se mantiene aunque el parque esté cerrado.</p>
";"09/09/2015 18";"49";"34";"15";"9";"877025188";"1318"
"2903";"Usar calles pequeñas como carril bici";"<p>Habilitar las calles pequeñas paralelas o cercanas a las grandes arterias como carril bici, prohibiéndolas para el tráfico motorizado y dejándolas en exclusiva para los residentes de dichas calles y bicicletas. De este modo se podría generar una auténtica red de carriles bici a un precio super-económico. La modificación de las calles apenas tendría coste para el ayuntamiento  y nos beneficiariamos tanto los que estamos deseando poder convertir la bici en nuestro medio de transporte en Madrid, como el tráfico motorizado, que se aprovecharía de la reducción de vehículos. </p>

<p>Somos miles los que queremos usar la bici como medio de transporte en Madrid, pero no nos atrevemos a compartir carril con los coches. Entiendo que hacer nuevos carriles donde no existen tendría un alto precio y una difícil solución ya que en numerosos lugares no existe espacio para ello, por eso considero que en muchas calles se podría utilizar este sistema dejando las calles grandes para coches, motos y autobuses y las pequeñas calles adyacentes para bicis ( y entrada, salida y aparcamiento de residentes, por supuesto) </p>

<p>Ventajas:</p>

<p>- Las bicicletas tendrían espacio real en la ciudad como medio de transporte.</p>

<p>- El tráfico motorizado se aprovecharía de la disminución de vehículos pues muchas personas cambiarían el coche por la bici.</p>

<p>- El Ayuntamiento se beneficiaría por no tener que pagar multas de muchos millones de Euros a la Comunidad Europea por exceder los niveles de contaminación.</p>

<p>- El Ayuntamiento se beneficiaría porque en lugar de gastar millones de euros en la construcción de carriles bici, simplemente tendría que invertir una cantidad ridícula en comparación para habilitar las zonas de las correspondientes señales.</p>

<p>- Tanto el tráfico motorizado como el ciclista se beneficiarían de no tener que compartir la misma calzada, donde las diferencias de potencia y velocidad son un incordio para ambos.</p>

<p>- Los residentes en las calles transformadas en  carril bici se beneficiarían de mucha mayor tranquilidad, reducción de ruidos y contaminación y mayor posibilidad de aparcamiento en sus calles.</p>

<p> </p>
";"09/09/2015 18";"62";"42";"20";"11";"877309003";"1490"
"2904";"La Danza, un arte agonizante";"<p>Quizá parezca un asunto menor pero la realidad de los bailarines profesionales y los jóvenes que pretenden serlo, en Madrid y en España es descorazonador.</p>

<p>Nuestra Asociación ha confeccionado una carta abierta a Celia Mayer Duque, Concejala Delegada del Área de Gobierno de Cultura y Deportes de la Villa de Madrid con objeto de llamar su atención sobre este problema dando alguna alternativa para mejorar esta lamentable situación.</p>

<p>Enlace a la carta abierta a Celia Mayer Duque: http://www.amigosdeladanza.es/Carta-cultura-ayuntamiento-madrid.html#carta</p>
";"09/09/2015 18";"20";"13";"7";"4";"873322057";"390"
"2905";"Sanción a quien NO respete los carriles bici";"<p>Lo habitual, es que la gente pida cosas como ""quiero carril bici por toda la ciudad"", pero aunque llenásemos toda la ciudad con un carril bici, en cada calle de cada barrio, al final todo eso es inútil si nadie lo respeta.</p>

<p>Cuando vas por la casa de campo, los tramos en los que hay carril bici, uno se encuentra de todo menos bicis. Desde la señora que va paseando a su perro con la correa extensible desde la otra esquina, hasta las familias que van todos caminando en paralelo ocupando toda la calzada, pasando por patinadores que van haciendo unas eses exageradamente grandes, perros sueltos que se tiran a morder en los tobillos, etc.</p>

<p>En los carriles que están por la ciudad (que son muchísimo más estrechos), lo normal es que las madres metan por ahí los carritos de los niños, los carritos de la compra, o que la gente simplemente le da por caminar por ahí cuando simple y llanamente, NO PUEDEN. Incluso hay sitios, como por ejemplo en la calle General Ricardos, en los que los bares directamente ponen su terraza encima del carril, con lo que cada vez que llegas a ese punto, esperas a que se levanten, te miren con mala cara, pases y luego ya vuelven otra vez a ponerse donde estaban.</p>

<p>En los tramos que están por el centro (Sol, etc.) las motos los invaden como si fueran para ellas, incluso en las narices de los agentes de movilidad... y allí nadie les dice nada.</p>

<p>Si en la Policía Municipal hay agentes que se dedican a recorrerse el paseo del Madrid-Río sancionando a los chavales que van con monopatines haciendo un poco el cabra, teóricamente ""molestando"" a los pobrecitos peatones, que lo hagan extensivo también a la inversa. Que destinen patrullas por los carriles bici para que se vigile que se hace un uso correcto de los mismos.</p>

<p>Como peatones tenemos TODA LA ACERA para nosotros... no entiendo por qué la gente se empeña en invadir el carril destinado para bicis, con lo escasos que son... (ya sin mencionar, la gente que deja la mierda de su perro allí plantada, como si NO fuera OBLIGATORIO recogerla).</p>
";"09/09/2015 18";"42";"30";"12";"4";"876989751";"1285"
"2906";"Tasa a los chicles.";"<p>Muchísimas aceras dan asco por la gran cantidad de chicles pegados en ellas.Dado que me parece imposible convencer a la gente, sobre todo gente joven, para que sea limpia, y no veo sentido a que la policía se dedique a perseguir y multar a los que tiren chicles, creo que sería buena idea poner una tasa a los chicles, de forma que lo que se recaude sirva para pagar la limpieza de los mismos.</p>
";"09/09/2015 18";"36";"28";"8";"2";"878045150";"1555"
"2907";"Poner en cada semaforo un avisador acustico";"<p>Poner un avisador acustico para las personas invidentes para que puedan conocer el estado del semaforo.</p>
";"09/09/2015 18";"32";"28";"4";"0";"879916725";"2100"
"2908";"Escuelas de Música Municipales";"Podemos afirmar a fecha de hoy, que el Ayuntamiento (anterior) suprimió la subvención a
las escuelas. Y ante la falta de respuesta de éste con respecto a las empresas adjudicatarias y los sindicatos, y por lo tanto la imposibilidad de actuación de éstos: los usuarios de todas las Escuelas Municipales de Música de la ciudad de Madrid tendrán que abonar el 100% del coste del servicio, lo que supone un incremento en las tasas de casi el triple de la mensualidad actual. El ayuntamiento tampoco ha contestado a posibles cambios pedagógicos, como l disminución del ratio de alumnos por clase para compensar la subida de tasas con un servicio más personalizado.

Esta subida desorbitada será imposible de soportar por muchas familias y llevará la
disminución del número de alumnos. Con ello, habrá parte del profesorado que se quede sin empleo, y todo este deterioro puede llevar, incluso, al cierre total de las Escuelas Municipales de Música.

PEDIMOS SE FINALICE CON ESTA PRIVATIZACIÓN. Tenemos derecho a la MÚSICA TODOS LOS MADRILEÑOS (no sólo los ricos) ;)
";"09/09/2015 18";"52";"43";"9";"8";"880766537";"2811"
"2909";"Paseo de Santa María de la Cabeza";"<p>En el programa de ahora madrid se habló de una reestructuración de dicho paseo para hacerlo más peatonal, más arbolado y en general más agradable. ¿ Llevarla acabo? Opinen.</p>
";"09/09/2015 18";"55";"49";"6";"4";"882525390";"3830"
"2910";"Que la Iglesia Católica pague el IBI.";"Al igual que otros entidades religiosas, organizaciones, sociedades mercantiles, ciudadanos, etc., la Iglesia Católica debe abonar el IBI. La enorme cantidad de edificios que posee en Madrid hace que el Ayuntamiento recaudará una substanciosa cantidad de dinero que revertirá en los ciudadanos.";"09/09/2015 18";"101";"74";"27";"5";"880244652";"3443"
"2911";"quitar el s.e.r, La calle es de todos ";"<p>Para lo que queremos madrid es la suma de todos....nos a jodido todo el día pagando. La zona azul y verde es un atraco al ciudadano. ¡Ya pagamos impuestos!</p>
";"09/09/2015 18";"40";"12";"28";"2";"864248558";"-480"
"2912";"Ampliación Línea 11 de metro";"<p>¿Para cuándo la ampliación de la línea 11 de metro desde la estación de Plaza Elíptica?  Actualmente, la línea 11 de metro (7 estaciones), que da servicio al barrio de La Fortuna de Leganés, el PAU de Carabanchel Alto y parte de Carabanchel Bajo, termina y tiene su única conexión  en la estación de Plaza Eliptica de la línea 6 (circular). El proyecto de ampliación lleva años en un cajón (dijeron que ha causa de la crisis).</p>
";"09/09/2015 18";"50";"42";"8";"3";"880869375";"2856"
"2913";"parque publico calle bustamante esquina rafael de Riego";"<p>Buenas...vivo cerca de la Estacion de Delicias de Cercanias , alli hay un parque que siempre esta lleno de gitanos rumanos o no se que son...no quiero ofender a nadie... ensuciandolo todo todos los dias y durmiendo `por la noche con gritos, borracheras etc etc</p>

<p>Los que vivimos alli cerca lo sufrimos cada dia...hablamos de la limpieza...pero que hacemos con esta gente? mi abuela no puede hacer uso del parque...bueno mi abuela y todos los vecinos ya que esta lleno de este tipo de gente que lo ensucian cada dia, la chioca que limpia cada mañana (la admiro) se lleva una cantidad de basura todos los dias impresionante, los parques deberian ser para los ciudadanos que pagamos impuestos...la imagen es lamentable...al lado de la estacion de Delicias...que hacer?</p>

<p> </p>
";"09/09/2015 19";"38";"36";"2";"24";"883067807";"3221"
"2915";"Arcén de la M30 en hora punta";"<p>La idea es permitir a las motocicletas, bajo unas estrictas condiciones, utilizar el arcén de la M30 (y quizá M40) para poder circular, ayudando a liberar el tráfico rodado. Esta ""habilitación"" se podría restringir sólo a ciertas franjas horarias, como por ejemplo de 7 a 10 horas y de 17 a 20 horas (ilustrativo), con una velocidad máxima reducida restringida a, pongamos, 60km/h, y por supuesto con la obligación de abandonarlo en caso de necesidad (ambulancia, policía, bomberos, etc...).</p>

<p>Con esta medida nos ahorraríamos accidentes de motoristas que circulan entre filas de coches, en las que alguno se olvida tanto de indicar con el intermitente su intención de cambiar de carril, como de comprobar por los retrovisores que no viene nadie. Aliviariamos un poco más la congestión de la ciudad, aprovecharíamos al máximo las posibilidades de nuestra red vial que tan cara es de mantener en buen estado, y fomentaríamos el uso de transporte más ecológico, económico y cómodo, por no hablar del aumento de plazas de parking disponibles en las calles, pues en el sitio de depende qué coche, se pueden meter 5 ó 6 motos.</p>

<p>Creo que se podría al menos valorar la ejecución de un piloto de un par de meses de duración y valorar la experiencia en función de los resultados obtenidos, el contento popular, etc.</p>
";"09/09/2015 19";"37";"18";"19";"3";"867924495";"-48"
"2916";"publicidad de los pliegos de los contratos publicos";"<p>No estaria mal el publicar los contratos publicos  del ayuntamiento de madrid , creo que contribuiria a la transparencia , que tanto se hecha de menos, y en un formato que luego sea manejable, ya que en un wordesta bien , pero es poco practico, mejor seria en libros de Excel</p>

<p> </p>

<p>Un Saludo</p>
";"09/09/2015 19";"13";"10";"3";"2";"874676177";"538"
"2918";"educación pública en el ensanche de Vallecas ";"<p>lLa competencia en educación depende de la comunidad de Madrid. Pero en el ensanche de Vallecas llevamos años esperando un instituto público y todos los años tenemos problemas en la escolarización de los niños de infantil y primaria por la falta de previsión de plazas. Esto ha llevado a que muchos padres nos veamos obligados a llevar a nuestros hijos, al acabar primaria, a institutos muy alejados de nuestras casas. Y en infantil y primaria hemos sido testigos de la pintoresca situación del colegio José de Echegaray, que lleva tres cursos desplazado a un centro provisional y aún no ha sido terminado; y encima se planifical y construye como centro de linea tres, pero este curso se ha visto obligado a abrir seis grupos de primero de infantil</p>

<p> </p>

<p>Desde este medio, quiero reivindicar para las familias del ensanche de Vallecas, que se respete la libertad de elección REAL y que se construyan de forma inmediata las infraestructuras educativas publicas necesaria para cubrir las necesidades de</p>
";"09/09/2015 19";"71";"64";"7";"2";"883802448";"5138"
"2921";"electrificar servicio bicimad";"<p>Cuando alguien la robe que suelte descargas de 1000 voltios al ladron...un sustillo vamos...</p>
";"09/09/2015 19";"17";"9";"8";"0";"867980732";"52"
"2922";"Transporte de barrio ";"<p>La movilidad dentro de los barrios a veces es complicada , especialmente cuando quieres moverte dentro de tu barrio a servicios municipales: Ir a la biblioteca del barrio, al centro cultural, al polideportivo ...o simplemente llevar al colegio a los peques , si no te pilla este demasiado cerca , aunque esté en tu barrio ,a veces es imposible en transporte público, incluso supone tener que coger dos autobuses distintos de un punto a otro u optar por el coche. A veces es mas facil ir al centro de la ciudad que moverse en el barrio. Mi propuesta es pensar en la movilidad de cercania en las rutas de los transportes públicos y facilitar el movimiento dentro del barrio sin necesidad de coche, favoreciendo a mayores y a niñ@s, que no pueden hacer distancias largas andando,con un transporte especial de movilidad por el barrio . Esto implicaría un precio especial , para que no te suponga el mismo coste hacer 4 paradas que 16. </p>
";"09/09/2015 19";"25";"20";"5";"0";"877395001";"1200"
"2923";"RETOMAR Recogida muebles y enseres  una vez al mes";"<p>En Madrid existía la recogida de muebles y enseres una vez al mes en el distrito centro y otros barrios como arguelles,  barrio Salamanca..  En los portales se ponía una nota informativa indicando que día se podían dejar los muebles en la puerta del edificio.  Ahora mismo es imposible,  ya que se llama y el ayuntamiento tarda muchísimo tiempo en atender la llamada.  Este servicio evitaba como sucede ahora que se deje más basura y muebles en la calle cualquier día y a cualquier hora.  Sería bueno retomar este servicio,  considero que era muy útil para todos. </p>
";"09/09/2015 19";"94";"91";"3";"7";"886887398";"8519"
"2924";"Escuelas de música municipales";"<p>Deberían volver a invertir en las escuelas de música y danza municipales. Qué se recuperen precios asequibles, con tasas especiales para las familias en las que asistan varios miembros y para las familias numerosas. </p>
";"09/09/2015 19";"50";"42";"8";"0";"880857168";"2856"
"2925";"Mas mascotas";"<p>Hola, queria proponer una propuesta para todos los amantes de los animales.</p>

<p> </p>

<p>Yo como propietario de dos perros me veo muchas veces sin espacio para ellos, sin que se valoren sus derechos...</p>

<p>Pagamos por un seguro obligatorio, por censarlos y el chip, velamos por recoger sus cacas y que respeten las normas de la sociedad ¿Y que nos encontamos? normas de no poder soltarlos mas que a ciertas horas, no tener zonas de esparcimiento (La del juan carlos 1 da autentico asco, no hay sombras, en cuanto llega la primavera esta lleno de garrapatas)</p>

<p>Las propuestas serian la siguientes:</p>

<p>-Dejar entrar a los perros, bajo unas normas al Metro de Madrid.</p>

<p>-Concienciar a todos sobre la tendencia responsable de animales, cursos y charlas a adoptantes de las perreras y protectoras.</p>

<p>-Mayores sanciones a maltratadores de animales y a todo aquel que intente dañarlo.</p>

<p>-Mas zonas de esparcimiento.</p>

<p>-Mayores sanciones a los que no recojan los excrementos de sus mascostas.</p>

<p>-Desde pequeños, enseñar en los colegios los valores del respeto hacia los animales.</p>

<p> </p>

<p>Gracias por su tiempo y un cordial saludo.</p>
";"09/09/2015 19";"50";"26";"24";"12";"871480879";"104"
"2926";"Dedicar una calle a Santiago Carrillo ";"<p>Viva Chavez, Monedero y la madre que los parió</p>
";"09/09/2015 19";"67";"15";"52";"5";"864358749";"-828"
"2928";"Barrio de Las Tablas";"<p>El ayuntamiento de Madrid nos tiene completamente abandonados. No tenemos apenas servicios públicos, no hay centro de salud, si tienes algún problema debes esperar más de una hora a la policía, no hay bilbioteca salvo un autobus que viene un hora dos mañanas (¡servicio comodísimo para los que estamos trabajando y muy educativo para los niños que a esa hora están en el colegio!, vease la ironía), cuatro colegios públicos línea 6 a 29 en las aulas pero... ¡no hay instituto!, ya por no hablar de polideportivo... se especula con el suelo público para que los servicios los den empresas privadas. Ahora leo que se va a paralizar la operación Chamartín. A mi me da igual que se llame Operación Chamartín o de otro modo, que se construyan grandes parques y rascacielos o que se conserven las casitas del pueblo de Fuencarral, pero me enoja que no se tenga en cuenta que Las Tablas es una autentica ratonera. Tenemos salida a la M30, M40, carretera de Fuencarral, carretera de Colmenar Viejo y A1, pero más de 50000 personas viven en barrio y la población se duplica durante el día. Entran en el barrio cada mañana 6000 trabajadores de Vodaphone, 12000 de telefónica y ahora otros 8000 del BBVA, por no hablar de los trabajadores de Mediasec, etc. TODAS las salidas de Las Tablas tiene un sólo carril, por lo que hay unos atascos insoportables. El trasporte público es penoso, pierdes un montón de tiempo en el cambio de metro en Tres Olivos y, aunque el tren está literalmente en Las Tablas, la entrada está en el barrio de Fuencarral, por lo que se tarda 25 minutos andando. ¡Esto hay que solucionarlo de algún modo! La señora alcaldesa dijo (muy bien dicho) que llevamos retrasando las soluciones 20 años, pero por favor, no pueden retrasarse otros 20, sólo por el afán de los políticos de hacer política y no de solucionar los problemas de los ciudadanos...</p>
";"09/09/2015 19";"79";"71";"8";"12";"884400301";"5662"
"2929";"Cerrar el CIE de Aluche.";"<p>Propongo que se cierre el CIE de Aluche, pues creo que no tiene sentido un CIE en el S. XXI y que ningún ser humano es ilegal.</p>
";"09/09/2015 19";"42";"23";"19";"2";"871603552";"219"
"2930";"que vuelva el looping star al parque de atracciones ";"<p>Pues eso...hay cosas que nunca tuvieron que desaparecer </p>
";"09/09/2015 19";"35";"17";"18";"3";"868067894";"-48"
"2931";"Separadores de carril bus ";"<p>Sería posible desmontar las llamadas Aletas de tiburón de separación del carril bus instaladas en algunas calles del centro de Madrid , quejan causado y seguirá causando accidentes a personas con cierta dificultad demovilidad así como entre vehiculos</p>
";"09/09/2015 19";"23";"16";"7";"3";"874978576";"626"
"2932";" Parque las cruces";"<p>Mejorar la conservación del parque. Hay un carril para bicis, pero vas paseando por cualquiera de los muchos senderos que hay, y de pronto un ciclista a toda velocidad, lo esquivas, te apartas y se acabó el paseo tranquilo.</p>
";"09/09/2015 19";"10";"7";"3";"4";"873028462";"280"
"2933";"Reorganizar y mejorar todos los pabellones de Casa de Campo-Madrid Arena";"<p>Esa zona, abandonada y dañada por el PP durante 20 años no tiene representatividad alguna para con Madrid y su imagen exterior, mientras que BCN tiene Montjuic y con sus instalaciones a pleno rendimiento, en Casa de Campo estan infrautilizadas.</p>

<p>Más dispuestas, mejorar los accesos y rehabilitar esos edificios para uso público y municipal, propuestas ciudadanas y tipo tipo de actos para la ciudadanía de Madrid y el turismo.</p>
";"09/09/2015 19";"36";"34";"2";"2";"882402684";"3022"
"2935";"Los perros y su espacio. creacion de parque de recreo";"<p>Por la creacion de parques de recreo para nuestros perros. Estoy arta de  de la represión que se realiza a los dueños de perros a la hora de sacar a sus animales. No se pueden soltar en ninguna parte dentro del parque. Modificación de la ordenanza municipal. </p>
";"09/09/2015 19";"51";"35";"16";"4";"877119848";"1303"
"2937";"Mas seguridad en los cruces de la Plaza de Chamberí ";"<p>La plaza de Chamberí está rodeada de colegios y es muy frecuentada por niños y ancianos. Sin embargo, está rodeade de calles muy transitadas y con paso de autobuses como son Sta. Engracia y Paseo de Eduardo Dato. Los coches pasan a mucha velocidad. La plaza no esta especialmente señalada como lugar con niños ni hay indicaciones de aminorar la velocidad. Además,  el semaforo del lado de Paseo de Eduardo Dato con dirección Paseo de la Castellana se pone en amarillo para permitir el paso de vehículos antes de que cambie a rojo para los peatones. Los coches y motos pasan cuando los niños aun no han alcanzado la acera o sin tener en cuenta que los niños son impredecibles y se dan media vuelta de modo sorpresivo. Deberia pasar de verde a rojo sin amarillo porque envia una señal errónea y un dia va a haber una desgracia. Todos los dias contemplo escenas que me ponen los pelos de punta. GRACIAS  </p>
";"09/09/2015 19";"24";"16";"8";"0";"874188896";"533"
"2938";"Redistribucion de las empresas para cambiar los flujos de tráfico";"<p>Estoy cansada de ver todas las mañanas una afluencia de tráfico inaguantable desde el sur hacia el norte, y viceversa por las tardes.</p>

<p>Mi propuesta es que se incentive a las empresas para trasladarse a zonas de Madrid (quizá no sólo de la ciudad, si no de la Comunidad) con menos densidad de oficinas que las conocidas (Parque Juan Carlos I, Las Tablas...). Para ello, propongo incentivar alquileres de edificios, tanto industriales como de oficinas, en las zonas sur y oeste principalmente, y penalizar lo contrario. Sería de gran ayuda una buena red de transporte público alrededor. Por ejemplo, en Vallecas-Ensanche, Villaverde, Legazpi, Carabanchel-Ensanche...</p>
";"09/09/2015 19";"49";"35";"14";"6";"877897872";"1500"
"2940";"taxis negros y rojos como antaño";"<p>Los taxis blancos son muy feos...lo clásico era más bonito. Deberían ser como antes.</p>
";"09/09/2015 19";"65";"20";"45";"7";"863776827";"-769"
"2941";"Wifi en el transporte público.";"<p>Esta propuesta esta dirigida para que el wifi sea facilmente disponible mientras vas por ejemplo en autobus, ya que aunque tecnicamente en algunos autobuses ponga lo del wifi la realidad dista mucho, para no abusar se podría poner un cupo diarío de descarga de Megas.</p>

<p>Algunas ciudades como Edimburgo disponen de estos servicios y pienso que no sería dificil implantarlo.</p>
";"09/09/2015 19";"41";"29";"12";"1";"876961794";"1202"
"2942";"Educación y civismo a la puerta de los colegios";"<p>Me parece conveniente tomar alguna medida contra las situaciones que se viven a diario en las puertas de los colegios a la entrada y salida de los niños.Quizá aumentar la presencia policial municipal de cada barrio recordaría a los padres, que están ahí para recoger/dejar a sus hijos en el colegio y no para invadir calzadas mientras charlan con otr@s, impidiendo la circulación y aumentando la peligrosidad por que hay algunos que no tienen medida (ni dos neuronas, ni conciencia) y quitan totalmente visibilidad en cambios de rasante etc....Peligrosidad para los niños principalmente (física y de mala educación subliminal). Por lo general, mis experiencias advirtiendo dichos peligros, han sido negativas, puesto que la reacción ha sido deplorable. Así pues, ya que no se puede con lógica, que se haga de otro modo, por ejemplo, sanciones de tráfico, las cuales tenemos que sufrir otros vecinos que, a tanto llega la locura, que no tienes dónde aparcar tu coche como debe ser y lo tienes que dejar de cualquier manera (de cualquier manera que sólo te pueda afectar a ti, por supuesto) y QUÉ CURIOSO a veces te afecta en forma de multa.... Por favor padres de Madrid, pensad en otros ciudadanos, un poquito de civismo y convivencia y sobre todo, dad ejemplo a vuestros hijos con actitudes respetuosas, cívicas y saludables (como enseñarles a ir caminando al colegio y volver igual si vive en el mismo barrio).</p>

<p>Un saludo de una madrileña desesperada al volante :(</p>
";"09/09/2015 19";"33";"31";"2";"2";"882022896";"2724"
"2943";"Recoger los restos de cadáveres que quedan todavía en las cunetas de España ";"<p>Buenas tardes, la guerra civil española ha pasado hace bastantes décadas pero todavía no se ha dignado nadie en recoger algunos cadáveres que quedan por las cunetas de toda España. Tienen derecho a ser enterrados con dignidad y que sus familiares sepan de ellos. A ver si porfavor tenemos un poco de conciencia y no los dejamos abandonados en las cunetas.</p>
";"09/09/2015 19";"58";"16";"42";"3";"864242774";"-717"
"2944";"Breve descripción de la persona o el hecho da nombre a una calle o avenida";"<p>¿Que mejor manera de realizar la necesaria renovación de los sosos, anticuados y poco visibles carteles que dan nombre a las calles de nuestra ciudad, que haciendo a la vez accesible una pequeña, pero importante, parte de cultura para todos los ciudadanos?</p>
";"09/09/2015 19";"28";"23";"5";"2";"878686976";"1478"
"2945";"Refugiados Sirios";"<p>Dentro de poco España acogera muchos refugiados, mi duda es como vamos a asegurar que estos residan en Madrid o otras zonas de España cuando únicamente hacen ímpetú para residir en paises como Alemania. Quiero decir, es solidario pero estos refugiados parecen que no quieren estar en algunos paises como se puede ver en Turquia, que a pesar de tener una culturar más similar que la nuestra y no haber guerra solo lo usan de paso.</p>
";"09/09/2015 19";"24";"16";"8";"3";"874591306";"533"
"2946";"Colegio en Valdebebas";"<p>En Valdebebas hay ya más de 6000 vecinos. Se prevé un gran aumento a corto plazo. La mayoría son familias con niños pequeños que no disponen de algo tan básico como un colegio.</p>

<p>Es un servicio totalmente necesario y prioritario.</p>
";"09/09/2015 19";"132";"124";"8";"9";"887793793";"10896"
"2947";"plantar bonsais en vez de arboles";"<p>Ya que si no se van a mantener los árboles existentes al menos que no se nos caigan encima</p>
";"09/09/2015 19";"40";"17";"23";"0";"865020483";"-254"
"2948";"Aparcamientos para bicicletas";"<p>Al anterior equipo de gobierno le propuse lo siguiente, pero no me hicieron ni caso:</p>

<p>Una manera de potenciar el uso de las bicicletas dentro del centro de Madrid, sería que dentro de los parkings publicos pàra coches  , se pudieran dejar las bicis de una manera segura y vigilada de manera gratuita , o con la tarjeta de bicimad. De tal manera que mucha gente podria acudir al centro en su bici particular sin que tuviera miedo a dejarla en la calle atada etc...Asi mismo, mucha gente del centro que vive en sitios pequeños que no puede tener bicicleta en casa por espcaio, o por vivir en cuarto piso sin ascensor ya que es poco operativo y practico, y por tanto, optan por no tener bicicleta. Si tuvieran un sitio donde dejarla de forma segura , se fomentaria su uso. Asi mismo, se le podria dar una utilidad a los Parkings públicos que vayan quedando en desuso por la peatonalización del centro, que llegará antes o después.</p>

<p> </p>

<p>Qué os parece? Me podriais Votar?</p>

<p> </p>

<p>Saludos!!</p>

<p> </p>
";"09/09/2015 20";"55";"40";"15";"7";"878794055";"1818"
"2949";"Que nuestra ciudad no parezca un cenicero";"<p>La idea sería penalizar de alguna manera a todo aquel que tire las colillas de sus cigarros al suelo, sin importar si está encendido o apagado y sin pensar en el mal efecto que causa ver un suelo que más parece un cenicero que el suelo de una ciudad como Madrid.</p>

<p>Otra manera menos punitiva sería la de habilitar más puntos donde apagar los cigarros de manera limpia y segura.</p>

<p> </p>
";"09/09/2015 20";"41";"38";"3";"2";"882805328";"3243"
"2950";"Más semáforos en ámbar intermitente, y menos semáforos en rojo";"<p>Para agilizar el tránsito rodado, y reducir la contaminación, en la mayor parte de los semáforos de cruces y rotondas de la ciudad, se podría substituir la fase rojo para girar a la derecha, y en los pasos de peatones de la salida de dichos cruces y rotondas, por fase ámbar intermitente. Para evitar riesgos innecesarios (accidentes o atropellos) sería conveniente hacer alguna campaña de concienciación ciudadana, o multas, para que los conductores reduzcan la velocidad y cedan el paso siempre al ver la fase ámbar.</p>
";"09/09/2015 20";"27";"10";"17";"0";"865312785";"-259"
"2952";"Intercambiar coches de Metro en determinadas líneas y aumentar la circulación";"<p>Concretamente estoy hablando de la línea 5 de Metro (aunque me imagino que habrá más), en esta línea de Metro los vagones siempre van repletos de personas, a cualquier hora, y los trenes son muy antiguos, me atrevería a decir que son de los más antiguos de toda la línea de Metro. Por ello pediría aumentar la frecuencia de trenes en esta y otras líneas que lo necesiten e intercalar trenes más modernos de otras líneas, así no habría líneas con coches totalmente anticuados y otras con todos los coches más modernos.</p>
";"09/09/2015 20";"26";"20";"6";"2";"877428413";"1076"
"2954";"KABOOM! Remodelación de la Puerta del SOL";"<p>Ahora mismo no hay mucho dinero y este proyecto puede cambiar Madrid para siempre a lago plazo, tanto desde el inicio de las posibes obras hasta su ejecutación y resultado. Cuando se hizo concurso por la remodelación de Puerta de Sol, cuando ya había sido remodelada solo 2 años antes, ganó un proyecto de Piensa Sol </p>

<p>http://www.abc.es/madrid/20140225/abci-nueva-puerta-201402242140.html        que ademas creo que NADIE de la ciudadanía votó.</p>

<p>Sin embargo, se ningunearon varios bastante interesantes</p>

<p>http://www.abc.es/madrid/tops/20140303/abci-propuestas-alternativas-201402271832_1.html</p>

<p>y en concreto el<strong> Proyecto Kaboom!</strong>, que sería una apuesta interesante para hacer de Sol una verdadera plaza central de Madrid.</p>

<p><strong>http://adjkm.com/index.php?/proyectos/kaboom/</strong></p>

<p><strong>http://www.plataformaarquitectura.cl/cl/02-339785/resultados-piensa-sol-concurso-internacional-de-ideas-espana/5310959dc07a80ed3b000267</strong></p>

<p>Como bien dicen los del proyecto, si no se hubiera desafiado las limitaciones y antiguas envergaduras del urbanismo en Madrid en situaciones razonables, jamás hubieramos tenido una Gran Vía.</p>

<p>Debería abrirse un debate para cambiar y actualizar la plaza más representativa e importante de Madrid, como es en Paris la Plaza de la Concordia o Trafalgar Square en Londres, ya que Madrid por desgracia solo cuenta con plazuelas, ni siquiera en el Congreso hay una plaza de estilo nacional como en Lisboa, Amsterdam o Atenas.</p>

<p> </p>

<p>https://www.facebook.com/adjkm/posts/10153867894830475</p>

<p> </p>
";"09/09/2015 20";"34";"13";"21";"3";"865078066";"-305"
"2955";"Colaboración con los servicios públicos.";"<p>Creo que el ayuntamiento debería públicar cuanto dinero recibe de donaciones de los ciudadanos para sus servicios públicos, supongo que será un dineral ya que hay tantas manifestaciones a favor de lo público y tanta gente preocupada por ello que reclama más cosas.</p>

<p>Tambien deberían facilitar las cosas a la hora de hacer donaciones para los diferentes servicios y así colaborar en el sostenimiento de esos servicios.</p>

<p> </p>
";"09/09/2015 20";"17";"11";"6";"0";"873049051";"323"
"2957";"Recuperar nuestro centro histórico";"<p>el centro de Madrid, empezando por sol, cortés, latina, fuencarral, etc es cierto que ha sufrido un cambio brutal y a mejor desde los años 80, pero ese cambio está volviendose en contra del centro de Madrid, la elevada cantidad de comercios de comida rápida, clubes y discotecas nocturnas que ofrecen alcohol barato a extranjeros y locales, estan convirtiendo al centro de Madrid en un barrio degradado de nuevo, en el que la suciedad, la acumulación de gente, y los ganchos de locales que continuamente atosigan a los viandantes para que entren en sus locales, hacen que pasear por este sea de todo menos agradable. ya va siendo hora de que se fomente un turismo y un modelo comercial mas respetuoso con nuestro centro histórico, que muestre la historia y cultura de nuestra ciudad que no es poca.además fomentando un turismo de mayor calidad se fomenta también el que los turistas que nos visitan sean de un nivel económico mayor por lo que al final es un beneficio para todos, tanto para los comerciantes como para el ayuntamiento y por supuesto para los ciudadanos. por no hablar claro del infame nombre que tiene nuestra emblemática plaza desde hace varios años, que debería cambiarse ya de una vez por todas a lo que siempre fue: Puerta del Sol</p>
";"09/09/2015 20";"65";"63";"2";"2";"885880206";"5912"
"2958";"ELIMINAR DUPLICIDADES";"<p>Todos sabemos que el Ppsoe duplicaron organos con identica función incluso dentro del ayuntamiento. Propongo eliminarlos siempre que tengan órganos con idénticas o similares o que puedan hacer la misma función en las juntas. Es ilógico que existan centros centralizados existiendo departamentos en juntas. La única utilidd que tienen es la de crear jefaturas y derrochar dinero. Todos sabemos q la junta es la administracion mas cercana al ciudadano. Apuesto a q si Manuela sigue mirando la composición de determinados departamnetoa se va a encontrar con sorpresas de jefaturas de mas de la mitad de la plantilla en esos organos centralizados y duplicados.</p>
";"09/09/2015 20";"43";"40";"3";"3";"883218963";"3441"
"2960";"Monumento al existencialismo";"<p>Es evidente que esto no es ni mucho menos una prioridad pero me parece una idea interesante, original, barata y fácil de llevar a cabo, por este motivo me gustaría compartirla aquí, así que inmediatamente paso a exponer en que consiste el monumento.</p>

<p>Para la construcción de este monumento sólo se necesitan señales de tráfico como las que señalan el camino a museos, estatuas, parques... Estas señales indicaran la dirección donde se encuentra el monumento al existencialismo pero, ahora viene lo bueno, las señales forman un camino cerrado sin llegar nunca a ningún sitio en concreto o bien, por proponer otra versión, las señales pueden estar distribuidas aleatoriamente seañalando hacia distintos lugares.</p>

<p>La idea es indiscutiblemente barata y original, lo que está por ver es si es o no interesante.</p>
";"09/09/2015 20";"36";"10";"26";"3";"865182838";"-444"
"2961";"Actualizar a los agentes de trafico a Guindous 10";"<p>Guindous 10 hes el mejor sistema operatibo del huniberso despues de GatoOS</p>
";"09/09/2015 20";"67";"12";"55";"2";"865633643";"-770"
"2962";"gratuidad de las escuelas infantiles públicas de 0-3 años";"<p>Que el periodo escolar de 0-3 años entre en el sistema educativo y sea gratuito, es vergonzoso que tengamos que pagar 350  al mes por niño en las esceulas infantiles PÚBLICAS (el precio más caro de todas las comunidades españolas!).</p>
";"09/09/2015 20";"34";"24";"10";"0";"876736651";"988"
"2963";"Parques chamberi";"<p>Es muy triste que en un barrio tan centrico y familiar como es Chamberi,tengamos tan pocos parques y la mayoria de ellos poco cuidados.</p>

<p>En particular el parque que hace esquina entre las calles Breton de los Herreros y Fernandez de la Hoz.Es una pena que una plazoleta tan grande y luminosa este tan mal aprovechada. Arboles cuyas ramas te dan en la cabeza al pasar,cacas de perros cada paso que das,malos olores,pintadas,basura rodeando los tres columpios del cutre parque infantil si se le puede llamar asi...en fin que no le vendria mal una remodelacion que permitiera a mayores y niños disfrutar de una zona ludica verde en pleno centro de Madrid.</p>
";"09/09/2015 20";"41";"39";"2";"2";"883615574";"3519"
"2964";"Más vigilancia policial real en la Plaza de las Cortes";"<p>Por esa zona hay una bandada de delincuentes que se dedican a robar a pequeños negocios, a molestar y a acosar tanto a residentes como extranjeros. La policia solo se encuentra enfrente del congreso, pero justo el problema reside cerca de la plaza neptuno, donde los robos se cometen a diario. Ya no solo mas vigilancia policial, sino hacer algo para que no se vuelvan a producir.</p>
";"09/09/2015 20";"19";"15";"4";"0";"876887269";"868"
"2965";"Habilitar en cada debate opción de reportar";"<p>Seria oportuno al igual que se puede votar a favor o en contra del contenido de los debates, poder informar a quien gestione este servicio de los temas de debate que no son oportunos y, de esa manera, poder ser eliminados. </p>
";"09/09/2015 20";"25";"14";"11";"7";"872436131";"168"
"2966";"Más dinero para las universidades.";"<p>Los profesores nos exigen comprar mas de 6 libros por año, los cuales las bibliotecas de las universidades no tienen por falta de liquidez. Bastante caras son ya las tasas de universidad para que encima tengamos que asumir un gasto de cerca de 500  el año pasado solo en libros de texto.</p>
";"09/09/2015 20";"32";"20";"12";"7";"874917976";"500"
"2967";"Ascensores en al menos el 90% de las paradas de Metro y servicios  adaptados";"<p>No es normal que personas que se mueven en sillas de ruedas no puedan bajarse en las paradas más cercanas a su destino. Muchas veces se bajan con la esperanza de encontrar un ascensor y a la salida no hay más que escaleras, causando esto la molestia de llegar tarde, pagar un nuevo billete, sentirse totalmente descriminado/a y tener que ingeniárselas para buscar una parada que sí que le permita salir a la superficie con un ascensor. </p>

<p>Lo mismo ocurre con los servicios. Si las personas con movilidad reducida ya tienen problemas para encontrar un baño en la calle que esté adaptado, imaginad en el Metro, que por no haber, no hay ni baños no adaptados. </p>

<p>Una persona que no vaya en silla de ruedas, puede salir a la calle en busca de un baño, pero una persona que va en silla puede que no encuentre un baño hasta después de muchas horas y con grandes dificultades. </p>

<p>Es por ello que es necesario que se coloquen baños adaptados en las calles de Madrid (ya que los baños de los bares, a parte de cobrarte por hacer tus necesidades, casi nunca disponen de baños en la primera planta y menos aún, disponen de baños adaptados) y dentro de la red de Metro. </p>

<p> </p>

<p> </p>

<p> </p>

<p> </p>

<p> </p>
";"09/09/2015 20";"78";"72";"6";"0";"885485107";"6092"
"2968";"Volver la carga y descarga de la APR Embajadores a su horario original";"<p>El Área de prioridad Residencial (APR) de Embajadores tenía un horario de carga y descarga de 10-13 h., lo cual era suficiente y apropiado para los vecinos. Este verano, sin ninguna consulta a los vecinos (¿donde está la participación ciudadana?), se ha ampliado a 8-18 h.!!!!, lo cual implica que tenemos camiones a todas horas y que los vecinos no podemos usar las plazas de aparcamiento de carga y descarga (que ademas están vacias ya que los camiones no las utilizan, se paran directamente en medio de la calle). Por favor que el Ayuntamiento vuelva a poner el horario de carga y descarga orginal, para que tengamos algo de tranquilidad y menos tráfico pesado. ¡Que cambio de horario más incongruente e inapropiado!</p>
";"09/09/2015 20";"21";"16";"5";"1";"876713543";"838"
"2969";"Museo de Metro en Cuatro Caminos";"<p>Desde la Plataforma Salvemos Cuatro Caminos promovemos la <strong>protección de las Cocheras Históricas de Metro (1919)</strong> y su conversión en un <strong>Museo de Metro</strong>, incluyendo la gran colección de trenes históricos que atesora Metro de Madrid en las afueras de la ciudad. </p>

<p>La propuesta dotaría de una institución cultural en un enclave principal de la ciudad a toda la ciudadanía, ofreciendo un museo que sería único en el mundo. Los beneficios que reportaría al barrio, al vecindario y a los comercios serían mucho más importantes y atractivos que el plan de seguir construyendo parque de viviendas en una de la zonas más densas de la ciudad.</p>

<p>Una dotación así además reportaría beneficios a toda la ciudad y permite poner en valor uno de los metros más antiguos del mundo. </p>

<p>Tenemos la oportunidad única, hagámosla valer. Si se se pierde no volverá; es AHORA o NUNCA: ¡no perdamos este tren!</p>

<p>#SalvemoslasCocheras + #MuseodeMetro = #ProyectoCuatroCaminos</p>

<p>+ info: twitter @salvemos4C  -  facebook: salvemos.cuatrocaminos</p>
";"09/09/2015 20";"1145";"546";"599";"631";"878597345";"-2527"
"2970";"Mantener el metro abierto 24 horas y eliminación del Autobús Nocturno";"<p>Veo necesario que el metro se mantenga abierto las 24 horas, cabe mas gente que en los autobuses nocturnos. Con 1 tren cada 30 minutos bastaría. También es necesario mucha mas seguridad en el metro.</p>
";"09/09/2015 20";"48";"22";"26";"2";"866165100";"-183"
"2971";"Parque forestal de los Altos de Madrid";"<p>El mismo lugar donde se quería construir Eurovegas es una zona natural preciosa de alto interés ecológico donde habitan visones, zorros, conejos, puercoespines... y van a cazar múltiples aves entre arroyos limpios, retamas y pinos. Centenares de madrileños lo usan para pasear entre naturaleza virgen con una vista inmejorable de la ciudad, con la Sierra al fondo. Además es el retamar más importante de la zona centro y el lugar donde nacen varios arroyos, el Antequina que riega la Casa de Campo, por ejemplo. Y todo en la entrada de Madrid con el metro en la misma puerta.</p>

<p>Pedimos la creación de un parque forestal de bajo coste (bastaría dejarlo como está) que lo proteja y conserve para todos los madrileños un necesario pulmón que renueve el aure y conecte el centro y la Casa de Campo con el parque Natural del Guadarrama a través de la misma cañada que recorren las ovejas que una vez al año visitan Madrid. Bastaría dejarlo como está. No es necesario grandes presupuestos ni infraestructuras, sólo protegerlo con leyes.</p>

<p>En la actualidad, es propiedad pública porque pertenece al Ministerio de Defensa. Cederlo para el negocio inmobiliario es un robo del patrimonio natural común.</p>

<p>Como es una zona que linda con Alcorcón o Boadilla, estaría muy bien llegar a un acuerdo con ambos ayuntamientos para que lo dieran continuidad hasta el parque Natural del Guadarrama. Si lees esto, ves a visitarlo, alucinarás y también querrás que no sucumba bajo el hormigon.</p>
";"09/09/2015 20";"40";"35";"5";"2";"881736536";"2625"
"2972";"Semáforo rojo = ceda el paso para bicis";"<p>Ya se ha hecho en ciudades como París. Hay muchos semáforos que están solo por peatones y no generaría peligro. Fomentaría más la bicicleta y agilizaría el tráfico para todos</p>
";"09/09/2015 21";"63";"38";"25";"1";"875524846";"784"
"2975";"Totalidad de los museos de Madrid gratuitos.";"<p>Me parece de mal gusto que haya que pagar por adquirir cultura.</p>
";"09/09/2015 21";"62";"29";"33";"5";"866493858";"-187"
"2976";"Rehabilitación completa del parque del Retiro.";"<p>Esta hecho una pena el parque, totalmente destrozado. Le convendria mantenerle cerrado durante unos meses para rehabilitarle en condiciones</p>
";"09/09/2015 21";"51";"33";"18";"2";"876493480";"970"
"2977";"Parar el centro comercial en Madrid Río";"<p>La última semana del gobierno de la alcaldesa Botella se aprobó la construcción de un centro comercial en la misma orilla de Madrid Río. Su estética es deplorable, nada aporta a una zona que pretende ser emblemática justo enfrente del Matadero, pero tampoco da valor social o de infraestructuras en el barrio. Además multiplicará el tráfico hasta hacerlo imposible en calles estrechas o muy atascadas como Antonio López.</p>

<p>Vota si quieres parar o modificar el proyecto para que, al menos, respete el entorno e incluya equipación social (bibliotecas, escuelas infantiles, servicios sociales...) o que se convierta en parque. NO necesitamos más centros comerciales, es un modelo económico caduco. </p>

<p>Acaban de poner las vallas de obra en el solar...</p>

<p> </p>
";"09/09/2015 21";"94";"50";"44";"5";"873335765";"319"
"2978";"Ayuda de 200  mensuales a todos los parados de larga duración de Madrid";"<p>400  me parece abusar de la buena fe de la gente, más de alguno se aprovecharia de ella. Pero 200  me parece una cantidad razonable, aunque solo le sirva para poder alimentar a sus hijos</p>
";"09/09/2015 21";"33";"13";"20";"0";"865481350";"-275"
"2979";"¿A alguien le parece normal el corte del Paseo del Prado?";"<p>Votemos para que no se cierre. Es un eje vertebrador de Madrid y dice que lo corta por un rey, cuando ella es comunista y no monárquica. Esto es cada día peor.</p>
";"09/09/2015 21";"59";"18";"41";"7";"864539053";"-701"
"2980";"Programa ""Ladrillos verdes"" (Tejados, azoteas, muros y fachadas)";"<p><strong>Objetivos</strong>:</p>

<ul>
	<li>Reducción del impacto térmico de las edificaciones en sí mismas y en la temperatura ambiente.</li>
	<li>Mejora de la calidad del aire de la ciudad.</li>
	<li>Realce del paisaje urbano y disfrute del aspecto de nuestra ciudad.</li>
	<li>Creación de empresas y puestos de trabajo en diversos sectores, con la consiguiente generación de riqueza.</li>
	<li>Creación de zonas de ocio para propietarios y visitantes.</li>
	<li>Moderación del drenaje de edificios. Reducción del impacto de tormentas en el alcantarillado.</li>
	<li>...</li>
</ul>

<p><strong>Incentivos</strong>:</p>

<ul>
	<li>Guías de instalación y mantenimiento.</li>
	<li>Divulgación de ejemplos prácticos y posibilidad de visitas.   </li>
	<li>Ayudas a la implantación.</li>
	<li>Exención de impuestos a las empresas del sector por proyecto realizado.</li>
	<li>Ayudas al mantenimiento de dichas instalaciones.</li>
	<li>Sistemas de premios y reconocimientos sociales.</li>
	<li>...</li>
</ul>
";"09/09/2015 21";"32";"23";"9";"1";"877131270";"1006"
"2981";"Posibilidad de uso zona azul por residentes.";"<p>En ciertos barrios de Madrid en los que se encuentra vigente el SER, y concretamente en el distrito de Chamberí (barrio Trafalgar), el estacionamiento para los residentes es muy difícil debido a la saturación de tráfico existente y las escasas y extremadamente caras plazas de garaje.</p>

<p>Mi propuesta es que se posibilite el uso de las plazas azules, además de las verdes, a los residentes indistintamente durante todo el día o, al menos a partir de las 15:00 horas. De esta forma se daría una prioridad real a los residentes de esta zona.</p>
";"09/09/2015 21";"46";"33";"13";"0";"878163739";"1434"
"2982";"No al corte del Paseo del Prado (LEED ANTES DE VOTAR)";"<p>Me parece absurdo cortar el tráfico 5 horas. Hacer eso es como no hacer nada, y genera más problemas que soluciones. Si vais a crear una norma así, haced algo que sea más notorio. En mi opinión, sería más rentable cerrar el paso de 9 a 16 de lunes a domingo. Esto si haría más notoria la medida.</p>
";"09/09/2015 21";"61";"19";"42";"6";"864510686";"-716"
"2983";"que vuelva el sereno";"<p>Las calles serían más seguras y no tendríamos que llevar las llaves en el bolsillo.</p>
";"09/09/2015 21";"55";"34";"21";"3";"875912577";"803"
"2984";"Socavones de madrid";"<p>En general las calles y carreteras de Madrid están llenas de socavones. Me llama especialmente la atención uno que se encuentra en la M14 en la salida a la T1 que es enorme y lleva estando ahí hace más de 5 años!! Pones una rueda ahí y te quedas sin coche. No quiero nada con una moto! Es bastante lamentable el estado de las carreteras. Para que pagamos el impuesto de circulación?</p>
";"09/09/2015 21";"30";"30";"0";"2";"883703947";"3000"
"2985";"Crear un IVA fijo y justo para todos. Fijar el IVA al 8% o 10 %";"<p>El IVA es un impuesto injusto en sí, que encarece recursos básicos y que nota mucho más el ciudadano de a pie. Veo más lógico aumentar otros tipos de impuestos que éste, el cual debería ser un impuesto simbólico en el que todos los ciudadanos aportar su pequeño grano de arena, no un impuesto que ahogue </p>
";"09/09/2015 21";"18";"12";"6";"1";"874201092";"400"
"2987";"Barrio BEGOÑA lleno de basura, gorrillas y hasta ratas!! entre 2 hospitales";"<p>El barrio de Begoña está completamente olvidado y sucio a pesar de vivir y trabajar miles de personas. Está lleno de papeles. Lleno de baches. Y hemos visto también ratas y eso que está entre La Paz y el Ramon y Cajal. Hay tambien gorrillas en todos los rincones que extorsionan, amenazan, revenden tikets de parquimetros y rompen coches. Esto más que Madrid parece el tercer mundo</p>
";"09/09/2015 21";"40";"34";"6";"2";"881273872";"2380"
"2988";"Crear más bibliotecas públicas para universitarios";"<p>Los libros de texto son muy caros, y el uso real de ellos es de una totalidad de 4 meses. Sería ideal que el acceso a estos libros fuera sencillo y económico.</p>
";"09/09/2015 21";"47";"33";"14";"0";"877886156";"1334"
"2989";"Que las propuestas ciudadanas se evaluén sobre el terreno, no solo por votación ";"<p>Estas herramientas informáticas que tanto pueden abrir el campo de participación plantean el riesgo de ceñirse a un criterio exclusivamente cuantitativo que puede conducir a errores de bulto cuando se trata de cuestiones que no son reducibles a un ""si"" o un ""no"". Por otra parte, al no ser la población votante el total de la población, siempre habrá un considerable margen para el error estadístico. Nuestros gobernantes deben evitar el riesgo de ""lavarse las manos"" confiando toda la responsabilidad de los cambios a una herramienta informática tan potente en unos aspectos y tan limitada para orientar cualitativamente sus acciones sin correr el riesgo de  contradecir sus propios valores e ideologia, aquellos por los que han sido votados. Me pregunto ¿asumiran decisiones que hayan obtenido un apoyo mayoritario pero supongan asumir la pérdida de derechos ciudadanos heredados del gobierno anterior? Otro handicap:vivimos tiempos en los que quienes más alérgicos se muestran a las libertades ajenas pueden resultar los más movilizados para  conseguir tener las normas de su parte. Por todo ello, creo que no debe bastar la sumatoria de votos y que siempre será vital el olfato político para no consagrar con herramientas democráticas regresiones o herencias intransigentes.</p>
";"09/09/2015 21";"22";"18";"4";"2";"878427229";"1145"
"2990";"KABOOM! Remodelación de la Puerta del SOL";"<p>Ahora mismo no hay mucho dinero y este proyecto puede cambiar Madrid para siempre a lago plazo, tanto desde el inicio de las posibes obras hasta su ejecutación y resultado. Cuando se hizo concurso por la remodelación de Puerta de Sol, cuando ya había sido remodelada solo 2 años antes, ganó un proyecto de Piensa Sol </p>

<p>http://www.abc.es/madrid/20140225/abci-nueva-puerta-201402242140.html        que ademas creo que NADIE de la ciudadanía votó.</p>

<p>Sin embargo, se ningunearon varios bastante interesantes</p>

<p>http://www.abc.es/madrid/tops/20140303/abci-propuestas-alternativas-201402271832_3.html</p>

<p>y en concreto el<strong> Proyecto Kaboom!</strong>, que sería una apuesta interesante para hacer de Sol una verdadera plaza central de Madrid.</p>

<p>http://adjkm.com/index.php?/proyectos/kaboom/</p>

<p><strong>http://www.plataformaarquitectura.cl/cl/02-339785/resultados-piensa-sol-concurso-internacional-de-ideas-espana/5310959dc07a80ed3b000267</strong></p>

<p>Como bien dicen los del proyecto, si no se hubiera desafiado las limitaciones y antiguas envergaduras del urbanismo en Madrid en situaciones razonables, jamás hubieramos tenido una Gran Vía.</p>

<p>Debería abrirse un debate para cambiar y actualizar la plaza más representativa e importante de Madrid, como es en Paris la Plaza de la Concordia o Trafalgar Square en Londres, ya que Madrid por desgracia solo cuenta con plazuelas, ni siquiera en el Congreso hay una plaza de estilo nacional como en Lisboa, Amsterdam o Atenas.</p>

<p> </p>

<p>https://www.facebook.com/adjkm/posts/10153867894830475</p>
";"09/09/2015 21";"16";"8";"8";"0";"868929694";"0"
"2991";"Habilitar parques para perros con papeleras y bolsas para excrementos gratuitas";"<p>Esto ayudaría a mantener las calles limpias y un menor trabajo para los limpiadores</p>
";"09/09/2015 21";"55";"44";"11";"2";"881177525";"2640"
"2992";"Mayor movilidad para los agentes de movilidad.";"<p>Dotar a los señores agentes de movilidad, que no dispongan ya de otro vehículo, con una patineta  y casco de protección, lo cual permitiría mayor movilidad a la par que desplazaientos más rápidos y menos contaminantes. Todo ello valores acordes con el actual equipo de gobierno.</p>

<p>Adicionalmente, deberían recibir adiestramiento en el uso de la dicha patineta como instrumento de defensa personal, que sería de gran eficacia y contundencia en la disolución de tumultos y disturbios ciudadanos.</p>
";"09/09/2015 21";"39";"27";"12";"5";"877396693";"1038"
"2993";"Bloqueo";"<p>Siendo esto un espacio publico y ""libre"" no entiendo los bloqueos que hacen a los usuarios... </p>
";"09/09/2015 21";"36";"17";"19";"4";"868586041";"-94"
"2994";"Poder tener un seguimiento de nuestras propuestas";"<p>En el apartado cuenta podriamos tener un listado con nuestras propuestas para así saber las votaciones que reciben. Desde debates acabamos perdiendo su seguimiento, y por lo tanto, dejamos de saber si son o no buenas propuestas e ideas</p>
";"09/09/2015 21";"49";"45";"4";"4";"883891299";"3765"
"2995";"Promover el uso de la bicicleta y deportes al aire libre";"<p>Promover el uso de la bicicleta y deportes al aire libre y facilitar la convivencia con el resto de ciudadanos.</p>

<p>Propuesta realizada por https://www.facebook.com/AdictosAlTriathlon</p>
";"09/09/2015 21";"65";"52";"13";"1";"881749210";"3120"
"2996";"Abono de parques y jardine con las heces de los residentes en las zonas cercanas";"<p>Si cada uno de nosotros aporta su granito de arena, podríamos obtener grandes beneficios para la ciudad:</p>

<p>Abono gratuito de parques y jardines.</p>

<p>Ahorro de agua por menor utilización de sanitarios.</p>

<p>Ahorro energético proveniente del menor consumo de agua y de los menores costes de depuración (menos caudal y menor carga orgánica en la red de saneamiento)</p>

<p>Estas medidas se podrían combinar con grandes espacios públicos abiertos para defecar disfrutando del medio ambiente... en fin, dejo a la sabiduría de nuestros gobernantes el darle forma a esta idea y aceptaré con deportividad las discrepancias de aquellas personas que no logren ver el cambio de modelo y vuelta a lo tradicional que esto supondría.</p>
";"09/09/2015 21";"48";"22";"26";"3";"866524525";"-183"
"2998";"FP superior y gratuita y prueba de acceso a grado superior.";"<p>Me encuentro en situación de desempleo, y al ser mayor de 29 años no puedo cursar un módulo de grado superior porque no tengo derecho a la beca, al estar en paro no puedo permitirme los 2700 aproximados que cuesta cada año (son dos años), además he aprobado con una nota media muy alta y con una beca Erasmus haciendo prácticas en Alemania.</p>

<p> </p>

<p>Hasta no hace mucho, la formación profesional de grado superior era gratuita en los centros concertados, dado que hay muy pocos centros públicos (donde si es gratuita) y que es casi imposible entrar dado la cantidad de demanda de plazas.</p>

<p> </p>

<p>Además de esto me parece un poco injusto que una persona que tiene una nota media de 9,5 (y una beca Erasmus, que por algo será) en formación profesional de grado medio, tenga que presentarse a la prueba de acceso a grado superior.</p>

<p> </p>

<p>No se si sirve de algo poner esto aquí, pero tengo que intentarlo porque ni me sale trabajo ni formación, ahora mismo estoy totalmente en blanco.</p>
";"09/09/2015 21";"27";"19";"8";"1";"876421987";"774"
"2999";"Bajar los nivees de CO2 como SEA.";"<p><strong>Ya a principiosde año se supero el nivel permitido de emisiones, se pueden hacer multipes actuaciones para impedir la excesiva movilidad de vehiculos privados, que ya se hace en muchas ciudades de Europa:</strong></p>

<p>- Abarratar o facilitar el transporte público en horarios laborales</p>

<p>- Permitir los dias pares mat´riculas alternas segun sus letras (L,X,V por ejemplo permitir letras de A-C-E-G..., MJV las restantas)</p>

<p>- Prohibir el acceso al centro en horas de descanso y no laborales, etc...</p>

<p>- Impusar de una vez toda una red municipal de carriles bici que atraviesen y conecten toda la ciudad, sobretodo en avenidas y accesos relevantes.</p>

<p><strong>- Crear autenticas comisiones municipales de medio ambiente y que cada 15 días hagan balances e informes técnicos, objetivos y eficientes</strong></p>

<p>etc...</p>
";"09/09/2015 21";"85";"69";"16";"3";"883089855";"4302"
"3000";"Recuperemos el nombre de Ayuntamiento de Madrid en vez de ! Madrid!";"<p>en 2003 los vecinos perdimos el nombre de Ayuntamiento de Madrid que se sustituyo por la marca !Madrid! Pues al parecer a Gallardon la palabra Ayuntamiento le parecía casposa o poco moderna para su estilo y clase .si leéis cualquier documento del Ayuntamiento de Madrid falta la palabra  AYUNTAMIENTO por lo que debemos suponer que el escudo simple  y el color azul es suficiente para identificar a la institución legal e histórica del municipio de Madrid .</p>
";"09/09/2015 21";"30";"16";"14";"1";"870890492";"106"
"3002";"Empleo digno para todos sin ninguna discriminacion ";"<p>Crear proyectos utiles para la ciudad que a su vez creen puestos de trabajo para todas las personas residentes en Madrid, sin ninguna discriminacion de ningun tipo</p>
";"09/09/2015 21";"49";"35";"14";"2";"878660762";"1500"
"3003";"Control municipal de la situacion laboral de los madrileños.";"<p>Con vistas a una mejor convivencia y para hacer un Madrid por todos y para todos, deberían controlarse los tipos de empleo que se dan en la ciudad, si son con contrato o sin contrato, con sueldo decente o no. Quiza esto fuera mas competencia de la Comunidad de MAdrid, pero es necesario un control para evitar explotacion de trabajadores por un lado y por otro la existencia de un gran numero de trabajadores que trabajan y cobran en B que hacen que cada vez los salarios bajen y bajen mas.</p>
";"09/09/2015 21";"24";"14";"10";"1";"872742771";"233"
"3004";"Dedicar una calle o plaza a la Segunda República Española.";"<p>El primer régimen democrático en España, con sufragio universal y garantías constitucionales anterior a 1978, no tiene ningun reconocimiento nacional y tampoco municipal. Muchos presidentes de gobierno de la monarquía bornónica y la Restauración los tienen, incluso algún presidente de la 1ª República, pero en Madrid no hay nada de ello, y en cambio hay cientos de calles dedicadas a la Dictadura.</p>

<p> </p>
";"09/09/2015 21";"103";"36";"67";"7";"863854829";"-1083"
"3006";"Colegio y centro de salud en valdebebas ";"<p>Somos muchos vecinos los que ya residimos en la zona de Valdebebas, creo que los suficientes como para empezar a tener servicios públicos tan básicos como un colegio público y un centro de salud.</p>
";"09/09/2015 21";"121";"116";"5";"1";"888781080";"10641"
"3008";"Reforzar limpieza de calles y castigar con servicios a la comunidad ";"<p>Vivo en el distrito centro, concretamente en La Latina, y es vergonzoso observar como la gente tira las bolsas de basura, muebles y trastos viejos en la acera, así como personas que sacan a sus animales a hacer sus necesidades y no recogen sus excrementos. Es cierto que parece que últimamente se ha reforzado ligeramente el servicio de limpieza pero creo que no es suficiente ya que habría que poner medidas contra la gente que ensucia para concienciar a estas personas de que la calle no es un vertedero, desde multas económicas a, por ejemplo, servicios a la comunidad como se hace en otros paises. </p>

<p>Por ejemplo, si te pillan echando basura a la calle, el castigo podría ser una multa económica o varias jornadas trabajando junto a los servicios de limpieza.</p>
";"09/09/2015 22";"79";"75";"4";"3";"886839608";"6740"
"3009";"Recuperar el cubo amarillo de reciclaje todos los días";"<p>Si queremos fomentar el reciclaje, lo primero sería recoger de nuevo diariamente el cubo amarillo. Así se incentiva el uso de estos cubos y evitamos el espectáculo de las bolsas tiradas (porque no caben) fuera los días de recogida.</p>

<p>Un saludo a todos</p>
";"09/09/2015 22";"40";"28";"12";"4";"877874683";"1120"
"3012";"Al cole en bicicleta";"<p>Fomentar el uso de la bici, en los desplazamientos de los niños al colegio, creando itinerarios seguros con monitores que guien a los niños  y dotando a los colegios de aparcamientos para bicicletas, dentro de las instalaciones.</p>
";"09/09/2015 22";"57";"43";"14";"1";"880339902";"2187"
"3013";"PROHIBIR Y SANCIONAR FLYERS, OCTAVILLAS Y PUBLICIDAD CALLEJERA.";"<p>UNA GRAN PARTE DE LA SUCIEDAD DE LAS CALLES DE MADRID, PRINCIPALMENTE EN EL CENTRO, VIENE DE ESTAS ASQUEANTES Y PERSISTENTES FORMAS DE PUBLICIDAD, POR OTRA PARTE INUTILES, YA QUE DURAN EN LA MANO 10 EXACTOS SEGUNDOS ANTES DE SATURAR PAPELERAS Y ACABAR EN EL SUELO DE NUESTRA CIUDAD. LAS EMPRESAS MADRILEÑAS DEBERIAN ADAPTAR SUS FORMAS DE PUBLICIDAD E INVERTIR ESE DINERO EN FORMAS DE PUBLICIDAD MENOS SUCIAS, COMO PROMOCIÓN POR INTERNET, PANTALLAS GIGANTES Y OTROS MEDIOS DE CARTELERIA. LA MALA IMAGEN DE VER TU EMPRESA POR LOS SUELOS, SERÍA SUFICIENTE, PERO TAL VEZ EL AYUNTAMIENTO DEBERIA PROHIBIR ESTAS TECNICAS DE PUBLICIDAD QUE ARUINAN LA LIMPIEZA DE MADRID.</p>
";"09/09/2015 22";"76";"66";"10";"29";"885015378";"4863"
"3015";"Remodelar Avenida Reina Victoria";"<p>Hola! Propongo remodelar completamente la Avda. Reina Victoria del barrio de Chamberí. Está muy obsoleta, descuidada y sucia en muchas ocasiones. A pesar de ser una avenida de dimensiones muy amplias, el bulevar central está totalmente infrautilizado al quedar encajonado entre los carriles de ambos lados. El resultado es que casi nadie pasea por dicho bulevar o descansa en sus bancos. Y en las aceras de los lados falta espacio por el mismo motivo. Al remodelarla, habría además espacio de sobra para construir un carril-bici. Se podría pensar otra vez en distribuir el espacio en la conexión de la Avda. Reina Victoria, Pablo Iglesias y Gral Ibáñez, de cara a dar más espacio a peatones y bicicletas. </p>

<p> </p>

<p>Un saludo</p>
";"09/09/2015 22";"33";"21";"12";"1";"875479462";"572"
"3016";"Supresión servicios Beer Bike";"<p>La actividad que permite su ayuntamiento a la empresa Beer Bike http://www.bbike.es/es  me parece ilegal y peligrosa, porque los clientes beben alcohol en la calle mientras dirigen el bus-bicicleta, increpan a los conductores, molestan con sus gritos y además dan una imagen patética y vergonzosa a la ciudad. Dos veces los he visto pasando por la plaza de Cibeles interrumpiendo el tráfico, vociferando... Dos veces me he sentido avergonzado de vivir en esta ciudad. Me pregunto qué pensarán los turistas cuando vean esto.</p>
";"09/09/2015 22";"60";"48";"12";"2";"881861434";"2880"
"3019";"Limitar el uso excesivo del coche";"<p>No es una propuesta específica porque no hay una única solución a este problema, pero algunos conductores hacen un uso excesivo e inapropiado del coche, generando kilos y kilos de contaminación que nos comemos los vecinos de Madrid. Por poner un ejemplo de medida, en la A6 está el carril Bus Vao al que sólo pueden acceder coches con dos o más ocupantes. Esto ha generado un cambio en la actitud de llos conductores del norte de Madrid, que se juntan con vecinos para poder acceder a este carril central o escogen el autobús/tren.</p>

<p>Para Madrid Centro habría que buscar otras alternativas ya que el tráfico que recibe la capital por todas sus entradas excesivo. ¿Se debería limitar la entrada a coches con un sólo conductor? ¿Se debería  imponer una tasa, un peaje, como ocurre en ciudades como Londres? ¿Se debería impedir la entrada a coches con la matrícula par un día y con la impar otro, como se propuso en febrero del 2015 en Madrid?) </p>

<p> </p>

<p>Son muchas las soluciones, algunas parecen muy rocambolescas, pero lo cierto es que hay que buscar una solución tajante al tema de los coches. Tenemos que lograr que la gnete que vive en ciudades dormitorio y usa el coche para ir a la oficina de Madrid use el transporte público. </p>
";"09/09/2015 22";"50";"30";"20";"2";"875537144";"600"
"3021";"Autobús de unión Ciudad Lineal, Moratalaz y Valdebernardo";"<p>Es imposible ir desde Ciudad Lineal-García Noblejas a Moratalaz y Valdebernardo sin tener que coger dos autobuses, el 140 y el 100, además  tardan en pasar muchísimo tiempo y cada vez tienen menor frecuencia.  Se podría crear una línea que uniera la plaza de Alsacia con Valdebernardo pasando por Moratalaz  o prolongar la línea  15 hasta Valdebernardo pasando por la plaza de Alsacia y Moratalaz.</p>
";"09/09/2015 22";"52";"45";"7";"9";"883378946";"3288"
"3022";"FOMENTO DE ARTISTAS Y DISEÑADORES ESCUELA DE ARTES Y OFICIOS ";"<p>EL FOMENTO DE LA CULTURA Y EL ARTES EN LAS CALLES DE NUESTRA CIUDAD ES TAN FACIL COMO DAR LA OPORTUNIDAD A JOVENES ARTISTAS Y DISEÑADORES PARA REHABILITAR ESPACIOS DEGRADADOS O VACIOS EN LA CIUDAD. HAY FACHADAS VACIAS Y ESTROPEADAS DONDE UN MURALISTA O UN GRAFITERO PODRÍA HACER MARAVILLAS, ZONAS DONDE UN MOBILIARIO URBANO DISEÑADO POR UN JOVEN DISEÑADOR DARÍA NUEVA VIDA A UN BARRIO, O CALLES QUE VERIAN SU ACTIVIDAD COMERCIAL REAVIVADA Y MEJORADA CON UNA SIMPLE INTERVENCIÓN ARTISTICA COORDINADA. EL FOMENTO DE NUESTROS ARTISTAS Y NUESTRA CULTURA  HACEN DE MADRID UNA CIUDAD CON PERSONALIDAD, Y VAMOS NECESITANDO UN RENACIMIENTO DE MOVIMIENTOS CULTURALES.</p>
";"09/09/2015 22";"36";"23";"13";"1";"875927426";"638"
"3029";"Apertura Renfe en Valdebebas";"<p>Queria proponer o debatir en este caso por que la renfe de valdebebas lleva años construida y terminada y no la abren.Es importante ya que la ciudad de Valdebebas ya tiene mucha poblacion y lo que no tienen coches tienen que cojer un autobus que sale desde Mar de Cristal, cosa que si la renfe estuviera abierta fomentabamos el que mas gente llegue y conozca valdebebas.Muchas Gracias</p>
";"09/09/2015 22";"107";"97";"10";"5";"887221468";"7886"
"3035";"Cajero o banco en Valdebebas";"<p>Hola,</p>

<p>Todos sabemos que muchas veces cuando más lo necesitas no tienes dinero en efectivo o tienes que hacer alguna gestión en el banco y el horario del trabajo te limita el horario para realizar estas gestiones.</p>

<p>Pues bien, creo que sería una buena propuesta que pusieran un cajero o una entidad bancaria en el barrio de Valdebebas donde podamos sacar dinero o realizar otras operaciones sin tener que coger el coche y recorrer mas de 5 kms para hacerlo. </p>

<p>Esta propuesta nos beneficiaría a todos los vecinos de Valdebebas.</p>
";"09/09/2015 23";"75";"60";"15";"3";"882994582";"3600"
"3038";"¿Y si vivieramos con el huso horario que nos corresponde?";"<p>La racionalización de los horarios españoles implica <strong>volver al huso horario de Greenwich</strong>. Es una decisión que debe tomar el Gobierno. Es fácil de llevar a la práctica y no genera ningún coste económico.</p>

<p>Sería tan sencillo como no adelantar los relojes el próximo año con la llegada de la primavera. El proceso debería ir acompañado por un cambio en ciertas actividades sociales. Por ejemplo, el <em>prime time </em>de la televisión se adelantaría una hora y, en el trabajo y la escuela, tendría que fomentarse<strong> la jornada continua </strong>y reducir la pausa para la comida.</p>
";"09/09/2015 23";"58";"37";"21";"7";"877773066";"1020"
"3040";"Acceso MOVILIDAD REDUCIDA desde ""CUATRO TORRES BUSINESS AREA - EST. CHAMARTIN""";"<p>Es incomprensible que aún no exista un acceso para personas de MOVILIDAD REDUCIDA desde ""CUATRO TORRES BUSINESS AREA - EST. CHAMARTIN"", solo hay posibilidad de acceder con coche o por un acceso poco cuidado y de pobre ejecución, que contiene escaleras que pasa por debajo de acceso rodado antes mencionado. (suele acomularse mucha basura, oscuro y maleza en los laterales).
Poco digno de un Madrid que debe acoger turismo, negocios y mejorar su economia.</p>
";"09/09/2015 23";"38";"33";"5";"0";"882337411";"2431"
"3043";"Aumento de opciones de grados superiores y medios.";"<p>Hola, buenas, mi nombre es Rubén y actualmente estoy preparándome para cursar un grado superior.</p>

<p>Mi propuesta es sencilla: aumentar los tipos y cantidades de grados medios y superiores para elegir, antiguamente había muchos más pero dados los recortes en educación se han reducido de forma drástica.</p>

<p>Me gustaría que se llevase a cabo porque creo que puede ser algo muy beneficioso para nosotros, los estudiantes, y para los futuros jóvenes que quieran optar por los grados.</p>

<p> </p>

<p>Gracias y un saludo.</p>
";"09/09/2015 23";"21";"9";"12";"0";"867763197";"-128"
"3044";"Permitir a vehículos residentes del centro circular por todas las APR";"<p>Con el cierre de Opera se pone de manifiesto que las Áreas de Prioridad Residencial discriminan a los residentes de los barrios limítrofes. En mi caso vivo por Malasaña. Para volver del trabajo subía por Plaza España y luego cruzaba Opera. ahora me veo obligada a dar una vuelta enorme, recorrer más distancia (contaminar más) y aguantar los atascos de la Gran Vía. Por favor, que no nos traten como si no residiéramos en el centro de Madrid!!!!</p>
";"09/09/2015 23";"48";"17";"31";"0";"865776169";"-495"
"3046";"ENSALZAR LA FIGURA DEL HUMANISTA MAS IMPORTANTE DE NUESTRO PAÍS.";"<p>Me dirijo a la opinión en aras de la cultura. ¿Quién no ha paseado por las calles de Madrid y ha observado que algo falta? Algo verdaderamente portentoso y grande que sirva de insignia, ya no solo para la ciudad sino a nivel nacional. Propongo la construcción de una estatua de Miguel de Cervantes, a ser posible de unos cuarenta metros (como el Cristo Redentor), en determinado emplazamiento para que pueda ser apreciado por todos. Considero que, si bien es cierto que se tiene en estima al creador de la novela-paradigma (amén del Instituto Cervantes), no es suficiente. Evidentemente surgen argumentos en contra, desde la exacerbación de una persona hasta el punto de rendirle un verdadero culto a la personalidad propio de regímenes autoritarios, hasta la ausencia y/o falta de financiacion de la construcción en sí. A sumarle todos los problemas que puedan derivar. Como dijo alguien: La vida es un sueño y los sueños, sueños son. Esto es una idea, desde luego no simple y fácil pero una idea. La idea es aquello que puebla la mente de uno y de todos y que puede realizarse o no. Una idea es siempre utópica hasta que se plasma. Ya que estamos abiertos a participaciones, ahí he soltado NUESTRA idea.</p>
";"09/09/2015 23";"54";"21";"33";"2";"865660787";"-466"
"3047";"Cierre del tráfico dentro de la M-30? NO ";"<p>Los millones de personas que vivimos fuera de la M-30 y pagamos MUCHOS impuestos por nuestro vehículo, necesitamos movilidad, y desde luego el metro y el bus tal y como están no son en absoluto suficientes (horario de cierre, tiempos de espera, conexiones, pago de varios billetes si quieres alternar bus/metro) etc.</p>

<p>NO es justo que además, no podamos usar el coche por el que TANTÍSIMOS impuestos pagamos.</p>

<p>Sé que para el que vive en el centro, le viene de perlas la idea de cerrar o limitar el tráfico en el centro, y yo si viviera en el centro lo desearía, pero aquí se trata del interés general y no del de unos pocos.</p>

<p> </p>
";"10/09/2015 00";"50";"17";"33";"1";"865941043";"-544"
"3048";"Propuesta: Violencia de Género (VG)";"<p>Sugiero incluir para ayudar de forma inmediata a mujeres que sufren o han sufrido VG (con sentencia firme), se incluya en las ayudas escolares (becas: libros de texto, comedor...) un apartado para víctima de violencia de género. Actualmente aparece familia numerosa, víctima de terrorismo, discapacitado...Existen muchas mujeres sin ayuda estatal que trabajan y por ello, no pueden acceder a Servicios Sociales. Lo cual no implica que subsistan cada mes, sino que además de tener que superar un trauma con o sin atención psicológica sin cobrar pensión alimentaria del agresor deben responsabilizarse de doble cargo progenitor (padre-madre) sin ayudas de ningún tipo de su Comunidad.</p>

<p>Confío en que si buscan nuevas soluciones y propuestas, además de incluir en Centros escolares la educación igualitaria, colaboren directamente con todas las víctimas según sus circunstancias personales.</p>

<p>Gracias.</p>

<p> </p>
";"10/09/2015 00";"40";"12";"28";"4";"866370170";"-480"
"3049";"considerar el trabajo en casa como un trabajo y que sea remunerado por ayto. ";"<p>Que uno de los Cónyuges pueda dedicarse profesionalmente toda su vida a este trabajo.</p>

<p>Que la remuneración vaya unida a la fidelidad (tiempo unidos) y numero de hijos.</p>

<p>Reconocimiento del trabajo en casa como el mas importante en una sociedad</p>

<p>Que el cónyuge amo\a de casa sea reconocido con el mismo nivel de un funcionario</p>

<p>Solamente serán reconocidos como cónyuge aquellos que por ccontraer matrimonio deseen ser reconocidos.</p>
";"10/09/2015 00";"68";"16";"52";"8";"866348920";"-847"
"3050";"Permitir que se coloque la placa ""DORMÍAMOS, DESPERTAMOS / PLAZA TOMADA"" en Sol";"<p>Los <strong><u>servicios de limpieza del Ayuntamiento de Madrid retiraron la placa</u></strong> que se colocó en la Puerta del Sol tras el 15 M. Permitir que se vuelva a colocar <strong><u>no tendría ningún coste</u></strong><u>,</u> como no lo tuvo en su momento, solo es anunciar que se permite que vuelva al lugar donde estaba. Fue <strong><u>la gente organizada la que intervino directamente sobre el espacio urbano </u></strong>de su ciudad.</p>

<p>No me basta con que el ayuntamiento ""cambie las plazas, ponga bancos y zonas verdes"", sino que ""deje"" e incentive a los ciudadanos a que sean <strong><u>responsables de su ciudad </u></strong>y sean sujetos activos pudiendo influir sobre el espacio público. El problema no es solo que el espacio público que se ha configurado en sí mismo (<strong><u>plazas de cemento, sin sombras, sin bancos)</u></strong>, sino que no se permite a la ciudadanía intervenir sobre la ciudad en la que viven. Los espacios públicos y como se construyen configuran la forma en la que las personas se relacionan en ese medio y todos queremos un medio que sea tan ajeno a sus ciudadanos.</p>

<p>Es una responsabilidad importante no dejar que se olvide que el 15M abrió las puertas a tener un gobierno en Madrid, un poquito más decente que los que tuvimos los últimos 30 años anteriores.</p>

<p> </p>

<p>Alguna otra opinion e información:</p>

<ul>
	<li>http://www.madridmemata.es/2015/05/madrid-plaza-tomada-o-el-15-m-llego-al-ayuntamiento/</li>
	<li>https://www.google.es/search?q=dormiamos+despertamos+plaza+tomada&amp;biw=1352&amp;bih=598&amp;tbm=isch&amp;tbo=u&amp;source=univ&amp;sa=X&amp;ved=0CCAQsARqFQoTCNL-h5mC68cCFQvpFAodXCgHQw</li>
</ul>
";"10/09/2015 00";"70";"25";"45";"5";"865602506";"-714"
"3051";"Agilizar y facilitar los trámites burocráticos!";"<p>Es un verdadero suplicio tener que hacer gestiones de oficina en oficina para resolver determinados asuntos. En una te piden un certificado de empadronamiento, en otra el libro de familia, formularios de ""nosequé"", copia del DNI, hoja modelo 3E50, y así hasta tenerte bien liado durante muchas horas o días. ¿No existe la posibilidad de que desde los organismos públicos se pida toda esa información de forma telemática y en el momento? No me creo que tenga que atravesar media ciudad para llevar un papel de un sitio a otro.</p>

<p>Por favor, revisen los procedimientos de solicitudes y pongan las cosas más fáciles a los ciudadanos para que cualquier papeleo no se convierta en una misión. La gente mayor y los que aún trabajamos agradeceremos que no nos hagan perder el tiempo ni la paciencia.</p>

<p> </p>
";"10/09/2015 00";"46";"42";"4";"3";"884796626";"3469"
"3057";"Conservación y recuperación de establecimientos y lugares históricos.";"<p>Me gustaría exponer una cuestión que siempre se me viene a la cabeza cuando paseo por el centro de nuestra ciudad. Madrid es una ciudad con mucha historia y un lugar en el que han residido un gran numero de escritores y artistas. </p>

<p>El centro de Madrid siempre ha estado lleno de cafés donde se realizaban las famosas tertulias y debates que tan famosos los hicieron, como el café de la montaña, el café levante, el cafe del principe etc. Así como la Gran Via siempre ha sido como el Broadway español, toda la calle llena de teatros y cines.</p>

<p>Por desgracia tdo eso casi ha desaparecido, siendo sustituido por franquicias alimenticias o grandes cadenas de ropa. Yo no digo que esas tiendas no deban existir, los tiempos cambian, pero creo que los lugares históricos debian estar protegidos, precisamente por eso, por su importancia histórica. Además, esto fomentaria más el turismo cultural de nuestra ciudad.</p>

<p>Cada cosa tiene su espacio y su lugar. No se trata de prohibir, sino de proteger lo que ha marcado la historia de nuestra ciudad.</p>
";"10/09/2015 01";"46";"40";"6";"1";"883811812";"2956"
"3059";"Limpiar madrid de propaganda";"<p>No sé si los señores administrativos del Ayuntamiento de Madrid aparcan en la calle, pero ¿no están cansados de tener que ""desempapelar"" su coche de propaganda todos los días un par de veces? Yo particularmente ya no recojo esta basura y la deposito en las papeleras, las tiro al suelo a ver si de una vez se empieza a multar a los anunciantes. Es un asco y una falta de respeto. Parece mentira que nadie tome medidas hasta que madrid parezca un estercolero. Gracias</p>
";"10/09/2015 01";"55";"49";"6";"4";"885247585";"3830"
"3060";"Asfaltar las calles tipo camino cabras";"<p>En mi calle ya empiezan a verse adoquines de la antigua villa de madrid. Hay baches que pueden destrozar suspensiones de tractores.... Me pregunto si están esperando a que la basura caiga allí por casualidad y vayan desapareciendo. Como se nota que viven en lugares bien bonitos y aseados. Si es que la NO CASTA se EN-CASTA con rapidez. Gracias</p>
";"10/09/2015 01";"32";"21";"11";"1";"877290952";"656"
"3061";"Remodelación de la Plaza de Tirso de Molina";"<p>Antes de ser ""remodelada"" por orden de Gallardón la Pza de Tirso de Molina olía a tierra mojada cuando llovía. Tenía muchos más árboles, una fuente para beber y bancos para sentarse. Ahora solo huele a pis. Quitaron el parque, los bancos, la tierra y la alicataron hasta el techo con un empedrado que tiene la sorprendente cualidad de acumular los churretones y los malos olores para que permanezan incluso cuando algune vez (raramente) se baldea.</p>

<p>Hoy apenas queda espacio para los vecinos en la plaza. Los feísimos y degradados armatostes que sirven como puestos de flores ocupan muchísimo espacio poniendo cada uno tres grandes sombrillas (además de sus toldos) y generan basura que se amontona en el suelo y junto a los contenedores de reciclaje (siempre llenos) convirtiendo la esquina con C/Duque de Alba en un vertedero permanente.</p>

<p>¿Para qué necesitamos vecinos y visitantes seis o siete tiendas de flores en una plaza?</p>

<p>Uno de esos puestos de flores, hoy permanentemente cerrado, se ha convertido en un espacio que proporciona la intimidad necesaria al enorme unrinario al aire libre en que se ha convertido un lado de la plaza, junto al Metro. </p>

<p>Alcoholicos e indigentes han ocupado de forma permanente los pocos espacios que había para sentarse y ya nadie disfruta de ellos si no es para participar de su botellón, peleas y fiesta de la espuma (de orines) permanente. Por cierto, el supermercado y las tiendas de alimentación aledañas se lucran vendiéndoles bebidas alcohólicas para consumir en plena calle pero no disponen ni siquiera de un baño donce estas personas puedan entrar a hacer sus necesidades. </p>

<p>Ya no hay ni rastro de los maceteros de hierbas aromáticas ni de las fuentes que la desastrosa remodelación de Gallardón diseñó en origen para la plaza. La lámina de agua luce casi siempre sucia y seca o se atasca por las hojas caídas o los papeles y las latas arrojadas al fondo.</p>

<p>Las fuentes del extremo están practicamente tapadas por un aparcamiento de motos en plena acera. Las otras averiadas u ocultas detrás de las enormes terrazas de los tres bares o cuatro que nos han privado a los vecinos del disfrute de la plaza (pública) si no es consumiendo y pagando sentándonos en las sillas y mesas colocadas algún (seguro que muy lucrativo) negocio privado.</p>

<p>Este es más o menos el aspecto actual de la Pza de Tirso de Molina y ruego a este Ayuntamiento que la remodele y nos la devuelva a los madrileños en condiciones dignas para su disfrute. </p>
";"10/09/2015 01";"56";"41";"15";"7";"881292202";"1903"
"3062";"Promocionar nuestro baile regional, ""el chotis""";"<p>Hola, me parece mentira, que el chotis esté practicamente en el olvido, que nuestros jovenes no sepan de que van frases como "" <em>Pichi</em>, <em>es el chulo</em> que castiga del Portillo a la Arganzuela, y es que no hay una chicuela que no quiera ser amiga de un seguro servidor"" , por eso pido políticas de promoción y expansión de nuestro bile identitario, gracias</p>
";"10/09/2015 01";"49";"31";"18";"3";"877897441";"822"
"3063";"Tarjeta de transporte publico para jovenes";"<p>Una tarjeta de transporte publico especifica para jovenes de 12-23 años mas barata y valida para todas las zonas de la comunidad de madrid</p>
";"10/09/2015 01";"30";"12";"18";"2";"867640778";"-240"
"3064";"Movilidad urbana que gire entorno a la bicicleta.";"<p>Si queremos tener una ciudad medianamente respirable y habitable, en mi opinión hay que apostar con decisión por el uso decidido de la bicicleta.</p>

<p>Por ello propongo una serie de medidas que hagan de la bicileta un tansporte atractivo para los usuarios, en sus desplazamientos diarios.</p>

<ul>
	<li>Integración de la bicileta en el transporte publico, ampliaando los horarios en los que se puede acceder al metro o cercanias con la bicicleta.</li>
	<li>Instalar portabicicletas en los autobuses.</li>
	<li>Crear zonas en las que el estacionamiento de la bicicleta privada sea seguro. Aparcamientos vigilados, convenios con empresas, instituciones publicas etc.</li>
	<li>Grabar el trafico de vehiculos en el centro con un peaje.</li>
	<li>Dotar a bicimad de sillas para niños, triciclos para llevar mercancia y otros vehiculos electricos para personas con movilidad reducida.</li>
</ul>

<p>En definitiva aprovechar el espacio publico para ganarle terreno al coche privado y penalizar su uso razonablemente.</p>
";"10/09/2015 01";"65";"36";"29";"3";"875668513";"387"
"3065";"Prioridad real en carriles bici sobre circulación a motor";"<p>Cuando uso los carriles bici de Madrid, sobre todo el Anillo Verde, no puede entender la forma en la que se han hecho mucho de los cruces y los cambios de vía innecesarios que existen.</p>

<p>Entiendo que cuando se realiza una obra como el Anillo Verde, o un carril bici que comunica con el centro, se hace para dar la preferencia total a las bicicletas, pero muchas veces nos encontramos con que hace giros y cruces de vía con el fin de que no molesten a la circulación de vehículos de motor, y se suele obligar a frenar al cilcista en todos los cruces con la vía.</p>

<p>Por tanto propongo:</p>

<p>- Que los carriles bici estratégicos: Anillos Verde y carriles bici que comunican (o puedan comunicar en el futuro) con el centro, se les dote de preferencia real sobre los vehículos de motor y se les obligue a ceder el paso a los ciclistas y/o peatones en esas vías. El fin es dotar de una preferencia real a éstas mediante pasos que estén con un peralte o semáforos en ámbar de forma continuada para vehículos de motor en los cruces.</p>

<p>- Rediseñar determindos puntos de estas vías que se han hecho pensando más en evitar molestias a la circulaciòn de vehículos a motor que en promocionar la movilidad sostenible como alternativa. Un ejemplo claro es el Anillo Verde a su paso por San Chinarro o Las Tablas.</p>
";"10/09/2015 01";"51";"32";"19";"2";"877878639";"815"
"3066";"Licitaciones publicas limpias";"<p>Crear un equipo tecnico multidisciplinar que valore tecnicamente las licitaciones publicas sin conocer los nombres de los licitadores. Esto, señores políticos es la clave de la corrupción en España y nadie tiene el coraje de entrar a valorar. La valoración técnica (que depende de un juicio de valor) es la que da puntos dificilmente recurribles y permite adjudicar millonadas a los amiguitos. Creen jueces tecnicos y exijan propuestas tecnicas totalmente anónimas. Adjudiquen al mejor y mas economico. </p>
";"10/09/2015 01";"22";"22";"0";"0";"884200191";"2200"
"3068";"Tejados Verdes";"<p>En mi opinión, creo que los edificios de Madrid son lo suficientemente robustos como para soportar ciertas cantidades de vegetación.
El motivo por el que me parece buena idea no es ni de producción ni estético. Sinó una aglomeración de los siguientes:</p>

<p>
<strong>- Mejorar el pulmón de Madrid.</strong></p>

<p>Madrid tiene la dichosa suerte de contar con un gran número de parques y jardines en comparativa con otras ciudades. Pero España ha perdido gran parte del verde que tenía y eso se nota a muchos aspectos. El calor del Sahara sube hacia el norte y el aire contaminado se mantiene.
Cualquiera que haya pasado la tarde mirando Madrid desde alguna altura por encima de los edificios se da cuenta. Hasta hace bastante poco, el Palacio Real era conocido por el cielo negro que presentaba cuando miravas sobre la ciudad en los atardeceres. Sinceramente, me parece algo bastante triste</p>

<p> </p>

<p>-<strong> Jardineros</strong>
Aunque sea poco, es más empleo. Lo cual es algo que creo que debería ser otra de las prioridades de cualquier govierno.</p>

<p>No se mucho sobre jardinería. Pero creo que hay plantas que solo necesitan un sistema automático de regado y alguien que las revise cada semana. Lo cual tampoco sería un gasto tan excesivo.
 </p>

<p>-<strong> Vanguardia</strong></p>

<p>Desde mi punto de vista, este proyecto debería aplicarse a todas las ciudades del mundo. El ser humano ha diezmado brutalmente los bosques de todo el planeta para hacer sus carreteras, ciudades, campos de cultivo, ect. Incluso es dificil perderse en un bosque de España a estas alturas. A penas son lo suficientemente espesos.</p>

<p>Pero, si este proyecto sale bien y, siendo absurdamente optimistas, todo el planeta lo sigue, creo que podríamos ayudar a la naturaleza a volver a su equilibrio. Solo un poquito. Creo que tampoco pido tanto.</p>

<p> </p>

<p>Creo que eso es todo. Me gustaría conocer las opiniones de mis vecinos al respecto.</p>

<p>Obviamente no pido que quiten antenas de comunicación. Hay muchos edificios que no las tienen.</p>

<p>Tampoco creo que sea un sacrificio tan grande de dinero. Creo que hay cosas que no se merecen tanta atención monetaria como lo hacen y podrían vivir perfectamente igual sin ese menos. No señalizaré por que no quiero comenzar disputas sobre eso.</p>

<p>Por favor, si comentais, hacedlo con lógica, calma y constructivamente.</p>
";"10/09/2015 02";"42";"35";"7";"1";"882953771";"2333"
"3069";"Y que hay de las Ventas ?? Habrá toros en San isidro?";"<p>¿ Que hay de las Ventas?¿ Habrá toros en San Isidro?</p>
";"10/09/2015 02";"59";"15";"44";"5";"867001401";"-737"
"3070";"Colonias de murciélagos contra la plaga de mosquitos de Manzanares Sur.";"<p>Una colonia de murciélagos puede comer entre 8.000 y 10.000 mosquitos por hora. Este tipo de control biológico de plagas se realiza ya en varias ciudades de España en colaboración con universidades. Recuperar la rivera y acabar el Parque Lineal del Manzanares atraería además a más fauna insectívora,.</p>
";"10/09/2015 02";"48";"44";"4";"1";"885716931";"3666"
"3073";"Transformación ""ecológica"" de la flota de taxis  ";"<p>Que bien sean híbridos, eléctricos o usen gas natural. Para próximos cambios y/o incentivos para la transformación a gas como combustible. La eficiencia en el consumo en los tres casos es evidente, como evidente es la rebaja en los contaminantes emitidos.</p>
";"10/09/2015 03";"48";"42";"6";"4";"885029913";"3150"
"3074";"Apertura del Metro por la noche para la gente sin hogar";"<p>Ciertas estaciones de metro disponen de espacio suficiente para alojar a cientos de personas que duermen cada día en la calle. </p>

<p>Con la llegada del invierno muchas personas pueden morir de hipotermia debido a las bajas temperuturas y a la obligación de dormir sobre un banco o en el mismo asfalto por las circunstacias que sean. </p>

<p>Propongo la apertura del metro por la noche para alojar a esas personas y la contratación de otras para vigilar que no causen ningun problema en las instalaciones. </p>

<p>De este modo se crearía empleo y se solucionaría uno de los grandes problemas actuales de España, la gente que tristemente duerme en la calle cada día.</p>

<p>Gracias</p>
";"10/09/2015 03";"67";"16";"51";"8";"867409987";"-835"
"3075";"Señalizacion Correcta (VerticalHorizontal) para la ""Carga y Descarga"" y S.E.R.";"<p>La mala señalizacion de las Zonas de Carga y Descarga (solo estan en Vertical mediente Placas) y de la Zona de Estacionamiento Regulado S.E.R. (solo en Horizontal mediante pintura Azul o Verde), hace que se impongan muchas multas en el Casco Urbano de la Ciudad de forma injusta.</p>

<p>Esto produce que muchas personas aparquen en dichas zonas y saquen el correspondiente ticket de Aparcamiento (Azul o Verde), sin darse cuenta que SOLO se puede estacionar en el la franja horaria entre las 14:00 y las 16:30, es decir tan solo 2 horas y media.</p>

<p>
Las Zonas de ""Carga y Descarga"" tienen un Horario de 09:00 a 14:00 y de 16:30 a 20:00 horas. Lo cual implica que el uso Autorizado para la Zona de Estacionamiento Residentes S.E.R. (Verde o Azul), SOLO se puede usar desde las 14:00 a 16:30 horas.

Al igual que hacen otros muchos Municipios, el doble uso deberia estar convenientemente señalizado de forma equitativa (Vertical y Horizontal), es decir que aquellas zonas SER que esten en zona de Carga y Descarga, deberian llevar ademas un rayado en Amarillo, advirtiendo que esa zona SER es de Horario Restringido.

Estas multas injustas no solo afectan a los Ciudadanos de Madrid, sino tambien a muchos visitantes que desconocedores de esta situacion, se fijan unicamente en la Señalizacion Horizontal (Verde o Azul) y no se fijan en las Placas Verticales de Prohibicion de Aparcamiento.</p>

<p> </p>
";"10/09/2015 03";"48";"42";"6";"10";"885430099";"3150"
"3076";"Señalización y megafonías bilingües en EMT y Metro.";"<p>En el Cercanías Renfe la tienes, ¿por qué no en estos transportes públicos? Así facilitariamos más la visita de un turista que no sepa hablar español. Tampoco sería mala idea en las pantallitas de los autobuses y las de algunas líneas de Metro poner en algunos idiomas más.</p>
";"10/09/2015 03";"44";"30";"14";"1";"879866773";"1090"
"3077";"Que se pueda andar en cueros por la calle";"<p>Esto sería algo realmente novedoso y representaría un importante ahorro en ropas para las familias más pobres. </p>
";"10/09/2015 04";"73";"18";"55";"1";"867818049";"-912"
"3078";"Incluir el Orgullo LGTB como fiesta popular";"<p>Hacer del Orgullo fiesta popular es necesario, ya que es la fiesta más grande de la ciudad y la que más afluencia y dinero trae a la ciudad. También potenciarla más y que sea como las Fallas en Valencia o la Feria de Abril en Sevilla. Y que siga teniendo el carácter revindicativo que tiene.</p>
";"10/09/2015 04";"84";"35";"49";"17";"867236778";"-583"
"3079";"Autobuses de la EMT en ciudades periféricas de Madrid.";"<p>Muchos ciudadanos y ciudadanas de ciudades periféricas trabajan y salen por Madrid capital. Sería bueno para ellos que tuvieran un autobús de la EMT en sus localidades y les acercara al centro de Madrid. Tendrian uno y ellos también deberían pagar a la EMT en sus municipios, muchos de sus autobuses les dejan en sitios no muy céntricos como Plaza de Castilla o Avenida de América y sería una gran ayuda que llegaran hasta Colón o Plaza de España. Podría funcionar en las localidades más próximas a Madrid como Alcorcón, Coslada, Getafe, Pozuelo de Alarcón o San Sebastián de los Reyes que están aproximadamente a unos 20 kilómetros del centro de nuestra ciudad.</p>
";"10/09/2015 04";"29";"10";"19";"3";"868564655";"-310"
"3080";"Peatonalizar más calles";"<p>Las calles del centro que se han peatonalizado (Arenal, Fuencarral...) se han convertido en un éxito social y comercial. Está claro que la ciudadanía demanda este tipo de espacios.</p>

<p>Propongo profundizar en esa tendencia, y hacerlo de sólo en el centro, sino también en los barrios en torno a los principales centros neurálgicos o comerciales.</p>

<p>En el centro sería muy bienvenida la peatonalización de la calle Mayor, un lugar con gran afluencia de público y con lugares emblemáticos por su historia y arquitectura, que se ve desmerecido por pequeñas aceras y el interminable ruido de los coches que se han adueñado de nuestra ciudad.</p>

<p>También del Paseo del Prado: ¿habéis imaginado al pasear por ahí que no hubiera coches? ¿Cómo se convertiría en una de las mejores calles del mundo para pasear y disfrutar de los museos, del botánico, los árboles...? Se podría soterrar el tráfico si esas comunicaciones fueran necesarias, pero ese espacio debe volver a los ciudadanos.</p>

<p>¡Madrid para los ciudadanos, no para los coches!</p>
";"10/09/2015 05";"72";"50";"22";"11";"882511005";"1944"
"3081";"Monumento de nuestro Rey de España, Don Felipe VI";"<p>La capital debe ensalzar los símbolos españoles, que menos que un monumento para nuestro Rey en funciones, Viva El Rey!!</p>
";"10/09/2015 05";"71";"21";"50";"4";"867910431";"-857"
"3083";"Jardinería en rotondas";"<p>Me llama poderosamente la atención, el gasto que algunas de las rotondas de Villa de Vallecas acarrean en concepto de ornamentación. Concretamente algunas, como la que da acceso al barrio desde el polígono. Cada pocos meses varios jardineros se afanan en replantar flores ornamentales, de corta vida. Es curioso el contraste con otras rotondas del mismo distrito, concretamente del ensanche, que lucen olivos, lavanda, y otros arbustos. Son mucho más sostenibles, y en nada desmerecen a las otras. Esta circunstancia se da, en todos los distritos.</p>
";"10/09/2015 07";"41";"36";"5";"3";"886143844";"2721"
"3084";"Terrazas ""búnker""";"<p>Buenas a todos. He repasado un poco todos los debates relativos a ""terrazas"" y no he encontrado lo que quiero plantear, al menos no de forma exacta. Si ya existiese otro debate, me gustaría que de ser posible, los administradores lo aglutinen o algo para no dispersar.</p>

<p>Bien, al lío. Madrid desde que recuerdo siempre ha sido una ciudad con terracitas de bares, algo muy agradable para los que en ocasiones somos clientes. El problema que encuentro es que de unos años hasta ahora, especialmente coincidiendo con la famosa ""Ley Antitabaco"", muchos negocios han construido ""fuertes"" o ""búnkeres"" que aún llaman ""terrazas"", es decir, <strong>construcciones </strong>privadas ocupando espacio público. Las hay parcialmente cerradas, con pilares y toldos, pero las hay incluso cerradas con ventanales de climalit y equipos de aire acondicionado o calefacción... en definitiva, que son <strong>extensiones de los locales en la vía pública que incluso sirven como forma de burlar las restricciones de la mencionada ""Ley Antitabaco""</strong>.</p>

<p>Particularmente no estoy nada de acuerdo con este modelo de terrazas, me parecen una burla a la ciudadanía.<strong> Me parece bueno el modelo tradicional, de mesita, sillas y si acaso sombrilla en verano, todo portátil</strong>, que se puede y debe retirar en los horarios en que no se esté explotando, y así libera de nuevo el espacio ocupado al público.</p>

<p>Espero que sea a consideración.</p>

<p>Saludos.</p>
";"10/09/2015 07";"68";"59";"9";"19";"888224855";"4338"
"3085";"Crear una red de carriles bici, en serio.";"<p>Sabemos que Madrid no es una ciudad plana, como otras del norte de Europa y que tiene muchas calles estrechas. Pero hay mucha gente que está dispuesta a moverse por Madrid en bicicleta, a moverse con seguridad y rapidez. Y ello no es posible hacerlo sin una red de carriles bici en condiciones, separados tanto de la calzada como de la acera, que tengan preferencia en algunos puntos sobre el tráfico rodado y sobre los transeúntes, no es lógico un carril bici donde en cada paso de cebra o semáforo te tengas que parar. A un transeúnte le cuesta muy poco parar y reanudar la marcha, a una bici un poco más. Y todo ello partiendo de la base de la seguridad del ciclista, obligando al casco, a una velocidad adecuada y a una visibilidad correcta. Sólo hay que ver el peligro que suponen las actuales bicicletas eléctricas que hay, con un ciclista sin casco, a velocidades muy elevadas y por aceras y lugares muy transitados.</p>
";"10/09/2015 07";"53";"36";"17";"2";"881936847";"1290"
"3086";"Aparcamiento para BICICLETAS en estaciones de Metro y Cercanías";"<p>Si quieres moverte en bici desde casa a un metro o cercanías, tienes que abandonarla en la calle o atarla a una farola. </p>

<p>Reclamamos la HABILITACIÓN DE APARCAMIENTOS dignos para BICICLETAS en todas las estaciones de metro y cercanías, así como en los intercambiadores de transporte.</p>

<p>¿Cuándo vamos a empezar a tener un entorno que promueva en serio el uso de la bici y el transporte público en Madrid?</p>
";"10/09/2015 07";"127";"109";"18";"1";"890070644";"7810"
"3087";"Barreras de sonido alrededor de la M30";"<p>Buenos dias, vivo cerca de la M30, y hay zonas con barreras de sonido y otras sin ellas, como es el caso del parque de Sancho Dávila, entre calle Alcalá y O'donell. Creo que hay que insonorizar toda la M30, pasear por las calles y parques cercanos será más agradable, así como vivir cerca.</p>
";"10/09/2015 08";"36";"33";"3";"4";"887026387";"2750"
"3088";"Piscina pública o servicios públicos en cocheras del metro";"<p>En Ventas están las cocheras del metro, que van a ser trasladadas. La propuesta inicial es centro comercial y pisos de lujo en ese espacio. Yo quería proponer que se haga un piscina pública, pues el centro carece de estas, y estaria junto al metro lo que favorecería que muchos la utilizasen sin necesitar coche. </p>

<p>Otras propuestas es una guardería pública, no hay en el barrio ninguna, o un parque bonito.</p>
";"10/09/2015 08";"35";"24";"11";"0";"881030991";"891"
"3089";"Subasta publica de todos los coches oficiales del ayuntamiento de madrid";"<p>Todo Funcionario y/o Trabajador ( de cualquier condicion ) del Ayuntamiento de Madrid en "" Transporte publico ""</p>

<p>y los "" Cargos Politicos "" en bici, metro , autobus ; o mejor en su propio coche .</p>

<p> </p>

<p>Subasta inmediata de todos los coches oficiales , incluido el de la alcaldesa y los consejales .....   la bici es mas sana ...</p>
";"10/09/2015 08";"118";"96";"22";"4";"888753417";"6020"
"3090";"ACERAS DEMASIADO ANCHAS";"<p>En Lopez de Hoyos se han ensanchado las aceras exageradamente, lo que hace estrechar el paso para los coches y consiguientes atascos. Han quitado zonas de aparcamiento y es un auténtico caos. Han puesto ""un bosque"" de semáforos que aún lo hacen más complicado. </p>
";"10/09/2015 08";"38";"10";"28";"1";"870169375";"-473"
"3091";"Conexión poligono Industrial Vallecas- Anillo ciclista";"<p>No existe conexión segura entre el carril bici del poligono industrial de Vallecas, (Ctra Villaverde-Vallecas), con el anillo ciclista.</p>

<p>Hay dos posibilidades, utilizar una carretera sin arcen, serpenteante y de mas de 2 km hasta la estación del Pozo o seguir el carril bici hasta el CTM de Vallecas y el Hotel-Pub, donde el camino desaparece y o te metes por la carretera o cruzas por debajo de la M40, por un camino de cabras, cristales, mierda y que cuando llueva será impracticable.</p>

<p>La opción de continuar por la carretra Villaverde Vallecas es la mas segura, por ser la mas corta, existen partes con arcen, y de bajada es mas rápida, pero no se avisa a los conductores de vehiculos a motor que puede haber ciclistas, ni por señales verticales ni horizontales. Con un par de señales de aviso sería suficiente.</p>
";"10/09/2015 08";"50";"40";"10";"1";"885381310";"2400"
"3092";"Aceras de asfalto o cemento en vez de granito y baldosas";"<p>Supongo que todos los madrileños habéis pisado en alguna ocasión una baldosa suelta en una acera y os habéis empapado de agua sucia o incluso os habéis hecho daño en un tobillo. Mi propuesta es <u><strong>que se vayan sustituyendo las actuales aceras</strong></u> de la ciudad <u><strong>por</strong></u> otras de <u><strong>material asfáltico o cemento</strong></u> (como se ha hecho en el Paseo de Recoletos). Es una solución práctica, económica y rápida que se utiliza en la mayoría de ciudades europeas. Tiene la ventaja de que por menos dinero se arreglan/construyen más metros de acera (y se da más trabajo), no hay baldosas rotas o sueltas y se repara en un momento.</p>
";"10/09/2015 08";"32";"19";"13";"1";"878414021";"356"
"3093";"Revisión de procedimientos administrativos y funciones";"<p>Las funcionarias y los funcionarios municipales somos también Ciudadanía.</p>

<p>Además de vecina de Madrid, soy funcionaria municipal, Administración a la que accedí mediante oposición libre primero, ascendiendo mediante concurso oposición de carácter interno con gran esfuerzo y años de lucha para conseguir que se abriera algún cauce de promoción.</p>

<p>Llevo 27 años en esta administración pública viendo como una serie de procedimientos obsoletos se perpetúan sin que ningún equipo de gobierno se haya preocupado en cambiarlos o eliminarlos, en todo caso se han incrementado y sin que exista una uténtica coordinación entre los distintos y complejos elementos que configuran una administración mucho más complicada de la que muchos imaginan.</p>

<p>Quiero, por tanto, abrir un debate necesario sobre dos cuestiones, respecto al Ayuntamiento de Madrid, en mi opinión básicas y que siguen sin ser tratadas en profundidad:</p>

<p>1º.-Sobre el papel de los funcionarios y funcionarias municipales que nos hemos visto privados de una carrera administrativa, promoción y formación de alta calidad, por unas políticas que no tenían en cuenta las ganas de aprender y hacer de muchos de nosotros y nosotras, primero mediante políticas de personal rancias y nepotistas y después con otras invasivas que no tuvieron en cuenta la frustración que podía producir la llegada, por otra parte necesaria pero que no debía ser generalizable, de trabajadores de otras AAPP. Hablo en concreto de los problemas que llevamos arrastrando desde hace años en relación a la promoción interna, la provisión de puestos de trabajo y el acceso a la dirección y predirección municipal.</p>

<p>2º.-El número de procedimientos obsoletos que aún tenemos en el Ayuntamiento y que nadie se ha ocupado de cuantificar, cualificar y eliminar o modificar, promoviendo una cultura interna de consulta a quienes estamos trabajando día a día en nuestro puesto de trabajo que vemos como se producen situaciones que más bien parecen de administraciones del siglo XIX que del XXI. Supongo que no seré yo la única funcionaria que observo que en mi ámbito podrían cambiar muchas cosas para realizar el trabajo de una manera más eficiente y menos perjudicial para la ciudadanía.</p>

<p>En definitiva quiero abrir un debate necesario sobre la función pública municipal y la necesaria implicación de los funcionarios y funcionarias par lograr una ciudad mejor, sin embargo para eso necesitamos estar motivados y además que nos permitan participar en ese cambio, no creo que ocupar los nichos por elementos venidos de la política solucione muchos de nuestros problemas toda vez que, LOS FUNCIONARIOS Y LAS FUNCIONARIAS MUNICIPALES TAMBIÉN SOMOS CIUDADANÍA.</p>
";"10/09/2015 08";"54";"50";"4";"13";"889372056";"4259"
"3094";"Radares Semaforo, hacer que no sean un peligro";"<p>Cuando veo un radar semaforo, lo que me dice mi instinto es que mire a las luces, encima a las de arriba. Estas pendiente de que no se ponga en ambar y si se da el caso, en ese momento te entra un estres terrible y no sabes qué hacer, si frenar (frenazo) o acelerar para que de te tiempo antes de cambiar a rojo.</p>

<p>Por lo general el tiempo que el semaforo permanece en ambar es relativamente corto y no hay tiempo de pensar qué es lo mejor.</p>

<p>Atencion, he dicho que estas pendiente de la luz, con lo cual si hay un peaton no lo vas a ver y como se le ocurra invadir la calzada te lo puedes llevar por delante.</p>

<p>Opino que son un AUTENTICO PELIGRO.</p>

<p>Creo que se debería regular su funcionamiento de alguna forma.</p>

<p>Sugiero algo parecido a un comentario que han puesto en otro hilo donde sugieren que se quiten, yo prefiero que se regulen, pero para que sean positivos. Mi propuesta es la siguiente</p>

<p>** Que el ciclo del semaforo antes de ponerse en rojo en los radares semaforo sea el siguiente:</p>

<p>      1.- Ciclo de 4 intermitencias en ambar de una duracion especificada en la norma</p>

<p>      2.- Luz ambar encendida durante un tiempo establecido en la norma, creo que 3 o 4 segundos sería adecuado</p>

<p>      3.- Encendido final de la luz roja</p>

<p>Opino que de este modo hay tiempo para que el conductor pueda reaccionar y tambien para que éste automatice la parada o no delante del semaforo. Si estas muy cerca y empieza la intermitencia, te da tiempo a pasar con tranquilidad y puedes estar pendiente de los peatones, si estas a cierta distancia no hay duda, frenas tranquilamente</p>
";"10/09/2015 08";"28";"23";"5";"4";"884244853";"1478"
"3095";"Amansar el tráfico poniendo badenes en los pasos de peatones";"<p>Para que los coches no aceleren al ver el semáforo en ambar y eviten circular a más de 50Km/h aunque haya pasos de cebra, se pueden poner badenes en los pasos de peatones como los que ya hay en muchas travesías de carreteras generales que atraviesan pueblos o, curiosamente, en las calles de barrios como La Florida u otras zonas residenciales. Esta medida es aplicable a los pasos con semáforo y a los pasos sin semáforo. En los pasos con semáforo se reducirá la velocidad y además se evitarán las ocasiones en las que se acelera para pasar un semáforo en ámbar o en rojo. En los pasos sin semáforo se evitará la velocidad excesiva y se protegerá el derecho preferente de paso del peatón en los pasos de cebra. En ambos casos se conseguirá amansar el tráfico y se le hará ver al conductor que la calle no es sólo suya porque los peatones también existe. Esta actuación además simplifica la adecuación de las aceras al nivel de la calzada pudiendo dejarse un nivel contínuo del firme para los peatones, especialmente para las sillas de ruedas. </p>
";"10/09/2015 08";"44";"19";"25";"4";"870567959";"-259"
"3096";"Aparcamientos públicos  disuasivos a la entrada a Madrid";"<p>Ahora que tanto se habla y con razón de reducir el tráfico en la ciudad y con ello la contaminación, el ruido, el stress,..., me parece una prioridad absoluta el invertir en <u>grandes aparcamientos públicos disuasorios </u>que estén ubicados al lado de estaciones de metro antes de acceder a la ciudad para que las personas que vivimos en la periferia podamos dejar el coche y acceder al centro en transporte público. Por ejemplo, el caso que conozco y del que puedo hablar sería en Colonia Jardín (estación de metro más cercana para gente de Boadilla, Brunete, Villaviciosa, Húmera...a través de la M501) donde el pequeño aparcamiento gratuito que hay es completamente insuficiente y enseguida ya no hay donde dejar el coche (Ah, el metro ligero es tan desesperadamente lento que no es una opción para ir a trabajar). Se podría cobrar una cantidad mínima simbólica (no lucrativa) para sufragar su mantenimiento y que no tuviese costes en ese sentido. Al igual que este caso que conozco y del que puedo hablar,sería extrapolable a los otros accesos a la capital.</p>
";"10/09/2015 09";"53";"49";"4";"5";"889197615";"4160"
"3097";"Instalaciones deportivas en el lago de la Casa de Campo.";"Las instalaciones para practicar waterpolo del lago de la Casa de Campo están en un estado deplorable, apenas son utilizadas y hay un pantalán permanente que ocupa gran parte de la superficie cercana al aliviadero del lago. Dichas instalaciones no permiten poder recorrer en barca todo el perímetro del lago, su escaso uso y su estado hace que parezca más un vertedero que instalaciones deportivas, afeando el paisaje, por lo que solicito su retirada.";"10/09/2015 09";"20";"19";"1";"0";"885747022";"1709"
"3098";"Solución al aparcamiento para residentes. Distrito Salamanca.";"<p>En el distrito de Salamanca, particularmente en la zona de Ibiza y calles aledañas existe un verdadero problema con el aparcamiento. Ya se realizó un parking cuyas plazas eran de venta al público pero esto no ha solucionado el problema, dado que en mi opinión no reside en el número físico de plazas de aparcamiento en la vía pública.</p>

<p>Cuando hablo de un problema serio de aparcamiento, estoy hablando de una media de una hora para poder aparcar. Una media. Esto significa que muchos hemos sufrido periodos de hora y media y hasta dos horas para encontrar una plaza libre. La zona de Ibiza está perfectamente comunicada por medio del transporte público y sobra decir la contaminación y el consumo energético que provocan en la zona estos embotellamientos. Esta situación viene producida por el hecho de que la zona tiene un fuerte desarrollo en el sector servicios. Hay una gran oferta, de calidad y a la que la gente acude con regularidad. Esto  es algo positivo, con la salvedad de que la administración anterior y sus evidentes intereses o favoritismos en la zona propiciaron una absoluta anarquía vial. No he visto en mis quince años de residente una sola grúa, ni funcionario público sancionando vehículos en la zona fuera del horario regulado. Hablo entradas de garajes, aceras, plazas para minusválidos y calles de dos carriles ocupadas por coches estacionados ilegítimamente a sabiendas de que no conllevará sanción alguna.</p>

<p>Esta situación se vuelve especialmente llamativa durante el fin de semana. De terminar la permisividad con este fenómeno se solucionaría casi por completo el problema, dado que como he expuesto anteriormente la zona es céntrica y está perfectamente conectada, por lo que puedo afirmar que el uso masivo del coche es una elección y no una obligación. El cumplimiento de las normas de aparcamiento en la zona disminuiría radicalmente el número de vehículos buscando plaza a sabiendas de que no existe la posibilidad de hacerlo ilegalmente y puesto que la zona ya está bastante congestionada de por sí.</p>

<p>Las aglomeraciones de tráfico se producen como es lógico en los intervalos que no cubre el servicio de estacionamiento regulado, por lo que en este sentido, no está cubriendo la necesidad para la que fue concebido. Esto podría solucionarse fácilmente con otras medidas, como destinar la mayor parte de plazas al estacionamiento de residentes fuera del horario del SER. La zona cuenta además con gran número de parkings que en estos intervalos están siempre al completo.</p>

<p>Gracias por la leerme y espero cualquier tipo de propuesta, alternativa o participación por parte de todos y en especial de mis convecinos sobre este asunto.  </p>

<p>Un saludo.</p>
";"10/09/2015 09";"20";"10";"10";"5";"873906108";"0"
"3099";"Autobuses urbanos e interurbanos no respetan las normas de tráfico";"<p>Propongo dar un curso de conducción responsable a los conductores de los autobuses de la EMT. Frecuentemente veo como se saltan semáforos en rojo, se saltan líneas contínuas o exceden la velocidad.</p>

<p>Una vez impartido el curso los autobuses podrían llevar un mensaje indicando que si alguien ve al conductor cometer una infracción lo denuncie de una determinada manera, indicando un código único para cada autobus. Seguro que la EMT y el Consorcio Regional de Transportes tienen identificados cada conductor con un vehículo en cada monento.</p>

<p>De esa manera podríamos contribuir a pacificar un poco más el tráfico.</p>
";"10/09/2015 09";"37";"35";"2";"3";"888367148";"3121"
"3100";"Dedicar una plaza o monumento a Los Tercios españoles";"<p>Creo que se debería dedicar una plaza y monumento por suscripción popular a los tercios españoles que durante  mas o menos 150 años fueron el asombro y azote de los enemigos de España.</p>

<p>Para recordar a todos aquellos, piqueros, arcabuceros, coseletes, mosqueteros, alfereces, capitanes, morraleros, que sufrieron y lucharon por España y sus ideales, creo que se les debe dedicar una plaza.</p>

<p> </p>

<p> </p>
";"10/09/2015 09";"81";"49";"32";"12";"881877931";"1028"
"3101";"Prohibición de taxis circulando vacios a la busqueda de clientes";"<p>La circulación de taxis vacíos dando vueltas a la búsqueda de clientes considero que es perjudicial para el tráfico urbano, un despilfarro energético innecesario y una fuente de contaminación adicional.</p>

<p>Ahora se habla de prohibirlo en los días de más contaminación, pero no le veo ningún beneficio a que se permita el resto de días.</p>

<p>Creo que sería más eficiente obligar a los taxis libres a permanecer en las paradas habilitadas para ellos y si alguien necesita que le recojan en un punto concreto puede pedirlo vía tlf o app.</p>

<p>Además no creo que perjudique a los taxistas, ya que nadie va a dejar de coger un taxi por esta medida, y dado que la norma afecta a todos por igual no discrimina a los taxistas que esperan en las paradas frente a los que dan vueltas.</p>
";"10/09/2015 09";"56";"29";"27";"6";"876611061";"103"
"3102";"Normas de funcionamiento Punto Limpio";"<p>Según me indicaron ayer en el Punto Limpio del distrito de Carabanchel, el depósito de aparatos eléctricos está limitado a tres. Me parece una norma absurda y poco efectiva si lo que se pretende es potenciar el hábito del reciclaje y el depósito selectivo de residuos por parte de los ciudadanos.</p>

<p>Me gustaría que se modificase la normativa de funcionamiento en ese sentido.</p>
";"10/09/2015 09";"26";"24";"2";"1";"886382750";"2030"
"3103";"Marquesinas EMT de cristal: Un horno en verano";"<p>Recientemente se han renovado las marquesinas de los autobuses de la EMT por todo Madrid. La prueba de que la Sra. Ana Botella y su gobierno municipal no veían en ellas más que soportes publicitarios y no un lugar para que los madrileños esperemos al autobús es que son de cristal y no dan sombra ninguna. Si habéis esperado al autobús este verano sabéis de lo que os hablo. Aparte de no dar sombra hacen efecto lupa y te mueres de calor ahí debajo. ¿De verdad era tan difícil pensar las cosas antes de hacerlas, Señora Botella? Madrid no es Estocolmo; en esta ciudad necesitamos protegernos del sol y del calor muchos meses al año. </p>

<p>¿Qué hacemos ahora? ¿Aguantarnos con el engendro de marquesinas nuevas causando de nuevo molestias y obras en la ciudad, u obligar a la empresa de publicidad que lleva años forrándose con este negocio a poner unas mejor adaptadas a la climatología de nuestra ciudad?</p>
";"10/09/2015 09";"28";"23";"5";"1";"884393781";"1478"
"3104";"¡Evitemos los listos que se cuelan! No a zonas ""negras"" sin respeto normas";"<p>Todos conocemos numerosos puntos o zonas donde los conductores listos ""se cuelan"" <u>saltándose líneas contínuas</u>, utilizando carriles de incorporación para adelantar o metiéndose al última hora, haciendo frenar a los demás conductores que circulan correctamente, provocando atascos y lo peor, <strong><u>provocando accidentes</u></strong>.</p>

<p>Propongo poner una web a disposición de los madrileños para que<strong> denunciemos entre todos estas zonas negras de nuestra circulación </strong>diaria. Una vez identificados habría que dar respuesta a cada punto de una manera pero en muchos casos bastaría con pintar una línea contínua y una cámara que identificara a los infractores.</p>

<p>Ya sé que no debería de hacer falta, que es una cuestión de educación pero a los hechos me remito.</p>

<p>Gracias</p>
";"10/09/2015 09";"42";"38";"4";"4";"888022354";"3076"
"3105";"Que vuelva la historia española a nuestras calles";"<p>Se han quitado muchas estatuas así como cambiado el nombre de las calles.</p>

<p>La historia no se debe olvidar y mucho menos se puede cambiar, ¡que vuelva de nuevo a las calles de Madrid!</p>
";"10/09/2015 09";"57";"40";"17";"5";"883805912";"1614"
"3106";"Aprovechar la biomasa de Madrid";"<p>Mi propuesta consistiría en procesar los restos de podas de árboles y jardines de la ciudad para producir astillas o pellets que pudiesen utilizarse en calderas de biomasa.</p>

<p>A su vez, podrían instalarse calderas de biomasa  piscinas climatizadas públicas para, junto con instalaciones de energía solar térmica, reducir la dependencia de los combustibles fósiles y la factura energética del consistorio.</p>

<p> </p>

<p>Muchas gracias</p>
";"10/09/2015 09";"51";"48";"3";"3";"889699718";"4235"
"3108";"Parque del Canal de Isabel II de Plaza Castilla: abrirlo hasta las 22 horas";"<p>La hora de cierre del parque en el verano son las 22 horas, pero en otoño se cambia a las 20, impidiendo disfrutar de él en unas horas muy agradables.</p>

<p>Propongo que se abra durante todo el año hasta las 22 horas,</p>

<p>Creo que si se redujera ligeramente la iluminación y el personal de seguridad no se reduciría la calidad y la modificación no supondría un gasto adicional</p>
";"10/09/2015 09";"26";"24";"2";"1";"886573488";"2030"
"3109";"PARQUES DE LOS NIÑOS";"<p>Buenos dias, soy una mama como muchas hay en Madrid, queria comunicarle al ayuntamiento que da pena llevar a nuestros hijos al parque, un momento de felicidad para disfrutar nuestros hijos que se convierte en malestar al ver el estado de los cacharritos donde juegan, al verlos llenos de arena cuando en otras comunidades llevan un suelo que amortigua las caidas y no se llenan ni respiran polvo, pero lo que me parece mas triste es ver como ocurre en mi barrio de toda la vida Vicalvaro como los niños juegan al lado de los cagaderos de los perros que en verano y con la calor huelen y estan los niños respirando el olor de la caca sin contar que los pobres cada dos por tres se acercan tocan la balla y se les cuelan las pelotas y pasan a cogerla. No creo que un parque infantil sea el lugar idoneo para que convinan a no ser que como ya observamos con nuestra anterior concejala que consideraba que los niños y los perros eran lo mismo.</p>

<p>Me parece estupendo la idea de esta plataforma para acercar nuestras quejas, muchas gracias y ojala podamos ver algún dia unos parques infantiles maravillosos donde nuestros hijos disfruten. Gracias</p>
";"10/09/2015 09";"29";"25";"4";"2";"885632328";"1810"
"3111";"Wifi gratuita para todos.";"<p> Buenos días a tod@s:</p>

<p>    Creo que es una buena idea que el ayuntamiento facilite espacios con wifi gratuita a los ciudadanos de Madrid. En otras grandes capitales europeas es muy habitual la existencia de esta red de lugares con Wifi, resulta muy práctico y fomenta el uso de las nuevas tecnologías y el acceso a la red a personas con menos recursos. </p>

<p>Un cordial saludo,</p>

<p>Ricardo Cordero ( Porcelano)</p>
";"10/09/2015 10";"55";"25";"30";"3";"871234425";"-227"
"3112";"Problemas de convivencia derivados de la ""okupación de viviendas"" en Canillejas";"<p>Comentar antes de nada que voy a enfocar este tema exclusivamente desde la perspectiva de la convivencia, y que no está en mi intención entrar a valorar otras cuestiones relacionadas con el asunto. Y es que particularmente llegado cierto punto me dan bastante igual esas otras cuestiones, para mi como alguien que sufre directamente las consecuencias de vivir cerca un edificio ""okupado"", lo importante es lo primero, insisto, la convivencia, y en ese aspecto si la cuestión la reducimos a eso tan conocido de ""vive y deja vivir"", creo es algo que tan solo se cumple en una dirección, me explico.</p>

<p>Vivo en Canillejas desde hace años, muy agusto por cierto, y de unos cuantos hasta ahora me ha tocado ""en suerte"" tener a escasos metros de mi casa un edificio ""okupado"". Por él ha pasado mucha gente, pero hasta llegar a los que actualmente lo habitan la problemática común y constante ha sido siempre la misma, el poco civismo y la poca consideración de esas personas hacia el resto de personas que vivimos en la zona, y en consecuencia, la degradación de la convivencia. A destacar tres aspectos: el ruido casi constante que generan especialmente por la noche y hasta altas horas, algo que ahora en verano con todas las ventanas abiertas para la gente que tenemos que levantarnos pronto para ir a trabajar es especialmente molesto. La suciedad en forma de todo tipo de desperdicios y de escrementos de perros que pueblan la calle, en el caso de los primeros hasta tiran directamente por la ventana de las casas, y en el los segundos que no hacen el menor ademán de recoger por mucho que incluso sepan les están viendo en ese preciso instante, y no es que tengan precisamente pocos perros la verdad. Y por úlitmo las broncas, las peleas, el trapicheo y en definitiva, el incremento de la inseguridad. A grandes rasgos esos serían los tres principales factores, que no los únicos, en los que se ve afectada y deteriorada la convivencia, una convivencia que hasta que el comentado edificio se comenzó a ""okupar"" se desarrollaba con total normalidad y no se veía afectada de ninguna manera por este tipo de cuestiones. En fin, entiendo que en los tiempos que corren cada uno se busca la vida como puede, entiendo que si hay unas casas vacias haya gente que considere que ""okuparlas"" es la mejor solución, en definitiva y como decía al principio entiendo perfectamente eso de ""vive y deja vivir"", pero claro, además de que considero que eso ha de ser algo recíproco, también entiendo aquello de que los derechos de uno, incluso los que no existen y te inventas, acaban allí donde comienzan los derechos de otro/otros, algo que para estas personas de manera muy evidente, no parece ser así.</p>
";"10/09/2015 10";"46";"42";"4";"5";"888762337";"3469"
"3113";"Parquimetros justos";"<p>Personalmente considero una estafa el hecho de que los que aparcamos en Madrid tengamos que establecer el tiempo de parking antes de saber cuánto tiempo nos va a llevar la gestión o gestiones a realizar. Nunca coincide dicho tiempo con nuestras previsiones y siempre se paga de más ""por si acaso"" o un simple despiste se penaliza con una cuantiosa multa.</p>

<p>Dado que nadie sabe con antelación el tiempo que va a necesitar el aparcamiento y dado que hoy en día tenemos a nuestro alcance todo tipo de tecnologías mi propuesta es bien simple: </p>

<p>- <strong>Sacar ticket de inicio tanto desde el parquímetro o desde el móvil y cuando te vayas a ir sacar ticket para confirmar el fin del estacionamiento</strong>.</p>

<p>Con esto conseguimos:</p>

<ul>
	<li><strong>Comodidad dado que no hay que estar pendiente de si se te acaba el tiempo del ticket</strong></li>
	<li><strong>Pagar el tiempo justo y exacto del uso del estacionamiento</strong></li>
	<li><strong>Los despistes no se penalizarían con una cuantiosa multa</strong></li>
</ul>
";"10/09/2015 10";"32";"22";"10";"3";"881888215";"825"
"3114";"LIMPIEZA CALLES CENTRO DE MADRID";"<p>ante el estado lamentable del centro de madrid se propone mejorar este servicio dadas las condiciones de limpieza de algunas calles del centro. en concreto, la calle jardines al lado de gran via esta tercermundista con olores diversos nada agradable</p>

<p>creo que se deberia dar un cambio radical al servicio de limpieza</p>
";"10/09/2015 10";"39";"36";"3";"2";"888353675";"3046"
"3115";"METRO ACCESIBLE PARA DISCAPACITADOS EN MORATALAZ";"<p>Me parece una verguenza que un barrio como Moratalaz, y con una boca de metro relativamente nueva que se hizo en el Intercambiador de Pavones, no haya ni un solo ascensor en el metro para poder acceder las personas con cualquier tipo de discapacidad.</p>
";"10/09/2015 10";"68";"64";"4";"6";"891154418";"5647"
"3117";"Bajar el precio del Bonotransporte para la gente que trabaja";"<p>Se debería de revisar el tema del precio del Bonotransporte, yo que tengo que pagar 72 por el B2 con un sueldo de apenas 1000, me parece muy elevado ese precio.</p>
";"10/09/2015 10";"36";"21";"15";"0";"878959360";"350"
"3118";"Abrir piscina de verano en invierno";"<p>Hay muchísima gente a la que nos gusta nadar y acabar en sitios cerrados como piscinas cubiertas es bastante claustrofóbico; además, las altas termperaturas impiden que el cuerpo oxigene bien, por lo que sería de agradecer que se abrieran estas piscinas en invierno.</p>

<p> </p>

<p>1. Con el frío la piel queda mejor.</p>

<p>2. Aumentan las calorías consumidas.</p>

<p>3. No hay que utilizar calentadores para el agua como en piscinas cubiertas.</p>

<p>4. El mantenimiento no sería mayor al actual en las cubiertas.</p>

<p>5. Cubriríamos las nesecidades del resto de ciudadanos.</p>

<p> </p>

<p>SALUD POR Y PARA MADRID</p>
";"10/09/2015 10";"43";"15";"28";"3";"870522057";"-453"
"3119";"Crear un templete o quiosco de música en callao ";"<p>Hola, me gustaría más música en directo en Madrid, y que se crease un quiosco en la plaza de Callao en donde pudieran actuar de forma gratuíta músicos y grupos emergentes que les sirva de platafoma para ser conocidos. Tambíén podrían actuar grupos o artistas consagrados que utilizaran este lugar para publicitar sus nuevos trabajos.</p>
";"10/09/2015 10";"44";"24";"20";"1";"877862532";"218"
"3120";"Seguridad y revisores en el transporte público";"<p>No pasa una semana sin que vea a una o dos personas saltarse los tornos del metro sin ninguna consecuencia. Esta escena es tan repetida que, si hubiera una seguridad que lo evitara y estos ""Polizones"" pagarn por el metro, se podría llegar a recaudar una gran cantidad de dinero.</p>

<p> </p>

<p>En el mismo orden de cosas, este mismo verano un grupo de 15 adolescentes subió a un autobús sin pagar con la mala suerte de cruzarse con un revisor que les pilló. Lejos de avergonzarse y/o pagar, increparon al revisor diciendo que no había nada que pudiera hacer para que pagasen.</p>

<p> </p>

<p>A parte de la preocupante existencia de una cultura de la gente a la hora de colarse en transporte público, todo esto supone un perjuicio a la gente que si paga y al propio transporte que va más lleno de lo que debería.</p>
";"10/09/2015 10";"45";"38";"7";"3";"887151527";"2617"
"3121";"Explotacion de licencias de taxis.";"<p>Por que el ayuntamiento permite que particulares y empresas trafiquen con licencias municipales de taxi, vendiendolas por 200.000 euros. El ayuntamiento debe retirar la licencia a la jubilacion del taxista o a los 20 años como mucho y sacarla a concurso por menos de 40.000 euros como se hace en otros lados,  para que todos podamos tener derdcho a la e xplotacion de una licencia repito Municipal y con ello conseguir un puesto de teabajo fijo ademas. Ya esta bien que el taxista despues de tener un trabajo muy bien remunerado y ademas fijo, pretenda jubilarse con un dineral por la reventa de  una licencia que no es suya y que el Ayuntamiento lo permita.</p>
";"10/09/2015 10";"86";"64";"22";"9";"886758879";"3125"
"3122";"CAMPAÑA CONCIENCIACIÓN PEATONES NO ANDEN POR CARRIL BICI";"<p>Como peatón y ciclista observo que los carriles bici de la ciudad que discurren por parques y calles de Madrid estan sistemática ocupados por cientos de peatones y corredores que disfrutan paseando por los carriles bici y aunque les timbres no se apartan. propongo una campaña de concienciaci´no sobre la necesidad de dejar estas vías libres para bicis, ya sea mediante mejorar la señalización vertizal y marcas viales, carteles y letreros incluso multas. Un saludo.</p>
";"10/09/2015 10";"126";"96";"30";"11";"888525124";"5028"
"3123";"Inaugurar ya el polideportivo y la plaza del mercado de Barceló";"<p>El Ayuntamiento, después de gastar 60 millones de euros en el edificio mercado y polideportivo en Barceló, jamás inauguró la parte del polideportivo y la azotea-plaza. A continuación está la descripción del edificio presente en la memoria del proyecto:</p>

<p>El nuevo polideportivo de Barceló está situado sobre los tejados de Madrid. La cubierta del mercado es en realidad una gran plaza de 1500 m2 en la que los niños juegan, los jóvenes hacen deporte, los mayores toman el sol, o simplemente se asoman a observar el perfil de la ciudad. Un núcleo de comunicación independiente y una larga rampa mecánica han permitido llegar directamente a este nivel, donde también se ubican vestuarios, aseos, control y acceso a la zona deportiva. <strong>Los escolares del colegio vecino acceden directamente desde el patio de la escuela por medio de una conexión subterránea</strong>. </p>

<p>Por favor inauguren el edificio, ¿o es que sólo tienen derechos los comerciantes?</p>
";"10/09/2015 10";"69";"62";"7";"6";"890277007";"4942"
"3124";"Revisar y unificar distintivos de aparcamiento para discapacitados.";"<p>Soy usuario de la tarjeta de aparcamiento para discapacitados que otorga el Ayuntamiento.</p>

<p>Despues de pasar unas pruebas medicas, el Ayuntamiento te concede la tarjeta, que es personal, y te la entrega, entre otras, con la cndicion de que NO SE PUEDE PLASTIFICAR (pues la picaresca hace que se fotocopien en color y se plastifiquen por lo que las medidas de seguridad que llevan para no falsificarlas no se ven claramente).</p>

<p>Por otro lado hay muchos ayuntamientos que otorgan estos distintivos a gente que NUNCA va a llevar un vehiculo o que su discapacitad no les impide moverse con normalidad (ej. sindrome de Down) y que ocupan plaza para personas con movilidad reducida.</p>

<p>Por ultimo estan los que llamo ""MINUSVALIDOS MENTALES"" aparcan en plazas reservadas para minusvalidos, sin distintivo ni nada y se quedan tan panchos sacando el tique de la hora... un aplauso la verdad.</p>

<p>Estaria bien:</p>

<ol>
	<li>Mas control de las tarjetas de minusvalidos existentes para ""sacar de ciruclacion"" tarjetas robadas o falsificadas.</li>
	<li>Mas control de las zonas reservadas a minusvalidos para evitar que los minusvalidos mentales aparquen en ellas.</li>
</ol>

<p> </p>
";"10/09/2015 10";"34";"28";"6";"2";"885722738";"1811"
"3125";"Pequeñas (y baratas) medidas para facilitarle la vida a los ciclistas";"<p>Hay medidas muy baratas y sencillas que nos facilitarian la vida a los ciclistas que queremos movernos por la ciudad. ¿Que opinais de ellas?</p>

<ul>
	<li>Espacio delante de los coches en los semaforos. Permite ver bien el semaforo, colocarte bien en el centro del carril y no molesta al peaton ya que no tienes que invadir el paso de peatones</li>
	<li>Ciclo carriles limitados a 30. Se ha ampliado las estaciones de bicimad y no se han modificado los ciclocarriles. Es necesario ir adecuando la señalizacion a la ampliacion del parque de bicis</li>
	<li>Aceras compartidas. Tan sencillo como una señal de un peaton y una bici. Pequeños tramos que ayuden al ciclista y respeten al Peaton: Cuesta Moyano (ahi tendrian que poner señal de monopatin tb:))</li>
	<li>Semaforos intermitentes para bicis. Hay determinados semaforos donde es posible adecuar la circulacion de las bicicletas y permitirles pasar antes que los coches.</li>
	<li>Carriles reversibles para bicis. Ciertos carriles donde se pueda circular contradireccion bien señalizados.</li>
</ul>
";"10/09/2015 11";"49";"27";"22";"2";"878673044";"275"
"3126";"EMPLEO PÚBLICO PARA MAYORES DE 50 AÑOS";"<p>Agradecería que contemplaran la posibilidad de crear empleos para personas mayores de 50 años que tanta experiencia laboral pueden aportar a la ciudad de Madrid. Este colectivo, lo tiene especialmente difícil y considero que sería interesante crear una plataforma de empleo para dicho colectivo.</p>
";"10/09/2015 11";"27";"21";"6";"0";"883765826";"1166"
"3127";"Recuperar la Plaza Huarte de San Juan (Puerta del Angel)";"<p>Soy una vecina de Puerta del Angel. Mi propuesta es recuperar la Plaza Huarte de San Juan que cada vez está más deteriorada y sucia. En mi opinión las posibilidades que ofrece este espacio son muchas. Existe en el centro de la plaza un quiosco de música que podría utilizarse para dar conciertos, actuaciones de teatro al aire libre, títeres y otras actividades culturales. Existen muchas bandas y grupos musicales deseosos de poder actuar. Solo sería dejarles libremente ese espacio. Otro de los atractivos de este lugar, es el cercano Mercado de Tirso de Molina, que constituye un edificio histórico de época republicana. Este lugar es un espacio que ha sabido conservar el producto fresco de calidad y el comercio de proximidad que contribuye a una economia sostenible.
Creo que el programar actividades culturales en esta plaza, acabaría con la actual imagen deteriorada, sucia, y de aire marginal a la que tristemente ha llegado esta plaza.</p>
";"10/09/2015 11";"28";"27";"1";"1";"888307222";"2507"
"3128";"PARTICIPACIÓN INFANTIL";"<p>Espero que en breve esta web también sea accesible a niños, niñas y adolescentes. Podrían participar de su visión de Ciudad y con sus propuestas. Fomentar la participación y la corresponsabilidad con los niños y las niñas no es opcional, ya que tienen los mismos derechos que los/as adultos/as. Fomentar que en cada barrio y distrito se incluya a la infancia en las politicas públicas para poder contar con su visión y vivencia de su barrio. Potenciar las Comisiones de Participación de la Infancia y la Adolescencia. Que los colegios, asociaciones y grupos de chavales/as tengan la posibilidad también de generar y participar en los debates sobre sus barrios. </p>

<p> </p>
";"10/09/2015 11";"30";"20";"10";"3";"881530911";"666"
"3129";"LIMITAR EL ACOSO DE LAS ONG´S POR LAS CALLES DE MADRID";"<p>Transitar por la C/ Fuencarral hasta Sol y alrededores (C/ Carmen, Preciados, Callao, etc) con tranquilidad es materialmente imposible pues cada pocos metros te ASALTA un desconocido que viene a perturbar tu tranquilo paseo haciendo que tengas que cambiar tu camino para deshacerte de su incomodo discurso que, por otro lado, no interesa.</p>

<p>Propongo que se les permita poner stands en la calle a los que acercarte si te apetece, pero prohibir ese acoso constante que hacen indiscriminadamente.</p>
";"10/09/2015 11";"102";"82";"20";"11";"889283500";"4984"
"3130";"Mascotas en el metro";"<p>Estaria bien que el Metro cambiara su politica con respecto a las mascotas y adoptara alguna mas parecida a la de Renfe Cercanias en el que puedes viajar con tu mascota sin necesidad de transportin. </p>

<p>Saludos.</p>
";"10/09/2015 11";"80";"49";"31";"3";"882541024";"1102"
"3131";"Peaje para entrar en Madrid en coche (como Londres)";"<p>Puede parecer contra-productivo, pero en realidad las empresas de reparto y profesionales autorizados (Correos, Entregas, Taxis, etc.) no pagarían pero se impedira a ciudadanos poco respuetuosos del medio ambiente añadir contaminacion y ruido al centro de la ciudad.</p>

<p>Se debe analizar para que agilize el transporte publico (que gane cuota de mercado, sobre todo en dias de alta contaminacion), que mejore la calidad del aire (definir las zonas donde se aplicaria) y que vaya coordinado con aparcamientos (como Londres, Copenhagen, Amsterdam...) en las afueras para que se pueda dejar el coche antes de pasar la M40/M30.</p>

<p>Se pagaria solo en las horas y zonas necesarias para mejorar trafico, reducir fatalidad y mejorar la economia (la de todos).</p>

<p>Se pondria en marcha utilizando los modelos que han demostrado sus eficiencias (que resulta un beneficio para la economia y los ciudadanos!) en el extranjero (no como las bicis que hemos tenido que pagar en lugar de hacerlas pagar a empresas de publicidad urbana como Decault en Paris que lo hizo para renovar su contrato de publicidad en las paradas de autobuses, ademas de ya instalar y mantener estas gratuitamente).</p>

<p>Un ciudadano con coche pero que no lo usa cuando no es realmente necesario.</p>
";"10/09/2015 11";"109";"54";"55";"3";"874729293";"-49"
"3132";"Fuentes públicas OPERATIVAS en el parque Juan Carlos I";"<p>Hola,</p>

<p>Vengo de pasar la mañana en el parque Juan Carlos I y he podido comprobar que las fuentes públicas no solo son escasas si no que NO FUNCIONAN. Intenté usar cuatro y ninguna de las cuatro funcionaba ni tenía pinta de haber funcionado en un período cercano. Aunque el parque está plagado de máquinas de vending -que funcionan sólo con monedas, cuidado- no me parece admisible que un parque público de esa extensión y con tan poca sombra no disponga de fuentes públicas y gratuitas.</p>

<p>Sospecho que detrás de la decisión de condenar las fuentes públicas está un afán recaudatorio para favorecer a las máquinas de vending, pero tengamos en cuenta que este parque, al ser de reciente creación, carece de sombras y en verano se alcanzan unas temperaturas considerables.</p>

<p> </p>
";"10/09/2015 11";"41";"37";"4";"1";"888506505";"2978"
"3133";"Aprovechamiento peatonalización Paseo Prado";"<p>¡Buenas a tod@s!</p>

<p>Tras la noticia de que los domingos se va a cerrar al tráfico el Paseo del Prado (idea que me parece estupenda) propongo que se utilice este tramo (además de para pasear o ir con la bici sin la congestión habitual) para llevar a cabo mercados temáticos, eventos deportivos, musicales, culturales...</p>

<p>Estamos hablando de mas de 1km de espacio que puede ser aprovechado de muchas maneras diferentes. (Conciertos, teatro al aire libre, exhibiciones de skate, mercados ecologicos etc etc)</p>

<p>La idea que propongo no es crear eventos cada domingo, tanto los peatones como los ciclistas tienen el derecho de disfrutar el paseo sin nada que les moleste, pero si que, cada cierto tiempo, se podría organizar algo que convierta a esta zona en un punto de encuentro.</p>

<p> </p>

<p>Un saludo,</p>
";"10/09/2015 11";"42";"25";"17";"8";"880798344";"476"
"3134";"Madrid y el deporte";"<p>Imaginad que tenéis un metrobús, que subís a un autobús municipal y os dicen: ""no, ese billete no vale en esta línea, porque es de gestión privada y tienes que comprar otro billete"". Pues bien, eso mismo pasa en los polideportivos municipales: unos son de gestión pública y otros de gestión privada (hay dos o tres empresas concesionarias) y para cada uno de ellos necesitas comprar la entrada o el abono específico.</p>

<p>Si, por ejemplo, tienes el abono del polideportivo de tu barrio para el fin de semana, pero entre semana, después del trabajo, quieres ir a otro, tienes que comprar otro abono. Si tienes el abono del polideportivo de gestión privada y quieres ir en verano a una piscina abierta municipal, necesitas otro abono.</p>

<p>Hace poco la alcaldesa se sorprendía del nivel de externalización del ayuntamiento (a mí me extrañaba que se extrañase) y en asuntos tan importantes como el deporte de base, no sólo tenemos una oferta externalizada, sino que además está fragmentada.</p>

<p>¿Se podría reconducir esta situación? No creo, porque el último contrato de externalización de un centro deportivo se ha firmado desde el nuevo gobierno de la ciudad...</p>
";"10/09/2015 11";"29";"25";"4";"2";"886301384";"1810"
"3135";"Añadir a cada semaforo una camara con lectura de matriculas";"<p>Hay cientos de atropellos de peatones cada año por las prisas de coches, autobuses. camiones... destruyen vida y cuestan una fortuna a la sociedad en impuestos no cobrados, en ayudas a sus familias, etc.</p>

<p>Se respetaria simplemente el codigo de circulacion a raja tabla (nada de acelerar en naranja ni saltar un rojo).</p>

<p>Es ilegal y peligroso, el dinero iria a seguridad vial, y una vez que se consiga un buen nivel de seguridad vial, se dedicaria a aprender a conducir a los ciudadanos.</p>

<p>Bajara la contaminacion ya que los coches tendran que respetar limites de velocidad y se economizaria millones de litros de combustible gastados en carreras de accelaracion que duran como mucho cientos de metros antes de frenar fuerte...</p>
";"10/09/2015 11";"54";"18";"36";"1";"870610584";"-600"
"3136";"Exceso de publicidad en algunas cadenas de televisión.";"<p>No me parece normal que corten un programa de televisión avisando de que son x minutos y pasado ese tiempo continue el programa, película o serie durante un breve espacio de tiempo y se vuelva a cortar (a veces en medio de una frase) durante más de 10 minutos.</p>

<p>Comprendo que algunos canales de televisión viven a costa de la publicidad, pero esto es un abuso. Lo mismo lo hacen para que nos pasemos todos a los canales con paquetes o las plataformas de televisión de pago.</p>

<p>Pues conmigo que no cuenten.</p>
";"10/09/2015 11";"40";"14";"26";"6";"871020687";"-419"
"3137";"Encierros en Madrid. Desde Felipe II hasta las Ventas";"<p>Dada la gran afición taurina de Madrid y el hecho de que la calle Álcala es una via pecuaria se podía plantear un encierro desde los alrededores de la plaza de Felipe II hasta los corrales de Las Ventas.</p>

<p>La financiación debería ser privada pero el ayuntamiento tiene que autorizarlo.</p>

<p>Atraeria mucho turismo, crearía empleo y sería un ejemplo de organización.</p>

<p>La fecha ideal seria antes de San Isidro.</p>

<p>Tenemos ejemplos en pueblos de los alrededores como San Sebastian de Los Reyes, Leganes,....</p>

<p> </p>
";"10/09/2015 11";"111";"23";"88";"10";"870874796";"-1346"
"3138";"Quitar los paneles de cristal del Viaducto";"<p>Los paneles de cristal se instalaron en el Viaducto hace ya bastantes años para disuadir a los suicidas. Creo que el que quiera hacerlo puede hacerlo simplemente con saltarlo y acceder a la barandilla. ¿No sería mejor sustituirlos por algún otro sistema de protección como el que tienen otros monumentos (por ejemplo, unas vigas que sostienen una red)  y que, al mismo tiempo que protegen permiten a los vecinos y turistas asomarse para comtemplar o fotografiar las vistas sin obstáuclos por medio?</p>
";"10/09/2015 11";"51";"37";"14";"4";"884933707";"1668"
"3139";"¿Es sostenible medioambientalmente, vivir lejos del centro laboral o educativo?";"<p>Siguiendo las indicaciones de los responsables de este <strong>foro de gobierno abierto municipal</strong>, que <em>un debate es un foro de discusión, no una propuesta ciudadana</em>, intentaré generalizar los problemas diarios que padecemos los vecinos, para <strong>convertirlos en causas sociales de ámbito global</strong>, para que se así pueda tener cabida en este <strong>foro filosófico</strong>. Un saludo a todos</p>
";"10/09/2015 11";"13";"10";"3";"4";"881883246";"538"
"3140";"inspecciones de trabajo de oficio para empresas informaticas";"<p>Hola a todos, como informático que trabaja subcontratado en la comunidad de madrid, estoy cansado de que las empresas gordas, te subcontraten por cuatro perras, y trabajes junto a sus empleados que te miran con desprecio por no ser ""interno"".</p>

<p>Creo que deberían realizarse insepcciones de trabajo de oficio en todas las empresas grandes que se dediquen al desarrollo de software, así como a las áreas de informática de bancos, aseguradoras y grandes empresas afincadas en madrid.</p>

<p>ISBAN, Banco Popular, Capgemini, Everis, Mapfre ...</p>

<p>Todas esas empresas y muchas más tienen más de un 60% de plantilla subcontratada, o lo que es lo mismo, co n trabajadores cedidos ilegalmente, personas que cobrando una miseria, realizan el trabajo de empleados, mucho mejor pagados, de esas empresas.</p>

<p>Se podría recaudar mucho dinero en multas, y , de paso, mejorar la calidad del trabajo en este sector tan abandonado.</p>
";"10/09/2015 11";"31";"27";"4";"6";"887055630";"2003"
"3141";"Es la chatarra una actividad nociva o peligrosa";"<p>Aceras destrozadas</p>

<p> personal destrozando electrodomésticos el los alrededores</p>

<p>Carros cruzando indebidamente</p>

<p>Desperdicios y Ruidos</p>

<p> </p>

<p>MaRques de Viana estaría mejor sin estas actividades</p>
";"10/09/2015 11";"25";"20";"5";"2";"884476356";"1200"
"3142";"Rectificar es de sabios.";"<p>El anterior equipo de gobierno municipal modificó el sentido de circulación del tramo de la calle Marqués de Cubas que va desde la Carrera de San Jerónimo hasta la calle Zorrilla con el consecuente aumento de tráfico rodado y contaminación acústica y medioambiental. Todo ello se engloba dentro del Área de Prioridad Residencial CORTES, se supone que cuando se crea una APR precisamente es para todo lo contrario, es decir, para reducir tráfico y contaminación.</p>

<p>Por otra parte, los autocares al venir por la Carrera de San Jerónimo y entrar por la calle Marqués de Cubas, quedan atrapados al intentar hacer el giro en el cruce de esta última con la calle Zorrilla dado lo estrecho de la calzada. Tienen que regresar marcha atrás con la consiguiente perturbación del tráfico.</p>

<p>Sería conveniente volver al antiguo sentido de la circulación en la citada calle Marqués de Cubas, así como instalar nuevos puntos de acceso controlado.</p>
";"10/09/2015 11";"17";"13";"4";"0";"882256880";"688"
"3144";"NO a la propuesta del Ayto. para servicio de alquiler de coches eléctricos";"<p>A raíz de los actos del día europeo de la movilidad el ejecutivo municipal ha insinuado que estudian implantar un sistema de alquiler de coches eléctricos. Propongo debatir sobre el tema.</p>

<p> </p>

<p>Mi postura es claramente negativa:</p>

<p>- el coche ya se usa, no es necesario implementar este medio de trasporte.</p>

<p>- ya hay un sistema de alquiler de coches en madrid: el taxi.</p>

<p>- el coste del estudio que se emplee en mejorar bicimad (que falta le hace y es un medio de trasporte marginal) o en reconvertir el parque de automóviles privados o de taxi en veículos eléctricos o híbridos.</p>
";"10/09/2015 12";"65";"15";"50";"7";"871250654";"-807"
"3145";"Jornada continua para los colegios de Madrid";"<p>Para cuando la jornada continua en los colegios publicos de Madrid.Muchos padres estamos hartoa de tener que pagar el comedor y dejar a nuestros hijos hora y media en un patio,es algo que no perjudicaria a nadie ya que estos servicios,(comedor y extraescolares)seguirian existiendo,pero muchos alumnos mejorarian su calidad de vida pudiendo irse a casa 3 horas antes que en la actualidad.</p>

<p> </p>

<p> </p>
";"10/09/2015 12";"30";"18";"12";"6";"880325726";"359"
"3146";"Recuperación de las 35 Horas semanales de trabajo para los funcionarios.";"<p>Ya está bien de robarnos nuestros derechos, hay que exigir a los gobiernos de turno, tanto Centrales como de las CCAA y los Aytos., la recuperación de este derecho que costó tanto conseguir, no solo se fomenta el empleo, si no que se concilia mejor la vida laboral y familiar y con ello somos más felices, por lo que iremos mas contentos a trabajar y rendiremos más, ya está bien de la sobre expolotación del Funcionario, con este aumento de horas trabajadas, no se ha conseguido nada, no se es más eficaz, ni se rinde más, al revés, se gasta más agua y luz en las dependencias municipales. Sra. Alcaldesa de Madrid, haga que recuperemos la fé en nuestros gobernantes. Ya sé que habrá muchas personas que criticaran esta propuesta y dirán que somos unos vagos y ganamos demasiado dinero, nada más lejos de la realidad, la mayoria de los funcionarios del Ayto. ganan en torno a los mil euros y trabajan mucho y muy bien, vagos y maleantes hay en todos los lados y a esos hay que sancionarles, pero la gran mayoría somos muy currantes y nos gusta nuestro trabajo además de  ayudar y servir a los <strong>Madrileños</strong>. </p>
";"10/09/2015 12";"65";"28";"37";"11";"871347454";"-387"
"3147";"Impuesto a pisos turísticos";"<p>Hola. En París acaban de aplicar una tax de sejour (tasa de alojamiento) para estos pisos, que se paga directamente en la página airbnb una vez haces la reserva. La medida ha empezado en Septiembre y la alcaldía prevee recaudar varios millones de euros al año.  (http://www.lemonde.fr/economie/article/2015/08/25/airbnb-s-apprete-a-collecter-la-taxe-de-sejour-a-paris_4736175_3234.html) </p>

<p>¿Si la alcaldía de París lo ha exigido, por qué no la de Madrid? De esta forma regulamos el alquiler entre particulares que se encuentra en un limbo legal. Lejos de prohibirlos, la idea es recaudar dinero de ello y que así los hoteleros no se estén quejando de competencia desleal. </p>
";"10/09/2015 12";"48";"30";"18";"3";"882060719";"750"
"3148";"Pistas de fútbol y canchas de baloncesto";"<p>Soy un vecino de valdebebas, me gusta hacer doporte, especialmente baloncesto. En Valdebebas, si quieres a correr, puedes hacer en cualquier sitio, porque no hay nada más, pero si quieres hacer algo, como jugar al baloncesto o al fútbol, te tienes que coger el coche para ir a otros barrios.</p>

<p>Viendo que hay un montón de terrenos reservado para el ayuntamento que están completamente vacíos, propongo a poner pistas de fútbol y baloncesto lo antes posible, no porque son más importantes que un centro de salud o un colegio, sino, creo que se necesito muy poco presupuesto y tiempo para realizarlo. Y ayuda mucho a la gente del barrio a tener un sitio más a dónde ir y conocerse, y mejorar el bienestar de los vecinos.</p>
";"10/09/2015 12";"63";"58";"5";"2";"891069817";"4879"
"3149";"Educar para el uso correcto de carriles bici, ocasiona muchos accidentes";"<p>Soy partidario de instalar carriles bici por toda la ciudad para que sea una opción de transporte a tener en cuenta. El problema es que los usuarios de carreteras no saben o no quieren usar los carriles como se debe. Vivo en Las Tablas y han puesto varios tipos de carriles bici. Uno, completamete separado del tráfico, entre una zona de aparcamiento de vehículos y la acera. Con este primero sólo le veo un problema. Está delimitado con pintura de la zona de tráfico de vehículos. Como existen bandas sonoras para hacer reducir la velocidad, muchos vehículos entran en el carril bici para no disminuir la velocidad. Esto tiene un peligro considerable por poder encontrarse alguna bicicleta o peatón y porque en la entrada en su carril de nuevo puede ocasionar algún problema con otros vehículos que circulan correctamente. Hay vigilancia nula en la zona y se hace constantemente.</p>

<p>Otro tipo es el de zona compartida con máximo de 30km/h. Ningún vehículo circula a 30km/h y por este tipo de carril es dificil encontrar bicicletas por lo peligroso que resulta.</p>

<p>El último tipo y el más peligroso es el carril exclusivo para bicicletas pero por el que hay que pasar con el vehículo si se quiere aparcar. Este carril creo que está mal explicado porque en mi opinión ha sido un ""apaño"" para mantener el aparcamiento y tener carril sin hacer mucha inversión, símplemente unas señales verticales indicando qué vehículos pueden y cuales no pasar por el carril. Estos carriles son usados por vehículos como un carril más y están dando lugar a muchos incidentes. Hasta la instalación del carril bici los vehículos que continuaban recto o giraban a la derecha iban por el carril derecho y los que iban a la izquierda o recto por el de la izquierda. Ahora el único carril que debería usarse para vehículos de motor sería el izquierdo y cuando se usa el derecho para ir recto por ejemplo provoca incidentes. La señal vertical que indica cómo usar el carril tiene un tamaño adecuado, pero contiene tanta información que es dificil ver el significado. Un ejemplo por ejemplo está entre las pistas de Padel y el Colegio Calvo Sotelo, peligro añadido.</p>

<p>Estaría bien hacer campañas para enseñar el funcionamiento de estos carriles y hacer una vigilancia de su uso para que la gente se conciencie de que no es como antes y que ponen en peligro a ciclistas y a ellos mismos usándolo como se está usando.</p>

<p>Con cinco minutos en este último tipo de carril sería suficiente para darse cuenta del uso que se le está dando.</p>

<p>Un saludo.</p>
";"10/09/2015 12";"38";"30";"8";"2";"885871829";"1736"
"3151";"QUITAR LOS ESPACIOS RESERVADOS DE APARCAMIENTOS PARA ORGANISMOS PÚBLICOS";"<p>¿Han pensado por qué la gente normal no tira al suelo de su casa un bote de refresco vacío o una bolsa de patatas y sí lo hace en cambio en la calle?</p>

<p>Pues yo creo que, en parte, es porque la gente no considera que la calle es suya, sino que es ""de los que mandan"" y por eso, piensan, ""que lo limpien ellos que para eso la calle es suya y no mía"".</p>

<p>Cuando veo zonas en el centro de Madrid en las que está prohibido aparcar excepto Ministerio tal u Organismo cual (todos públicos) me pregunto por qué yo me tengo que levantar para ir a trabajar una hora antes de lo que podría para ir a aparcar al fin del mundo, porque con la zona ORA o como se llame es imposible aparcar donde trabajo, mientras que los altos funcionarios y personas ""que mandan"" aparcan en la puerta de su trabajo. Sin pagar ticket.</p>

<p>Pues eso, o empiezan a reservar zonas de prohibido aparcar excepto fontaneros o abogados o dependientes de perfunería o quitan los espacios de aparcamiento reservados a los servidores públicos que utilizan lo público como privado. </p>
";"10/09/2015 12";"38";"29";"9";"1";"885277529";"1526"
"3152";"Baños públicos y limpios atendidos por personal remunerado";"<p>Creo que Madrid debería contar con baños públicos atendidos por personal remunerado. En todos los países existen baños públicos. Hay que pensar en las personas mayores, personas con enfermedades neurológicas, embarazadas, etc. Podrían tener un precio simbólico como por ejemplo 20 céntimos, así se cuidarían más. Sería un servicio público que además daría puestos de trabajo.</p>
";"10/09/2015 12";"45";"41";"4";"0";"889605143";"3371"
"3153";"Futuro car sharing eléctrico";"<p>Hoy he visto la noticia de que antes de finalizar este año se implantará en madrid un car sharing similar al que ya se hizo con bicicletas. Me parece una cosa muy interesante y me gustaría sugerir que se tengan en cuenta los desplazamientos hacia las zonas de trabajo poniendo estaciones bien repartidas por toda la capital. Creo que sería una muy buena ayuda al desplazamiento diario para muchas personas si se crea una buena infraestructura. Estaciones cercanas a bocas de metro sería una opción muy cómoda para completar desplazamientos. Incluso complementar el abono de transportes con esta opción también estaría muy bien. Quizás un pago mensual sería demasiado elevado pero un precio especial por minuto para usuarios de bonos mensuales de transporte podría ser algo que ayudase a su uso habitual.</p>

<p> </p>
";"10/09/2015 12";"23";"16";"7";"0";"881972872";"626"
"3154";"Donar bicicletas sin uso a asociaciones o familias con bajos recursos";"Me gustaría que Madrid implantara una idea muy buena que se hizo en el municipio de Aranjuez en que los ciudadanos que quieran, puedan donar sus bicicletas antiguas, que iban a tirar o que ya no quieran seguir usando al ayuntamiento y estos a su vez las arreglarían y pondrían a punto para prestarlas durante un periodo de 1 o 2 años (en Aranjuez son 2) a asociaciones, oenegés o a familias con bajos ingresos del municipio.

Al finalizar ese periodo, se vería si es necesario ""renovar el contrato"" para que la siga usando esa familia o asociación o traspasarla para que la pueda usar otra nueva persona.

Este programa en Aranjuez se llama Aranbike-Recicla. Tiene una serie de normas y tal, lo único que me preocupa es que alguien se intente aprovechar, pero no creo que sea el caso.

Para donar las bicis se deberían entregar en los puntos limpios fijos o en las comisarías de Policía local.

";"10/09/2015 12";"34";"22";"12";"1";"881902671";"647"
"3155";"Personas que aparcan ilegalmente en plazas de personas con discapacidad";"<p>Creo que sería bueno dar potestad a los agentes de movilidad para que pusieran multas a las personas que ocupan ilegalmente las plazas de personas con discapacidad. Curiosamente, los que aparcan ""para un momentito"", no lo hacen en una zona de carga y descarga porque saben que ahí sí que les pueden multar. Ya que hay tanta gente que no piensa en los demás, quizás sí tuvieran ""un incentivo"" económico, sí que lo harían.</p>
";"10/09/2015 12";"44";"34";"10";"3";"886160774";"1854"
"3156";"Aclarémonos: azoteas verdes o azoteas solares";"<p>Ambas opciones son tentadoras.</p>

<p>Yo  prefiero disfrutar de arbolado y vegetación en parques dónde puedan acceder mis hijos facilmente.</p>

<p>Creo que el ayuntamiento debería presentar una normativa de energía sostenible que obligue a la instalación de paneles solares en las azoteas de los edificio de nueva obra y paulatinamente ir reformando la existente. Aunque al menestro Soria no le parezca molón.</p>

<p>Por otra parte ¿Qué hay de la empresa municipal de energía eléctrica que se pretende crear en Barcelona?¿Es posible en Madrid</p>
";"10/09/2015 12";"19";"16";"3";"2";"884905984";"1094"
"3157";"Inspecciones en tiendas regidas por personas de nacionalidad China";"<p>Es algo que vengo pensando desde hace mucho, la falta de higiene y de todo que hay en la mayoría de tiendas que son regidad por ciudadanos chinos. </p>

<p>¿No pasan inspecciones de sanidad? o incluso tiendas en las que veo a hijos muy jovenes trabajando de sol a sol, si que ningún adulto responsable este presente.</p>

<p>Creo que debería meterse en este tema en serio.</p>

<p> </p>
";"10/09/2015 12";"57";"45";"12";"7";"887594263";"2605"
"3158";"Control de familias problemáticas ";"<p>No estaría de más implementar algún tipo de servicio online en el que los ciudadanos podamos indicar los domicilios en los que residen familias problemáticas, esas que nos hacen la vida imposible con ruidos, basura o comportamientos incivicos.</p>
";"10/09/2015 12";"82";"64";"18";"5";"888486742";"3590"
"3159";"Restricción del tráfico en la zona centro";"<p>Estoy totalmente de acuerdo con la ampliación de la restricción del tráfico a Latina y Sol. Pero creo que hay algo en lo que siempre se falla, y es en la mejora siginficativa del transporte público para ir a estas zonas desde la periferia. Además, lograr la convivencia entre peatones y ciclistas con carriles bici decentes, y no aceras bici u otro de estos inventos.</p>

<p> </p>
";"10/09/2015 12";"40";"27";"13";"0";"883135607";"945"
"3160";"Parquimetros";"<p>No entiendo porque cuando te pasas unos minutos en el estacionamiento tienes que anular la sancion o ser multado y sin embargo cuando te sobra tiempo el parquimetro no dispone de medios para poder acumular ese tiempo no consumido. Si te pasas pagas y si te sobra pierdes, el caso es que siempre le toca al mismo. Me gustaría que esto se debatiera y se le pusiera solución porque no es razonable, creo que lo razonable es que si te pasas pagues y que si te sobra lo acumules.</p>
";"10/09/2015 12";"28";"23";"5";"0";"885715442";"1478"
"3161";"Continuidad o no del SER en barrios residenciales.";"<p>Creo que, cuando se aborden desde el Ayuntamiento los temas más urgentes, se debería debatir por barrio la continuidad o no del Servicio de Estacionamiento Regulado (SER) ya que se impuso en algunos barrios en los que sus vecinos pelearon duramente para que no se instalara (ejemplo el Barrio del Pilar) y donde muchos pequeños comerciantes tuvieron que cerrar por sus inconvenientes y los que continúan en el barrio poco tardarán si no se vuelve al libre aparcamiento pronto. En muchas zonas este servicio es innecesario ya que es totalmente residencial con pequeñas tiendas de toda la vida donde compran vecinos también de los barrios próximos y donde hay aparcamiento de sobra durante el día y escasez cuando regresan los vecinos a sus casas que es precisamente cuando el SER deja de funcionar. Total que los vecinos pagamos anualmente un servicio que no nos aporta absolutamente ninguna mejora y no nos soluciona la falta de aparcamiento por las noches, con el inconveniente de que nuestras familias/amigos cuando vienen a visitarnos tienen que cambiar el ticket cada dos horas (máximo permitido) porque al ser barrio residencial no hay parcking público alternativo como en el centro. Además, la empresa que consiguió el contrato lo hizo sacando más plazas de aparcaiento de lo que había posibilitando el aparcamiento en esquinas de calles que imposibilitan una buena visibilidad del cruce e impidiendo la correcta circulación tanto del peatón como de los vehículos.</p>
";"10/09/2015 13";"27";"17";"10";"4";"881142758";"440"
"3162";"Baños públicos en la calle";"<p>Quién no ha tenido la necesidad de orinar durante un paseo por la calle? En ciudades como París o Londres hay baños públicos, que tanto de pago como gratuitos permiten orinar sin las molestias que ocasiona hacerlo en la calle. ¿Por qué Madrid no hace nada ante esta necesidad? Ojo, que aunque fuera a 0,50 me parecería bien, simplemente porque hubiera.</p>

<p> </p>
";"10/09/2015 13";"47";"40";"7";"2";"888422573";"2808"
"3163";"Permitir la circulación por el arcén de la M-30 a motos.";"<p>Soy usuario de moto durante todo el año (tanto si llueve, hace frio o sale el sol) puesto que lo considero una forma más eficiente y ecológica de moverse por Madrid.</p>

<p>Aunque la normativa nos permita circular entre medias de los coches, ésta es una práctica arriesgada debido al poco espacio que queda entre los mismos y la posibilidad de romper un retrovisor o que un vehículo más grande haga un cambio de carril sin señalización provocando un accidente en el que la moto y el motorista se llevan la peor parte.</p>

<p>Desde que hago este recorrido siempre he visto que hay motos que circulan por el arcén sin molestar ni a los vehículos que circulan ni a los posibles vehículos parados por averías. Pero también he visto que la policía municipal los detiene y multan por circular por un espacio prohibido por la normativa actual.</p>

<p>El código de circulación lo prohíbe ""salvo que haya alguna señal específica, se haya habilitado un carril adicional o haya un desvío por obras"".</p>

<p>Creo que si se permitiera circular por el arcén a las motos se fomentaría el uso de las mismas en una M-30 saturada de coches en horas punta y ayudaría a descongestionarla, y de paso reducir la emisión de gases de efecto invernadero tal y como apuntan muchos estudios medioambientales.</p>
";"10/09/2015 13";"59";"35";"24";"8";"882090344";"652"
"3164";"Sopladoras de porquería en la calle";"<p>No limpian, sólo remueven la porquería del suelo para que acaben metiendose por ventanas abiertas o en la cara de los viandantes. En el suelo se acumulan bacterias, ácaros, virus y huevos de parásitos, no los vemos pero están ahí, y gracias a las ""sopladoras"" se suspenden en el aire y los inhalamos o ingerimos (si tienes la mala suerte de llevar la boca abierta en ese momento) sino entran en nuestras casas y acaban en las manos de niños pequeños. Los parásitos como la triquina o la giardia pueden vivir meses enquistados en sus huevos, cuando desaparecen las heces de los perros, aún quedan los parásitos en el polvo del suelo, el mismo polvo que movilizan al soplar la calle.</p>

<p>No es higiénico, sólo sirven para extender polvo, microbios y mal olor. </p>

<p>Por favor, que las quiten de una vez y vuelvan las escobas de toda la vida.</p>
";"10/09/2015 13";"63";"57";"6";"3";"890958474";"4614"
"3167";"ELIMINACION DEL IMPUESTO POR EL INCREMENTO DEL VALOR DEL SUELO URBANO";"<p>En aquellos casos en los que se venda una vivienda y se invierta en otra nueva (que sea vivienda habitual) en la ciudad de Madrid, debería eliminarse este impuesto al igual que ocurre con la plusvalía de IRPF . Se da la circunstancia en Madrid que este impuesto se calcula sobre el valor catastral del suelo que está casi tan caro como el valor de la vivienda, y cuya fórmula resulta sangrante para aquellas familias que queremos cambiar de vivienda por aumento de la familia, caso extremo en familias numerosas con nacimientos de múltiples.</p>

<p>Entiendo que el beneficio que implica la venta de la vivienda pasado unos años, lo invertimos de sobra en la nueva vivienda habitual, pagamos dos veces la revaloralización del inmueble que vendes y el que compras.</p>

<p>Este impuesto no se aplica en otras ciudades y de hecho está denunciado y hay sentencias en contra. ¿Por qué se sigue aplicando a Madrid?.</p>

<p> </p>
";"10/09/2015 13";"36";"30";"6";"1";"887034215";"2000"
"3169";"Convoquen oposición para plazas de bombero -conductor ya.";"<p>Creo que hay en proyecto plazas de bombero, pero lo que más necesita el Servicio Contra Incendios son bomberos conductores pues hace mucho que no se convocan plazas y no se cubren las jubilaciones. Un camión de bomberos no puede ir a ningún sitio sin conductor, aunque esté lleno de bomberos.</p>
";"10/09/2015 13";"19";"11";"8";"0";"878264239";"173"
"3171";"Plaza de la Remonta en Valdeacederas (Tetuán)";"<p>La plaza de la Remonta necesita un poco de cuidado. Los principales problemas de este gran espacio público son:</p>

<p>1- Los coches que circulan y aparcan en la misma plaza. Muchos son de la Policía Nacional y eso que tienen un espacio reservado en la calle Muller.</p>

<p>2- El estado del pavimento, está bastante deteriorado.</p>

<p>3- Las terrazas de los bares y restaurantes. Con mal tiempo las cierran con lonas y son espacios encubiertos para fumadores, incumpliendo la ley antitabaco.</p>

<p>4- Un espacio para perros acotado.</p>

<p>Muchas gracias por esta oportunidad de poder debatir sobre las necesidades de Madrid.</p>
";"10/09/2015 13";"23";"22";"1";"4";"888365490";"2008"
"3172";"Modernizar la red de la EMT";"<p>Realmente creo que es necesaria la modernizacion de la red de autobuses de Madrid, suprimir las duplicidades de las lineas, muchas heredadas de antiguos tranvias, y crear lineas de alta capacidad con recorridos trasversales mejorando la movilidad de los distritos perifericos y conectandolos entre si sin necesidad de tener que pasar por el centro, (conexiones entre Latina-Carabanchel-Usera-Puente de Vallecas), asi como crear conexiones entre barrios que no tienen metro o una linea de EMT por ejemplo entre Carabanchel y Principe Pio.</p>
";"10/09/2015 13";"60";"57";"3";"4";"892107767";"5130"
"3173";"Discapacidad intelectual - inteligencia límite";"<p>Creo que no existen residencias para mayores con una discapacidad intelectual e inteligencia límite.  Estas personas no pueden ser encasilladas con otras cuya discapacidad es más profunda y para las que sí existen residencias.  El problema surje cuando los progenitores fallecen y llega el caso de no poder vivir totalmente solos.  Por eso, creo que es imprescindible que se tengan en cuenta las necesidades, presentes ya, futuras dentro de algún tiempo para este colectivo de seres humanos.
También podrían ser pisos compartidos y tal vez tutelados, donde se ubicasen estas personas para tener un ambiente lo más agradable posible.  Hay que pensar que económicamente pueden estar tan necesitados o más como los que ""nos llamamos normales"", pero sus sensibilidades sí son diferentes.</p>

<p> </p>
";"10/09/2015 13";"13";"11";"2";"0";"883667557";"761"
"3175";"Recuperar la recogida de trastos viejos";"<p>La recogida de trastos viejos una vez al mes, fue una efímera pero gran idea, ayudaría mucho a la limpieza, al reciclaje, al agobio de tener que llevar los tratos a los pocos puntos limpios que existen y con unos horarios muy limitados.</p>

<p>Espero que se recupere</p>
";"10/09/2015 13";"66";"62";"4";"7";"892293420";"5448"
"3176";"Uso a la Nave Boetticher Villaverde";"<p>Hoy leo (http://www.abc.es/madrid/20150910/abci-carmena-proyecto-botella-boetticher-201509071804.html) que ahora que se le había propuesto un uso por fín a esta nave histórica de Villaverde, mejor o peor, tecnológico iba a ser, bien, algo iba a ser, y encima atraía a empresas punteras a este barrio. Ahora se tumba el plan y vuelve a quedar por meses (si no años) en desuso (y van 23 años sin uso). No sé, podría ser un tercer ¿Museo de Ciencia y Tecnología? (ya hay en Albobendas y Delicias). Pongan propuestas..</p>

<p>Hagan un proyecto tecnológico, cultural, lo que sea, que atraiga a la gente de Madrid y de fuera, que diga, vamos a Villaverde a ver .. como actualmente se dice vamos a Mendez Alvaro al 'Planetario'. Hagan algo que merezca la pena, que sea orgullo del barrio, que deje actividad económica y turística en el barrio, y dejemos ser marginados en el ámbito empresarial económico y cultural.</p>
";"10/09/2015 13";"31";"29";"2";"4";"889172077";"2525"
"3177";"Eliminación del transbordo en Tres Olivos.";"<p>Buenos días a todos,</p>

<p>Si habiendo leído el titulo no sabéis de que va este tema, es porque no habéis tenido la suerte de haber estado en la estación de metro de Tres Olivos. Lo explico. En Tres Olivos hay que hacer un transbordo. Lo mejor es que este transbordo no implica cambio de línea y es totalmente inútil.</p>

<p>La estación está situada en la línea 10. Si vas hacia el norte, dirección Hospital Infanta Sofía, al llegar a la estación hay que bajarse del tren, pasar los tornos (sin pasar la tarjeta o billete) y montarse en el tren de enfrente. Si vas en hacia el sur, dirección Puerta del Sur, la cosa mejora. Al llegar, tienes que bajarte del tren, pasar los tornos (esta vez pasando la tarjeta o billete) y montarte en el tren.</p>

<p>¿Problemas que todo esto acarrea? Varios. Obviando que es absurdo cambiarse de tren, el mayor problema es la pérdida de tiempo. En el mejor de los casos, al llegar a Tres Olivos ya estará el tren en el otro andén y solo habrá que subirse. En este caso, se perderán uno o dos minutos. En el peor, toca esperar 3, 4, 5, incluso en ocasiones hasta 8 minutos (con huelga puede llegar a 15 fácil) para que llegue el tren. Hay que sumarle además que en ese intervalo llegarán más trenes y tocará ir como sardinas en lata. Si vamos en dirección sur, hay que sumar el obstáculo de los tornos, en el cual hay pocos y no pocas veces alguno se rompe, formándose un embudo en torno a los que funcionan.</p>

<p>¿Qué se pide? La <strong>eliminación o la mejora </strong>del transbordo.</p>

<ol>
	<li>Para la eliminación, bastaría con seguir las vías  y unirlas a las existentes, puesto que la estación de Tres Olivos tiene ya dos andenes para poder recibir trenes a la vez en ambos sentidos.</li>
	<li>Si esto no fuera posible por cualquier causa, al menos eliminar todos los tornos y barreras en el andén y que los trenes de ambos lados estuvieran preparados a la vez, haciendo el trasbordo lo más rápidamente posible.</li>
</ol>

<p>Ya se hizo una petición en change.org (https://www.change.org/p/no-al-cambio-de-metro-en-tres-olivos). A ver si esta vez conseguimos que se arregle.</p>

<p>Un saludo.</p>
";"10/09/2015 13";"115";"112";"3";"10";"895584743";"10615"
"3178";"carril BICI calle Alcala";"<p>Una de las calles más largas de Madrid, podria tener su carril BICI (de principio a fin de la calle). De esta forma podria probarse lo que muchos estamos deseando, tener un acceso acondicionado donde poder disfrutar de la bici, y los que estamos fuera de madrid llegar al centro y a Retiro sobre dos ruedas.</p>

<p> </p>
";"10/09/2015 13";"45";"30";"15";"0";"883534081";"1000"
"3179";"Guardia y Custodia compartida";"<p>Soy un Padre separado con un hijo de 5 años. Estoy luchando por la defensa de un derecho como es el de mi hijo de estar en igualdad de condiciones y tiempo que con su padre, y me estoy danto contra un muro porque en esta Comunidad de Madrid es complicado obtener este derecho, en cambio en otras Comunidades Autónomas se da automáticamente, ejemplo Comunidad Valenciana, Cantabria, Aragón.</p>
";"10/09/2015 13";"23";"17";"6";"2";"883555422";"813"
"3180";"Bajar el importe de las multas del SER si te confundes de color (Ahora son 60 )";"<p>Somos muchos los que distinguimos mal los colores azul y verde.</p>

<p>Cada vez que al aparcar nos confundimos, nos ponen una multa como si no hubieramos pagado nada . La multa dice ""Título no válido"" y nos clavan 60.</p>

<p>Estoy de acuerdo en pagar una multa para que la gente no lo haga a propósito, pero ""no tan alta"".</p>

<p>Por favor señores del Ayuntamiento, bajen la multa cuando nos confundimos de color.</p>

<p>Como ya hemos pagado (cuando pagamos zona verde y aparcamos en zona azul, pagamos más de lo debido) la multa debería ser proporcional a lo que hemos dejado de pagar. Por ejemplo 10 veces lo que hemos dejado de pagar. ¡Que ya sería bastante!</p>

<p>Muchas gracias</p>
";"10/09/2015 13";"49";"39";"10";"3";"887445805";"2308"
"3181";"La horrenda Plaza de los Cubos";"<p>El hermano menor de la zona Azca, pone de manifiesto que en cuanto el ser humano construye un subterráneo sus congéneres indefectiblemente lo mean o intentan violar a una mujer. Esta espantosa plaza ha sido famosa por sus reuniones de bandas de la extema derecha, neonazis incluidos, que llegó a tener una policía dedicada en exclusiva a la zona de la comisaría de la calle Rey Francisco.</p>

<p>Más tarde, se convirtió en un centro expendedor de drogas duras y blandas con los camellos aposentados junto al nefando monumento que da nombre al lugar.</p>

<p>Hoy es unos de los botellometros más molestos para vecinos que vivan en una manzana a la redonda, ante la pasividad o impotencia de la policía municipal . Las noches de la primavera verano es imposible dormir con las ventanas abiertas, sobre todo los jueves, viernes y sábados, cuando la alegre muchachada sale a emborracharse sin importarle menudencias tales como la convivencia y el respeto a los demás. El paisaje de las mañanas siguientes, sobre todo sábados, para lo que madrugamos, en este país, las 10 de la mañana es dantesco antes de que pasen los servicios de limpieza, pero ya estamos acostumbrados a vivir entre la basura que nos ha proporcionado y entre la que ha educado a algunas generaciones, la inolvidable Botella, Queen of the Olympics Games.</p>

<p>En una manzana a la redonda desde su epicentro alberga 28 bares, los he contado, casi todos cutres y de comida basura con terrazas que ocupan el espacio que les da la gana sin miedo a las multas, tal y como ha reconocido el concejal de centro, impotente ante el desmadre, que además no garantiza votos populares.</p>

<p>Sólo la salva los cines y su adicto público, algo provecto entre los que me cuento, que tiene que salir de la última sesión entre peleas, vomitonas y gritos para regresar a sus casas y los que vivimos en los alrededores, cerrar a cal y canto ventanas y enchufar los aires acondicionados los que los tengan.</p>

<p>Propongo hacer cumplir la ley al respecto de ruidos, botellones, terrazas... etc. Algo francamente complicado en este país, donde las leyes se hacen para aplicar la ley del embudo. Y si no lo hacen por sus votantes populares, háganlo al menos por frenar el calentamiento del planeta y el cambio climático. Que no todo es montar en bici, estimada Inés (Sabanés, por supuesto)</p>

<p>Gracias por la lectura, que no servirá de nada. Un cordial saludo</p>

<p>Un vecino</p>
";"10/09/2015 13";"59";"51";"8";"5";"889965811";"3716"
"3182";"Recoletos ciclista";"<p>Actualmente está prohibido circular con bicicleta por aceras. Pero hay calles en las que parece que es de cajón ir por ellas. Por ejemplo el bulevar de Paseo de Recoletos, con su pista asfaltada, ancha, bajo la sobra de los árboles y en contrapunto con la bulliciosa calzada atestada de coches.</p>

<p>Quizás podría hacerse una zona de coexistencia bici peatones, siempre que las bicis respeten y circulen a una velocidad prudente, no tendría por qué haber problemas.</p>

<p>¿Alguien más ve la propuesta de permitir circular bicis, con restricción de velocidad, en el bulevar de Recoletos?</p>
";"10/09/2015 13";"34";"13";"21";"1";"872295111";"-305"
"3184";"Plantar arboles ";"<p>habria que plantar arboles cuando quitan otros porque estan mal o secos.inmediata y obligatoriamente plantar otro.y en lugar de tanto adoquin en plazas mas arboles.madrid mas natural.</p>
";"10/09/2015 13";"55";"52";"3";"2";"891789481";"4632"
"3185";"una web madrid.es donde sea mas facil encontrar las cosas ";"<p>una web madrid.es donde sea mas facil encontrar las cosas</p>

<p>para llegar a encontrar este foro de debate :  decide.madrid.es ; he tenido que ir a google, lo suyo es que apareciera en la primer pagina de madrid.es ; o en la de participa, o sea algo intuitivo.</p>

<p> </p>

<p>También puede ser que sea muy torpe, y no haya sido capaza de encontralo.</p>
";"10/09/2015 13";"39";"37";"2";"2";"890511674";"3320"
"3186";"Competencias de la Policía Municipal";"<p>Cuando escucho la palabra ""Policía"" pienso en alguien que nos proteja, que se la juegue por los ciudadanos, que su objetivo sea hacer de esta ciudad una ciudad más segura y mejor para todos. Pero en los últimos tiempos, escuchar Policia Municipal significa: Ahogar al ciudadano en multas, y más en concreto con la multa por botellón. Me parece genial que se castiguen actos así, pero que a mí un Policía Municipal me diga: (En diciembre de 2014, sin este gobierno en el ayuntamiento) ""Exclusivamente me han mandado esta noche poner multas por botellón"" me parece muy fuerte, para que se forman policias municipales y se les paga un sueldo mejor que a los Nacionales o la Guardia Civil, ¿Para que me frían a multas y nos ahoguen más aún?. Por favor, que la Policía Municipal se dedique a lo que se tiene que dedicar, que es protegernos y no a estas cosas, porque pierden reputación ellos y perdemos los ciudadanos. Es mi humilde opinión, como un madrileño más y como futuro Policía que me gustaría ser, no quisiera dedicarme a poner multas, quisiera ayudar y salvar a la gente.</p>
";"10/09/2015 13";"30";"25";"5";"1";"886705157";"1666"
"3187";"ESCUELAS DE MÚSICA Y SUS PRECIOS";"<p>Las Escuelas de Música Municipales, en los últimos años por temas de privatización subieron tanto los precios que se ha convertido en unas Escuelas Municipales de Música para los que más dinero tienen.</p>

<p>Un ejemplo: 2 horas de flauta a la semana, 85 .</p>

<p>Actualmente en casi todas las Escuelas hay plazas de sobra, cosa que jamás sucedía en esta ciudad porque antes era accesible a todxs, era dificilísimo entrar, el problema era el contrario, no había plazas suficientes.</p>

<p>Con la nueva reformas educativa, la asignatura de música como otras relacionadas con el arte han quedado relegadas a nada dentro del curriculum escolar, con las consecuencias que ello tiene tanto para las habilidades individuales, sociales y a la cultura en general.</p>

<p>La cultura, que debería ser un bien accesible a cualquiera, se ha convertido en elitista. No puede ser que en esta ciudad, las personas con unas capacidades musicales y artísiticas increibles no puedan desarrollarlas, y menos en un Espacio Público.  </p>

<p> </p>

<p> </p>

<p> </p>
";"10/09/2015 13";"47";"41";"6";"10";"889576583";"3053"
"3188";"ILUMINACION RECORRIDO RUNNING PARQUE EL RETIRO.";"<p>Normalmente el recorrido de running en el parque de El Retiro, discurre a lo largo del perímetro del mismo, que se encuentra iluminado por las farolas de las calles adyacentes, pero en el tramo que va de la puerte de La Puerta de Alcalá a la primera puerta de la Calle Alfonso XII, el circuito se separa de la valla del parque, por lo que se pierde también la iluminación de la calle adyacente, lo que representa un problema de seguridad para el corredor, ya sea de lesiones físicas por ser el firme inestable, o de que haya problemas de agresiones o robos aprovechando la oscuridad. Me gustaría que se planteara la posibilidad de poner algo de iluminación en este tramo, ya sea con farolas, o con iluminación tipo LED en el suelo.</p>

<p>Muchas gracias.</p>
";"10/09/2015 13";"32";"13";"19";"0";"872663691";"-243"
"3189";"Cambiar de nombre Travesía General Franco";"<p>A la salida del metro Carabanchel Alto existe una travesía recientemete vuelta a abrir a la circulación llamada Travesía General Franco como se puede ver en cualquier callejero.</p>

<p>Travesía del General Franco, 28044 Madrid, España</p>

<p>Creo que seria muy conveniente un cambio de nombre de esta calle que ni siquiera tiene placa con el nombre.</p>
";"10/09/2015 14";"65";"38";"27";"2";"882060466";"643"
"3190";"Camino escolar seguro! Que los niños vayan solos andando o en bici al cole!";"<p>Hace solo unas décadas era habitual que los niños iban solos al cole.</p>

<p>Hoy en día van sobreprotegidos en los todoterrenos de los padres por muchos motivos, pero principalmente por la inseguridad vial percibida. Hay que trabajar para que eso cambia. Cada mañana se agolpean los coches delante de los colegios, dando todo una lección sobre movildad insostenible y crear sistuaciones de inseguridad especialmente para los niños que van solos.</p>

<p>La autonomía de los niños es fundamental para su proceso de socialización en el mundo que les rodea.</p>

<p>La adminstración tiene que crear procesos de concienciación entre los docentes, padres y otros agentes sociales sobre este problema y garantizar que las calles sean seguras para los niños que van en bici o andando.</p>

<p>Gracias por leer la propuesta, espero que haya apoyos!</p>
";"10/09/2015 14";"33";"23";"10";"4";"883896229";"906"
"3192";"Madrid:  Ciudad de sonrisas y buen rollo";"<p>Si lo declaramos y practicamos viviremos mejor todos el tiempo que nos queda a cada uno</p>
";"10/09/2015 14";"30";"14";"16";"3";"875180986";"-93"
"3193";"Acercar competencias a juntas de distrito: DESCENTRALIZACIÓN";"<p>Murgui ya ha planteado o lleva años, el tiempo que lleva con los que estamos en asociaciones de vecinos, planteando la descentralización, con un fin: acercar la administración más cercana al vecino o ciudadano. Propongo que se vaya haciendo con prontitud y celeridad. Además, ante cualquier problema lo podemos plantear en la Junta en la que ahora, ya hay concejales de Ahora Madrid, q nos harán más casos, y discutirlo en pleno a través de vocales vecinos. </p>

<p>La administración que creó el PP, en estas últimos años (mejor dicho décadas) generó no descentralización sino duplicidad de órganos con el único fin de crear órganos centralizados para dar jefaturas. De nada nos vale un órgano centralizado de un área o de una empresa pública o de un organismo autónomo, si está fuera de nuestro distrito o no está en una zona accesible y distante equivalente de todos los distritos. Así, los órganos centralizados pierden su razón de ser.</p>

<p>En este sentido se ha creado un debate sobre bancos, fuentes y sombras que me parece que va acorde con este tema de la descentralización o eliminación de duplicidades. Hay servicios que existen en juntas y no tienen porqué estar duplicados: licencias, consumo....Y así podemos ir diciendo un sinfín. La descentralización o eliminación de duplicidades genera: eficiencia, ahorro y celeridad administrativa en los trámites.</p>

<p>Saludos camaradas y a hacer de Madrid la ciudad del cambio.</p>
";"10/09/2015 14";"80";"68";"12";"4";"890821904";"4760"
"3194";"CARRIL-BUS EN M-607";"<p>Si los autobuses no pasaran, en hora punta, parte del tiempo de su recorrido en un atasco, seguramente tendrían más usuarios que cambiarían su coche por ir cómoda y rápidamente a su trabajo en transporte público.</p>

<p>La solución pasa por destinar un carril para uso de las líneas de EMT e interurbanas que utilizan esta vía para acceder al intercambiador de la Plaza Castilla.</p>

<p>Podría implantarse de forma inmediata en la zona de titularidad del ayuntamiento, prácticamente desde su entrada al término municipal de Madrid.</p>

<p> </p>
";"10/09/2015 14";"29";"24";"5";"1";"886528755";"1572"
"3195";"Mas seguridad en guarderias, colegios e institutos";"<p>Vivo en el distrito de San Blas y todas las mañana dejo a mi hijo en una guarderia municipal, en la cual no hay ni un solo municipal en la puerta para cuidar a esos niño, las puertas estan gran parte del tiempo abiertas permitiendo el paso a cualquier extraño que quiera. Al ir a trabajar paso por muchos colegios ya que trabajo en el distrito de hortaleza, ningun colegio publico tiene municipales en la puerta, pero SORPRESA el subencionado si los tiene. Son esos niños mas importantes?? Creo que tanto publicos, subencionados como privados debian de tenerlo, porque hay que cuidar a los pequeños. Son nuestro futuro</p>
";"10/09/2015 14";"48";"41";"7";"0";"888977613";"2904"
"3197";"Certificado de Seguridad en la web del ayuntamiento.";"<p>Hola, buenas tardes.</p>

<p>Pues eso, qué tal si los administradores técnicos de la plataforma de muchos de los subdominios de la web de Madrid instalan un certificado de seguridad? Nos movemos en peticiones seguras (HTTPS) y siempre hay que estar salvando el problema con el  navegador.</p>

<p>Un ejemplo: https://deportesweb.madrid.es/deportesWeb/Login.aspx</p>

<p>He visto que el certificado es válido y está asignado a todos los subdominios de *.madrid.es</p>

<p>Pero no funciona como debería.</p>

<p>Pues eso, que le echen un vistazo al problema. Que a mi no, porque soy informático, pero a algún otro usuario le puede dar sensación de no confianza.</p>
";"10/09/2015 14";"22";"19";"3";"0";"886354484";"1381"
"3198";"Autobuses Eléctricos o Híbridos";"<p>Con la gran tasa de contaminación que tenemos es absolutamente reprobable que la ciudad este llena de autobuses urbanos municipales de gasoil. Cuando en los taxis hay una gran tendencia hacia los vehículos híbridos.</p>

<p>Creo que habría que ir renovando la flota con autobuses eléctricos, si es posible, o, como mínimo, hibridos enchufables.</p>

<p>Pero que obtengan la energía eléctrica de fuentes limpias, de nada nos sirve electricidad proveniente de coMbustibles fósiles o atómicos, pues lo único que hacemos es cambiar la contaminación de lugar.</p>

<p>Para ello habría que poner en las cocheras instalaciones de generación de electricidad limpia, solar, eólica, etc. O incluso aprovechar también el proyecto en marcha de la electricidad generada por las frenadas de los trenes del metro. Cualquier opción de energía limpia es válida.</p>

<p>A medio/largo plazo supondría un importante ahorro para el ayuntamiento pues ya no se gastaría tanto dineral en gasoil, tendrían combustible limpio y casi gratuito... y mejoraría mucho la calidad de vida de los ciudadanos y visitantes.. al tener una atmósfera más limpia.</p>

<p>Además el Ayuntamiento tiene que ser el primero en dar ejemplo.. Y, hasta ahora, con esos autobuses petroleros.. lo que está haciendo es todo lo contrario...</p>

<p>Saludos</p>

<p>Juan </p>
";"10/09/2015 14";"61";"57";"4";"1";"892098598";"4952"
"3199";"Puntos limpios móviles con horarios rotativos";"<p>En los pocos días que lleva esta web se está notando una preocupación por el medio ambiente, y qué mejor forma de contribuir que el reciclaje accesible. Propongo que los puntos móviles vayan cambiando de horario cada semana, para adaptarse a los horarios de los ciudadanos. Simplemente con eso se aumentaría el reciclaje de cosas que sabemos que se reciclan, pero no podemos acceder a los contenedores específicos, como por ejemplo las radiografías.</p>
";"10/09/2015 14";"22";"18";"4";"0";"885355086";"1145"
"3200";"Papel reciclado";"<p>Usar papel reciclado en lugar de papel normal en el ayuntamiento y en todos sus centros administrativos dependientes.</p>
";"10/09/2015 14";"39";"36";"3";"0";"890027294";"3046"
"3201";"LA REMUNICIPALIZACIÓN DEBE SER VENTAJOSA PARA TODOS.";"<p>Últimamente están saliendo muchas voces de trabajadores de empresas privadas que, amparándose en el buen mensaje que supone la remunicipalización de los servicios municipales, quieren entrar a trabajar como personal propio de la Administración municipal sin hacer oposición previa. Creo que el deber de todo gobierno municipal debe ser realizar una gestión adecuada del dinero que ponemos todos los contribuyentes de nuestro bolsillo, por ello, si se quieren remunicipalizar los servicios, primero debería hacer una reestructuración de todo el personal funcionario y laboral que tenga actualmente en plantilla para una mejor gestión de los servicios y una mejor distribución del personal y, si de esa reestructuración hiciese falta más personal debería convocar oposiciones públicas donde todos los madrileños y españoles tengan opción a sacarse una plaza en la Administración pública. Creo que es lícita la lucha de los trabajadores de contratas de quedarse en la Administración, pero si el gobierno municipal mete a todo este personal directamente a la Administración se está quitando la posibilidad a otros ciudadanos de poder conseguir un puesto en la Administración. Por favor, el gobierno debe mirar por todos, no solo por unos pocos.</p>
";"10/09/2015 14";"40";"25";"15";"7";"882752006";"625"
"3202";"No a los abusos en los restaurantes. No agua embotellada. No contaminacion.";"<p>No se si os habra pasado alguna vez. Pero me indigna muchísimo en los restaurantes cuando pides agua y te traen una botellita de 20 ml o 33 ml. Botella previamente comprada en un supermercado por dos duros y vendíendola a 2 o 3 euros (Comprobado por mi). Me parece increible que una ciudad como madrid que presume de tener un agua buenisima, probablemente el mejor agua del país y se siga con una demanda excesiva de agua embotellada. Ya no es por las dos o tres botellas que pides en un restaurante para acabar la comida satisfactóriamente (y los sucesivos 5 euros), mas importante es el derroche de energía y la contaminación que produce fabricar botellas  embotelladas de ese tamaño.</p>

<p>Se podria seguir el modelo de EE.UU. o almenos de Nueva York, que aunque no sea una ciudad ídeal pero en este sentido, en todos los restaurantes tiene a alguien que se pasa por todas las mesas sirviendo agua de una jarra a todos los comensales, para que nunca falte agua y no te amargue la comida. (tambien comprobado por mi  = )  )</p>

<p>Soy consciente de que no es algo super urgente y super importante (alomejor para algunos unas tonteria), pero creo que es algo que tiene muy facil aplicación y hariamos de Madrid una ciudad un poquito mejor. BASTA YA DE ABUSOS!!!</p>
";"10/09/2015 14";"37";"26";"11";"7";"884694171";"1054"
"3203";"Convertir el Palacio de la Música de la Gran Vía en sala de conciertos ";"<p>Mi idea es convertir la Palacio de la Música de la Gran Vía,en sala de conciertos.Para conciertos de grupos nacionales e internacionales.Evitaríamos que se convitiese,en una tienda de ropa de una multinacional y así seguría destinado a la cultura.Que es lo que realmente es su uso.</p>

<p>Así tendríamos una sala decente en el centro de Madrid.Ya que La Riviera o la Heineken,se quedan pequeñas.Y el Palacio de los Deporetes,no da abasto.Aí tendríamos,un Shepherds Bush Empire de Londres a la madrileña.Y está en un lugar muy bién comunicado.</p>

<p>Espero que mi propueta se tenga en cuenta</p>

<p>Muchas gracias.</p>

<p>Un saludo</p>

<p> </p>
";"10/09/2015 14";"46";"39";"7";"2";"888867187";"2713"
"3204";"Vivienda Digna y multa a bancos por viviendas vacías ";"<p>Viviendas en propiedad a precios solidarios y adsequibles, viviendas que se puedan pagar aún  si tienes Renta Mínima. Viviendas para familias monomarentales y monoparentales. Con garantías de habitabilidad mínima 5 años, sin cambio de condiciones ni abusos. Con una Tae % única para este tipo de operaciones regulada por decreto. Que a cada banco se le asigne  una cuota social de pisos y que las viviendas  se encuentren en todas las zonas de Madrid. Sin experimentar con las personas, permitiéndoles vivir donde quieran. Si los bancos  se niegan  o incumplen que la multa sea equivalente al precio de mercado de los pisos en venta más un %.</p>
";"10/09/2015 14";"81";"59";"22";"13";"887830625";"2695"
"3205";"Organizar los debates. Agrupar repetidos.";"<p>Detecto muchos debates repetidos. Los votos se dispersan. Hay muchos debates similares para leer. Solicito buscar una solucion para agruparlos. Por ejemplo enviar en email al debate con menos votos para que se integre en otro con mas votos que versa sobre el mismo tema. Gracias.</p>
";"10/09/2015 14";"59";"56";"3";"3";"892486827";"5030"
"3206";"Iluminar algunos caminos de la Casa de Campo para facilitar el deporte";"<p>Mediante la instalaciones de farolas solares en algunos caminos de la Casa de Campo se favorecería que en Invierno pudiésemos seguir saliendo a andar o a correr al salir de trabajar igual que hacemos cuando anochece tarde. Facilitaría el deporte al aire libre.</p>
";"10/09/2015 14";"37";"25";"12";"3";"883883727";"878"
"3207";"Reabrir el Auditorio del Parque Juan Carlos I";"<p>Lleva varios años cerrado y abandonado.Podríann a volver abrirse las fuentes cibernéticas que ah allíi y utilizarse para conciertos,festivales,cine de verano,teatro o utilizarlos para los Veranos de la Villa.Qué era lo que se hacia antes allí.</p>
";"10/09/2015 14";"44";"38";"6";"1";"889204983";"2763"
"3209";"Busto a J.C ";"<p>Quería proponer la creación de un busto en el ayuntamiento de Madrid a uno de esos héroes aninonimos que no se les reconoce. Ayer por la noche mi compañero de piso J.C evitó que todo el bloque de edificios ardiera al quitar las lentejas del fuego que se estaban quemando,  creo que se merece este reconocimiento. PD: las lentejas estaban buenas </p>
";"10/09/2015 14";"54";"16";"38";"4";"872133777";"-651"
"3210";"Reabrir el Auditorio del Parque Juan Carlos I";"<p>Volver abrir de nuevo el auditorio.Que lleva varios años cerrado y abandonado.Volver a utilizarse la fuente cibernética,conciertos,festivales,teatro,cine de verano o llevar allí los veranos de la Villa</p>
";"10/09/2015 14";"69";"63";"6";"5";"892352276";"5204"
"3212";"¡Queremos BiciMad en Vallekas!";"<p>Somos mas de 300.000 vecinas y vecinos en los dos distritos vallecanos los que nos quedamos sin poder usar las Biciletas del ayuntamiento.</p>

<p>Nos gustaría que al menos se pudieran extender al distrito de Puente de Vallecas para que así podamos disfrutar todas de este servicio.</p>
";"10/09/2015 14";"90";"69";"21";"3";"889194785";"3680"
"3213";"Cambiar Oso y Madroño ";"<p>Propongo cambiar el símbolo de nuestro escudo, por el de los famosisimos ""Hermanos Osos"" de Puertollano.  Creo que se lo merecen por varios motivos, acabar con el hambre en el mundo, acabarse las copas de sus amigos para que no les siente mal,... PD: expropiese parcela con hectáreas de sobra (propongo el retiro) </p>
";"10/09/2015 15";"60";"7";"53";"1";"874275460";"-536"
"3214";"Reabrir la Nave de la Música (Matadero)";"<p>Tras la tragedia del Madrid Arena y la ""peculiar gestión"" de dicho conflicto por parte de la anterior corporación municipal, se dejaron de programar conciertos en la<strong> Nave de la Música del Matadero</strong>, un espacio que sin duda debería aprovecharse más para que los promotores puedan programar conciertos en Madrid.</p>

<p>
<strong>Reapertura ya</strong> y acondicionamiento para que la música luzca como se merece.</p>

<p>Nota: en la web oficial todavía pone un sonrojante <em>""Suspendida la actividad por reformas hasta finales de 2014"".</em>
http://www.mataderomadrid.org/nave-de-musica.html</p>
";"10/09/2015 15";"47";"45";"2";"4";"891991690";"4117"
"3215";"MAQUINAS EXPENDEDORAS EN LA CALLE";"<p>QUIERO QUE EL AYUNTAMIENTO COBRE UNA TASA ESPECIAL A LAS MAQUINAS EXPENDEDORAS DE SERVICIOS QUE SE ENCUENTRAN EN LA CALLE EN SUELO PUBLICO Y EN ESTABLECIMIENTOS PUBLICOS DEL AYUNTAMIENTO DE MADRID: MAQUINAS DE COCACOLA, MAQUINAS DE PEPSI, MAQUINAS DE AGUA, TODO TIPOS DE MAQUINAS.</p>

<p>MOTIVO ENSUCIAN LA CIUDAD.</p>
";"10/09/2015 15";"34";"13";"21";"12";"873099285";"-305"
"3216";"Proponer como Patrimonio de la Humanidad a la Unesco monumentos zonas de Madrid";"<p>Serían El Prado,tanto museo y el paseo.El Palacio Real.La Plaza Mayor y el Madrid de los Austrias y el de los Borbones.La Gran Vía.El Parque del Retiro.Palacio de Telecomunicaciones.Templo de Debod.</p>

<p>Así tendría su reconocimineto por su historia y su cultura y fomentaría el turismo.</p>
";"10/09/2015 15";"46";"39";"7";"3";"889178488";"2713"
"3217";"Hacer de Malasaña un barrio diferente";"<p>Actualmente está de moda pero está todo muy sucio, sin estilo y poco amigable. Se podría hacer solo para peatones en fin de semana, limpiar pintadas,...</p>
";"10/09/2015 15";"39";"24";"15";"0";"882218824";"553"
"3218";"Plenos del Ayuntamiento";"<p>Buenas tardes , me gustaria proponer que los Plenos que se realizan en el Ayuntamiento fuesen mas accesibles al público y que se pudiese saber de primera mano los debayes , intervenciones y propuestas que se realizan en ellos . Por eso , me gustaria proponer que se pudiesen seguir de alguna manera por youtube o por alguna plataforma del mismo tipo</p>

<p>Muchas gracias</p>
";"10/09/2015 15";"28";"26";"2";"0";"889220539";"2228"
"3222";"Transformar Gran Vía - Princesa: Ampliar espacio peatonal pasando de 3+3 a 2+2 c";"<p>La Gran Vía soporta una cantidad ingente de peatones cada día, hasta hacer limitada la capacidad de caminar o estar. Pese acontar con unas aceras amplias, las características de la vía requieren una ampliación de las mismas:</p>

<ul>
	<li>Eliminar un carril por sentido de tráfico privado.</li>
	<li>Incluir un carril exclusivo para bicicletas.</li>
	<li>Ampliar ambas aceras [1.5 m aprox]</li>
	<li>Crear aparcamientos de bicicletas y motos en las calles adyacentes ----&gt; Prohibir aparcar motos en la Gran Vía</li>
</ul>

<p>Digamos que uno de los carriles pasaría a ser para el peatón y otro para ciclistas. El tráfico es perfectamente asumible en una configuración de 2+2.</p>

<p>_Ejemplo de Oxford street en Londres:</p>

<p>Abrir un debate sobre si el tramo central entre Callao y Montera <em>(el de mayor carga peatonal)</em> podría contar con 1+1 carriles, sin paradas de autobús ni taxi <em>(éstas estarían en Callao y justo después de Red de San Luís)</em>, como sucede en esta calle londinense</p>
";"10/09/2015 15";"64";"37";"27";"1";"882266342";"578"
"3223";"Hola y adiós. ";"<p>Parecía una propuesta interesante esta página de debates pero me temo que, salvo alguna que otra honrosa excepción , no es más que una inicativa demagógica y sectarista copada por las minorias que intentan imponer sus criterios, en muchos casos disparatados, a la mayoría. Algo que me temo tendremos que sufrir durante cuatro largos años... y como no consumo aquello que no me gusta me doy de baja</p>
";"10/09/2015 15";"43";"13";"30";"3";"872652827";"-513"
"3224";"Perros con bozal";"<p>Recuerdo que hubo una temporada donde hubo varios ataques de perros en un periodo muy corto de tiempo, incluso creo recordar que hasta una niña fue atacada, por desgracia, y como los medios no paraban de hablar de ello, los políticos hablaban de multar y de hacer esto y lo otro, y el caso es que durante un tiempo funcionó, como suele pasar en este país, los dueños llevaban a sus perros con bozales, pero ya está todo olvidado, ahora es raro ver a perros con bozales, y, por el contrario, muy normal ver a perros totalmente capaces de matar a un adulto, ni que decir a un niño, sin bozal ni nada de nada, y sus dueños tan tranquilitos, y esto será así hasta que de nuevo vuelva a pasar una desgracia.</p>

<p>Que se cumpla la obligatoriedad de los bozales ya, que se persiga este tema, y a quien no cumpla sanción de las gordas, que no es ninguna broma este tema, y es que cabrea tener que cambiar de acera por miedo a que nos ataquen a nosotros o a nuestros niños.</p>
";"10/09/2015 15";"63";"43";"20";"9";"886091779";"1569"
"3225";"Baños públicos en Madrid Rio";"<p>Deberían poner baños públicos a lo largo de Madrid Rio.Ya que no hay ninguno y hay muchas familias con niños y la gente puedan hacer sus necesidades y así no ir a los bares y los chiringuitos de la zona.</p>
";"10/09/2015 15";"90";"81";"9";"1";"893210475";"6480"
"3226";"Eliminar la cuota mensual de autonomos";"<p>Creo que una de las <em>lacras</em> para la creación de nuevas empresas y el emprendimiento es la cuota de autónomos. En países como Francia, Alemania e Inglaterra este impuesto es algo testimonial (7 euros en Francia) lo cual permite que cualquier persona pueda aventurarse a montar un negocio de cualquier tipo sin el riesgo de perder sus escasos ahorros en el camino.</p>

<p>Mientras en España cualquier persona que quiera montar una empresa pequeña tiene que pasar por caja, pagar los 260 euros mensuales, da igual si gana dinero o no. Esto tiene que cambiar.</p>

<p>Con el fin de fomentar la creación de empresas en Madrid, propongo directamente eliminar la cuota mensual de autónomo para las empresas pequeñas (menos de 5 trabajadores) hasta que dicha empresa tenga beneficios de 30.000 euros.</p>

<p> </p>
";"10/09/2015 15";"38";"30";"8";"3";"887229600";"1736"
"3227";"Zonas Peatonales";"<p>Se supone que las zonas peatonales son para los peatones y servicios de emergencias, pero no es el caso. Vivo en una zona peatonal y pasan coches y hasta incluso se ponen a lavar los coches, tendría que haber algún dispositivo y/o bolardos para los servicios de urgencias con un mando especial  que pudieran bajarlos cuando les hiciera falta, y así que no entrarrian todos los coches. Gracias</p>

<p> </p>
";"10/09/2015 15";"21";"15";"6";"0";"883311039";"642"
"3228";"DEPORTIVO GALLUR";"<p>Los niños que estan en la escuela de fútbol de Gallur no tienen campo para entrenar porque lo construyeron hace muchos años pero por una mala gestion se abandono, parece ser que les salia mas barato abandonarlo para que destrocen los vestuarios, se lleven el cobre y demás que pagar a un vigilante para poder tener unas instalaciones adecuadas. Quiero que se debata la necesidad de que estos niños futuros deportistas tengan instalaciones para poder hacer deporte</p>
";"10/09/2015 15";"22";"13";"9";"1";"880206827";"236"
"3229";"Polideportivo en Sanchinarro";"<p>Rumores de que se iba a hacer un polideportivo, pero nada. El de hortaleza aparte de estar un poco lejos, desmantelan servicios como el padel por las mañanas. </p>
";"10/09/2015 15";"42";"36";"6";"0";"889171670";"2571"
"3230";"Respeto para los refugiados, no  a las cuotas.";"<p>No son ganado y por tanto no se les puede repartir por toda europa por cuotas, ¿¿vamos a obligarles a venir a españa si prefieren estar en alemanía??</p>

<p>Ademas repartirlos de esta manera es igual que decir que son un problema y por tanto que hay que repartirse entre todos el problema ¿de verdad son un problema??</p>

<p>Y ¿¿que se hará con los refugiados a los que les toque irse a rumanía y quieran estar en alemania o con los que se manden contra su voluntad a portugal y quieran escapar para ir a alemanía?? vamos a vigilar la frontera con portugal para que no salgan de ahí??</p>

<p>No al reparto forzoso de refugiados.</p>
";"10/09/2015 15";"43";"16";"27";"20";"872927240";"-409"
"3231";"Reconstruir el antiguo mercado de la Cebada";"<p>Proponer de hacer de nuevo el antiguo mercado.Del siglo XIX y era precioso y derribar el que ahí ahora es feo y horroso y no pega nada con el entorno.</p>
";"10/09/2015 15";"46";"32";"14";"3";"885424088";"1252"
"3232";"Aparcamientos para bicicletas en edificios públicos.";"<p>Cuando voy a la biblioteca en bici, me toca buscarme una señal para <strong>aparcar la bicicleta donde no moleste demasiado a los peatones</strong>, ya que casi nunca hay aparcabicis ni me dejan meterla en el recinto del edificio.</p>

<p>También le pasa a algún político que intenta ir a trabajar en bici (http://www.abc.es/20111217/madrid/abcp-bicis-pero-parking-oficial-20111217.html) y seguro que muchos de los que van a <strong>polideportivos, centros culturales o colegios</strong> encuentran el mismo problema.</p>

<p>Propongo que se<strong> incentive la colocación de aparcamientos para bicicletas en los edificios públicos </strong>para así evitar este problema y fomentar el uso de la bicicleta.</p>
";"10/09/2015 15";"85";"69";"16";"0";"890550163";"4302"
"3233";"Derribar el Centro Colón y reconstruir el Palacio de Medinaceli ";"<p>Es espantodo y feo y no pega nada cone entorno y levantar de nuevo el Palacio de Medinaceli del siglo XIX e injustamente derribadoy gran pérdida para Madrid.</p>
";"10/09/2015 15";"48";"20";"28";"3";"872888806";"-333"
"3234";"Acondicionamiento del carril bici de la M-607 en llegada a Madrid";"<p>Aún siendo el carril bici muy probablemente de titularidad autonómica por serlo la carretera, el ayuntamiento debería buscar conjuntamente con la comunidad de Madrid una solución al estado del mismo desde la zona de Valdelatas / IES San Fernando (en suelo municipal). 

En esa zona el carril bici bidireccional, viniendo dirección norte y previo al cruce con la M-40, es dividido en dos carriles bicis de un solo sentido, existiendo un paso elevado por la carretera para el sentido Madrid. Pero el estado y trazado de este sentido es tan lamentable que no es utilizado por los ciclistas, sino que se usa el sentido Colmenar por los ciclistas discurriendo en ambas direcciones.</p>

<p>Para añadir más problemas, este sentido tiene tramos muy estrechos, sobre todo en el paso por la M40, con poco espacio entre esa vía y el trazado del tren... Lo cual genera situaciones muy peligrosas para los ciclistas. Además el propio firme es defectuoso en muchos sitios.</p>

<p>Creo por tanto necesario y preferible arreglar y ampliar en su ancho (previo estudio de viabilidad) el trazado del carril sentido norte, para habilitarlo cómo carril bidireccional y señalizar para evitar el uso del otro carril unidireccional.</p>

<p>Además se da la circunstancia de que más al sur de la M40 a la altura de la incorporación a la M-607 del trafico desde la carretera de fuencarral, hay un paso por un tramo de tierra (cuya titularidad ignoro pero parece de la casa incrustada en esa parcela) que permite en el sentido sur incorporarse a la calle de nuestra señora de valverde, que es la vía más rápida para los ciclistas que quieren entrar en Madrid, en lugar de la oficial usando el anillo verde ciclista y recorriendo más kms. En cambio en dirección norte, la calzada existente no permite incorporarse al carril bici de la m-607 a menos que se circule en sentido contrario por el arcen, cosa que es habitual ver entre los ciclistas que por ocio o desplazamiento realizan recorridos Madrid-M-607.  Esto genera más situaciones complicadas entre los ciclistas y podría ser resuelta convirtiendo el arcén de ese tramo norte-sur de enlace entre carretera de fuencarral y nuestra señora de valverde en un carril bici bidireccional, que luego se prolongaría hasta su enlace con el anillo verde ciclista unos cientos de metros más adelante, mejorando las conexiones. También sería conveniente convertir en carril bici las decenas de metros de descampado de propiedad dudosa usadas habitualmente para realizar dicha conexión.</p>

<p>



 </p>
";"10/09/2015 15";"24";"15";"9";"0";"881443665";"375"
"3236";"Ayuda a las víctimas de violencia de género";"<p>Me parece muy importante que las víctimas de violencia de género cuenten con el apoyo de los profesionales del Ayuntamiento de Madrid. Hay víctimas que tienen miedo, pena o vergüenza y no lo denuncian y niegan todo maltrato ya sea físico o psicológico. Además hay víctimas de violencia de género que no lo ven. Se podría llamar síndrome de la mujer maltratada. Estas mujeres vienen a justificar todo y a echarse la culpa de los malos tratos que está sufriendo. Aquí es donde el Ayuntamiento de Madrid debe prestar un servicio imprescindible. Esto es, ser capaz de llegar a las víctimas de violencia de género aunque ellas no lo demanden. Así se las podrá ayudar a salir de esta situación de una manera más rápida. Estas víctimas si no se las ayuda, en muchos casos, no salen de la situación en la que se encuentran. De esta manera, se podrían evitar malos tratos y asesinatos de las mujeres víctimas de violencia de género.</p>

<p>Se podría ayudar a las víctimas de violencia de género a demanda de familiares, amigos de las víctimas o bien de los profesionales sanitarios o trabajadores sociales. Se podría publicitar de la siguiente manera: ""Conoces a una mujer que esté siendo maltratada? Cuentanoslo, los profesionales del Ayuntamiento de Madrid la ayudarán"". Muchas gracias</p>
";"10/09/2015 15";"35";"22";"13";"5";"883049478";"565"
"3237";"Teatro de Madrid";"<p>Creo que es necesaria la reapertura de este famoso teatro cercano a la Vaguada que lleva años en la sombra desaprobechado.</p>
";"10/09/2015 15";"44";"41";"3";"4";"891490930";"3540"
"3238";"Reciclado de agua para Parques, Jardines y limpieza de calles";"<p>El agua es un bien preciado, da pena ver parques ""quemados"" en verano por falta de agua, el consumo por hogar es alto, y la pérdida del agua utilizada es vergonzosa, soy profano en relación a los costes que una nueva instalación de este tipo pudiera suponer, pero los parques que ya cuentan con este sistema son una maravilla, extender estas redes de distribución sobre todo por los anillos exteriores de la ciudad permitirian crear unos cinturones verdes de alta calidad para una ciudad comprometida con el medio de forma sostenible y para un futuro ecologicamente humanizado.</p>

<p>Gracias por permitir expresarse a los ciudadanos.   </p>
";"10/09/2015 16";"35";"34";"1";"1";"891457590";"3205"
"3239";"Repensar las líneas de la EMT: Red ortogonal, líneas N-S y líneas E-O";"<p>La red de la EMT es una malgama compleja de números que en muchas calles se superponen, lentitud y en algunas líneas grandes tiempos de espera.</p>

<p>En Barcelona y Vitoria se implantó la <strong>red ortogonal</strong>, que plantea líneas en sentido vertical y líneas en horizonal. Lo que reduce el gran número de líneas  y aumenta asombrosamente las frecuencias y la velocidad comercial. Desde que se implantó en estas ciudades, el uso de la EMT se disparó.</p>

<p><strong>El funcionamieto:</strong></p>

<ul>
	<li>Red norte-sur denominada con números (1, 2, 3, 4....)</li>
	<li>Red este-oeste denominada con letras (A, B, C, D...)</li>
	<li>Una línea diagonal (x ej. Ñ) por Alcalá-Mayor.</li>
	<li>Cuadricular la ciudad en los mapas de las paradas, web y app de forma que sepamos nuestro origen y destino: F4, B5... algo así como en el Ajedrez.</li>
	<li>La lógica de las líneas será intuitiva, y se sabrá que podemos coger las líneas B y la 5 para llegar a nuestro destino, por tanto desde nuestro punto F4 podremos coger la línea F o 4 hasta cortar con la línea B o 5 y transbordar.</li>
	<li>Las paradas de las líneas norte-sur y este-oeste estarían en los cruces de las calles, facilitando el transbordo</li>
	<li>Mayor frecuencia: autobuses cada +-3 min</li>
	<li>Tiempos de espera de transbordo de 2-3 min <em>(experiencias de Barcelona y Vitoria)</em>
</li>
</ul>
";"10/09/2015 16";"40";"34";"6";"3";"889114487";"2380"
"3240";"¡¡¡ Que la Policia Municipal en vez de multas, reparta besos ¡¡¡";"<p>Por que no pueden los agentes en vez de multar explicar que lo que hizo estaba mal y que la proxima vez podria ser multado , pero que por ser la 1ª vez se le perdona y se le da un besito.</p>
";"10/09/2015 16";"63";"21";"42";"2";"872271539";"-700"
"3241";"Legislación música callejera";"<p>Creo que se debería revisar la legislación municipal en cuanto a la música callejera en varios aspectos.</p>

<p>1. Se prohibe la percusión y la amplificación, por ejemplo, de guitarras, en cambio cualquier viento puede tocar libremente. No es cuestión de instrumentos sino de decibelios. Hay que limitar el exceso de ruido pero no a costa de sacrificar ciertos instrumentos que por el ruido ambiente de la calle no se oyen.</p>

<p>2. Habilitar algún momento y lugar determinados para que se pueda tocar libremente, por ejemplo, las plazas los domingos por la mañana.</p>

<p>3. Aunque la mejor prueba es el gusto del público, no me parece mal que se realicen pruebas para tocar en la calle, pero que exista la posibilidad de solicitar el permiso en cualquier momento o que haya pruebas periódicas.</p>

<p>Por último, comentar que todo músico o artista necesita un público, que muchas veces tocamos por amor al arte y con riesgo de ganarnos una multa y que a mucha gente le agrada encontrarse música por la calle.</p>
";"10/09/2015 16";"28";"23";"5";"1";"887108621";"1478"
"3242";"Música en la calle";"<p>Volver a regular la presencia de músico callejeros en la que se establezcan líneas rojas como decibelios u horarios, un mapa de puntos donde no es posible tocar y donde sí... Y abandonar la política de criminalización de quienes tocan en la calle. Recuperar la música de la calle y que sea una ciudad music friendly como tantas otras en Europa o en Latinoamérica. </p>
";"10/09/2015 16";"42";"37";"5";"1";"890038272";"2819"
"3244";"NO AL ROBO IMPUNE DEL CARTON DE LOS CONTENEDORES.";"<p>Cada dia me sorprende mas como roban y saquean los contenedores de carton que los vecinos madrileños nos molestamos en reciclar.Hace unos años eran furgonetas con dos individuos los  que vaciaban los contenedores , ahora como el negocio les va bien son camiones con 4-5 individuos cometiendo todo tipo de infracciones de trafico (van de pie en la zona de carga, no utilizan cinturones de seguridad, tiran al asfalto todo lo que no les vale, etc.) y robando todo el carton y papel que pueden.Todos los vemos a cualquier hora del dia ( antes lo hacian por la noche ) y cuando digo todos los vemos me refiero a todos (niños , ancianos, policia municipal, etc.) Acabemos con estas malas practicas.</p>
";"10/09/2015 16";"61";"51";"10";"3";"890316604";"3427"
"3245";"ITE desfavorable y costes altísimos de rehabilitación";"<p>Los vecinos que tenemos un piso en el centro de Madrid tenemos que asumir el mantenimiento de edificios con una edad de más de 100 años. Todos estamos de acuerdo que los edificios hay que mantenerlos pero el ayuntamiento no puede ponerse una venda en los ojos y simplemente dedicarse a poner multas si los vecinos no hacen las obras y sin tener en cuenta en que circunstancias se encuentra la comunidad de vecinos.</p>

<p>En muchos casos (o mayoritariamente) el coste las obras de rehabilitación para poder hacer frente a la ITE desfavorable, que ha otorgado el ayuntamiento a la comunidad, no puede ser asumido por los vecinos porque podemos estar hablando en cantidades de entre 500.000 y 1.000.000. Además tenemos que contar con el problema que ha causado la crisis y muchos vecinos al no tener trabajo o con una pensión muy baja no pueden hacerse cargo de los pagos de las derramas.</p>

<p>El ayuntamiento de Madrid tiene que involucrarse más con los vecinos y estudiar en detalle cada caso, no se puede limitar a hacer la visita del perito, enviar el requerimiento y si los vecinos no han empezado con las obras... limitarse a poner multas y a la 4ª multa hacer ellos la rehabilitación del edificio y si los vecinos no pueden asumir ese coste se les desaucia.</p>

<p>En muchos casos hablamos de comunidades de vecinos humildes, gente mayor con pensiones pequeñas. El ayuntamiento tiene que mirar por el mantenimiento de los edificios pero tambien por los ciudadanos de Madrid. Y sobretodo no puede mirar para otro lado cuando pasa este tipo de injusticias.</p>

<p>Necesitamos un ayuntamiento que este mas cerca de los ciudadanos y los apoye en las problematicas del día a día.</p>

<p>Desde aquí pido al ayuntamiento poder tratar todos juntos como se podria cambiar la situación actual para todos estos casos y mejorar en lo posible la situación de todos los vecinos que nos encontramos con este tipo de problemas</p>
";"10/09/2015 16";"19";"12";"7";"1";"881355062";"315"
"3246";"Museo o un lugar de homenaje a la movida madrileña";"<p>Crear un espacio o un museo a la movida madriñena.Por lo que significó en la cultura y sociedad de Madrid y de España en la transición y en los años 80.</p>
";"10/09/2015 16";"40";"19";"21";"2";"875837680";"-95"
"3247";"Pintar las plazas de aparcamiento en línea de coches en las calles";"<p>Las zonas de aparcamiento en línea pueden estar más o menos aprovechadas dependiendo del día por como aparquen los coches. Hay días que los huecos entre coches son tan amplios, sin caber otro coche, que se puede estar perdiendo un tercio de las plazas. Para evitar esto, creo que pintando mínimamente donde empieza y acaba cada plaza la gente lo tomaría como referencia y se aprovecharía mejor el espacio disponible.</p>
";"10/09/2015 16";"21";"16";"5";"2";"884918345";"838"
"3248";"Ecologismo en el Ayuntamiento y empresas asociadas.";"<p>El ecologismo local implica la potenciación de la agricultura y producción energética local, la utilización de materiales sostenibles, papel reciclado, madera no proveniente de selvas <em>(a ser posible de nuestro entorno próximo controlado)</em> etc.</p>

<p>Una entidad local, dado su tamaño y visibilidad debe volcarse en este sentido sin ninguna excusa. Lo ecológico es nuestra línea de supervivencia como sociedad, la potenciación de las economías locales, la recuperación de los entornos rurales y descontaminación de los ecosistemas.</p>

<p>Para comenzar el debate, se exponen algunos puntos a tratar, el resto de puntos, el cómo implantarlos y ejemplos concretos son parte de este debate:</p>

<ul>
	<li>Utilización alimentos ecológicos y locales en las dependencias del Ayuntamiento, centros de día, escuelas, etc...</li>
	<li>Promoción del consumo ecológico dentro de la ciudadanía</li>
	<li>Impulso de cooperativas de producción ecológica</li>
	<li>Uso de material ecológico, local y responsable <em>(mesas, sillas, papeles, tintas, vasos...) </em>
</li>
	<li>Obligatoriedad de utilizar materiales y sistemas ecológicos <em>(y locales) </em>en la construcción, reforma y mantenimiento de edificios e infraestructuras <em>(como calles) </em>dependientes del ayuntamiento y empresas asociadas.</li>
	<li>Piscinas públicas con depuración salina</li>
	<li>Jardinería ecológica, libre de químicos en todo el municipio y promoción de ella.</li>
	<li>Desarrollo de granjas ecológicas en el interior de Madrid, siguiendo el ejemplo de Berlín (espacios dentro de la Casa de Campo, Retiro, Carabanchel, riberas del río, etc...</li>
	<li>Empresa energética municipal con base renovable (placas fotovoltaicas sobre edificios municipales, energía geotérmica, eólica sin aspas...) hasta entonces contratar a cooperativas que empleen unicamente energía renovable.</li>
</ul>

<p>¿Qué opináis? </p>
";"10/09/2015 16";"35";"24";"11";"2";"884600219";"891"
"3249";"Numerito para aparcar en la zona de residentes";"<p>Me gustaría proponer al Ayuntamiento d Madrid la posibilidad de poder abonar anualmente el numerito para aparcar en zona de residentes, no solo a los empadronados en la zona si no tambien a los que justifiquen con sus contratos el lugar de trabajo. Así los que tenemos que desplazarnos en vehículo propio al lugar de trabajo tendríamos más posibilidades de aparcamiento y el Ayuntamiento se beneficiaría d ello.</p>

<p>Gracias</p>
";"10/09/2015 16";"24";"11";"13";"4";"876457535";"-91"
"3250";"Contaminación acústica";"<p>Esta medida tendría coste cero y es de muy fácil aplicación: suspender el toque de campanas que realizan las iglesias. Quien va a misa no lo necesita y quien no va no es molestado.</p>
";"10/09/2015 16";"37";"21";"16";"12";"882062941";"283"
"3251";"Multas a menores por botellón";"<p>Si la <strong>Policia Municipal</strong> sancionara con la ley de seguridad ciudadana (estatal)  en lugar de con la ley antibotellón autonómica, los menores (y sus padres) podrían sustituir el pago de la multa con la participación en unas actividades reeducativas. Con la ley antibotellón no hay posiblidad alguna de remisión de la sanción. Con la ley estatal se puede sustituir, en los menores de edad, la multa por consumo de drogas y se abre la puerta a hacer lo mismo con el alcohol.
Esta sería una solución transitoria hasta que se empiecen a derogar las leyes redactadas solo para recaudar.</p>
";"10/09/2015 16";"36";"17";"19";"0";"875554109";"-94"
"3253";"Ayuntamiento de Madrid, un gran coste para los madrileños.";"<p>Propongo alquilar espacios actualmente vacíos y con exposiciones que no merecen realmente la pena, a empresas privadas, de las cuales, su beneficio de alquiler, se dedique a fines sociales o para el uso y disfrute de la ciudad de Madrid, comenzando por los barrios periféricos.</p>
";"10/09/2015 16";"47";"34";"13";"0";"886592571";"1519"
"3254";"Aprovechar espacios públicos para educar en civismo";"<p>A mi parecer, la solución a muchas de las propuestas que en este foro se plantean pasan en mayor parte por una labor de educación y concienciación de la ciudadanía.</p>

<p>Creo que el ayuntamineto debería aprovechar espacios públicos posibles y propicios para llevar acabo distintas campañas de educación y concienciación de todos los problemas que aqueja nuestra ciudad, y de cómo podemos cada uno de nosotros tener un impacto positivo en los mismo.</p>

<p>Así mismo como se hizo con la candidatura de ""Ahora Madrid"", creo que la ciudadanía creativa e implicada en su ciudad podría aportar grandísimas ideas a coste cero para realizar los contenidos de las campañas.</p>

<p>A título personal me llama mucho la atención la cantidad de espacio publictario desperdiciado en el Metro dedicado al autobombo en vez de aprovecharlo para incidir en las buenas prácticas de uso del mismo, más aún cuando no se duda en empapelar estaciones enteras o vender su nombre a empresas privadas con fines publicitarios hechos de los cuales dudo que algún madrileño se pueda sentir cómodo ni orgulloso. Da gusto ver otras ciudades del mundo dónde aún en distintos idiomas no se ruborizan en insistir en este tipo de mensajes que aquí reclamo, y como no por casualidad dichas ciudades se ven limpias y el civismo de los ciudadanos es muy palpable.</p>
";"10/09/2015 16";"36";"32";"4";"9";"890245355";"2488"
"3255";"Aparcamiento bicicletas";"<p>Para impulsar la utilización de los carriles bici que se están creando en Madrid sugiero la <strong>creación de una sección para aparcar bicicletas</strong> <strong>dentro de los aparcamientos municipales para residentes</strong>. De esta forma personas que vivan tanto dentro como fuera del anillo de la M30 y que no tengan sitio en sus viviendas podrían acceder a este medio de transporte.</p>
";"10/09/2015 16";"49";"34";"15";"1";"885984725";"1318"
"3257";"Aceptar la reforma del Estadio Santiago Bernabéu";"<p>Aceptar la reforma del Estadio Santiago Bernabéu que tenia planificada el Real Madrid CF. Todos queremos un estadio mas moderno de la ciudad de Madrid. Asi aportariamos un toque de elegancia a la ciudad. </p>
";"10/09/2015 17";"164";"48";"116";"2";"871713845";"-1990"
"3258";"Teleasistencia gratuita a mayores de 70 años y minusvalidos";"<p>Creo que sería bueno que el Ayuntamiento, tanto que se está centrando en la sociedad, otorgara la Teleasistencia de forma gratuita a todos l os mayores de 70 años que lo solictaran además de a todas las personas que presentaran una minusvalia con un mínimo del 30% y que estuviera acredsitada de forma oficial.</p>
";"10/09/2015 17";"53";"45";"8";"4";"890536811";"3141"
"3259";"La indefensión de los jóvenes frente a las multas por botellón";"<p>Multas razonables para educar y no recaudar por el botellón. Una vergüenza:  340 euros si lo admites en un plazo de 10 días. 600 euros (si recurres) que se pueden incrementar a 800 euros cuando se ha dado la fase de apremio. Yo no digo que no se pague, pero que se pague una cantidad razonable.</p>

<p>En primer lugar, hemos de considerar, que, en la mayoría de los casos, se trata de jóvenes mayores de edad, estudiantes, que son insolventes económicamente ( esto es conocido por la Administración, pues en las propias multas la Administración les  recomienda  que, si no disponen de medios que pidan el dinero a sus padres, o,  mejor aún  que pidan un préstamo al Banco....). Está claro, que lo que se trata es de cuanto más se recaude mejor.</p>

<p>(Fuente del segundo párrafo: http://tinyurl.com/p5by8r4)</p>

<p>Firmar la peticion en change.org: http://tinyurl.com/q3dj2d5</p>

<p> </p>
";"10/09/2015 17";"47";"16";"31";"4";"873068698";"-510"
"3262";"Mayor duración de semáforos para peatones";"<p>Hablo en particular de una de las calles en las que es más difícil cruzar sin tener que hacerlo en varias etapas, el Paseo de la Castellana. Para cruzar de un lado a otro hay que esperar 2 tramos semafóricos si quieres hacerlo cumpliendo las normas (sin cruzar con el semáforo en rojo) Estaría bien revisar el tiempo que hay para que crucemos los peatones y que podamos cruzar de un lado a otro sin que se nos cierren los semáforos a mitad de cruce.</p>
";"10/09/2015 17";"35";"27";"8";"0";"887010092";"1465"
"3263";"Parada de Metro que incluya la palabra: Madrid";"<p>Hola, antes que nada me gustaría agradecer que hayan abierto esta web para que podamos proponer cosas los ciudadanos.</p>

<p>Desde que nací en Madrid y resido en Madrid, las paradas del Metro de Madrid siempre han llevado nombre de diferentes países como Colombia o República Argentina, de grandes pintores como Velazquez o Goya o de ciudades de otros países como Cuzco. </p>

<p>Mi pregunta es si vivimos en la capital ""Madrid"" y una gran ciudad llena de madrileños y de gente de otras partes, ¿por qué no incluimos una parada que se llame Madrid? He ahí mi propuesta. </p>

<p> </p>
";"10/09/2015 17";"33";"7";"26";"0";"874444890";"-403"
"3266";"Plan general de ayuda a indigentes";"<p>Ahora que las noticias de los refugiados sirios parecen haber despertado olas de solidaridad, puede ser buen momento para establecer un Plan integral de ayuda a indigentes.</p>

<p>En donde vivo, ves furgonetas llegar cada mañana y repartir mendigos por esquinas, cafeterías, iglesias etc. Hay tullidos, ancianos, mujeres embarazadas. Suelen ser extranjeros, explotados por mafias desde su pais de origen y que no tienen posibilidad de escapar de la espiral de miseria en la que están metidos.</p>

<p>El Ayuntamiento no necesita ir a buscar refugiados sirios a Hungría. Hay suficientes necesitados, explotados, en nuestras calles.</p>
";"10/09/2015 17";"43";"30";"13";"3";"885935725";"1186"
"3267";" PLAN DE EMPLEO PARA MAYORES DE 50 AÑO Shttps://decide.madrid.es/debates/2193";"<p>ESTE DEBATE ESTÁ INICIADO PERO ESPERO QUE VOTÉIS MAS POR ÉL.
</p>
";"10/09/2015 17";"35";"26";"9";"8";"886769577";"1262"
"3269";"La indefensión de los jóvenes frente a las multas por botellón por...";"<p>... MULTAS QUE NO DIFERENCIAN ENTREN BOTELLON Y BEBER EN LA CALLE.</p>

<p>Actualmente beber una simple lata de cerveza en la calle, sin molestar a nadie, te puede costar 600 . En mi opinión esa es una sanción extremadamente desproporcionada, sobre todo teniendo en cuenta que es la misma sanción que se aplica a quienes, durante un botellón, generan ruidos molestos hasta altas horas de la noche, dejan todo lleno de basura y en ocasiones hasta rompen mobiliario urbano. Obviamente estoy completamente a favor de sancionar esta segunda actitud, pero me parece una grave injusticia castigar la primera.</p>

<p>Multas razonables para educar y no recaudar por el botellón. Una vergüenza:  340 euros si lo admites en un plazo de 10 días. 600 euros (si recurres) que se pueden incrementar a 800 euros cuando se ha dado la fase de apremio. Yo no digo que no se pague, pero que se pague una cantidad razonable y proporcionada.</p>

<p>En primer lugar, hemos de considerar, que, en la mayoría de los casos, se trata de jóvenes mayores de edad, estudiantes, que son insolventes económicamente ( esto es conocido por la Administración, pues en las propias multas la Administración les  recomienda  que, si no disponen de medios que pidan el dinero a sus padres, o,  mejor aún  que pidan un préstamo al Banco....). Está claro, que lo que se trata es de cuanto más se recaude mejor.</p>

<p>FIRMAR LA PETICION: https://www.change.org/p/ayuntamiento-de-madrid-la-indefensión-de-los-jóvenes-frente-a-las-multas-por-botellón</p>

<p> </p>
";"10/09/2015 17";"46";"16";"30";"7";"873220004";"-486"
"3270";"Juegos Deportivos Municipales";"<p>Buenas tardes.</p>

<p>La preparación de los juegos deportivos municipales es un poco caótica, podrían mejorarse determinados aspectos.</p>

<p>Igual que veo un muy buen precio por la competición no veo tan bien que haya que guardar colas para inscribirse, que no se pueda centrarlizar fichas de los jugadores (siempre hay que presentar la documentación, en lugar de tener fichas que gestione la competición y los delegados). Algunas de las instacaciones deberían o quitarlas, o renovarlas. Por ejemplo, isla de tabarca es bastante pobre: ni vestuarios (cerca del campo de fútbol grande) ni redes de seguridad decentes.</p>

<p>No sé, creo que para ser un servicio municipal no está a la altura de Madrid.</p>
";"10/09/2015 17";"16";"14";"2";"2";"886909000";"1050"
"3271";"Estaciones de Metro con nombres más identificativos y claros";"<p>El objeto de este debate es proponer al Consorcio de Transportes de Madrid la modificación del nombre de algunas estaciones de Metro y Cercanías, para hacerlas más identificables, y para evitar ambigüedades con otros lugares de Madrid.</p>

<p>A continuación propongo el cambio de nombre de las siguientes estaciones.</p>

<p>Formato: Nombre actual (Metro/Cercanías) -&gt; Nombre propuesto. Motivo.</p>

<p>1) <strong>Pta. Arganda</strong> (C) -&gt; <strong>Vicálvaro </strong>(C).
Vicálvaro (M) -&gt; URJC Vicálvaro (M). 
Universidad Rey Juan Carlos (M) -&gt; URJC Móstoles (M). Las estaciones con parada de metro y cercanías deberían coincidir en el nombre para evitar equívocos, y con más motivo si la homónima está en otra ubicación distinta como es este caso.</p>

<p>2) <strong>Sierra de Guadalupe</strong> (M) -&gt; <strong>Villa de Vallecas</strong> (M). 
Vallecas (C) -&gt; Villa de Vallecas (C). 
Villa de Vallecas (actual) (M) -&gt; García Lorca (M). 
Caso similar al de Vicálvaro.</p>

<p>3) <strong>Gregorio Marañón</strong> (M) -&gt; <strong>José Abascal</strong> (M).
Para evitar que la gente al salir del metro pregunte: ""¿Dónde está el Hospital Gregorio Marañón?""</p>

<p>4) <strong>Atocha </strong>(M) -&gt; Atocha-Carlos V (M).  
Atocha Renfe (M) -&gt; Puerta de Atocha (M).  
Por desambigüación.</p>

<p>5) <strong>Banco de España</strong> (M) -&gt; <strong>Cibeles </strong>(M).  
Nombre más identificativo del lugar.</p>

<p>6) <strong>Sevilla </strong>(M) -&gt; <strong>Canalejas </strong>(M).  
Nombre más identificativo del lugar.</p>

<p>7) <strong>Estadio Olímpico</strong> (M) -&gt; <strong>Estadio Luis Aragonés</strong> (M).  
No parece que ya vaya a ser olímpico. Debería adoptar el nombre del futuro estadio.</p>

<p> </p>

<p>En el pasado ya ha habido algunos buenos ejemplos de cambios de nombre: Gran Vía, Santiago Bernabéu, etc.</p>

<p>Queda fuera de este debate el nombre de la estación Vodafone Sol, por tratarse de una índole distinta, y por existir otros debates en este foro sobre el nombre de la estación Sol con o sin patrocinador.</p>

<p> </p>

<p> </p>
";"10/09/2015 17";"42";"19";"23";"2";"874817574";"-180"
"3273";"¿Quién está a favor de una #mocióndecensura a la alcaldesa y a sus concejales?";"<p>El equipo de @ahoraMadrid llegó a la alcaldía de Madrid gracias al apoyo del PSOE y Carmona (no por decisión de los madrileños). En estos meses han impuesto una serie de decisiones que en definitiva no aportan gran beneficio para los madrileños. El cambio de nombres de calles, intentar alojar a sus okupas y contratar a sus familiares destacan entre sus aportaciones más brillantes.</p>

<p>¿Qué han hecho por nuestra ciudad?</p>

<p>Nada, sin embargo todo el grupo de @ahorapodemos y amiguetes varios ya están perfectamente colocados, es su particular 'Juego de Tronos'. Criticaban a la vieja política, la llamaban 'casta' y hasta la fecha han demostrado que son más de lo mismo, nepotismo puro y duro.</p>

<p>¿Queremos un gobierno así en nuestra ciudad?</p>

<p>Este debate no gustará, pero la libertad de expresión es lo único que queda y creo que también se puede preguntar a los madrileños si estamos de acuerdo con la gestión que está llevando a cabo, recuerden con el dinero de todos los madrileños.</p>
";"10/09/2015 17";"105";"24";"81";"14";"873057207";"-1302"
"3274";"CAMBIO NOMBRE CALLE";"<p>Hola¡¡</p>

<p>Os propongo se tome en consideración el cambio de nombre a la calle ""Millán Astray"" por el de ""Gil de Biedma"".</p>

<p>Saludos,</p>

<p> </p>
";"10/09/2015 17";"25";"8";"17";"2";"874365904";"-288"
"3275";"votación vinculante mediante el DNIe";"<p>Siempre nos quejamos de que no se nos da ni voz ni voto y esta plataforma es un primer paso excelente para poder votar las propuestas ciudadanas, pero no dejan de ser propuestas de que se debatan en el ayuntamiento. ¿No sería mejor utilizar nuestro voto directo?</p>

<p>Gracias a las nuevas tecnologías, se podría habilitar una plataforma de democracia liquida () y en ella poder votar directamente las propuestas de los ciduadanos y de los partidos políticos. Ahorrarían mucho en los presupuestos a la hora de realizar referendums ciudadanos sin tener que abrir todos los colegios de madrid.</p>

<p>Para más información mirad :</p>

<p>http://www.democracialiquida.org/</p>

<p>https://es.wikipedia.org/wiki/Democracia_l%C3%ADquida</p>
";"10/09/2015 17";"47";"41";"6";"7";"891144153";"3053"
"3276";"Suciedad y desidia alrededor del Planetario";"<p>Quiero proponer este debate; alrededor del Parque del Planetario y del Museo del Ferrocarril hay una extensión de terreno muy grande, miles de metros cuadrados, no sé si pertenecen al Ayuntamiento o a Adif. Según algunos vecinos estaba previsto realizar un Instituto un ambulatorio y más servicios. El caso es que está abandonado lleno de suciedad, está producida por muchos motivos por la poca educación. Hay además indigentes rumanos que también contribuyen con sus ""cabañas"" y restos de todo. Se ponen en todos los sitios debajo de los árboles, puentes.</p>

<p>Llevamos unos cuatro meses en los que se están produciendo incendios, en todo este terreno, como ya dentro del Parque del Planetario, colindante con la zona abandonada.</p>

<p>Creo que se debería realizar algo con todo, suciedad, indigentes, servicios.</p>
";"10/09/2015 18";"44";"42";"2";"5";"893017893";"3818"
"3277";"Que venga a Madrid Will Smith pero en blanco";"<p>Opino que ya está bien de estar siempre el último de la fila en cuanto a ciudades, Madrid no puede seguir así, es algo inmoral y desdeñable que sigamos siendo la última ciudad en cuanto a popularidad se refiere.</p>

<p> </p>

<p>Opino que pino, y que pino, no es nadie más ni nadie menos que el gran Will Smith blanco, porque creo que es necesario que los artista patrocinen la sede de España y creo que aumentaria la popularidad, el turismo y el empleo en esta nuestra querida capital.</p>

<p> </p>

<p>Convertir las plazas de toros en circuitos privados, la plaza del Sol, en un mercadillo popular para todos esos refugiados que de dinero no disponen, convertir el agua de las fuentes de Madrid en fantas de naranja, el agua de los lagos en rica Pepsi, la sede del Ministro en un cine al aire libre, los centros comerciales en centros penitenciarios, los hospitales en hostales y refugios, los rayos de sol que iluminan esta nuestra ciudad en caramelos de colores, de hacendado si es posible.</p>

<p> </p>

<p>Ya está bien, no podemos seguir con este pleibiscito permanente, aquí hay muchas cosas que fallan, muchas más de lo que la gente cree, y es hora de cambiar de una vez por todas</p>
";"10/09/2015 18";"46";"12";"34";"2";"874088172";"-573"
"3278";"El comercio y los domingos...";"<p>Me gustaría saber si alguna vez se podrá volver a descansar un Domingo. Es decir,como se ha hecho de toda la vida, el domingo en casa y no haciendo 12 horas en un centro comercial, y en caso de que te toque trabajar, no lo hagas gratis. Supongo q estos establecimientos que abren casi todos los días del año también influyen en el pequeño comercio que desaparece poco a poco. Ya que hay tanto paro cabe decir q estas empresas podían contratar a más gente para  trabajar los festivos y domingos. Con la excusa de la crisis, dese hace unos años nos toca trabajarlos gratis...y digo gratis, si. me gustaría saber cuando van a hacer ese cambio... Un saludo </p>

<p> </p>
";"10/09/2015 18";"42";"23";"19";"7";"881773381";"219"
"3279";"Peatonalizaciones puntuales";"<p>A parte del Paseo del Prado, que cerrará una de sus dos calzadas al tráfico todos loa domingos de 9 a 14h, (por si no os habíais enterado, el país lo explica bien aquí &gt; http://ccaa.elpais.com/ccaa/2015/09/09/madrid/1441793308_423813.html ) algunos distritos como Villa de Vallecas o Puente de Vallecas han optado por peatonalizar con el mismo horario pequeñas calles de sus distritos. ¿Qué opináis de esta medida? Y si hay alguien de Tetuán, ¿Que calles peatonalizarías tu del distrito de Tetuán?</p>
";"10/09/2015 18";"30";"18";"12";"5";"882853520";"359"
"3281";"reducir horario de terrazas";"<p>En la actualidad los bares con licencia pueden abrir la terraza, dependiendo del día, hasta las 2:30 de la madrugada. A todos nos gusta disfrutar de nuestros bares, pero debemos considerar que los edificios que lindan con estos locales tienen inquilinos que trabajan y desean descansar y en muchos casos se trata de menores que deben ir al colegio al día siguiente. No prohibimos, convivamos reduciendo estos desmesurados horarios.</p>
";"10/09/2015 18";"51";"35";"16";"5";"886715752";"1303"
"3282";"Elecciones";"<p>Cada vez que hay elecciones, y este año hemos tenido y vamos a tener unas cuantas, muchos temblamos para que no nos toque ir de mesa electoral.</p>

<p>Propongo que a las mismas, vayan personas que estén en paro y si ya han terminado la prestacíón mejor. De esta manera no se provocan trastornos a los trabajadores en activo, tampoco a las empresas y a estas personas supongo que les vendrá muy bien el dinero que se da por esta labor.</p>
";"10/09/2015 18";"18";"8";"10";"6";"877786064";"-88"
"3283";"Cercanias incluido en la tarjeta azul";"<p>La tarjeta azul que disfrutan ciertos colectivos ( mayores, rentas , bajas , discapacitados ..)Pueden disfrutar del metro y de la EMT pero no asi del cercanías que es del estado central.Propongo que sea incluido el cercanías en la tarjeta azul.</p>
";"10/09/2015 18";"23";"18";"5";"2";"886658971";"1017"
"3284";"Monumento simbólico en el Centro de Madrid. Tipo I AM AMSTERDAM ó LOVE de NYC";"<p>Estaría bien algún ""monumento"" simbólico por el centro de Madrid , no necesariamente de un artista famoso que cobre millones. </p>

<p>Algo tipo I AM AMSTERDAM (http://viajar.elperiodico.com/var/viajar/storage/images/media/imagenes-y-videos/letras-i-amsterdam/822454-1-esl-ES/letras-i-amsterdam_galeria_principal_size2.jpg) o el LOVE de Nueva York (http://imgc.allpostersimages.com/images/P-473-488-90/21/2162/G6CCD00Z/posters/amanda-hall-love-sculpture-by-robert-indiana-6th-avenue-manhattan-new-york-city-new-york-usa.jpg).</p>

<p>Es decir, algo que sea sencillo y bonito , pero a la vez moderno con lo que los turistas se hagan fotos y se publicite la ciudad. </p>

<p>Algo que característico de Madrid. Estaría bien poner uno o varios por la zona de Sol , Callao , Palacio Real , Plaza España , Reina Sofía , ...</p>
";"10/09/2015 19";"51";"21";"30";"9";"874273190";"-370"
"3285";"TASAS EN LA UNIVERSIDAD DE MADRID";"<p>Como todos sabemos y sobretodo estudiantes, ya hemos tenido miles de huelgas por esto y siguen sin hacernos nada de caso. Si de verdad quieren hacernos caso ahora que ha entrado una nueva presidenta de la comundad de Madrid (independientemente si es PSOE PP o Podemos) podrian hacernos caso de una vez?</p>

<p>Siempre estamos pidiendo que nos rebajen las tasas es injutos pero totalmente injusto que la gente tenga que pagar 2000 euros de matricula y ya no hablemos si hay que pagar una segunda matricula. No sabemos a quien quejarnos ni que mas hacer, ademas si hacemos huelgas nadie se solidariza con nosotros, ya que cuando hacemos el mundo no se para para nadie solo para nosotros que ademas de hacer una huelga perdemos clase (porque no se si la gente lo sabe pero los profesores siguen dando ese dia o esos dias clase y si estan estudiando ingeneria o alguna carrera que haga falta ir a clase no creo que les haga mucha gracia perderse 6 horas por dia). Exigimos y hasta casi pedimos por favor que bajen las tasas ya no es justo que en otras comundiades una matricula valga 800 euros y no empiecen que es por el renombre que tiene la UCM, UAM, UPM porque para eso esta las notas de corte entra el que es bueno y el que no no entra , es totalmente injusto que Una persona tenga un 10 pero no tenga 2000 euros SOLO para matricula alojamiento y demas busquense la vida claro esta. </p>

<p>Asique si de verdad quieren hacer un cambio, empiecen por rebajar matriculas en Madrid que luego no vemos ningun cambio hay los mismo profesores aulas viejas todo roto y no hay mejoras de ninguna clase. Solo vemos que reducen años, aumentan el precio del credito (ya mismo rozara lo mismo que coche y tendremos que pedir hipotecas para pagarlo) y a todos los que no estudian o no tienen hijos les da igual. Os lo digo por aqui ademas por si la gente sin hijos o hijos pequeños o que no saben del tema se solidaricen y empiecen a darse cuenta de que parece que pagamos por una universidad privada.</p>

<p> </p>

<p>Gracias y espero que esto sirva para algo.</p>
";"10/09/2015 19";"23";"12";"11";"3";"879157306";"52"
"3286";"ELIMINAR LOS DEBATES QUE ESCRIBAN TODO EL TÍTULO EN MAYÚSCULAS";"<p><strong>TAMBIÉN LOS QUE <u>ABUSEN DE LAS NEGRITAS</u>. ES MOLESTO, <u>DE MALA EDUCACIÓN</u>, SE APROVECHAN DE RESALTAR SOBRE LOS DEMÁS Y PERJUDICA LA LEGIBILIDAD. </strong></p>

<p><strong>POR SUPUESTO ESTE DEBERÍA SER EL PRIMERO EN SER BORRADO</strong></p>
";"10/09/2015 19";"33";"20";"13";"0";"883190977";"424"
"3287";"Los 4,7 millones de las luces a la limpieza";"<p>Creo que seria bueno que todo el dineral que se gasta en las luces de Navidad ,cuyas luces no tienen ningun sentido navideño, son publicitarias, se gastase en la limpieza de Madrid.Es una verguenza que el ayuntamiento no limpie las calles.Por eso con este dinero se podrà incrementar la limpieza creando asi puestos dectrabajo y no poniendo luces de navidad que son espantosas y publicitarias.Es preferible tener un Madrid limpio que un Madrid sucio,con ratas combo ahora y con luces que no tienen ningun sentido navideño .</p>
";"10/09/2015 19";"25";"14";"11";"1";"880942249";"168"
"3288";"Operación Campamento: Macro-Complejo comercial o proyecto original";"<p>Siendo la Operación Campamento una de las operaciones urbanísticas más importantes de la ciudad y en especial de la zona suroeste, deberían ser los madrileños quienes tengan la ultima palabra sobre cual de los dos modelos construir. Aunque también estén implicadas administraciones a nivel estatal, seremos los ciudadanos de Madrid quienes suframos las consecuencias para bien o para mal, por lo que debería hacerse un referéndum vinculante de especial importancia.</p>

<p>¿Macro-Complejo comercial para el empresario chino Wang o proyecto original para los madrileños?</p>
";"10/09/2015 19";"21";"14";"7";"6";"884365258";"466"
"3289";"¿Por qué los ciclistas incumplen las normas de circulación? ";"<p>Somos muchos usuarios de vehículos motorizados que, cada día más, vemos asombrados como ciudadanos que van en bicicleta o similar (por ejemplo, en patinete, aunque menos) inclumplen las normas básicas de circulación. Ya no me refiero simplemente a ir por la acera de peatones, me refiero a saltarse los semáforos o ir por medio de la calzada en dirección contraria. Me gustaría saber qué tipo de sanciones se estipulan en estos casos y si se están llevando a efecto (personalmente creo que no), Cada día la sensación es que conducimos peor, no respetamos los pasos de cebra, las incorporaciones de vehículos a la M30 o nacionales,... Esto es agravar aún más la situación, en la que, sin culpa, por ejemplo te puedes ver arrollando a un ciclista en un giro en el que te viene en sentido contrario, que vayas a pasar el paso de cebra y, como me pasó a mi, estuvo a punto de atropellarme un ciclista ""a todo gas"" con su semaforo en rojo...</p>

<p>Por favor, reflexionemos y démonos cuenta de que hay que ponerle remedio cuanto antes.</p>

<p>Saludos.</p>

<p> </p>
";"10/09/2015 19";"54";"41";"13";"9";"889417025";"2125"
"3290";"Permitir y regular la apicultura urbana en Madrid";"<p>La presencia de colmenas en las ciudades proporciona beneficios ambientales y económicos. Las abejas polinizan una gran variedad de plantas, y la miel que producen se vende a restaurantes y tiendas locales. </p>

<p>Londres, Nueva York, París, Berlín, Tokio, Turín, Vancouver, Montreal, Otawa, Chicago, Johannesburgo, Hong Kong, Melbourne, Sidney... En todo el mundo, muchas áreas urbanas promueven y regulan esta práctica. En Madrid, la apicultura urbana sigue prohibida pese a que los ayuntamientos madrileños tienen la potestad de permitir la instalación de colmenas en los cascos urbanos (artículo 7, Decreto 35/1985, de 8 de mayo, por el que se establece la normativa reguladora de la actividad apícola en el territorio de la Comunidad de Madrid).</p>

<p>Como bien se indica en el título del debate se trata de regular, es decir, no se trata de plantar  en cualquier parte de la ciudad, pero sí en determinadas azoteas, parques y zonas protegidas y señalizadas.</p>

<p>Existe, por ejemplo, un precioso colmenar histórico en el Parque del Capricho que podría resucitar su uso: http://mieladictos.com/2012/03/06/el-capricho-colmenas-urbanas-en-el-madrid-del-siglo-xviii/</p>

<p>Recomiendo este artículo para ahondar en el debate ""Un mundo sin abejas sería también un mundo sin abejorros, y tal vez sin flores, pues las abejas y las flores evolucionaron juntas, y son las dos caras de la misma moneda desde un punto de vista ecosistémico. Un mundo triste y monótono como una ciudad fantasma, una pesadilla estéril a solo un paso de la nada. La ciencia está movilizada. La inteligencia política debe seguir en su estela.""  http://sociedad.elpais.com/sociedad/2014/06/27/actualidad/1403882291_329326.html</p>
";"10/09/2015 19";"41";"27";"14";"4";"885703360";"856"
"3291";"Cambios reales hacia el bien HUMANO";"<p>Mucho tiempo llevo planteándome el por qué de buscar la separación entre provincias, comunidades, países... etc. Seguro que de esto que escriba la mitad no se leerá y la otra mitad se leerá a ciegas. Dicho esto comienzo:</p>

<p>Muchos han sido los avances que el ser humano, a lo largo de la historia, ha realizado. La mayoría de los avances se centraron en crear comodidades, facilidades, vías de escape al trabajo intensivo. Pero últimamente, y con el paso de los años, me he dado cuenta de que estamos teniendo una involución de ese ideal, la sociedad se está volviendo algo pernicioso, dañino para el ser humano.  Tantas frases de: con un duro esfuerzo llegarás muy lejos, eso, amigo lector, es mentira.</p>

<p>Tenemos miles de avances tecnológicos, políticos y sociales, pero en cambio solo benefician a unos pocos y en su mayoría vienen de una alta cuna. El resto de los mortales se mata a trabajar para, como mucho, llegar algún día a lamerle los pies a alguien de más arriba.  Obviamente si uno es inteligente y saca adelante un proyecto llegará a ser importante y a ser otro de los beneficiarios de la sociedad. Pero, admitámoslo, eso es el 1% de la población.  Cabe mencionar a Steve Jobs, Bill Gates, J.K. Rowling, gente importante, genios de nuestra era que supieron exprimir sus ideas. Privilegiados, si se les puede llamar de alguna forma. Esas personas, a día de hoy son grandes beneficiarios de sus logros, y así sus descendientes por varias generaciones lo serán. Pero, ¿qué hay de la gente de a pie? Esa gente, en su mayoría trabajarán toda su vida por un mísero salario que les dará para vivir, y recalco vivir. No para vivir bien. </p>

<p>Hace décadas que podíamos tener una jornada laboral de cuatro horas y llamar a esta una jornada completa. En cambio, nos hundimos en la miseria evolutiva manteniéndonos firmes en nuestro ideal de sociedad perfecta, una sociedad putrefacta que dejamos sobre la mesa esperando que madure y salga un manzano de ésta, cuando la realidad es que se la están comiendo los gusanos y tarde o temprano alguien tendrá que venir y tirarla a la basura.  Quiero, deseo y espero llegar a ver el momento álgido de la historia en el que los trabajos que no requieran de un alto grado de formación desaparezcan, siendo las personas sustituidas por máquinas. Y es que, ya no vivimos en el siglo XIX, ya no son paranoias de unos analfabetos desesperados por dar de comer a su familia a riesgo de sacrificar la vida misma con tal de conseguirlo. Estamos en pleno siglo XXI, una era de enormes avances cada diez años, una era en la que los robots son cada vez más inteligentes, seguros y eficientes incluso que las personas. Estamos a punto de romper la barrera de la naturaleza y mirar cara a cara a Dios. Nuestras propias creaciones: los robots. </p>

<p>Cientos de millones de transistores recorriendo cada parte de su esqueleto metálico, tan distintos a nosotros y a la vez tan semejantes. Ellos son nuestro futuro, nuestra creación, y temo, que nuestra evolución.  Ahora, llegados a este punto, querido lector. Responde: ¿Cómo crees que se encargará la sociedad de regular ese despido masivo de personas? ¿Cuántos crees que se beneficiarán de las tecnologías de nueva era? Estamos en una sociedad que prioriza al a la mujer, al niño, pero por encima de todo, prioriza al rico. Y no, si seguimos de la manera en la que hemos estado haciéndolo hasta ahora solo los ricos seguirán sacando ventajas de vivir en el siglo XXI. Mientras tanto, el resto de gente vivirá en el XIX, porque somos débiles, porque nos ciegan y nos abducen. Y aquí ya no hacen falta alienígenas, como en las típicas películas de los 90, solo hay que mirar y encontrarlos en las altas esferas de nuestra sociedad, se disfrazan de personas, hacen creer que son iguales a nosotros, incluso ellos mismos creen serlo, pero no es así. Hemos pasado de investigar curas contra las enfermedades por el bien de las personas a investigarlas solo en caso de que haya dinero de por medio.</p>

<p>Priorizamos el uso contaminante del petróleo porque a nuestros bolsillos les duele más tener un coche eléctrico, porque nadie quiere que compres un coche eléctrico, ¡qué harán los pobres jeques sin sus petrodólares si todos invierten en energías renovables!  ¿Véis? ¡Anteponemos el dinero al bien común, anteponemos el sucio, mugriento y envenenado dinero a salvar vidas!,  tal es el grado de abstracción y ceguera del ser humano de nuestra época que, ¡anteponemos el dinero al ser humano! ¡Somos esclavos del verde y las apariencias! Propongo poner fin a esta pesadilla de separación, de marginación y exclusión social causada por nuestra propia creación. Es hora de hacer cambios en la estructura política y social y cambiar de una forma drástica y absoluta nuestra forma de guiarnos por la vida. Es hora de echar colirio a nuestros ojos y librarnos de la ceguera provocada por los cristales camuflados entre el humo de la quema de petróleo y ver más allá de nosotros y lo que nos envuelve, de darnos cuenta de que hay más personas que nosotros, de que hay más vida que nuestro cuerpo, de darnos cuenta de una vez De que lo estamos haciendo mal.  </p>
";"10/09/2015 19";"26";"9";"17";"1";"874993641";"-276"
"3292";"Bajar precios escuelas de musica";"<p>Hace ya un tiempo se subieron de manera espectacular los precios en las escuelas publicas de música, no entiendo porque el Estado se gsdta dinero en publicidad diciendo a los jóvenes que rellenen su tiempo para no caer en las drogas cuando se lo ponen tan difícil para tener otros planes de ocio que no sea un botellón. Vivo en el barrio de Villaverde y aquí la mayoría no podemos pagar los mas de 90 euros al mes que se nos piden por hijo para estudiar musica, instrumento aparte claro. Cuando entenderán los políticos que la clave de un buen futuro es una buena educación. Gracias</p>
";"10/09/2015 19";"33";"27";"6";"1";"889058860";"1718"
"3293";"Auditorio Parque Juan Carlos I";"<p>El Auditorio del Parque Juan Carlos I se encuentra totalmente abandonado. Hace años se utilizaba en verano para hacer exhibiciones de Agua, Luz y Sonido y también se celebraban conciertos. Actualmente está muy deteriorado y es una pena que un espacio así se eche a perder. Creo que debería volver a utilizarse y sacar provecho de sus instalaciones.</p>
";"10/09/2015 19";"45";"42";"3";"1";"893099813";"3640"
"3294";"Acceso libre a los propietarios y residentes de las ZPR";"<p>Desde hace ya unos años que estamos habituados a ver la implantación de zonas de prioridad residencial. Yo vivo en la de Las Letras y, aparte de haber costado un montón de dinero a los madrileños ya que los sistemas de tarjeta y bolardos se cambiaron dos veces y nunca llegaron a funcionar, lo único que he observado es un decremento contínuo en el acceso a la vivienda.</p>

<p>Es de prioridad residencial, pero cualquier moto puede pasar por esta zona durante el día.</p>

<p>Hasta enero de 2010, mis hermanos y yo, como hijos de una mujer de avanzada edad, podíamos solicitar un permiso anual para poder llevar y traer a nuestra madre a y desde su vivienda. A partir de enero de 2010, era necesario pedir un permiso que inicialmente tenía una duración de unos 5 días (si no recuerdo mal) pero que era ampliable. Ahora, según el Ayuntamiento, mi madre (¡¡¡87 años!!!!!) puede acceder con su vehículos libremente y para cualquier acceso, es necesario solicitar un permiso de un día de duración y como máximo se pueden solicitar 10 al mes. En contrapartida, ahora en esta zona que teóricamente es de PRIORIDAD RESIDENCIAL, pueden también acceder los vehículos eléctricos aunque no sean del barrio de las letras.</p>

<p>Yo estoy empadronada en la vivienda, pero aún así, si sufro algún contratiempo, nadie puede acercarme a mi domicilio libremente, tengo que informar al Ayuntamiento de Madrid. A mí personalmente me molesta bastante el hecho de tener que dar explicaciones a nadie de quien entre o sale de mi casa, no creo que deba ser así, pero me gustaría que se revisase este tema para volver al menos a las condiciones previas de 2010, es decir que los hijos (ya no digo los yernos) o hermanos tengan un permiso permanente para el acceso, ya que las condiciones de ser hijo o hermano de no son susceptibles de variar a corto plazo.</p>

<p> </p>
";"10/09/2015 19";"17";"9";"8";"0";"878248622";"52"
"3295";"Señalización adecuada de los aparcamientos de carga y descarga.";"<p>Supongo que no soy el único al que le ha ocurrido. No me considero mal ciudadano, pero, a veces, te hacen sentir como si lo fueras.</p>

<p>El asunto que vengo a comentar es la inadecuada señalización de bastantes zonas de carga y descarga que comparten espacio (por unas pocas horas) con el servicio de estacionamiento regulado S.E.R.</p>

<p>No pocos madrileños hemos cometido el tremendo ""delito"" de aparcar nuestro vehículo en una de estas zonas sin ver la señal de carga y descarga (estaba tapada por un árbol, por un camión, doblada,, girada hacia donde no se ve,..). Puede parecer de risa, pero no lo es tanto cuando te pasa y te multan sin maldad por tu parte. Y repito (lo puede confirmar el 010), le pasa a más madrileños de los que nos pensamos.</p>

<p>Hace años, con mi primer ""delito"", escribí a atención al cliente del S.E.R. exponiéndoles el caso y dándoles alguna solución (creo que sólo cambiaron la señalización de plazas de minusvalías, que por entonces también estaban mal). Todavía estoy esperando respuesta.</p>

<p>La solución que propuse era, como en otras ciudades, señalizar con una línea amarilla, añadida a la verde o azul, en el suelo donde estacionamos nuestro vehículo. No creo que sea tan caro, digo yo.</p>

<p>De verdad, que si se pretendía un aumento de la recaudación, basada en la confusión y no en la maldad o falta de respeto, lo debieron de conseguir, y a buen seguro que lo seguiran consiguiendo. Yo cada vez que aparco, miro muy bien, porque, repito, no me considero mal ciudadano, pero hay algunos que sí lo deben de ser.</p>

<p>Saludos.</p>
";"10/09/2015 19";"38";"36";"2";"0";"892758425";"3221"
"3297";"Control de trolls";"<p>Hace dos días que se abrió este foro de debate y ha sido inundado por una banda de trolls, como sabemos que eso no es casualidad, sino una estrategia de ciertos sectores que no han sabido digerir la perdida de la alcaldía, propongo que se cree alguna herramienta que controle e identifique a estos saboteadores.</p>
";"10/09/2015 19";"58";"32";"26";"9";"883307199";"331"
"3298";"Recuperar los cines de barrio";"<p>Los cines de los distritos se han ido cerrando, dejando locales vacíos que se convierten en un foco de degradación o se transforman en franquicias comerciales, en el mejor de los casos. Por ejemplo, en Tetúan no hay ni un solo cine en funcionamiento, y esto ocurre en muchos distritos. El Ayuntamiento podría recuperar estos locales para hacer filmotecas de distrito, con programación clásica o alternativa, a precios accesibles, para no perder el patrimonio cultural de nuestra ciudad.</p>
";"10/09/2015 19";"68";"61";"7";"3";"893875440";"4844"
"3299";"Finalizar las obras del Centro Acuático aledaño a la Peineta";"<p>El Centro Acuático aledaño a la Peineta se comenzó a construir con las candidaturas de Madrid Olímpico. Después de no resultar elegida en la última candidatura, las obras se paralizaron y se puede observar como las instalaciones están a medio acabar. Es una pena que después de todo el dinero invertido se echen a perder dichas infraestructuras. Estaría bien que las obras de finalizaran y Madrid pudiera contar con unas nuevas instalaciones para practicar natación.</p>
";"10/09/2015 19";"44";"35";"9";"3";"889700757";"2068"
"3300";"Medidas dirigidas a las Empresas para incentivar el uso de la bicicleta";"<p>La bicicleta como medio de transporte urbano por Madrid puede ser una de las medidas que contribuya a mitigar el problema de la polución medioambiental. No obstante, considero que no sólo es preciso incentivar su uso por parte de los usuarios, es también necesario <strong>concienciar a las empresas que deben adoptar medidas que incentiven su uso por parte de los trabajadores</strong>, especialmente en grandes empresas y en el sector público. Por ejemplo, disponer de duchas, de aparcamientos para bicis, incentivos a los trabajadores... </p>

<p>Entre otras medidas podría darse una distinción que por ejemplo podría denominarse ""Empresa colaboradora con la mejora del medio ambiente"", <strong>""Biking company"", ""Green company""</strong>, o similar, a las empresas que acrediten disponer de los medios necesarios para que los trabajadores puedan desplazarse a su puesto de trabajo usando la bicicleta como medio de transporte.Esta acreditación podría ir acompañada, si así se considera, de algún beneficio fiscal, como descuentos en IBI u otros y podría darse a las empresas que acrediten una proporción de trabajadores superior al 10 por 100 que acuden en bicicleta a su puesto de trabajo.</p>

<p>Creo que es una medida apropiada para los que creemos que para solucionar los problemas es mejor incentivar que prohibir.</p>

<p>Gracias por contribuir a mejorar nuestro medio ambiente.</p>

<p> </p>
";"10/09/2015 20";"56";"37";"19";"1";"886725350";"1189"
"3301";"Eliminación SER fuera de zona centro ";"<p>Buenas tardes, </p>

<p>Abro un debate para la eliminación, fuera de zona centro, del Servicio de Estacionamiento Regulado (más conocido como zona verde/azul). Me parece bien, el fomentar el ir al centro en transporte publico pero en barrios residenciales no se entiende el pago extraordinario.</p>

<p>Muchas gracias por adelantado.</p>

<p>Un saludo.</p>
";"10/09/2015 20";"31";"15";"16";"1";"878398736";"-48"
"3302";"Patios de las escuelas abiertos los domingos y sabados";"<p>En Barcelona ya existe tal política. Con no demasiados medios se puede dar entretenimiento y un lugar de reunión y de cita de los chavales de los barrios. Bastaria con una  o dos personas vigilando esos patios. Posteriormente se podrian organizar todo tipo  de actividades organizadas por las diferentes asociaciones de los propios barrios. Eso si la dinamización deberia ser organizada al menos en sus inicios por el Ayuntamieno a traves de las Juntas Municipales. posterormene podrían ser asociaciones del barrio y cooperativas de gente joven del propio barrio; siempre claro esta con apoyo economico del Ayuntamiento. Habria que estudiar su coste y la disponibilidad presupuestaria, pero no cabe duda que se dinamizaría la participación con todo lo positivo que ello tiene en todos los aspectos.</p>
";"10/09/2015 20";"31";"21";"10";"3";"885717616";"745"
"3303";"Que vuelvan a convocarse pruebas de guía de turismo en Madrid";"<p>Hasta hace unos años era posible obtener (haciendo un extenso examen de por medio) la habilitación para ejercer como guía de turismo en la ciudad.</p>

<p>Las últimas pruebas tuvieron lugar en 2009, fecha a partir de la cual se liberalizó el sector.</p>

<p>Lo que en un principio, podría parecer algo positivo refleja una realidad muy diferente: Las agencias exigen el carnet oficial de guía de turismo (o el permiso de Patrimonio Nacional que dejó de convocarse en 2013) para contratar y se multiplican por la ciudad los grupos guiados por guías amateur, no profesionales que dan una información errónea, incoherente y en ocasiones hasta absurda dejándonos sin un trabajo digno a toda una  generación que realmente lo necesitamos.</p>

<p>Dada la coyuntura económica que estamos pasando, sería de vital importancia  que se convocarán las pruebas de habilitación de guia de turismo en un futuro no muy lejano y se nos permitiera ejercer una profesión de una forma coherente y legal para las que nos hemos formado. (En mi caso tengo licenciatura en Historia del Arte, Master en Bienes Culturales y tres idiomas)</p>

<p>Es injusto que se nos cierren las puertas a una generación muy preparada que podríamos aportar mucho a la empobrecida cultura de este país y se nos aisle sistemáticamente del mercado laboral.</p>

<p> </p>
";"10/09/2015 20";"21";"18";"3";"0";"888540009";"1285"
"3304";"Apertura de bibliotecas municipales los fines de semana";"<p>Para los estudiantes que a la vez de formarnos academicamente, trabajamos. Creo que sería una genial idea habilitar las bibliotecas municipales para que también abran los fines de semana, es el momento de la semana en el que más tiempo libre tenemos la mayoría de los jovenes. Un espacio de estudio como las bibliotecas municipales deberían de ser un espacio abierto todos los días de la semana. No solo estudiamos de Lunes a Viernes.</p>
";"10/09/2015 20";"55";"51";"4";"4";"894055640";"4358"
"3305";"Autobús desde Barajas hasta el Hospital 12 de octubre";"<p>Deberían poner un autobús desde el barrio de Barajas hasta el Hospital 12 de octubre para todos los vecinos de Barajas que tengan que ir al citado hospital. Esta es una reivindicación histórica de los vecinos de Barajas. Actualmente para poder ir de Barajas al Hospital 12 de octubre hay que ir en Metro hasta Begoña y luego andar unos 20 minutos o bien ir en Metro hasta Chamartín o Nuevos Ministerios y luego ir en la Renfe hasta Ramón y Cajal. Además no creo que sea muy costoso y hara un buen servicio a los vecinos de Barajas. Gracias</p>
";"10/09/2015 20";"18";"12";"6";"0";"883819485";"400"
"3306";"Abrir un centro de interpretación del paleolítico en Vicálvaro";"<p>El taller paleolítico de los Ahijones se encuentra en medio de un gran proyecto urbanistico. Representa un ejemplo poco común de la industria paleolítica de al menos 200.000 años. En realidad el yacimiento es mucho mayor que los escasos 80 metros cuadrados que se han estudiado.</p>

<p>Sería posible plantear un centro de interpretación del sílex, cuya extracción ha sido tan importante en la zona desde el paleolítico hasta los muros del Madrid medieval. Además están las tumbas visigodas, los restos árabes, romanos, medievales....</p>

<p>Para el que no lo conozca, Basta poner en google: vicalvaro, paleolítico.. y leer</p>

<p>Un saludo</p>

<p> </p>
";"10/09/2015 20";"31";"24";"7";"0";"888162304";"1316"
"3307";"Uso regulado y vigilado  parcelas  Ayuntamiento ,para evitar mal uso.";"<p>El Ayuntamiento debe de vigilar por la perfecta limpieza, uso y mantenimieto de las parcelas municipales, asi como su vigilancia ,para evitar usos indebidos tales como botellones , carreras de coches, venta de bebidas y comida de forma  ilegal,ruidos, gente orinando en los alrededores...que solo llevan al abandono.Ademas de poner horario de uso.</p>
";"10/09/2015 20";"24";"21";"3";"1";"889718628";"1575"
"3308";"No quiten el SAMUR";"<p>En las últimas semanas estamos viviendo una auténtica ofensiva por parte de la comunidad de Madrid de quedarse con el servicio mejor valorado por los vecinos de Madrid: el SAMUR.</p>

<p>El actual consejero de sanidad de la Comunidad de Madrid ha manifestado públicamente su sueño de unir el SAMUR y el SUMMA de la CAM. Este sueño implicaría pasar SAMUR a la CAM, lo que implicaría su desaparición, dejando de estar a manos del ayuntamiento de Madrid.</p>

<p>Este colectivo se ha ganado el cariño de los ciudadanos de la ciudad de Madrid día a día, atendiendo a los vecinos en sus caídas, enfermedades, atropellos, en el fatídico 11-M o el desgraciado accidente aéreo de spainair.</p>

<p>Disfrazan este intento de quedarse con el servicio más valorado en la coordinación de emergencias, en sueños o hablando de duplicidades que no se producen.</p>

<p>Cuando el SUMMA quiera coordinarse con el resto de servicios de emergencias, que se integre en Madrid- 112, como están el resto.</p>

<p>La ciudad de Madrid necesita una respuesta coordinada y cercana en emergencias, una respuesta municipal que incluya los bomberos, la Policia municipal, la protección civil y el SAMUR, como viene siendo hasta ahora.</p>

<p>Este servicio es así de querido por los ciudadanos y está reconocido a nivel mundial tal y como esta. Si se regala a la CAM, los ciudadanos de Madrid perderemos esta asistencia sanitaria extrahospitalaria tan reconocida internacionalmente.</p>

<p>Intentar integrar SAMUR y SUMMA es un sueño tan irreal como intentar integrar la Policia Municipal con la Guardia Civil.</p>

<p>Protejamos lo nuestro. Protejamos el SAMUR. Sra. Carmena, por favor, no quite el SAMUR.</p>

<p>Diga NO al consejero de sanidad y a la presidente de la CAM.</p>
";"10/09/2015 20";"108";"97";"11";"29";"896415322";"7724"
"3309";"S.E.R ¿tiempo agotado de estacionamiento? ";"<p>Soy trabajador autonomo en el sector profesional de instalaciones térmicas, realizo muchas instalaciones en viviendas y locales. No puedo realizar bien mi trabajo y me obligan a abandonarlo por tener que desplazar mi vehiculo a otra zona de estacionamiento limitado cuando supero las 4 horas de estacionamiento en zona azul o verde. Llevamos mucho tiempo esperando una respuesta directa y efectiva para facilitar las labores a autonomos y pymes, con lo que estariamos muy agradecidos si todo esto fuera más adecuado ya que no nos negamos a pagar a pesar de lo caro que es.. </p>
";"10/09/2015 20";"22";"13";"9";"2";"882546704";"236"
"3310";"Revitalizar Gran Vía";"<p>Es una pena como la Gran Via de MAdrid carece de todo esplendor. Propongo se revitalicen teatros y cines en el llamado Broadway madrileño, que cada vez lo es menos... La iluminacion de los edificios es pobre en la noche y da un aspecto triste y siniestro... en fin una calle actualmente lejos del glamour, la cultura y la oferta que deberia ofrecer MAdrid</p>
";"10/09/2015 20";"39";"31";"8";"1";"889588126";"1828"
"3311";"Recuperar los bulevares (la M-10) para los peatones";"<p>Hasta finales de los años 60, las calles de Marqués de Urquijo, Alberto Aguilera, Carranza y Sagasta eran <strong>bulevares</strong>, es decir, calles con un ancho paseo central (con arbolado, bancos, quioscos y terrazas, y hasta belenes en navidad) y aceras (relativamente) pequeñas, separados por una calzada para circulación rodada (y, entonces, tranvías) en cada sentido. En los años 70, la política de ""todo para el coche"" arrasó esos paseos centrales y dejó solo las aceras laterales. Actualmente, ""los bulevares"", como todavía se conocen popularmente (técnicamente, la M-10) están formados por dos calzadas de cuatro carriles cada una, separados por una ridícula mediana: una verdadera autopista en un entorno de barrio netamente urbano. <strong>Propongo reducir esos cuatro carriles por sentido a solo dos por sentido</strong>, eliminando la restricción existente del carril bus (ya que por él apenas circula la poquísimo frecuente línea 21 y alguna otra en cortos tramos del recorrido) y volviendo a crear un paseo central utilizando los dos carriles ganados a cada lado más la mediana, en total unos 10 m de ancho. <strong>Los entronques de ese recuperado paseo con las glorietas de Ruiz Giménez (""San Bernardo""), Bilbao y Alonso Martínez deben diseñarse para que el peatón disfrute de las fuentes</strong> existentes en las mismas y estas dejen de ser un elemento ornamental pero aislado del público.</p>
";"10/09/2015 20";"57";"51";"6";"3";"893598510";"4026"
"3312";"acceso a cercanías de San Cristóbal para los vecinos de la zona nueva de Rosales";"<p>Los edificios de la zona nueva de Rosales llegan prácticamente hasta la estación de cercanías de San Cristóbal. Sería una forma muy barata de mejorar el transporte público en esa zona dado que la estación de cercanías de villaverde bajo está a más de un kilómetro y los autobuses son insuficientes. Además, supondría comunicar San Cristóbal con esta zona.</p>
";"10/09/2015 20";"16";"14";"2";"2";"888343109";"1050"
"3313";"REGULACIÓN PARQUÍMETROS";"<p>Yo vivo en Madrid, en Cuatro Caminos, y es complicado aparcar con parquímetros y sin parquímetros, a mi me parece bien en calles de ocio, comerciales, etc, pero no en muchas calles, como en la que yo vivo, que solo intentamos aparcar los residentes. Muchos sin tarjeta, puesto que somos clase obrera, nos dan un vehículo de empresa(furgoneta), y cuando llevas doce o mas horas trabajando, deseando llegar a tu casa para ver a tu familia, resulta que no puedes aparcar o si, si pagas su correspondiente ticket. Y ademas, llega el fin de semana, ¡QUE ALEGRÍA¡ pues no¡ resulta que el sábado tampoco te puede venir a ver la familia hasta las tres porque tienen que sacar un recibito, y ademas si se pasan de las cuatro horas se tienen que llevar el coche a otro barrio, jajaja ... que gracia. Y dirás, porque no vienen en transporte publico? pues mira, yo te contesto, resulta que viven en carabanchel, tienen 70 y 67 años, la combinación de metro hasta cuatro caminos es de una hora y cuarto, el autobús mas o menos y el taxi les cobra 33 eurazos, entonces, como comprenderás, se cogen su cochecillo y vienen a ver a sus nietos, si la zona ser se lo permite CLARO..</p>

<p>Pues bien, como se que no van a desaparecer, sólo pido que se regulen, que la hora se reduzca a las 19:00 o 20:00, que los sabados no haya que pagar, y que los que disponemos de vehiculo de renting, que nos da la empresa y no tienen domicilio fiscal en Madrid, tengamos la opcion de emitirnos la tarjeta de residente, sin que sea retribucion en especie, que el seguro este a tu nombre, etc... Vamos, como hace dos años.</p>

<p> </p>

<p>Muchas gracias.</p>
";"10/09/2015 20";"24";"14";"10";"1";"882401316";"233"
"3314";"Parada de cundas en Villa de Vallecas ";"<p>Cada vez que entro a mi barrio por el acceso de la estación de cercanías de Vallecas me parece estar viendo Walking Dead. Personas organizando cundas, y esperando por ellas una constante llegada de drogodependientes. </p>

<p>Solo pido una solución definitiva, no patrullas de la policía que pasan, en ese momento cede el goteo, esperan y al irse la policía volvemos a lo mismo. </p>

<p>Que pena da entrar o llegar a mi barrio y ver siempre la misma imagen... </p>

<p>Menuda primera impresión da, parecemos un barrio decadente, un gueto y eso no lo podemos permitir! </p>
";"10/09/2015 21";"63";"61";"2";"2";"895935017";"5712"
"3315";"construcciones de aparcamientos en altura o soterrados en distrito Villaverde";"<p>Algunos barrios como por ejemplo San Cristóbal no cuentan con ningún aparcamiento para vehículos, ocupando todos la vía pública. En las zonas de los casos antiguos de Villaverde Bajo y Alto tampoco hay. Ello podría aprovecharse para quitar vehículos de las calles y ampliar aceras, con árboles y bancos, mejorando la movilidad sobre todos de personas mayores, personas con carros, personas en silla de rueda. Además, construir aparcamientos supone crear puestos de trabajo. Los precios deberían ser adecuados y no abusivos.</p>
";"10/09/2015 21";"20";"16";"4";"1";"887479738";"960"
"3316";"Acceso a San Chinarro desde Arturo Soria.";"<p>Seria necesario remodelar la conexion peatonal desde Arturo Soria a San Chinarro. Por la acera no cabe un carrito de bebe, ni una silla de ruedas.</p>
";"10/09/2015 21";"16";"12";"4";"0";"885570778";"600"
"3317";"Ampliar las calles con un carril en la que puedan ir las bicis.";"<p>Actualmente, algunas calles tienen el carril derecho para que lo compartan las bicicletas y los coche, a una velocidad de 30 Km/h máximo. Propongo que progresivamente todas las calles con dos o más carriles (que no tengan un carril bici/acera bici paralela) tengan el de la derecha para que compartan las bicicletas y los coches.</p>
";"10/09/2015 21";"42";"29";"13";"4";"887401529";"1104"
"3318";"Que el Ayuntamiento fomente la investigación (becas y proyectos), en futuro";"<p>- Becas de investigación para estudiantes predoctorales y postdoctorales</p>

<p>- Contratos para técnicos</p>

<p>- Priyectos de investigación</p>
";"10/09/2015 21";"41";"33";"8";"0";"890133335";"2012"
"3319";"Limitar la apertura de comercios los domingos y festivos";"<p>Para muchos trabajadores del sector del Comercio, nuestra vida ha cambiado totalmente a partir de la ley llevada a cabo por Esperanza Aguirre que permitió que comercios y grandes superficies abran todos los domingos y festivos durante el gobierno del PP en nuestra Comunidad. A partir de entonces a muchos de nosotros nos es muy difícil  conciliar nuestra vida personal/familiar con nuestro trabajo. No se han creado más puestos de empleo, sino que se ha ampliado un día más los contratos de fines de semana reduciendo el número de horas por día de dichos trabajadores. A quienes trabajamos 30-40 horas semanales se redistribuyó nuestra jornada y nos vimos obligados a firmar una disponibilidad horaria total de L-D incluyendo cualquier horario imaginable si queríamos mantener nuestro empleo. Librar uno o dos días entre semana nos permite disfrutar de nuestras familias/hijos y amigos, ya que la mayoría trabajan de L-V y es difícil verles con turnos partidos/rotivos. Hace años al menos teníamos el domingo para disfrutar de nuestro ocio con la gente gente que queremos. Esta libertad de horarios sólo beneficia a las grandes empresas que disponen de nuestras vidas como si fuerámos juguetes en sus manos, como llevan denunciando varios sindicatos y asociaciones desde hace años. Por favor aunque no sea competecia directa del Ayuntamiento, alguien tiene que negociar con la Comunidad para limitar este abuso. Los trabajadores de Comercio también tenemos derechos. Gracias a todos de antemano por vuestra colaboración.</p>
";"10/09/2015 21";"52";"25";"27";"7";"878938965";"-96"
"3320";"Polideportivo de La Latina";"<p>Propongo volver a construir, en su emplazamiento original, lo que hoy seria el llamado 'Campo de la Cebada', el polideportivo municipal, con su correspondiente piscina, que Gallardon, siendo alcalde, primero cerró y luego, derribó.</p>
";"10/09/2015 21";"25";"22";"3";"0";"890258019";"1672"
"3321";"Renta básica para los colectivos más desfavorecidos";"<p>Como los inmigrantes y los parados sin estudios, ya que son unos de los más afectados por la crisis económica, se podría financiar a través del aumento del IBI a aquellos que sean propietarios de varias viviendas.</p>

<p>Con esta medida se busca finalizar con la especulación y un aumento de la redistribución de la riqueza.</p>

<p>Un saludo.</p>
";"10/09/2015 21";"42";"13";"29";"0";"875284975";"-495"
"3322";"Re-educación ""botellón""";"<p>Sustitución de las actuales y abusivas multas por consumo de alcohol en vía pública por medidas de reeducación, trabajos sociales y servicios a la ciudad.</p>
";"10/09/2015 21";"36";"21";"15";"2";"883775360";"350"
"3323";"Isleta central pro-fauna en Río Manzanares";"<p>Los primeros meses tras inaugurar Madrid Río, las compuertas de las presas del río estuvieron abiertas y el agua serpenteaba por el fondo del cauce, dejando amplias zonas llenas de vegetación, en las que anidaban, descansaban y encontraban alimentos numerosas aves: patos, 3 tipos de gaviotas, pollas de agua, garzas... hasta un martín pescador ví una vez! También se veían tortugas, cangrejos y otros animales. Eran un gran aliciente durante los paseos por la orilla del río.</p>

<p>Desde que se cerraron las compuertas y se estableció la lámina de agua, toda la vegetación ha desaparecido y, con ella, prácticamente todas las aves. Sólo quedan algunos patos en ciertos puentes donde son alimentados por la gente. El río es bonito así también, pero está casi desprovisto de otra vida que no sean los peces.</p>

<p>La propuesta consiste en, excluyendo la zona dedicada al remo, instalar una isleta central todo a lo largo del cauce, con sección triangular, de tal forma que incluso con las compuertas cerradas y el nivel máximo todavía asome la punta por encima del agua, con una anchura aproximada de 1 metro, suficiente para que crezca la vegetación y dar cobijo a las aves. El impacto sobre la sección del cauce en caso de avenidas de agua (muy poco probables hoy en día gracias a la presa del Pardo) sería despreciable.</p>
";"10/09/2015 21";"44";"40";"4";"2";"893267390";"3272"
"3324";"Volver a poner fuentes de agua potable";"<p>Todos hemos conocido fuentes de agua potable para beber en las calles y esquinas, que hacen un servicio público esencial, tanto para los ciudadanos como para los turistas. Además dan muestra de algo tan sencillo y que nos une como ciudadanos y como humanidad: el agua, para todos y de todos. Estas fuentes se conservan en muchas ciudades, como Barcelona, Roma, etc. Y sin embargo, en Madrid, que dispone de la mejor agua de España, no existen, como si dar algo gratis, aunque fuera agua, no fuera de recibo en esta sociedad <em>maravillosa </em>del consumismo donde todo ha de tener un precio. Sin embargo, no olvidemos el dicho aquel de: ""el agua no se le niega ni al enemigo"". Recuperemos pués las fuentes de agua potable.</p>
";"10/09/2015 21";"71";"61";"10";"0";"893739651";"4381"
"3325";"Donación de dietas de trabajadores del SAMUR para ayudas a refugiados";"<p>Considero que este colectivo debe hacer un trabajo basado en el ámbito vocacional y cobra un elevado plus de dietas, que podría ser donadas, dado el espíritu de su trabajo, a las ayudas para la recepción de los refugiados. Gracias</p>
";"10/09/2015 21";"63";"5";"58";"5";"877466610";"-420"
"3326";"Baños públicos en las calles de Madrid";"<p>Es una pena que en nuestra ciudad no contemos con baños públicos en las calles, teniendo que recurrir a los bares más cercanos, o peor, a algún árbol o esquina (con el correspondiente riesgo a una multa de 3.000 euros). Esto, en el mejor de los casos, hace incomodar a los propietarios de los locales y ensucia las calles.</p>

<p>Ciudades como Bilbao cuentan con baños públicos para uso de todo el mundo, algo que ayuda bastante si te surge una urgencia en la calle. Propongo que se construyan unos años para todos en la ciudad, y no los urinarios móviles típicos de fiestas, que tampoco solucionarían mucho.</p>

<p>Muchas gracias a todos</p>
";"10/09/2015 21";"45";"36";"9";"0";"890581652";"2160"
"3327";"La EMT. Un sistema de transporte eficaz, rápido y cercano";"<p>La actual red de autobuses de la EMT es una red radial. Hay que plantear un nuevo modelo de red de autobuses. </p>

<p> </p>

<p>Debe unir barrios entre sí y a la vez comunicarlos con aquellos puntos de referencia de los ciudadanos  (hospitales, centros de salud...)</p>

<p>Por ejemplo en Carabanchel no existe una línea de autobuses que conecten la zona de General Ricardos con el paseo de Extremadura o Principe Pio en el distrito de Latina.</p>
";"10/09/2015 22";"51";"45";"6";"1";"893258250";"3441"
"3328";"Pagar 600 euros por beberte una lata de cerveza en un banco. Apaga y vámonos.";"<p>En primer lugar, soy consciente de la asquerosidad a la que conllevan los botellones. Botellas rotas, plásticos, suelos pegajosos... Nadie de aquí con dos dedos de frente va a durar por un minuto que es normal una sanción económica por ensuciar un espacio público, a menos que fuera un evento preparado por el ayuntamiento o cualquier cosa similar. Ahora bien, de ahí a andar multando porque una persona esté bebiéndose una cervecita en la calle, hay un trecho. Que estamos hablando de que puede provocar la misma suciedad, en el peor de los casos, que una persona bebiéndose un zumo o un agua. </p>

<p>Por eso creo que es oportuno modificar esta <strong><em>LEY 5/2002, de 27 de junio, sobre Drogodependencias y otros Trastornos Adictivos</em></strong> que se encuentra en el TITULO PRELIMINAR - Disposiciones generales. a) Las bebidas alcohólicas de graduación superior a 1 grado porcentual de su volumen subiendo y poniendo como limite 4,5 de grado porcentual para considerarlas como bebidas alcohólicas. </p>

<p>Sin mas dilación creo que es UN ROBO A MANO ARMADA A LA PERSONA QUE SE ENCUENTRA TRANQUILAMENTE SENTADA EN UN BANCO BEBIENDOSE UNA CERVEZA.</p>

<p>Ya que si seguimos leyendo la dicho ley podemos encontrar lo siguiente:</p>

<p><strong>Artículo 59.- </strong><em>De la cuantía de las sanciones </em></p>

<p>1. Las infracciones de la presente Ley se sancionarán con multas cuyas cuantías se regirán de acuerdo a la siguiente graduación: </p>

<p>a) Infracciones leves, con multa desde 300 hasta 30.050 euros.</p>

<p>b) Infracciones graves, con multa desde 30.051 hasta 60.101 euros. </p>

<p>c) Infracciones muy graves, con multa desde 60.102 hasta 601.012 euros.</p>

<p>No hay mayor diferencia. Y yo, como ciudadano cumplidor, me sentiría estafado si recibiese una sanción económica por algo así. Tal sería mi indignación, que me negaría rotundamente a pagarla, y creedme que haría lo que fuera porque esa sanción jamás se viese cumplida. Y esto es, porque las leyes están para preservar el orden en la sociedad, no para andar sablando a la gente por cualquier razón totalmente carente de un componente inmoral.</p>

<p> </p>

<p> </p>
";"10/09/2015 22";"64";"43";"21";"2";"888320173";"1478"
"3329";"Flores ornamentales ";"<p>Quería traer este debate aqui, pues creo que todo es importante. En Madrid existen muchas plzas públicas que los jardineros municipales se afanan en en tener vistosas, sobre todo en el centro de Madrid. Son flores ornamentales que se cambian cada poco para cambiar los colores de los edifcios o plazas que acogen este tipo de plantas.</p>

<p>Cuando estas plantas han hecho su función , su vida en las jardineras puede variar entre un mesy medio o algunas semanas si se han puesto para un acto en concreto, estas se tiran, pues yo lo he visto. </p>

<p>La idea sería ofrecerlas una vez quitadas a otros ayuntamientos de la Comunidad, pequeños sin mucha posibildiad de poder plantas en sus rotondas, como son los de la Sierra Norte que no se puden permitir muchas veces  estos lujos y embellezar sus calles, con un adorno importante y se  ayuda a los pequeños ayuntamientos. </p>
";"10/09/2015 22";"16";"12";"4";"0";"886021189";"600"
"3330";"Crear una red de casas dispuestas a acoger a refugiados Sirios";"<p>Estamos ante una urgencia humanitaria, y a parte de las medidas que se estén pensando desde las instituciones, el propio ayuntamiento podría articular una red de personas/familias que tengan un espacio en el que acoger altruístamente a refugiados Sirios. Es algo muy sencillo y fácil siempre que se encuentre la forma legal y haya intención de hacerlo: simplemente hay que poner a disposición de los ciudadanos la plataforma para que se apunten (número de personas que pueden acoger, tiempo que están dispuestas a acogerlas, etc..) y en cuanto vayan llegando se encontrarán con una ciudad acogedora y hospitalaria, que es lo que es realmente. </p>
";"10/09/2015 22";"51";"23";"28";"1";"876176323";"-225"
"3331";"Que la clasificación de Mejor Valorados sea por mayor porcentaje de SIES";"<p>La clasificación de Mejor Valorados de Decide Madrid se realiza contando sólo el número de SIES de cada propuesta. Esto conduce a absurdos como que la propuesta más valorada sea una que tiene casi tantos NOES como SIES, por tener mucha polémica y muchos votos, además de ser de las más antiguas. Además, ello favorece injustamente a las propuestas iniciales que tienen muchos más votos, de tal forma que todas las propuestas mejor valoradas son las más antiguas. Si se hiciera por porcentaje de SIES respecto de votos totales la clasificación de Mejor Valorados sería mucho más dinámica y daría una oportunidad a las nuevas propuestas.</p>
";"10/09/2015 22";"22";"15";"7";"6";"886034660";"545"
"3332";"Que para poder aparcar en zona verde baste con vivir en Madrid, no por barrios";"<p>Resulta chocante que los vecinos de Madrid, que pagan en Madrid sus impuestos, no puedan aparcar en el barrio de al lado, o si lo hacen que sea en las mismas condiciones que los que vienen de otras localidades. La zona verde, de residentes, debería ser para residentes de toda la ciudad de Madrid, no de un barrio determinado. Es una vergüenza que lleguen con el coche desde todos los municipios de alrededor de Madrid y tengan los mismos derechos que quienes vivimos aquí. No debería haber diferfencias entre los residentes de un barrio y otro.</p>
";"10/09/2015 22";"40";"15";"25";"4";"875618158";"-375"
"3333";"No me parece bien que se paguén una tasa de basuras";"<p>Primero por que se lucran con nuestra basura ¡ q menudo negocio tienes hay!           ssegundo ya casi todos reciclamos y con la falsa esperanza de que lo hacemos por mamá tierra                                                           tercero les hacemos parte de su trabajo y encima pagamos creo q vasta ya de exprimir  y ser justos para todos .                    Un saludo    </p>
";"10/09/2015 22";"68";"48";"20";"1";"889622779";"1976"
"3334";"Latina";"<p>El distrito de Latina, como el resto de Madrid, necesita barrenderos (como hemos tenido toda la vida). Están las calles sucias, cuando se caen las hojas de los arboles (que aún nos quedan en pie) las calles son intransitables y con riesgos de caídas. Hay excrementos de perros en parques, aceras, calles, etc... Creo que es más importante que nos mejoren los servicios a que nos bajen los impuestos. </p>
";"10/09/2015 22";"27";"23";"4";"2";"890410752";"1618"
"3335";"Petición de ola de solidaridad";"<p>Buenas a todos y todas, pues como bien dice el titulo me gustaria pedir tanto al ayuntamiento como a los ciudadanos que nos volquemos con todo lo que podamos con estas personas que lo han perdido todo en la guerra, acojerlos como sea posible y que se sientan como en casa.</p>

<p>Permitirles una buena integracion, ya que en un futuro seran nuestros amigos y quien sabe si nuestras parejas.</p>

<p>Darles una nueva vida y como no compartir nuestras culturas.</p>

<p>Gracias y buenas noches a todos, juntos podemos !</p>
";"10/09/2015 22";"21";"10";"11";"2";"879426585";"-47"
"3337";"Parques verdes ";"<p>vivo en el pasillo verde, mejor llamado marrón. </p>

<p>¿ por qué no hay ningún parque publico con césped y todos tienen tierra sucia?</p>

<p> </p>

<p>no habéis pensado lo que mejoraría el aire, la temperatura, etc con césped. Se puede regar con agua reciclada, con goteo. Si las piscinas privadas y los campos de golf lo tienen, los madrileños lo merecemos</p>
";"10/09/2015 22";"25";"18";"7";"0";"887057494";"792"
"3339";"Monumentos gratis para madrileños";"<p>Si la cultura es algo legislado por derecho y pagamos impuestos, ¿Por qué no se ofrece descuentos sustanciales para los museos y monumentos? ¿Por qué tengo que entrar al Prado a la misma hora que los turistas que son los que deberían pagar más para mantener el patrimonio?</p>

<p>El residente en Madrid tendría que tener derecho a conocer su patrimonio de una forma mucho más accesible para los bolsillos.</p>
";"10/09/2015 23";"35";"25";"10";"0";"887991406";"1071"
"3340";"CUIDADO CON LOS QUE SE VAN A BENEFICIAR DE LA REMUNICIPALIZACION.";"<p>     Cuidado con las personas que, bajo un slogan de dificil oposición moral, pretenden ganar derechos que no les corresponde. Hay trabajadores de contratas privadas seleccionados con criterios empresariales que dicen llevar 20 años explotados para que se les haga fijos en la Administración y ocupando plazas de deberían ser concocadas en oposición libre. De todos los contratados privadas, solo 4 gatos llevan 20 años ( Ya han tenido tiempo de aprobar oposiciones o de mejorar su trabajo) y el resto llevan unos meses o unos años. Si salieran esas plazas a oposición todos tendríamos derecho a obtener una plaza en la Administración y no solo unos pocos.</p>
";"10/09/2015 23";"73";"30";"43";"156";"886997317";"-534"
"3341";"Conexión para bicis Madrid-Río con Anillo Verde por General Ricardos";"<p>Pienso que hace falta una conexión entre esta zona de Carabanchel y Madrid Río ya que ahora mismo no se puede acceder al centro desde esta zona sin entrar en una peligrosa calzada pensada exclusivamente para vehículos a motor, con el añadido de tener unas cuestas bastante importantes que obligan a las bicicletas a ir a 10 km por hora y a los coches a perder los nervios detrás.</p>
";"10/09/2015 23";"68";"55";"13";"3";"892832977";"3397"
"3342";"sanciones a vhos con música alta ";"<p>Vhos que por las noches recorren nuestras calles haciéndonos partícipes de los gustos musicales de sus propietarios deben ser multados por la Policía Municipal, supone un riesgo para la conducción, lesiona el derecho al descanso de los vecinos y es un atentado al buen gusto en la mayoría de los casos.</p>
";"10/09/2015 23";"34";"26";"8";"4";"889540415";"1376"
"3343";"Recuperación Bulevares Chamberi";"<p>Que bonito sería poder pasear por los bulevares desde casi el retiro hasta el parque del oeste tranquilamente sin cientos de coches. Chamber- Centro necesita mas espacios limpios para pasear y disfrutar todos y los bulevares es una magnifica y preciosa opcion, para atravesar madrid este-oeste ya hay unas rondas, no tengamos autopistas en el centro de Madrid, nos merecemos algo mejor.</p>
";"10/09/2015 23";"62";"51";"11";"1";"893021863";"3290"
"3346";"Eliminar cuota de 60/mes a nacidos en 2015 en Escuelas Infantiles Municipales";"<p>Este año se ha aplicado una cuota de 60/mes a los nacidos en 2015 matriculados en Escuelas Infantiles Municipales de la Comunidad de Madrid, lo que supone un aumento considerable en la tarifa mensual de estos centros. Mi propuesta es suprimir esta tasa de 60 de forma que los padres sólo corramos con los gastos de escolarización (que depende de la renta familiar) y de comedor.</p>
";"11/09/2015 00";"21";"11";"10";"0";"880000239";"52"
"3347";"Nuevos equipamientos deportivos en el Parque de las Avenidas";"<p>En la Avenida de la Guindalera hay dos grandes solares desde ""siempre"". Desconozco si la titularidad es municipal o privada, pero sería conveniente dotar esta zona con equipamientos deportivos como una piscina ya que solo existe una opción privada, la Fundación Santiago Apóstol, donde se segrega la zona de baño por sexos.</p>
";"11/09/2015 00";"33";"26";"7";"3";"890285471";"1496"
"3348";"Establecer un porcentaje de impuestos dependiendo de la renta (Leer explicación)";"<p>No veo justo que una persona que cobra 10000 euros pague lo mismo en impuestos que una persona que cobra 600.</p>

<p>Por supuesto deberia ser completamente supervisado y dependiente de la situación de cada uno, ademas de una reparticion justa y proporcional.</p>

<p>Pero por poner un ejemplo, una familia de cuatro, trabajando ambos padres que cobren en total 50000 euros al año no se sostiene para nada igual que esa misma familia con una renta total de 20000. </p>

<p>Por ello pido que se regularice aunque no por ello pido que los ricos sean pobres, sino un porcentaje justo y proporcional.</p>
";"11/09/2015 00";"28";"5";"23";"5";"877533602";"-321"
"3350";"Línea de autobús de EMT de La Elipa a Fuente de la Mora por la calle Torrelaguna";"<p>Propongo una línea de autobuses que empiece en La Elipa, pase por Avenida de Hnos García Noblejas, cruce la calle Alcalá por Pueblo Nuevo, suba desde el Polideportivo de la Concepción, que recorra toda la Calle de Torrelaguna hasta San Juan Bautista y una vez llegue a Arturo Soria, en la actual cabecera de la línea 53, girar a la izquierda hacia la calle de Arturo Soria y una vez allí, seguir hasta que termine en la estación de Renfe y Metro Ligero de Fuente de la Mora.</p>

<p> </p>

<p>Otra propuesta que ya leí a otro ciudadano hace ya unos meses en otra web de propuestas, fue la de ampliar la línea 74, que actualmente acaba en Parque de las Avenidas, también hasta Arturo Soria, pero a la altura de Condesa de Venadito.</p>
";"11/09/2015 00";"21";"12";"9";"1";"883026162";"171"
"3351";"Elección de empleo público, por oposición o concurso";"<p>Sistema de elección de personal o cargo público, por capacidad, oposición, baremación o concurso entre los que estén capacitados para dicho puesto y lo soliciten, ya sea por titulación o experiencia, no cayendo en el enchufe o dedazo directo</p>
";"11/09/2015 00";"22";"15";"7";"0";"886302357";"545"
"3352";"Acceso directo de Villa de Vallecas al Hospital Infanta Leonor por la vía.";"<p>Solicito la apertura de un puente o un paso para acceder al Hospital Infanta Leonor desde el barrio La Uva de Vallecas. </p>

<p>La distacia del hospital al dicho barrio no es mayor de 100 metros, sin embargo los habitantes de Vallecas han de dar un rodeo de varios kilometros para acceder al hospital incluso cogiendo dos autobuses por falta de un simple tunel o paso elevado que atraviese las vias del tren y que facilite el acceso a peatones y automoviles.</p>
";"11/09/2015 00";"53";"45";"8";"0";"893517613";"3141"
"3353";"Blablacar urbano (con la comodidad y rapidez del taxi, pero a precio de autobús)";"<p><em><strong>Necesitamos un Blablacar urbano, para los viajes de cada día.</strong></em></p>

<p>Sales a la calle principal de tu barrio y señalas en una applicación de tu móvil a donde quieres ir. Un sistema detecta que a uno de tus vecinos (que está yendo a trabajar en su coche y tiene asientos libres) le pilla de paso llevarte. La app de su móvil le dice donde puede parar para recogerte. Se van recogiendo varias personas, hasta completar las plazas del coche. La app. del conductor le va señalando donde debe parar, para ir dejando a los pasajeros que ha recogido, mientras sigue de camino hacia su propio destino. El sistema va repartiendo los gastos del coche (unos 25 céntimos de  por cada kilómetro) entre el número de personas que lleva en cada tramo del viaje (el conductor no gana dinero, sino que ahorra buena parte de los gastos que pagaría si fuera él solo en el coche). Cuando un pasajero baja del coche, su app le dice cuanto dinero le costó el viaje, y lo transfiere de su cuenta a la del conductor. Cuando el conducto llega a su destino, su app le dice cuanto dinero ha recuperado, gracias a los pasajeros que ha llevado.</p>

<p><strong><em>Tiene ventajas para todos:</em></strong> Un prototipo indica que en un coche con 4 pasajeros, el conductor y todos ellos pueden ahorrar hasta un 75% de los gastos que tendrían, si fuera cada uno con su propio coche (más de 200 al més, si trabajas o estudias a 20 Km de donde vivies). Solo uno tiene que aparcar. Unos tres millones de madrileños viajan cada día en transporte público. Los que tardan una hora, ganarán comodidad y ahorrarán tiempo de viaje. No habrá atascos de tráfico en hora punta (en Madrid hay un millon de viajes en coche al día, y muchos solo llevan al conductor). Menos contaminación (no harán falta prohibiciones ni restricciones de tráfico). Ahorro de combustible (en España lo tenemos que importar, y nos hunde la economía). Quedará petroleo para nuestros biznietos. Menos gases de efecto invernadero, que pueden provocar un cambio climático.</p>

<p>Es un sistema recien patentado. <em><strong>¿Nos ayudas a ponerlo en marcha?</strong></em></p>

<p>¿Tú lo usarías? ¿Cómo conductor o cómo pasajero? ¿Cómo se podría mejorar?</p>
";"11/09/2015 00";"46";"23";"23";"28";"884418083";"0"
"3354";"Los barrios sin ley (Dias de fútbol en el Vicente Calderon)";"<p>Como vecino desde hace 10 años, el vivir en las cercanias del estadio Vicente Calderon es un verdadero calvario los días de partido. La dejacion de los anteriores gobiernos municipales propiciaban y desgraciadamente esta temporada que acaba de empezar continua asi, que los aficionados de los clubes visitantes y del propio Atletico de Madrid, perturben la habitabilidad de ni mas ni menos que de 3 distritos con sus correspondientes barrios (Imperial,San Isidro,Los Carmenes). ¿ Que sucede? :</p>

<p>- En el barrio de Los Carmenes; Paseo Ermita del Santo. En esta calle y en sus inmediaciones, el comienzo de la Via Carpetana se transforma en una plataforma reservada al aparcamiento de autocares de los aficionados que acuden al futbol, sin permitir aparcar a residentes, y con la amenaza de multa siempre latente y de grua. Además una señalización con rotulador negro borroso ""avisa"" de próximos eventos con una pésima ortografía , como ya digo a rotuldador en una señal. Por otro lado el parque totalmente peatonal que une el Paseo Ermita del Santo con la calle Sepulveda, se convierte en parking improvisado, ahora para particulares, cuando en cualquier otro dia esos vehículos serían totalmente sancionados, , ademas de encontrarte en aceras y en las marquesinas de autobuses coches aparcados con total permisividad de la policia municipal. A eso sumenle las alteraciones de las lineas 17 y 25 que algun dia han tenido que ser desviadas, por no hablar de sus frecuencias, (y esta zona precisamentre no se caracteriza por tener mas opciones de transporte público).</p>

<p>-Imperial, aqui el epicentro. Al margen de los problemas de movilidad, y de retenciones en los autobuses 17,36,50,62,41, sumamos que el parque entre la calle San Alejandro y Melancolicos se convierte en un botellodromo autorizado, también bajo impasividad de agentes municipales. Aqui es habitual encontrar restos de botellas, gente bebiendo en el citado parque, orinando en la calle a eso de las 8 de la tarde y un largo etc. Todo permitido. En la zona centro ese tipo de comportamientos, o incluso en cualquier otra de Madrid, la multa sería inminente , ¿No?</p>

<p>-Carabanchel; aparcar en el mismo  parque destinado a uso peatronal entorno al Paseo 15 de Mayo-Ermita del Santo, es lo habitual en los días de partido, tambien que transeuntes que se dirigen al partido que se celebra en el V. Calderon utilizen el Puente elevado de la M30 que une Piramides con Marqués de Vadillo, exclusivamente para coches, es también muy comun. No pasa absolutamente nada</p>

<p> </p>

<p>Desde aquí insto al Ayuntamiento, que de una vez tome cartas en el asunto, que lo que no este permitido en un rincon de Madrid, lo este en otro, porque haya un evento de cualquier indole,  que se hagan respetar las normas, pues no creo que los citados comportamientos sean lógicos, ni normales por mucho fútbol que haya de por medio.</p>
";"11/09/2015 00";"57";"44";"13";"8";"892123630";"2392"
"3355";"PROHIBIR INCORPORAR LA PUBLICIDAD FLYERS EN LOS AUTOMÓVILES";"<p>PROHIBIR INCORPORAR LA PUBLICIDAD FLYERS EN LOS AUTOMÓVILES</p>

<p>Eliminar la publicidad en los limpiaparabrisas de los coches.</p>
";"11/09/2015 00";"38";"30";"8";"2";"891067575";"1736"
"3356";"¿que hacer con el aceite usado de las casas?";"<p>¿por que en Madrid no hay contenedores o algun sistema para poder recoger el aceite usado que tenemos en las casas? yo en Alcalá de Henares he visto contenedores apropiados para esta recogida. es bueno y necesario ademas se le puede dar un uso para biocombustible aparte de lo que supone no contaminar el medio ambiente.....</p>
";"11/09/2015 00";"40";"35";"5";"0";"893311781";"2625"
"3357";"53.000 votos positivos para que nos hagan caso...";"<p>http://www.20minutos.es/noticia/2552951/0/ayuntamiento-madrid/consultas-ciudadanas/vinculantes-referendum/</p>

<p>Pablo Soto, en qué año de legislatura estimas que se pueda alcanzar esa cifra? </p>

<p>Soy un usuario activo de esta página desde que se abrió.</p>

<p>Y la lectura de esa noticia ha sido un jarro de agua fría. Bastante desmotivadora. Ahora mismo no vamos a ningún lado. Esta web parece creada para que nos desfoguemos y para que parezca que podemos aportar algo. Cómo vamos a llegar a 53000 votos positivos????? Siento que estoy perdiendo el tiempo. Es más, ni siquiera estoy empadronado en Madrid capital, así que NO puedo proponer nada...</p>

<p>Se están aportando ideas muy interesantes en este foro. Y se van a perder.  Solo espero que algunos de los pueden decidir algo nos lean y tomen nota de las propuestas de la gente. </p>
";"11/09/2015 00";"28";"20";"8";"7";"888606698";"857"
"3358";"Terrazas de Bares y Restaurantes";"<p>Que se regule los horarios de los las terrazas en vias publicas, para que los vecinos podamas descansar, hay 5000 terrazas en Madrid, antes de 2012 en 1500, cualquiera que pida una terraza se la dan, sin importar el descanso de los vecinos, hay terrazas hasta en invierno, cosa que es solo para recaudar, se puede entender que la gente busque en verano salir a tomar algo, pero en invierno no es normal, solo para recaudar, Madrid en una de las ciudades con mas ruido, empezemos a cambiar esto, y que se limiten las terrazas, gracias</p>

<p> </p>

<p> </p>
";"11/09/2015 00";"56";"46";"10";"5";"893335292";"2957"
"3359";"Puerta del sol- No apta para mayores";"<p>Es incomprensible que un lugar tan emblemático no tenga en toda la Puerta del Sol bancos para sentarse.Vemos a diario turistas y vecinos sentados como pueden alrededor de una fuente que nunca entendí se rodeó con una barandilla terminada en pinchos. ¿se queria evitar que se sentaran? . Que alguien me explique por qué no hay bancos púbicos para sentarse y pediria que se sustituya esa barandilla en la fuente.</p>
";"11/09/2015 00";"42";"35";"7";"2";"892547708";"2333"
"3360";"AUTONOMOS y PARQUÍMETROS - ABONO O PRECIO ESPECI";"<p>Médicos, fisioterapeutas, enfermeros, fontaneros, electricistas y otros profesionales de visita autónomos deben pagar parquímetro ya sea en zona azul o verde (siendo este carísimo) y que tras todas las visitas diarias a domicilios puede suponer un gasto muy importante y un perjuicio para los propios visitados. Creo que sería una buena iniciativa para beneficiar al autónomo que se le proporcionase algún tipo de abono mensual de parquímetro o bajada de precio. ¿Qué os parece?</p>
";"11/09/2015 01";"24";"12";"12";"4";"880455521";"0"
"3361";"Multa a los pedorros en el transporte público.";"<p>Empiezo este debate porque desde que yo era pequeña y tengo uso de razón siempre vi fumar en los andenes del metro, por lo que en el metro olía a tabaco. Pero señores y señoras, desde que prohibieron fumar en el metro cuando se monta o llega a las estaciones (sobre todo en verano), huele a sobaco. Y en ocasiones, se me ha dado el caso, estar en un vagón y de repente notar un intenso olor a pedo.</p>

<p>Mi propuesta es que multen severamente a los pedorros y a los que cuidan poco su higiene personal, esto, o que por favor permitan volver a fumar (urgentemente) en el metro de esta nuestra ciudad.</p>

<p>Gracias. Y espero que mi propuesta no caiga en saco roto.</p>
";"11/09/2015 01";"30";"14";"16";"2";"879612457";"-93"
"3362";"N° teléfono 010 del ayuntamiento y 902...";"<p>Eliminar el coste que tiene para el ciudadano que llama pidiendo información al ayuntamiento al número telefónico 010.</p>

<p>Eliminar también los números de teléfono que empiecen por 901, 902, 807, etcétera. Que son teléfonos que suponen un coste para el que realiza la llamada. Y esto no debería ser asi, ya que la persona que realiza una llamada, aparte de que ya la está pagando mediante su factura mensual de su compañia telefónica , está evitando tener que acudir hasta una institución pública solo para informarse o realizar un trámite sencillo, obviando lo lejos que le puede quedar desde su casa, y evitando saturación, grandes colas y esperas en esas instituciones, contaminación de la ciudad dependiendo del vehículo que haya cogido, etc, etc.</p>

<p>Además si fueran gratis, la gente llamaría más para pedir información, y el ayuntamiento necesitaría mas telefonistas con lo cual daría más empleos.</p>

<p>Sólo veo ventajas.</p>

<p>Esta medida también debería hacerse a nivel estatal, evitando abusos de las multinacionales con sus clientes que ya pagan por sus servicios, y encima les cobran las llamadas porque te obligan a hacer todas las gestiones por teléfono hoy en día.</p>
";"11/09/2015 01";"53";"48";"5";"1";"895409581";"3894"
"3363";"Parque para rinocerontes.";"<p>Tengo una amiga, llamada Purita Volquetes, que tiene un rinoceronte, llamado Oneverio, por mascota y mi pobre se ve en grandes dificultades para sacar a pasear a su querido rinoceronte ya que  no tiene un parque para este tipo de animales.</p>

<p>Cuando sale a la calle la gente se asusta por el gran tamaño del animal en cuestión, y sin mencionar el tamaño de las cagadas que echa semejante animal. Tiene que llevar un cubo de basura e norma y una pala para su recogida.</p>

<p>Si mi amiga tuviese un parque en el cual se pudiesen pasear todo de animales, desde pulgas hasta gorilas, mi amiga no se vería obligada a recoger semejantes cagadas y a no poder casi pasear al animal. Es muy bueno para este tipo de animales pasear.</p>

<p>Además, así crearemos más puestos de trabajo.</p>

<p>Gracias. Espero su participación.</p>

<p>Saludos,</p>

<p>Filomena Tablones.</p>
";"11/09/2015 01";"53";"13";"40";"1";"877123218";"-662"
"3365";"Multas a bancos y propietarios en general con numerosos pisos cerrados";"<p>Multas o una enorme subida de impuestos por especular. Yo empezaría por los bancos y ver su repercusión.</p>
";"11/09/2015 01";"58";"35";"23";"3";"887397022";"724"
"3368";"Puntos de recarga de coches eléctricos con paneles solares";"<p>Implantar más puntos de recargas por toda la ciudad y que éstos tengan una placa solar en su parte superior como los de las máquinas de cobro de aparcamiento de zona azul y verde.</p>

<p>Se obtendría de esta manera una energía totalmente o parcialmente más limpia, ya que no se necesitaría la energía eléctrica contaminante.</p>

<p>Ahorro económico del ayuntamiento en electricidad.</p>
";"11/09/2015 02";"35";"32";"3";"2";"894285130";"2651"
"3369";"Prohibir a los autobuses de ALSA ";"<p>Me gustaría debatir, si se les debe PROHIBIR a los autobuses de la empresa ALSA, la utilización de la rotonda de la M-22 a la altura del km 12 de la A2, sentido Madrid, ya que debido a la intensa rotación de todas las líneas que utilizan esa rotonda ( 224 - 224A - 226 - 261 - 281 - 282 - 283 - 284 ) RALENTIZAN y en muchas ocasiones COLAPSAN, sin mencionar el altísimo número de accidentes que provocan y los muertos que se pueden contabilizar indirectamente, por accidente por este motivo.</p>

<p>Yo  pienso que se les debería de PROHIBIR la entrada a esa rotonda absurda que hacen y realizar la parada como lo hacían antes, cuando no provocaban retenciones, NI colapso, NI accidentes, NI muertes.</p>
";"11/09/2015 02";"24";"6";"18";"3";"878024291";"-300"
"3370";"Transporte respetuoso con el medio ambiente";"<p>Madrid es una ciudad que cuenta un gran servicio de transporte público, metro, autobús, taxis, etc. Por ello debido a los altos niveles de contaminación estos medios deberían funcionar mediante sistemas de propulsión de origen no fósil, es decir, respetuosos con el medio ambiente, a ser posible vehículos eléctricos no contaminantes no solo a nivel del aire sino también acústico.</p>

<p>En definitiva más transporté eléctrico, no sólo público sino que se extienda también a los usuarios privados mediante incentivos.</p>
";"11/09/2015 02";"60";"54";"6";"2";"896056282";"4320"
"3371";"Antiguos pueblos reconvertidos en barrios y distritos";"<p>Creo que después del mal que supuso la anexión forzosa de 13 municipios a Madrid (Vicálvaro, Vallecas, Barajas, Chamartín de la Rosa, Fuencarral, El Pardo, Villaverde, Canillejas, Hortaleza, Canillas, los Carabancheles y Aravaca) en los años 50, el Ayuntamiento de Madrid debería hacer más por recuperar la historia y el patrimonio de estos antiguos pueblos, que en muchos casos aún conservan cascos históricos interesantes.</p>
";"11/09/2015 02";"61";"47";"14";"2";"892683685";"2542"
"3372";"Denunciar a los cerrajeros ";"<p>Buenas mañanas, tardes o noches, estimados vecinos:</p>

<p>Alguna vez seguro que te has fijado, y si no es el caso, ahora lo harás: </p>

<p>es despreciable como está todo Madrid con las famosas pegatinitas de ""Cerrajero 24 horas"" 6XX 123 123, en color verde, rojo, azul, etc, os invito a deteneros a mirar todos los bajos de los cierres comerciales, los alrededores de los portales, las papeleras de publicidad, etc, cantidad de elementos, llenos de las dichosas pegatinas.</p>

<p>Por un lado vamos a saco a por un grafitero que realiza una pintada y por otro lado permitimos que nos llenen Madrid, de pegatinitas de cerrajeros, pérmitanme , no lo entiendo.</p>

<p>Quiero dejar bien claro que no tengo nada en contra de la profesión de los cerrajeros, ni tampoco quiero fastidiarles su trabajo, pero no se debe permitir ensuciar Madrid ""gratuitamente"".  </p>
";"11/09/2015 02";"65";"60";"5";"4";"897099441";"5076"
"3373";"Basta ya de demagogia, pancarta ";"<p>Para quién la pancarta de bienvenidos inmigrantes ?, para los medios de comunicación. Para ir de buenos. Por que no dais permiso de trabajo a los inmigrantes latinos, hermanos de lengua y cultura ?, y les hacéis esperar 3 años para tener permiso de trabajo. A los sirios, pobres, ... les acogeis sin haber siquiera llegado, y os molestaís tanto que hacéis pancartas/pantomimas. Ya llegarán, si. Los hispanoamericanos los tenemos aquí, y les ignorais, les despreciais ... dónde está la justicia ???</p>
";"11/09/2015 02";"43";"23";"20";"2";"884038814";"160"
"3374";"Distritos con mayor autonomía ";"<p>Propongo que los distintos distritos de Madrid tengan una mayor autonomía de decisión en temas que los afectan directamente, así como la elección por parte de los ciudadanos del representare de nuestro distrito. </p>

<p>Queremos elegir a nuestros concejales del distrito.</p>
";"11/09/2015 03";"22";"17";"5";"0";"889618801";"927"
"3375";"SER Tarjeta Residente de Empresa (para trabajadores en zona)";"<p>Actualmente solo se concede la tarjeta de residente, a la persona que está empadronada en una determinada vivienda de la zona SER de Madrid,</p>

<p>¿pero que pasa con el que viene de fuera a trabajar y realmente reside durante 8/12 horas todos los días de lunes a viernes, e incluso algunos más que los propios empadronados?  </p>

<p>Actualmente muchísimas empresas ya salieron del casco de Madrid, para irse a Polígonos Industriales, no se podría crear la tarjeta de Residente de Empresa, es decir dotar a las empresas/negocios un número limitado de tarjetas para poder estacionar durante la jornada laboral, ¿que os parece?</p>

<p> </p>
";"11/09/2015 03";"33";"13";"20";"2";"878045807";"-275"
"3376";"Contratación de un equipo de la justicia";"<p>para Madrid. Es decir, por ejemplo: Tenemos Guardia Civil, Local y Nacionales... por poner un ejemplo pero a veces están tan atareados que no consiguen hacer bien del todo su trabajo, por lo que recomendaría contratar a las siguientes personas para tal tarea, evidentemente, en orden ascendente de precios según importancia y rudeza:</p>

<p> </p>

<p>- 700  / mes = Antman</p>

<p>- 850  / mes = Hulk</p>

<p>- 1250 / mes = las Supernenas</p>

<p>- 1400  /mes = Bob Esponja (viene Calamardo en el pack).</p>

<p>- 1800 / mes = Harry Potter</p>

<p>- 2200 /mes = Shrek y Asno (Fiona y Gato con botas se añaden con un Pack especial ""Felices para siempre""</p>

<p>- 2400 /mes = Homer Simpson</p>

<p>- 3500 /mes= Spiderman... cuidado, que tiene el síndrome de Spiderman... ya sabéis.</p>

<p>- 3550 /mes= Batman</p>

<p>- 3640 /mes = Máquina de guerra</p>

<p>- 4000/mes = Hulka (no destroza tanto como Hulk, de ahí la diferencia de salario)</p>

<p>- 4900 /mes = Capitán América (por el hecho de que valoramos más la bandera ajena que la nuestra propia)</p>

<p>- 5500 /mes = Ruiz Mateos vestido de Súperman</p>

<p>- 6000 /mes = Lobezno</p>

<p>- 9000 /mes = Antorcha humana (además sirve para calentar las piscinas en inviegno)</p>

<p>- 10000 / mes = Ash Ketchum de Pueblo Paleta (nunca envejece y su Pikachu es el más fuerte de todos los Pokémon).</p>

<p>- 1.000.000  /año =Tony Stark y Iron Man</p>

<p> </p>
";"11/09/2015 03";"14";"3";"11";"0";"879438340";"-171"
"3377";"Multas ""efectivas"" a peatones por cruzar indebidamente";"<p>Buenas, </p>

<p>cuando voy con mi coche circulando por Madrid, si rebaso un semáforo en rojo, o realizo un giro prohibido pisando una línea continua, me denuncian,</p>

<p>¿porqúe cuando cruzo indebidamente como peatón y delante de la policia municipal / agentes de movilidad, no me denuncian?</p>

<p>*Con evitar un atropello estoy conforme.</p>

<p> </p>

<p> </p>

<p> </p>
";"11/09/2015 03";"86";"45";"41";"7";"885314821";"209"
"3378";"Edificio plaza de España ";"<p>El icono edificio de la plaza de España no es de gran importancia arquitectónica, pero si simbólica para la ciudad de Madrid. Debemos impedir a toda costa que se desmonté su fachada por que lo más probable es que no se vuelva reconstruir de nuevo. Otros ejemplos son el desastroso derribo del interior de la antigua sede del banco Banesto que no ha gozado de toda impunidad por parte de los causantes.</p>

<p> No a la desmantelacion de los edificios. Mayor control por parte del ayuntamiento.</p>
";"11/09/2015 03";"70";"54";"16";"10";"893897305";"2931"
"3379";"Denuncia por coeficiente";"<p>Vecinos,</p>

<p>propongo que las denuncias tengan un importe fijo según la infracción cometida, más un importe-porcentaje variable, según última declaración de la renta del infractor o de la unidad familiar a la que pertenezca el infractor, en el caso de no realizar declaración.</p>

<p>- Si a mí me denuncian por aparcar indebidamente con 90 euros, teniendo un salario mensual de 900 me supone el 10% de mis ingresos, y me hacen la puñeta del mes, pero si mis ingresos fueran de 6.000 euros mensuales, me importan tres narices los 90 euros y tendría la libertad de cometer infracciones según me pareciera, y así pasa.</p>

<p>Por eso os planteo esta propuesta de debate....</p>

<p>muchos habeís pensado en los coches de empresa, no hay problema: multas astronómicas para evitar la no identificación del conductor, y dinerito para la saca del Ayuntamiento para servicios sociales, es decir para todos.</p>

<p> </p>
";"11/09/2015 03";"40";"19";"21";"1";"880371303";"-95"
"3380";"Ascensor Estación Cercanías de Aluche";"<p>Estimados vecinos,</p>

<p>empiezo este debate, ya que opino que no es de recibo que en el año 2.015 y sin saber la afluencia diaria de viajeros que puede tener y después de haberlo solicitado a Renfe hace más de cuatro años, siga sin tener un ascensor la estación de Renfe de Cercanías de Aluche, limitando a toda persona en silla de ruedas, carritos de bebes, etc la utilización de la mencionada estación por omitir un ascensor.</p>

<p> </p>
";"11/09/2015 04";"27";"25";"2";"1";"894337396";"2129"
"3381";"CAMBIAR MADRID";"<p>La forma de cambiar esta ciudad no viene de otro lugar que de la inversión. La colaboración público PRIVADA es esencial para que Madrid avance.</p>

<p> </p>

<p>Tras cerrar proyectos como el solar del CICCM o rematar actuaciones como el eje prado recoletos, veo NECESARIO el cerrar proyectos como Op Chamartín, Campamento, Canalejas y Plaza España. </p>

<p> </p>

<p>Dejemonos del tópico de pelotazos urbanísticos y avancemos para mantener la tercera posición de capital europea e intentemos avanzar para escalar puestos y crear unas zonas financieras que tanta falta hacen para centralizar las sedes multinacionales españolas en lugares que merecen.</p>

<p> </p>

<p>Creemos más zonas verdes, controlando la deuda pero no congelando la inversión.</p>

<p> </p>

<p>Terminemos de rematar ese madrid del S XXI y démosle a la capital el skyline y los proyectos que se merece, solo así el turismo de calidad será referente y solo así las inversiones, las empresas y el empleo volverán a la ciudad.</p>
";"11/09/2015 04";"22";"15";"7";"0";"887986825";"545"
"3382";"Regularizar la situación de los músicos en Madrid";"<p>Estipular un salario mínimo - cotizar en la seguridad social - tener derecho al paro u otro subsidio - incentivar a los locales a contratar músicos y no ponerles pegas. Seguramente muchísimas más ideas que se pueden aportar.</p>

<p>Es inadmisible que en una capital europea los músicos trabajemos en negro y además cobrando miseria, muchas veces teniendo que luchar contra los dueños de los locales, restaurantes, etc... para que nos paguen. Nuestro trabajo es como otro cualquiera y tenemos derecho a tener un sueldo digno, un contrato y una seguridad (aunque sea mínima) para mantener a nuestras familias. Tampoco es coherente que se pongan tantas pegas para que haya música en directo, la mayor parte de las veces no se sobrepasan los decibelios y no se molesta a nadie.</p>

<p> </p>

<p>muchas gracias por favor ayuden a que Madrid sea una ciudad más culta, nos ira mejor a todos</p>
";"11/09/2015 04";"45";"36";"9";"6";"893674370";"2160"
"3384";"Calle o PLaza a la ciudad San Agustín de Florida";"<p> San Agustín de Florida es la primera ciudad fundada por europeos en lo que actualmente son los E.E.U.U.</p>

<p>La fundó en 1565 Pedro Menédez de Avilés, mucho antes que los primeros colonos ingleses llegaran a Massachusetts en 1620.</p>

<p>Florida fue parte de España hasta 1821, con algún periodo intermedio de posesion inglesa.</p>

<p>Un reconocimiento a esa ciudad y a quien la fundó.</p>
";"11/09/2015 07";"25";"20";"5";"1";"892710949";"1200"
"3385";"Cetrería para el control de palomas";"<p>Existen algunas parejas de halcón peregrino en la ciudad pero no dan abasto para controlar a tanta paloma.</p>

<p>Propongo que se autorice a los cetreros a usar sus halcones en parque publicos tales como El Retiro, Juan Carlos I, Templo de Debot,..., en determinados dias, horas y lugares para que mantengan a raya a las palomas.</p>
";"11/09/2015 07";"50";"36";"14";"10";"893363717";"1584"
"3386";"Que el ayuntamiento use el patrón oro";"<p>Que el ayuntamiento abandone el  aceptando en sus transacciones sólo oro.</p>

<p>Si esto no es factible ahora mismo por lo menos que empieze a transformar sus revervas de  a kg de oro en el Banco de España</p>

<p>El dinero FIAT es la causa de nuestra ruida y la de muchos.</p>
";"11/09/2015 07";"46";"14";"32";"4";"879418742";"-547"
"3387";"QUE LOS OKUPAS REALICEN LABORES DE LIMPIEZA DE CALLES";"<p>Como no pagan hipoteca, como el resto de ciudadanos, deberían colaborar en la limpieza de las calles.</p>
";"11/09/2015 08";"63";"52";"11";"6";"896875437";"3384"
"3388";"Ningún sin techo durmiendo en la calle en noches de mucho frío";"<p>Todos queremos tener un techo y unas paredes para protegernos, y de lógica es que no queramos estar nunca durmiendo en la calle y no deseemos que nadie lo haga. Pero ya que por diversas circunstancias eso ocurre, que por lo menos las noches de mucho frío no permitan por ley que ninguna persona humana tenga la posibilidad de contraer ninguna enfermedad relacionada con el frío y mucho menos morir por el mismo como sucede todos los inviernos.</p>

<p>Por favor, que no se permita que nadie duerma en la calle las noches de mucho frío, pero no bajo multa, sino como obligación humana.</p>
";"11/09/2015 08";"43";"35";"8";"3";"895173457";"2197"
"3389";"Concejales que nos representan";"<p>Hay cierta persona en ese Ayuntamiento que a todos nos avergüenza cada vez que aparece en televisión y lo hace a diario. ¿No hay forma de despedirla? Se trata de la ""asalta capillas"". Algunos la llaman de otra forma más grotesca, que podéis suponer. Creo que tenemos derecho a protestar por las personas indeseables y pedir que se vaya.</p>
";"11/09/2015 08";"50";"27";"23";"18";"888472629";"216"
"3390";"Operación Calderón";"<p>En el caso de que se decida continuar con la operación Vicente Calderón/Mahou, ""<strong>No"" </strong>permitir la construcción de los dos rascacielos en los terrenos del campo de fútbol y crear en ellos un gran parque.</p>
";"11/09/2015 08";"42";"18";"24";"1";"880177186";"-257"
"3391";"Niños y no tan niños tocando las narices en los parques.";"<p>Me gustaría que alguien pudiera ayudarme. Vivo en un piso que da a un pequeño parque el cual todas las tardes se convierte en el campo de futbol oficial de la zona, con niños dando unos balonazos y unos gritos que ni en el Calderón (los niños y sus padres que les arengan), molestando a los vecinos que tenemos que trabajar o que queremos descansar. Además, juegan con una fuerza que ni en la final de Copa, dando unos balonazos que de vez en cuando salen a la calle dando golpes a los coches. Pero lo peor ya no es eso, que grave es que los padres les consientan molestar a la gente con esa algarabía. Lo peor es que encima por la noche, a eso de las 23:00/0:00, llegna chavales a continuar molestando con el mismo juego. Es un ruido constante desde las 17:00 hasta la 1:00 como poco. Ayer jueves a las 0:00 oigo a un niño decir a unos chavales que a ver si empezaban el partido, a dios gracias, llamé a la policia y en poco rato vinieron y les echaron. Ya les llamé para darles las gracias, pero lo hago aquí publicamente.</p>

<p>Mi pregunta es, ¿qué es lo que hay que hacer para prohibir que jueguen al fútbol en zonas que no están habilitadas para ello?</p>
";"11/09/2015 08";"32";"22";"10";"4";"891350486";"825"
"3392";"Apertura fines de semana de bibliotecas y escuelas de música municipales.";"<p>Es una pena que los fines de semana permanezcan cerrados las bibliotecas y escuelas de música municipales. Por varios motivos:</p>

<p>- es cuando disponemos de tiempo libre para utilizarlas.</p>

<p>- se crearía empleo útil.</p>

<p>- amortización de instalaciones.</p>

<p>- celebración de actos con público.</p>

<p>- alternativa al botellón para los jóvenes.</p>

<p>Se podría empezar un piloto en algún barrio e ir extendiendo si tiene éxito.</p>
";"11/09/2015 09";"54";"49";"5";"1";"898769227";"3992"
"3393";"Recuperar el antiguo hospital Puerta de Hierro";"<p>Desde que la Comunidad de Madrid trasladó el hospital de Puerta de Hierro a Majadahonda, el edificio ha quedado abandonado y es un foco de infección y de degradación en el barrio. Se podría reutilizar como equipamiento municipal, residencia de ancianos o derribarlo y hacer un parque. Cualquier solución sería mejor que el estado de ruina en que se encuentra. Como entiendo que es patrimonio de la Comunidad de Madrid, se podría crear una comisión mixta y participativa con las asociaciones de vecinos, para darle un nuevo uso.</p>
";"11/09/2015 09";"41";"37";"4";"0";"897562785";"2978"
"3394";"coches de policia";"<p>Queria proponer que en el nuevo contrato de adquisicion de coches para la policia, el modelo elegido sea uno que se construya en Madrid, tenemos fabricas de coche en nuestra ciudad que deberian ser los que esten patruyando la ciudad, para asi dinamizar la economia de la ciudad, ya que es un pedido importante y ayudaria a la industria madrileña, ademas de un escaparate de lo que se hace en Madrid, apostando por nuestro producto.</p>
";"11/09/2015 09";"38";"29";"9";"3";"893945505";"1526"
"3395";"MEJOR COMUNICACIÓN TRANSPORTES EN SAN BLAS-CANILLEJAS CON DISTRITOS COLINDANTES";"<p>¿Sería posible una mejor comunicación de transportes entre el Barrio de San Blas, con, por ejemplo, barrios como Vallecas, Villaverde, Alameda de Osuna, Barajas, etc?...Estos barrios están cerca pero si no vas en coche, te obliga a coger 2 autobuses mínimo o hacer transbordo en Metro.</p>
";"11/09/2015 09";"47";"43";"4";"1";"898489508";"3568"
"3396";"Transporte directo desde San Blas-Canillejas al Hospital Ramón y Cajal";"<p>Sé que es competencia del Consorcio y de la Comunidad pero creo que estando dentro de terrenos del Ayuntamiento éste debería de presionar para que de una vez, todxs lxs vecinos de este distrito disfrutemos de lo que todos los demás hacen, un hospital cercano y de fácil acceso, ya que es la única área sanitaria metropolitana que no tiene hospital y llegar al de referencia (aunque haya circunscripción única, la gente sigue acudiendo ""al de toda la vida"") en menos de una hora, creo que es un derecho y por tanto, hay que reivindicarlo</p>
";"11/09/2015 09";"33";"28";"5";"5";"895716369";"1951"
"3397";"Mayor frecuencia en los autobuses de la EMT, EJEMPLO LINEA 4";"<p>No entiendo cómo es posible que algunos autobuses, como por ejemplo la Línea 4, tarden más en llegar que lo que tarda el trayecto que vas a realizar. Para ir a trabajar, en hora punta, he tenido que esperar, hasta 20 minutos para un trayecto de 4 paradas...A veces, casi merece la pena ir a trabajar andando, aunque lleves zapatos poco cómodos para ello...</p>
";"11/09/2015 09";"26";"24";"2";"0";"896342908";"2030"
"3398";"Posibilidad de despido a los funcionarios como a cualquier trabajador";"<p>Si trabajas no te despedirán, y si no trabajas a la calle. Es la selección natural del hombre. Si no existe esa posibilidad, se acomodan la mayoría trabajando lo justo e incluso mucho menos, y se acaba malgastando muchísimo dinero publico al ser poco eficiente el mantener un parque de trabajadores inadecuado.</p>
";"11/09/2015 09";"65";"47";"18";"10";"894884247";"2096"
"3399";"Locales para emprendedores en vez de para Okupas";"<p>No estaría nada mal que el Ayuntamiento se preocupara de dotar a los emprendedores de locales e instalaciones al mismo precio que pagan los Okupas. Me resulta muy frustrante no poder poner en marcha un negocio desde hace años por no poder acceder a un local mientras veo que se hace una defensa en esta materia de personas (Okupas) que estando en edad productiva no aportan nada a la sociedad.</p>

<p>Gracias  </p>
";"11/09/2015 09";"74";"63";"11";"11";"898817577";"4427"
"3401";"Todos los gastos reflejados en tablones públicos de sus ayuntamientos";"<p>Como los impuestos los pagamos todos, todos debemos saber el dinero que hay y en que se gasta. Puesto que cada departamente exponga mensualmente el dinero que tenían en caja, los gastos y en qué se ha gastado, y el que queda, por supuesto. Así desde la asignación de los presupuestos conjunto con los que quedaban de las otras asignaciones, vamos, el computo total de la caja, y por siempre.</p>
";"11/09/2015 09";"25";"22";"3";"1";"895318400";"1672"
"3402";"No me parece ética la contratación de familiares y amigos";"<p>Desde que el nuevo equipo de gobierno ha llegado al Ayuntamiento, nos hemos encontrado con las noticias de las contrataciones de familiares y amigos de algunos miembros de dicho equipo, empezando por la Alcaldesa.</p>

<p>Por toda justificación se argumenta que las contrataciones lejos de ser por motivos familiares se han realizado en base a la valía profesional de dichas personas, de lo cual no me cabe duda.... al igual que no me cabe la menor duda tampoco de que seguro hay personas más válidas que las contratadas.</p>

<p>Yo me considero una persona muy valida en mi profesión, donde de hecho tengo cierto prestigio, es más, creo que podría serle de gran utilidad al ayuntamiento, pero sinceramente, tengo muchísimas dudas de que se pongan en contacto conmigo para contratarme, incluso aunque yo mismo sea el que opte a un puesto. </p>

<p>A ver si tengo suerte y alguien de mi familia empieza a trabajar en el consistorio para que comente internamente lo valido que soy.</p>

<p>Un saludo</p>
";"11/09/2015 09";"63";"53";"10";"7";"897947820";"3617"
"3403";"CREACIÓN DE UN TRANVÍA QUE COMUNIQUE BARRIOS MADRILEÑOS DEL ANILLO M-40";"<p>Propongo la creación de un tranvía en superficie (tipo como los Tram en la zona de Alicante)  que conecte y tenga paradas en los barrios madrileños próximos a la M-40 (anillo circular), por ejemplo; San Blas-Canillejas, Barajas, Hortaleza, Valdebebas, Montecarmelo, Fuencarral-El Pardo (Parada en el Hospital Ramón y Cajal)., La Vaguada, así como el resto de zonas Oeste y Sur de Madrid (Aluche, Villaverde, Vallecas, Vicálvaro, etc.. El Metro o Bus, en general, te lleva todos estos sitios, pero se te hace interminable llegar con tanta estación y tanto transbordo. Para los que residimos en barrios periféricos de Madrid y tienes que desplazarte para trabajar a otros distritos cercanos a la M-40, se evitaría tener que coger coche y aguantar los atascos y posibles accidentes que se producen en la M-40 diariamente. </p>
";"11/09/2015 09";"91";"64";"27";"9";"895320046";"2602"
"3404";"Estado aconfesional. Eliminar subvenciones públicas a la Iglesia YA. ";"<p>Buenos días,</p>

<p>Anulando gastos a la iglesia: gastos de seguridad, limpieza, organización y cesión de terrenos para la celebración de la Jornadas religiosas, etc...cubriríamos muchos servicios públicos. Eliminen privilegios a la iglesia, tales como sueldos de sacerdotes o profesorado religioso en colegios públicos, deberían autofinanciarse y genera desigualdad con otras confesiones. Deberían eliminar la casilla de la Renta que también pagamos con nuestros impuestos. Además, disfrazan los fines sociales que también son destinados a organizaciones y fundaciones católicas. Una Europa laica no debería financiar proyectos de instituciones católicas, ni colegios concertados cuando faltan colegios públicos, guarderías e institutos públicos en muchos barrios. Seguimos manteniendo la figura del cura sin acceso a concurso público en Instituciones Penitenciarias y en cuarteles con nóminas del  Estado. Continuamos gestionando con empresas públicas eventos religiosos. Con lo cual, la iglesia la estamos pagando entre todos.</p>

<p>Gracias.  </p>
";"11/09/2015 09";"89";"60";"29";"10";"894402385";"2089"
"3405";"ABONO TRANSPORTE GRATUITO ¿Privilegios?";"<p>Hola,</p>

<p>A los funcionarios del ayuntamiento se les entrega anualmente un abono transporte que les lleve desde su casa (vivan donde vivan) hasta su lugar de trabajo.</p>

<p>Esto es un privilegio del que no disfrutan el resto de trabajadores, ni funcionario de la administración central. Por un lado se generan desigualdades y por otro es un privilegio en comparación con el resto de trabajadores.</p>

<p>¿Lo considera un privilegio? ¿Piensa hacer algo al respecto con él? </p>

<p>Gracias,</p>
";"11/09/2015 09";"29";"20";"9";"1";"891380557";"758"
"3406";"Que las gasolineras contraten más personal  para llenado depósito, cobro, etc.";"<p>Con esta medida se crearían cientos depuestos de trabajo. Los clientes se ahorrarían incómodos paseos, pasar frío y calor y el olor a gasolina en la mano. Las gasolineras han eliminado cientos de puestos de trabajo y cobran la gasolina al mismo precio que otras gasolineras que contratan más personal y lo sirven. En Canarias se realizó una protesta ciudadana y todos los empresarios del sector volvieron a contratar al personal.</p>

<p>Un saludo.</p>
";"11/09/2015 09";"36";"17";"19";"6";"884133178";"-94"
"3407";"PONER ALCORQUES EN LOS CUADRADOS DONDE ESTÁN LOS ARBOLES";"<p>En la mayoría de los barrios céntricos de Madrid, hay colocados alcorques en el cuadrante donde está ubicado el árbol (o incluso no hay árbol, está vacio) , pero en la mayoría de los barrios periféricos no es así. Además de que las zonas peatonales son estrechas, para poder pasar caminando o llevando un carrito, has de pisar sobre estos cuadrantes que son realmente agujeros por no estar tapados por alcorques, con la consiguiente posibilidad de sufrir una caída. Propongo que se coloquen en esos espacios los alcorques para que no haya ""sortear"" esos hundimientos en los espacios donde están los árboles. </p>
";"11/09/2015 09";"30";"28";"2";"0";"897342261";"2426"
"3408";"Rebaja en los títulos de transporte durante el verano";"<p>Puesto que hay una reducción considerable del servicio que presta el metro, la EMT, los interurbanos...durante los meses de verano, me parecería normal que hubiese una reducción en los títulos de abono transporte.</p>
";"11/09/2015 10";"30";"25";"5";"1";"895084048";"1666"
"3409";"¿Welcome refugees?";"<p>Ya que este gobierno presume de democracia participativa, deberían realizar una consulta a los madrileños para saber si queremos o no recibir a los refugiados en nuestra ciudad. ¿Nos sobra el dinero? Pues que se use en mejorar la limpieza, el transporte público, la sanidad, etc. Yo no pago impuestos para arreglar los problemas de otros países. Los medios de comunicación nos están manipulando con historias lacrimógenas, pero el conflicto de los refugiados se soluciona desde dentro con organizaciones como la OTAN o USA y no como nos lo están vendiendo.</p>
";"11/09/2015 10";"97";"46";"51";"22";"884198480";"-237"
"3410";"Ascensores en todas las estaciones de Renfe y Metro";"<p>No me parece normal que haya estaciones de Renfe y metro sin ascensores: limita la movilidad de las personas en sillas de ruedas y con carritos de bebé.</p>
";"11/09/2015 10";"48";"41";"7";"3";"897384571";"2904"
"3411";"Control de la tenencia de perros peligrosos";"<p>En mi barrio (Moratalaz-Vallecas) los propietarios de perros considerados peligrosos los pasean sin bozal y muchas veces sin siquiera correa. He vivido personalmente las consecuencias de un ataque de estos perros a otro. Y me han contado de otras incidencias de este tipo. No es de ninguna manera aceptable que los espacios públicos sean ocupados por estos animales sin ningun tipo de control, amedrentando a los otros dueños de perros. Tambien he tenido oportunidad de ver la reacción de algunos propietarios de perros peligrosos a cualquier comentario acerca de las precausciones que impone la ley. No se puede estar permanentemente con altercados, ese no es el objetivo.</p>

<p>Ya he propuesto que la policía municipal realice visitas aleatorias (no tienen por que ser demasiado frecuentes) a los parques de Madrid para revisar la documentación requerida por la ley y el cumplimiento de las medidas de seguridad, pero no he recibido ninguna respuesta (mi propuesta es de hace un mes). Con esta simple medida, muy seguramente la mayoría de los dueños de perros peligrosos no los dejarían sueltos en la calle y les pondrían el bozal, con lo cual ya no existiría ningun riesgo para los otros perros ni para las personas. Es extremadamente simple.</p>
";"11/09/2015 10";"96";"89";"7";"5";"902017613";"7602"
"3412";"Endurecer leyes contra el maltrato animal o el abandono.";"<p>Las penas son de risa para los atrocidades que algunos cometen (si no se hace la vista gorda antes)</p>
";"11/09/2015 10";"64";"58";"6";"2";"899804362";"4712"
"3413";"Conexión peatonal Avenida de Burgos por Nudo Manoteras.";"<p>Actualmente muchos madrileños trabajamos en la zona de Las Tablas y Sanchinarro debido a que muchas empresas se han asentado en esta zona en distintos parques empresariales. La movilidad a estas zonas se encuentra muy limitada por la saturación de las infraestructuras de acceso así como falta de accesos al transporte público metro o ferrocarril. La Avenida de Burgos que se prolonga entre Las Tablas y Pinar de Chamartín tiene una discontinuidad a la altura del nudo Manoteras que impide su utilización por peatones o ciclistas. Realmente esta conexión no precisa de una gran inversión puesto que a priori sólo sería necesario prolongar las aceras en uno de los márgenes para completar la conexión permitiendo por tanto el acceso a la almendra de Madrid peatonalmente, y aumentando las posibilidades de movilidad. Una de las mejoras más inmediatas es que se tendría acceso a la estación de Bambú de Metro Madrid.</p>
";"11/09/2015 10";"54";"52";"2";"1";"900597822";"4814"
"3414";"Alumbrado Público y poda de árboles";"<p>Aunque no lo parezca ambas cosa van en consonancia en muchas calles de Madrid.</p>

<p>Existen farolas de 6 m. de altura para su haz de luz abarque una zona más amplia iluminada con lo que nos ahorramos zonas de penumbra pero, como los árboles son más bajos los dejan crecer en altura para que sobrepasen a las farolas con lo que resulta que tenemos árboles de hasta 20 m de alto y quebradizos, por una mala poda, que con un fuerte viento o una nevada rompen ventanas y tejados de algunas casas y se parten ellos. Cerca de mi han caído tejas golpeadas por los árboles.</p>

<p>¿Se podrían hacer farolas más bajas y árboles no tan altos? Ya sé que cambiar los báculos de las farolas podría ser costoso pero con ello se podrían tener árboles más bajos y mejor podados y a lo mejor se salvaban vidas.</p>
";"11/09/2015 10";"35";"31";"4";"0";"896942799";"2391"
"3415";"Palacio de los Deportes - NO Barclaycardcenter";"<p>Creo que no sólo la estación de metro de Puerta del Sol no debería llevar el nombre de una marca de móviles.</p>

<p>También nos la colaron con la publicidad del Barclaycardcenter. El nombre debe volver a ser lo que ha sido siempre: EL PALACIO DE LOS DEPORTES.</p>
";"11/09/2015 10";"49";"32";"17";"2";"892084467";"979"
"3416";"Mejorar carriles bici y restringir tráfico en el centro de Madrid.";"<p>Una inversión en mejores carriles bici se recupera fácilmente a través de los enormes beneficios para la salud y el posible ahorro económico. También hay otros beneficios; la mejora de la calidad del aire, menos tráfico y el hecho de que la gente se mueva más.</p>

<p>Restringir el tráfico a determinadas horas del día por el centro de Madrid. </p>
";"11/09/2015 10";"69";"46";"23";"1";"893465228";"1533"
"3417";"El Retiro no es para maratones";"<p>El Retiro es un parque histórico, vulnerable y frágil y así debe ser considerado por los usuarios. No es escenario para competiciones deportivas.  Se ha comprobado que el peso al que son sometidas las raíces de los árboles en las competiciones de carreras es perjudicial. Así lo han dictaminado los técnicos forestales.</p>

<p>Las carreras deben celebrarse en recintos acondicionados para ello o por las calles de la ciudad, pero no en El Retiro. Basta con ver cómo queda después de cada marathon. Botellas, papeles, banderines, plásticos, restos de comidas...</p>
";"11/09/2015 10";"55";"40";"15";"0";"894547221";"1818"
"3418";"Prohibición de acumulación de negocios creando guetos";"<p>Venimos asistiendo desde hace muchos años a una ""guetizización"" de algunos barrios o calles que bajo la excusa de una determinada especialización lo único que provocan es la creación de guetos y los consecuentes problemas de convivencia.</p>

<p>Ejemplo.</p>

<p>Supongamos que pongo una tienda de deportes especializada en fútbol.</p>

<p>Después la especializo en calzado de fútbol</p>

<p>Y por último digo que es solo para fans del Real Madrid.</p>

<p>Al lado de esa tienda de calzado deportivo del Real Madrid, llega otra de boligrafos para fans del Real Madrid,.....,asi hasta el infinito, al final esa zona bajo una falsa especialización es una gueto madridista.</p>
";"11/09/2015 10";"36";"12";"24";"4";"880786325";"-400"
"3419";"Aprovechar edificios vacíos para proporcionar espacios a artesanos";"<p>Creo que una buena idea a la hora de ayudar al pequeño emprendedor sería proporcionarle un espacio donde pudiera desarrollar su actividad y además poder vender sus productos al público. De cara al turismo sería muy interesante un sitio donde ver trabajar a la gente: ceramistas, joyeros, pintores, escultores... y donde poder además adquirir sus productos. El artesano por supuesto pagaría un alquiler por el espacio, pero un alquiler justo. </p>
";"11/09/2015 10";"50";"38";"12";"0";"895242612";"1976"
"3420";"Limitar el acceso de coches al centro";"<p>Con la red de transporte público que tenemos, es innecesaria la cantidad de coches que circulan por Madrid aumentando la horrorosa contaminación que padecemos diariamente. La ciudad mejoraría en gran medida si se limitara de alguna manera el flujo de tráfico en la ciudad, al igual que hacen otras ciudades europeas (por ejemplo, matrículas pares e impares). Si a eso añadimos buenos carriles bici (lo de pintar una bici en un carril de carretera es peligrosísimo) y siguen instalando Bicimad para aquellos que no quieran sudar mucho la bici...conseguiríamos una ciudad infinitamente más limpia!!!!</p>
";"11/09/2015 10";"65";"43";"22";"3";"893386310";"1389"
"3421";"Permitir el acceso de perros de cualquier tamaño al transporte público";"<p>Creo que sería positivo que se permitiera el acceso de perros de cualquier tamaño al transporte público madrileño (Metro y autobús), si éstos van debidamente equipados (bozal). Actualmente, la prohibición de acceso es un lastre para las personas que necesitan desplazarse con su perro por Madrid (por ejemplo, para ir al veterinario) y no disponen de vehículo privado.</p>

<p>En Cercanías de Madrid ya es posible acceder sin problema y en Barcelona los perros pueden usar el Metro, como en muchas otras ciudades de Europa. Madrid puede tomar ejemplo.</p>
";"11/09/2015 10";"167";"98";"69";"6";"893263991";"1701"
"3422";"Rutas escolares organizadas por el ayuntamiento";"<p>Cada año los padres que llevamos a nuestros hijos al colegio en coche sufrimos niveles de contaminación muy elevados y atascos innecesarios, que nosotros contribuimos a empeorar. Muchos de nosotros podríamos dejar de ser parte del problema si existieran rutas en nuestra zona que pudiéramos pagar. Actualmente los precios son abusivos ¿ no podría el ayuntamiento regular las rutas escolares?</p>
";"11/09/2015 10";"26";"17";"9";"0";"890460434";"523"
"3423";"Madrid ciudad para los mayores ";"<p>El envejecimiento de la sociedad es un hecho; que las ciudades actuales noestán preparadas para ayudar a los mayores y sus familias es una realidad.</p>

<p>Propongo que muchos de los edificiosque el Ayuntamiento tiene vacíos se acondicionen para atender a los mayores; aumentar los centros de día y los pisos tutelados.</p>

<p>Debemos hacer un plan para que el cuidado de las personas mayores no se convierta en una carga. Hablar con los médicos de atención primaria; enfermeras; trabajadores sociales para detectar a los mayores con vulnerabilidad y darles apoyo y una vida digna.</p>

<p>Preparemos a Madrid para el futuro. Porque nosotros también lo necesitaremos en un futuro.</p>
";"11/09/2015 11";"32";"28";"4";"0";"896760336";"2100"
"3424";"Sancion económica por hacer botellon en Madrid";"<p>Hola.Las multas que hay por hacer botellón en la calle me parecen excesivas, de 600 euros y el ''maravilloso'' descuento del 40% si admites que has realizado la infracción. Estas multas se aprovechan de la gente que realiza botellón porque no tiene el suficiente dinero para beber en un bar donde te cobran ente 5-10 euros por una copa.Estas multas tienen un fin simplemente recaudatorio ya que por una infraccion así , la cantidad de 600 euros me parece exscesiva , cuando por ejemplo otras infracciones como conducir en sentido contrario son 500 y alli estas jugando con la vida de personas. Encima las ''fiables'' pruebas que realizan los policias para saber si estas bebiendo alcohol o no , es oler tu vaso. Soy un joven que acostumbra a beber en la calle y me parece correcto que multen por beber en la calle ya que se arma escandalo y se ensucia la calle, pero en otras provincias como Ávila estas multas son de entre 30-90 euros , un precio mas asequible y mas lógico teniendo en cuenta la acción que estas realizando. Si no quieren que bebamos en la calle que dejen de poner multas para beneficiar al sector servicios y pagar las deudas que tenga el ayuntamiento , y si no que habiliten un lugar para poder beber donde no se moleste a nadie, ''un botellodromo''. </p>

<p> </p>
";"11/09/2015 11";"55";"33";"22";"5";"891265249";"660"
"3425";"Parques infantiles del centro de Madrid";"<p>Da pena llevar a niños de 2, 3,4 y 5 años a los parques infantiles del centro de Madrid. Hablo de parques con el suelo de tierra sucia, llena de colillas, excrementos de perro, restos de botellones.. Columpios rotos, desfasados e inadecuados.</p>

<p>Los parques de Malasaña, Arapiles, Plaza de comendadoras, Conde Duque, Olavide, Centro Cultural Galileo, Andrés Mellado...dan verguenza, tienen todos los columpios destrozados y anticuados. Actualmente, hay columpios mucho más modernos y educativos con los que nuestros hijos pueden disfrutar, y así lo han entendido cientos de Ayuntamientos en este país, sean del corte político que sean, da gusto visitar ciudades como Pontevedra, Villagarcía de Arosa, Barcelona, etc.. donde los niños disfrutan y aprenden en un entorno agradable y seguro.</p>

<p>Pensemos que miles de niños que viven en el centro, tienen como única fuente de ocio ""ir al parque"", y muchos de ellos se pasan los meses de julio y agosto en esos parques infernales..</p>

<p>El coste económico de arreglar y actualizar los parques infantiles es mínimo y a cambio miles de niños pueden  disfrutar de ser ""niños"".</p>

<p> </p>

<p> </p>
";"11/09/2015 11";"60";"54";"6";"5";"899981991";"4320"
"3426";"Abono transporte (EMT) social";"<p>Se trata de algo que ya comentó Manuela Carmena en agosto al tomar el control de la EMT. Un abono de autobús para los colectivos mas desfavorecidos: parados, sobre todo los de larga duración, ya que no cobran subsidio, personas con ingresos bajos, etc.</p>

<p>Con lo que cuestan los billetes ahora, mucha gente no se puede permitir el lujo de utilizar el transporte público para moverse por toda la ciudad a buscar trabajo por ejemplo.</p>

<p>No menciono el metro ni cercanías, porque no es competencia del ayuntamiento, por eso lo propongo en la EMT.</p>

<p>Gracias</p>
";"11/09/2015 11";"52";"42";"10";"2";"897001350";"2584"
"3427";"Creación de ciclocarriles en calles con carril bici o acera bici";"<p>La ordenanza de circulación de Madrid no obliga a usar los carriles bici o aceras bici. Además el Ayuntamiento está procediendo a retirar las señales R407a que obligarían a su uso. Sin embargo muchos conductores desconocen la ordenanza y creen que si hay una infraestructura ciclista esta es de obligado uso por los ciclistas. Son 290km de calles con vias segregadas en las que los ciclistas que usamos la bici como medio de transporte sufrimos el aumento de agresividad de los conductores. En el mejor de los csos esta agresividad se traduce en insultos, en el peor en maniobras peligrosas para el ciclista.
  Para reforzar el mensaje de que no son obligatorias se puede hacer un ciclocarril30 en todas las calles donde exista carril o acera bici. De este modo se conseguiría además que los carriles y aceras bici fueran mas seguros ya que sin medidas de calmado son un verdadero peligro en los cruces tal como muestran las estadísticas de atropellos.</p>
";"11/09/2015 11";"60";"44";"16";"3";"895547482";"2053"
"3428";"HACER CONTROL DE ALCOHOLEMIA A LOS TAXIS DE MADRID";"<p>Se que el sector del Taxi de Madrid es muy fuerte, pero me parece inconcebible que en estos tiempos beber y conducir un medio de transporte público no esté más controlado. Un claro ejemplo lo tienen Vds. en bares que abren hasta tarde donde se reúnen los taxistas, no culpabilizo a los locales pero si a la falta de control de estos conductores. Un ejemplo lo tienen en la parada de la glorieta de Ruiz Jiménez y el conocido bar Ibe..., les animo a que se pasen y comprueben a que lo más consumido no son cafés. MÁS CONTROL DE ALCOHOLEMIA A TAXISTAS, LA SEGURIDAD DE TODOS EN JUEGO.</p>
";"11/09/2015 11";"80";"74";"6";"11";"901958194";"6290"
"3429";"PROHIBIR EL USO DE BARREDORAS/SOPLADORAS";"<p>Es insufrible la proliferación de las barredoras/sopladoras, pues no solo limpian sino que contaminan el ambiente removiendo todo el polvo de las calles con sus ácaros e impurezas que respiramos todos, con los gases de combustión del propio aparato y con el ruido que meten. Cuando a los propios usuarios, la Ley de Seguridad Laboral correspondiente, les exije gafas, mascarilla y cascos para su uso, por qué los ciudadanos tenemos que soportarlo. Ya hay muchas ciudades occidentales y comunidades que las han prohibido</p>
";"11/09/2015 11";"55";"42";"13";"1";"896197407";"2214"
"3430";"Supresión del suplemento del billete de Metro para el aeropuerto.";"<p>El gesto tan bonito que supone ir a buscar a un amigo, un familiar o tu pareja al aeropuerto para darle le bienvenida a nuestra ciudad segun toma tierra en Madrid, se puede estar perdiendo por la dificultad de tener que pagar una tarifa extra a la salida y a la entrada del Metro. 
Pagar un extra de 3 euros para entrar y 3 para salir hace que si lo sumamos al precio ya pagado por el servicio en si del transporte en metro, pueden llegar a ser hasta 10 euros, utilizando el transporte público más económico que se puede utilizar y que tanto estamos promoviendo.
¿No sería mejor hacer que el transporte más comodo limpio y sencillo, sea tambien más económico?</p>
";"11/09/2015 12";"71";"64";"7";"2";"900931660";"5138"
"3431";"Rampa de acceso  ---->    también para bebes, de entrada y salida.";"<p>Ignorando las instrucciones cursadas al personal de EMT, vemos con creciente preocupación su renuencia para facilitar los <strong>medios disponibles</strong> ya instalados (de uso restringido, dicen) al costoso y frecuentemente arriesgado tránsito de criaturas sobre el estribo de los Autobuses:  estos pequeños carros -aun resultando finalmente plegados- en manos de atareadas madres/abuelas/sirvientes que portan multiples enseres (biberones, caperuzas, toalla, pañales) mientras ""rebuscan"" sus moneda ó Abonos son ante todo origen de muy desgraciados ACCIDENTES para el pequeño ""pasajero"" en circunstancias de manejo angosto.  Y por ende, fuente de conflicto con otros -exigentes- ciudadanos... démosles a todos la <u>tranquilidad en el viaje</u> que sin duda merecen.  La rampa SIEMPRE disponible, no infra-utilizada.</p>

<p>Fernando  (Cmdd Aut Mdr)</p>
";"11/09/2015 12";"24";"15";"9";"4";"890395496";"375"
"3432";"Limpieza,Perros,Educación y Convivencia,Civismo,Gitanos. ";"<p>Vivo en el barrio de Vallecas y la verdad es que no puedo con el poco civismo que hay en este barrio(sin generalizar por supuesto)y ahora llamenme clasista o lo que quieran.Gran numero de dueños llevan a sus perros considerados de raza peligrosa(en este barrio los hay a cientos)sueltos y todos sin bozal,los perros hacen sus necesidades y no las recojen,comen pipas y tiran las cascaras al suelo,beben latas de cerveza o litronas y teniendo cubos de basura y papeleras a mansalva las dejan en bancos publicos o asientos de paradas de bus etc..etc..Una gran mayoria de personas de etnia gitana hacen lo que les da la gana a ellos ya que se realojaron en el barrio a cientos y despues no se les a hecho un seguimiento de reinsercion y aparte nadie se atreve a decirles nada por miedo por que ya se sabe que les dices algo a uno y aparecen doscientos.Hacen fiestas,sobre todo en verano,con la musica a todo gas hasta la hora de la madrugada que a ellos les da la gana,se reunen con las amacas en la calle beben comen y alli dejan los restos,tiran las bolsas(en algunos casos)desde las ventanas de sus pisos a la calle etc.. etc..Como pienso yo pienso lo piensa una gran mayoria de las personas que vivimos por aqui(solo hay que preguntar a pie de calle) en este barrio tan castizo,bonito y tristemente siempre castigado</p>
";"11/09/2015 12";"32";"30";"2";"1";"898705888";"2625"
"3433";"Potenciar imagen de turismo de Madrid en redes sociales";"<p>Acción de marketing gratuíta para la potenciación de la imagen exterior de Madrid. Consistiría en señalar puntos turísticos de la ciudad como imprescidibles para hacerse un selfie o fotografiar para colgar en las redes sociales como Instragran, Twitter o Facebook. De esta manera estas fotografías son susceptibles de ser vistas por un público potencial muy alto e incluso convertirse en virales. Y lo mejor de todo... que se produciría de manera GRATUÍTA!</p>

<p> </p>

<p> </p>
";"11/09/2015 12";"38";"36";"2";"1";"899664221";"3221"
"3434";"Cerdo de San Antón";"<p>Recuperar la tradición del cerdo de San Antón.</p>

<p>Un cerdo que se cria libremente por las calles de la ciudad comiendo  lo que encuentra y los vecinos le van dando.</p>

<p>Por San Anton se subasta y se hace matanza con él, asi el ayuntamiento sacaria dinero.</p>

<p>Otra opción es no subastarlo y organizar una comida popular con él en la Plaza Mayor para todo el que se acerque.</p>

<p>Debería hacerse por distritos, para que a todos les toque algo del cerdo</p>
";"11/09/2015 12";"51";"17";"34";"2";"881022948";"-566"
"3435";"Transporte público gratuito(menores 15 años)-Billete Sencillo/10 viajes por edad";"<p>Un niño menor de 15 años (por poner una edad) no suele ser ""independiente"" y viajar solo. Viaja con sus padres o familiares. Y en algunos casos suelen ser viajes puntuales. </p>

<p>El Sistema actual no ayuda a los padres con hijos como debiera (transporte, educación....) En el transporte público nos movemos muchos con los hijos y a partir de 7 años ya van a tener que pagar. Son excesivos gastos en total. Los precios actuales empujan a muchos a usar transporte privado. </p>

<p>Existe el abono Jóven, pero no existe el billete sencillo Jóven (ni infantil). Como tampoco existe el abono de 10 viajes por edades (Infantil, Joven). Dadas las opciones actuales, sería lógico que existieran.</p>

<p> </p>

<p> </p>

<p> </p>
";"11/09/2015 12";"31";"17";"14";"0";"887840135";"164"
"3436";"Convertir este foro en una herramienta seria de decisión ciudadana.";"<p>Leo en diversos medios que las propuestas más votadas las tendrá en cuenta el consistorio, incluso que si alguna propuesta tiene más de 53.000 votos sería llamada a referéndum.

Estás dos cosas me parecen estupendas, al fin y al cabo es darle la gobernanza a los ciudadanos pero no puede llevarse a cabo sin un censo previo. Por ahora son foros a los que puede acceder Ninnete, un señor de Murcia o quince veces con quince usuarios aquel que tenga tiempo y ganas para crearse varios alias.

Mi propuesta pasa por usar el dni electrónico que todos tenemos junto con una plataforma del tipo agora voting o similar que garantice todas las cosas que han de garantizarse cuando se vota con una papeleta en una urna.

Para las personas que carecen de los medios materiales o el conocimiento como para poder votar desde su casa habría que habilitar una serie de locales con todo lo necesario como para que pudieran hacerlo personándose ahí, como quien va a una urna pero con las ventajas e inmediatez de lo digital.

Mientras no se haga algo así, esta web no será más que una declaración de buenas intenciones.</p>
";"11/09/2015 12";"30";"23";"7";"4";"894694776";"1226"
"3437";"Refugiados y mayores";"<p>Son muchos los mayores de nuestra ciudad que están solos, desamparados con pocos ingresos que no les permite alcanzar una calidad de vida decente y que tienen una casa con habitaciones libres. Mi idea es que acojan a refugiados en sus domicilios a cambio de ayudar al mayor en la rutina diaria, que se pueda escolarizar a los hijos de los refugiados.</p>

<p>Las tareas serían ayudar a los mayores en la limpieza, cocinar, la higiene personal, acompañarles al médico; a cambio el mayor les daría un techo y la posibilidad de escolarizar a los hijos de los refugiados.</p>

<p>Sería abrir una bolsa de personas interesadas y que desde Servicios Sociales se valoren las viviendas y necesidades de mayores y refugiados.</p>
";"11/09/2015 12";"33";"21";"12";"2";"891465053";"572"
"3438";"CONTROL ASENTAMIENTOS GITANOS RUMANOS PARA EVITAR LAS  MOLESTIAS A LOS VECINOS";"<p>Existen un elevado número de asentamientos de gitanos rumanos en diversas zonas de Madrid (que el SAMUR SOCIAL conoce perfectamente). Es necesario ejercer un control sobre ellos con el fin de evitar la insalubridad de las zonas donde se mueven (basuras, malores olores, beber en la calle, hacen sus necesidades en la vía pública, etc.), crean  infraviviendas en lugares céntricos, etc. con el riesgo que ello conlleva por no cumplir las mínimas condiciones de seguridad  (altísimo riesgo de incendio en zonas que facilmente se puede propagar), etc.  </p>

<p>Entiendo que son personas sin recursos que es necesario integrar en la sociedad, pero si no quieren, lo que no es de  recibo es que seamos los vecinos los que tengamos que sufrir su comportamiento inapropiado. Porque no se planifica un  programa de ayuda con dispersión de los individuos? 3  puede no ser mucho problema, pero cuando se juntan 14 comiendo, bebiendo, peleando,  meando y llenando la zona de inmundicias,   entonces si es un problema para los vecinos (no podemos llevar a los hijos al parque, riesgos de enfermedad por la insalubridad, inseguridad en la zona, etc.).</p>

<p>Cuando ponen una chabola en zonas centricas de Madrid porque no se actua de forma inmediata, pues ya sabemos lo que va a venir ..., porque se espera a que haya 1, ...2, ...3,... 4,... 15 chavolas,  etc.? </p>

<p>Propongo que se les ayude, que no se permita la creación de guetos, y si no quieren esa ayuda,  pues otras medidas restrictivas, pues los sufridores somos los vecinos (no puede actuar la Policia Municipal para hacer  cumplir la Ordenanza Municipal o  tenemos que organizar patrullas los vecinos, para asegurarnos poder mantener unos mínimos en la convivencia de  cada barrio? ).</p>

<p>El modus operandi de este colectivo es siempre el mismo, por tanto, porque no se hace un plan específico de tratamiento de este colectivo?, sabemos que es un problema que existe y existirá, mejor estar prevenidos y atajar el problema cuando es incipiente.</p>

<p>Por último, apoyo el plan de choque de limpieza, `pero no solo es eso, los vecinos tenemos que ayudar no ensuciando (y quien no lo haga que se le sancione).
 </p>

<p> </p>

<p> </p>
";"11/09/2015 12";"85";"75";"10";"6";"901355502";"5735"
"3440";"Jornadas sobre circulación para bicis y coches";"<p>Hola buenos días.</p>

<p>A consecuencia de los distintos debates leidos, qusiera proponer que el ayuntamiento, realizara jornadas, manuales y/o programas para la formación al ciudadano sobre normas de circulación tanto para ciclistas como conductores.</p>

<p>Yo representoa  ambos, y quiero dejar constancia de que en terminos generales, ambos grupos chocan por que no existe todavía consciencia y por ello quisiera proponer que se hicieran programas centrandose en los principales puntos, donde los usuarios tuvieran toda la información.:</p>

<p>Para ciclistas:</p>

<p>- Normas de seguridad.</p>

<p>- Ubicación de carriles bici y calles con menos tráfico dependiendo la hora.</p>

<p>- Normas de circulación: eres un vehiculo y como tal no debes saltarte los semaforos en rojo, ni ir por la acera etc..</p>

<p>- Peligros principales a los que se exponen</p>

<p> </p>

<p>Para conductores de vehiculos:</p>

<p>- Mantener distancias de seguridad.</p>

<p>- informar de que la bici es un vehiculo y como tal debe ir en medio del carril, si el vehiculo  no puede adelantar deberá esperar a que se amplien dos carriles o esperar sin estar lamiendote el culo.</p>

<p>(apara ambos punto se aceptan propuestas, es cuestión de todos)</p>

<p>Considero fundamental que se adapten las calles y aumenten los carriles bici pero hasta entonces, me gustaría lo expuesto, proponer que se realizaran manuales y campañas donde viniera toda la información recogida para que la gente leyera y tanto ciclistas como conductores nos entedamos y vayamos juntos hacia una mejor movilidad y sostenibilidad. </p>

<p> </p>
";"11/09/2015 12";"17";"9";"8";"1";"885741057";"52"
"3441";"Urge la aplicación de un paquete de medidas ecológicas";"<p>Necesidad de un <em>paquete de medidas ecológicas. Aquí propongo algunas (seguro que a Vds. se les ocurren muchas más)</em>:</p>

<ol>
	<li>Reducir la <strong>contaminación atmosférica</strong>:

	<ol>
		<li>Limitando la circulación de coches en zonas y durante periodos de alta contaminación.</li>
		<li>Plan para sustituir calderas de calefacción contaminantes.</li>
		<li>Incentivos para uso de transporte público.</li>
	</ol>
	</li>
	<li>Reducir <strong>contaminación de las aguas</strong>:
	<ol>
		<li>Más vigilancia. Medidas periódicas de niveles de contaminación de rios y arroyos.</li>
		<li>Más depuradoras.</li>
		<li>Más rigor en la aplicación de sanciones a empresas/particulares contaminantes.</li>
	</ol>
	</li>
	<li>Mejorar la gestión de <strong>residuos solidos</strong>:
	<ol>
		<li>Aumentar cantidad de contenedores de reciclaje de embalajes, recipientes, papeles, cartones, etc.</li>
		<li>Incentivar la reutilización de embases, sistemas de transporte y embalajes.</li>
		<li>Aumentar contenedores de residuos peligrosos: pilas, aceites, etc.</li>
		<li>Más vigilancia de vertederos ilegales.</li>
		<li>Más rigor en la aplicación de sanciones a empresas/particulares contaminantes.</li>
		<li>Aumentar plantas de tratamiento, selección y reciclaje de basuras.</li>
	</ol>
	</li>
	<li>Proteger la <strong>vida animal/vegetal</strong>:
	<ol>
		<li>Elaborar un listado de especies locales en peligro de extinción.</li>
		<li>Prohibición de espectaculos que fomentan el maltrato animal.</li>
		<li>Fomentar explotaciones ganaderas que respeten y mejoren las condiciones de vida animal hasta el sacrificio.</li>
		<li>Vigilar y prevenir la tala o degradación indiscriminada de superficie arbolada.</li>
	</ol>
	</li>
	<li>Plan de <strong>ahorro energético</strong>:
	<ol>
		<li>Programa de ahorro energético en edificios públicos: apagar equipamiento innecesario fuera de horas, bombillas de bajo consumo, etc.</li>
		<li>Incentivos al ahorro energético en empresas y hogares.</li>
		<li>Reemplazar sistemas de alumbrado público por otros más eficientes.</li>
	</ol>
	</li>
	<li>Aplicación urgente de <strong>medidas reparadoras</strong> del medio ambiente dañado:
	<ol>
		<li>Aumentar superficie arbolada, verde, arenas/gravas/arcillas en zonas urbanas. Sobretodo en zonas expuestas a contaminación.</li>
		<li>Aumentar limpieza de cauces y orillas de rios, caminos, senderos.</li>
		<li>Plan urgente de repoblación forestal de superficies quemadas o gravemente dañadas.</li>
		<li>Plan de recuperación y/o repoblación de especies en peligro de extinción.</li>
	</ol>
	</li>
	<li>Aplicación urgente de <strong>medidas preventivas</strong>:
	<ol>
		<li>Impuesto ecológico: quién contamina, paga. </li>
		<li>Campañas de concienciación: reciclaje, ahorro energético, uso de transporte público, etc.</li>
		<li>Más transparencia sobre los niveles de contaminación: a través de portales web y carteles informativos.</li>
	</ol>
	</li>
</ol>

<p> </p>
";"11/09/2015 12";"30";"20";"10";"3";"892241678";"666"
"3442";"Tarjetas de aparcamiento personas movilidad reducida";"<p>En Madrid los titulares de tarjetas de aparcamiento para personas de movilidad reducida pueden aparcar en distintos tipos de plaza. Propongo que se compruebe que <u><strong>realmente</strong></u> se hace buen uso de esas tarjetas y no es un familiar o amigo el que hace mal uso de ese derecho y se sancione de forma ejemplar a quien haga uso fraudulento de esas tarjetas.</p>
";"11/09/2015 12";"37";"29";"8";"2";"895807754";"1645"
"3444";"Zonas Públicas  ""Libre de Humos""";"<p>Se debería considerar ampliar la Ley Antitabaco para que se extienda a los espacios públicos; ya que las personas fumadoras no han entendido muy bien que fumar es malo para la salud, sobre todo los que somos fumadores pasivos y niños.</p>

<p>El poder llegar a un parque, plaza, terraza, piscina.....libre de humos es un derecho que tenemos todos, y las zonas públicas es el lugar donde convivimos, y son los más pequeños  los que hacen un uso constante de ellas.</p>

<p>El proponer que se amplíe la ley y que se multe en estos lugares, que es lo más efectivo parece ser; haría que la Seguridad Social invierta menos dinero en tratamientos para las enfermedades que el tabaquismo origina a todos, fumadores y los que somos fumadores pasivos y así ganaríamos en salud.</p>

<p> </p>
";"11/09/2015 12";"39";"25";"14";"5";"892408891";"705"
"3445";"Trabajadores externos públicos turno de 4 -o- 6 horas para dar más puestos.";"<p>Que el ayuntamiento tenga en contrato a todas las personas de nueva incorporación en jornadas de menos horas diarias para repartir el trabajo y la ""riqueza"" entre todos los ciudadanos que necesitan un trabajo. Si hay poco trabajo, pues que se reparta incluso el de un mismo puesto. Es una medida que puede parecer absurda pero que soluciona un problema directo y muchísimos problemas indirectos que tiene la sociedad.</p>
";"11/09/2015 12";"20";"6";"14";"5";"882581820";"-240"
"3446";"Que los nuevos autobuses recuperen el color rojo";"<p>Los autobuses en Madrid siempre han sido de color rojo. Paulatinamente se han sustituido por el azúl ¿Por qué motivo? ¿Color corporativo del partido anteriormente gobernante? Mi propuesta es que las nuevas flotas recuperen el rojo tradicional.</p>
";"11/09/2015 13";"42";"8";"34";"9";"882323257";"-495"
"3447";"No a las obras sin terminar en Madrid ";"<p>Abro este debate pues me parece terrible que el ayuntamiento ""olvide"" finalizar ciertas obras.</p>

<p>Por ejemplo hace un par de meses se produjo la rotura de una conducción de agua en los túneles de azca. El problema se solucionó y se reabrió el tráfico pero no la salida a la calle capitán haya ¿por qué? no se dabe, pues no hay ningún operario trabajando ni ningún percance, simplemente las vallas siguen allí.</p>

<p>Interrumpiendo el tráfico terriblemente.</p>
";"11/09/2015 13";"26";"22";"4";"0";"896045266";"1523"
"3448";"SER No pagar estacionamiento en las horas de comida de 14.00 a 16.00 ";"<p>Hola</p>

<p>Poder comer tranquilamente sin preocupacion del dichoso papelito del estacionamiento regulado SER</p>

<p>Poder aparcar mas de dos horas en zona verde o cuatro en zona azul sin tener que cambiar de distrito Zonal </p>

<p>   </p>
";"11/09/2015 13";"40";"25";"15";"0";"891679382";"625"
"3449";"Medidas especiales para fomentar el turismo internacional que deja riqueza";"<p>Aunque pueda parecer absurdo, si se crea un comité que se ponga a trabajar de como aumentar de manera muy considerable el turismo internacional en todas las épocas del año, se crea un aumento de la economía de una manera sustancial y por encima de la propia sostenibilidad pues es una inyección de capital extranjero, dinero que entra nuevo de fuera para quedarse en nuestra economía.</p>
";"11/09/2015 13";"21";"16";"5";"0";"893376076";"838"
"3450";"Creación de comité específico para las nuevas ideas de crecimiento económico";"<p>Todas las ideas que surjan tanto dentro como fuera del seno municipal, que sean por parte de la ciudadanía, que se debatan y estudien de manera especial dentro de un comité que se encargue de su estudio y desarrollo.</p>
";"11/09/2015 13";"15";"12";"3";"2";"893322486";"720"
"3451";"Implantación de linea nocturna de la EMT en aravaca ";"<p>En aravaca la comunicación con el resto de madrid durante el dia es pesima puesto que solo existen 3 lineas de autobuses  en los cuales la frecuencia mas baja son 15 minutos en las horas punta,fines de semana y otras horas pasa la media hora de largo.</p>

<p>Por la noche es inexistente, en este barrio no contamos con ""buho"" EMT para poder regresar a casa despues de las 11:30 de la noche o para acercarte al centro o a otros barrios de madrid despues de las 11.</p>

<p>La unica solucion es coger el nocturno de la empresa llorente (interurbano de Pozuelo) con el consiguiente incremento del billete o abono transportes para poder hacer uso de este.</p>

<p>Por lo que pido se cree una linea de autobus nocturno que haga el recorrido del 160 o que por lo menos comunique aravaca con moncloa dando servicio a el barrio.</p>
";"11/09/2015 13";"26";"20";"6";"4";"894580885";"1076"
"3452";"Regulación de la música en comercios y locales";"<p>¿Es necesario tener música a todo volumen y la puerta abierta para vender un par de zapatos o unos pantalones? ¿De qué sirve insonorizar un local, café, restaurante o incluso discoteca, si luego abrimos la puerta y dejamos escapar un ruido infernal? </p>

<p>Estoy segura de que hay normativa al respecto pero, o bien la policía no la hace respetar, o bien es demasiado laxa. </p>

<p>Un claro ejemplo es la <strong>Calle Fuencarral  </strong>que, de un sitio desagradable y oscuro lleno de coches,  ha pasado,  mediante <strong>la engañifa de las peatonalizaciones  de Botella, </strong> a <strong>un infierno de músicas y ruidos sin freno alguno</strong>. Compadezco a los vecinos que les haya tocado vivir debajo de una tienda de ropa con la música a toda pastilla todo el día. Creo que incluso existe un informe del ayuntamiento en el que se dice que<strong> el ruido en la calle Fuencarral, lejos de disminuir, ha aumentado con la peatonalización  ... </strong></p>

<p>Otro ejemplo clarísimo son las peluquerías llamadas ""modernas"" ... donde la música está a un nivel casi de dolor que molesta a todo el mundo:viandantes, vecinos del inmueble e incluso clientes ... </p>

<p>Veo necesario pues,  crear una legislación  pensada en la convivencia y no en el enriquecimiento de los grandes comercios y, por supuesto, crear los mecanismos necesarios para hacerla cumplir.</p>

<p>Gracias por este espacio.</p>

<p> </p>

<p> </p>

<p> </p>

<p> </p>
";"11/09/2015 13";"33";"28";"5";"1";"897121563";"1951"
"3453";"Falta de alumbrado M-40";"<p>El alumbrado de la M-40 es una competencia del Ayuntamiento de Madrid, en los últimos años ha sufrido un deterioro importante debido a la falta de conservación, con lo que la mayoría de las luminarias (farolas) de la M-40 se encuentran apagadas en la actualidad con la consiguiente merma en las condiciones de visibilidad y seguridad de la vía.</p>

<p>Mi propuesta es que se restituya el servicio de las luminarias de la M-40 a fin de que mejore la seguridad para los usuarios de la vía y redunde en una reducción de los accidentes.</p>

<p> </p>

<p> </p>
";"11/09/2015 13";"30";"23";"7";"4";"894995522";"1226"
"3454";"Promocionar el deporte de base";"<p>En Madrid existen muchos equipos de portivos que tienen que subsistir con las aportaciones que hacen los padres de los niños y, en muchas ocasiones, desaparecen. Creo que el Ayuntamiento debería promover este deporte de base (fútbol sala, baloncesto, etc) de alguna manera: bajando el precio de los alquileres de pistas y polideportivos para la competición y los entrenamientos, ayudando a los clubes más desfavorecidos subvencionando el coste de las fichas en las federaciones, coordinando la formación deportiva con la formación académica de los chicos, etc. Más que nada, creo que se trata de una inversión a futuro, ya que con ello habrá más chavales  que puedan acceder al deporte de base y se alejen de otras actividades no tan sanas.</p>
";"11/09/2015 13";"36";"31";"5";"1";"897754823";"2238"
"3455";"PING PONG EN LOS SEMÁFOROS (https://www.youtube.com/watch?v=SiE7ojP5k2Y)";"<p>Propongo instalar ese tipo de juegos en los semaforos de los cruces más concurridos de Madrid, una medida barata (serían unos 10-15 cruces) pero con una repercusión enorme. En Alemania hace tiempo que se usan, pueden verlo aquí </p>

<p>https://www.youtube.com/watch?v=SiE7ojP5k2Y</p>

<p> </p>
";"11/09/2015 13";"51";"18";"33";"3";"881362840";"-529"
"3456";"Iluminación en el parque Dehesa de la Villa";"<p>Hay cientos de personas que utilizan cada día el camino de tierra que discurre por el interior de la Dehesa de la Villa perpendicular al carril bici. Sobre todo en invierno por la falta de iluminación a partir de las 5 se hace imposible andar, correr o montar en bici con seguridad. Por eso veo necesario instalar farolas, si fueran LED y con paneles fotovoltaicos mejor que mejor, para poder disfrutar de este espacio por las tardes y noches.</p>
";"11/09/2015 13";"31";"24";"7";"1";"895123341";"1316"
"3457";"Campaña especifica de alimentación para así rebajar el gasto en sanidad";"<p>Que se cree una campaña especifica de alimentación para así rebajar significativamente el gasto en sanidad. Esto es real Y LO PONGO SOLO COMO UN EJEMPLO DE MUCHOS REALES: Yo me resfriaba y cogía gripes todos los años desde que nací, y me dió por tomar batidos de limón, ajo y cebolla (si, lo sé, asqueroso) y puedo prometer que no he cogido ni un simple resfriado desde que lo tomo hace 5 años. Lo mio puede parecer extremo, pero funciona. La alimentación correcta aydua a no contraer enfermedades, por lo que si se hace adecuadamente se reducen las visitas a los centros de salud, gasto de medicamentos por parte de la seguridad social, y todas las demas enfermedades realccionadas o empeoradas por otras que con una buena alimentación se pueden evitar. Puede ser dificil de entender el gran beneficio económico, pero si se es inteligente y eficiente en la raiz de los problemas se puede ahorrar mucho dinero. solo hace falta gente inteligente y atrevida que ponga en marcha medidas que parecen absurdas pero que son las más inteligentes soluciones. Y añado, que si se baja el iva a productos que mejoran la salud, como por ejemplo los indicados por mí en este mensaje, se comprarán más y traerán relativamente un beneficio económico. Son cosas muy inteligentes y que hay que saber entender y desarrollar. Y aclaro, no soy ni agricultor ni comerciante.</p>
";"11/09/2015 13";"12";"8";"4";"0";"889583242";"266"
"3458";"Desvío de la línea 60 EMT por la calle avena";"<p>El barrio del Zofío tiene un polideportivo y un colegio. El metro más cercano se encuentra a 15 minutos, andando, por una zona bastante solitaria y oscura por la noche. Propongo que por la zona, en vez de la línea 78 de autobús (con frecuencia de 15 minutos en adelante), pase el autobús 60 (con frecuencia de 5 minutos), que viene directo desde el metro Plaza Elíptica. Simplemente sería subir por la calle Parque de la Paloma-calle Avena (colegio y Pabellón Jesús Rollán)-Ricardo Beltrán y Rozpide  </p>
";"11/09/2015 13";"12";"10";"2";"3";"893434159";"666"
"3459";"Biblioteca e instituto en Aravaca";"<p>En el barrio de aravaca tenemos dos estupendos colegios de primaria, CP Aravaca y CP Rosa Luxemburgo; en los cuales los alumnos han de irse a el municipio contiguo (Pozuelo de Alarcon) o a otro barrio de madrid como principe pio porque no existe ningun instituto publico en este bario y lo mismo pasa con una biblioteca, que tanto para que los vecinos estudien o quieran leer un libro haciendo uso de la red de bibliotecas municipales se tienen que desplazar a otro barrio.</p>

<p>Esto es una reivindicacion que se lleva haciendo en este barrio muchos años y de la cual el ayto a pasado olimpicamente como en muchos otros asuntos.</p>
";"11/09/2015 13";"26";"22";"4";"0";"896215949";"1523"
"3460";"Mayor número de cursos en Formación Profesional en la modalidad de Distancia";"<p>La comunidad de Madrid es la segunda comunidad española con menor oferta de cursos de formación profesional tienen en la modalidad de distancia tanto para grado medio como superior con tan solo tres cursos uno de grado medio (CFGM Gestión Administrativa) y dos de grado superior (CFGS Gestión de Ventas y Espacios Comerciales y CFGS Educación Infantil), solo superada por Melilla, Es la comunidad con mayor población y con mayor número de personas trabajando, se debería ampliar considerablemente la oferta de cursos de formación profesional en la modalidad de a distancia para facilitar a las personas trabajadoras la opción de seguir incrementando sus estudios.</p>

<p>Gracias por adelantado.</p>

<p>Un saludo.</p>
";"11/09/2015 13";"19";"15";"4";"3";"894077580";"868"
"3461";"Arreglar la pista de atletismo del polideportivo de Orcasitas";"<p>Querida Manuela.</p>

<p>La pista de atletismo del polideportivo de Orcasitas está en un estado lamentable. Con parches, baches, zonas levantadas y lugares donde la pista ha desaparecido. Esta pista se inauguró hace más de 30 años y nunca se ha realizado ningún arreglo en ella. En esta pista de atletismo (en la cual entrena mi hijo y yo) entrena la escuela de atletismo del mejor club de atletismo de Madrid (A. D. Marathón). Yo creo que ya se merece que se arregle la pista y dotarla de todo lo necesario para que se pueda entrenar en condiciones óptimas e incluso volver a disputar en ella pruebas oficiales de atletismo como antiguamente.</p>

<p>Ójala que esto se cumpla. Es el deseo de muchos de los atletas y padres de los chicos que allí practican este deporte. Un abrazo.</p>
";"11/09/2015 13";"32";"27";"5";"3";"897081708";"1856"
"3462";"Madrid insostenible.";"<p>Pido a todos los ciudadanos de madrid que apoyen mi proposicion. Y no es mas que se repitan las elecciones municipales en Madrid,ya que el partido que nos gobierna no es el que las gano y muchos de nosotros cambiariamos nuestro voto al ver que la izquierda mas izquierdosa gobierna nuestra querida ciudad.Si no hacemos algo pronto nuestra ciudad sera insostenible.</p>
";"11/09/2015 13";"44";"13";"31";"5";"881795260";"-531"
"3463";"dormíamos, despertamos";"<p>Este era el sencillo mensaje de la placa que firmaba Plaza Tomada y que se colocó en la acampada en Sol del 15-M.</p>

<p>La placa fue retirada (dos veces, pues se colocó de nuevo tras la recuperación de la plaza en vísperas de las generales). Imagino que al anterior Ayuntamiento no le gustaba.</p>

<p>Los símbolos son importantes, y este además era emocionalmente muy querido por muchos. Resume lo mejor del despertar ciudadano del 15-M, un momento histórico para nuestra ciudad y nuestro país cuyas consecuencias estamos viviendo hoy, en logros como conseguir recuperar el Ayuntamiento para la gente.</p>

<p>Por todo ello, os animo a sumaros a mi propuesta y pedir al Ayuntamiento que instale de nuevo aquella placa en su lugar original, pasando a formar parte del catálogo de monumentos y placas conmemorativas de la ciudad para que nadie pueda volver a arrancarla sin más. Al menos, mientras sigamos despiertos.</p>

<p>Espero conocer también las objeciones y puntualizaciones, y saber contestarlas con suficiente fundamento.</p>
";"11/09/2015 13";"33";"12";"21";"3";"882158293";"-327"
"3464";"Limpieza,Perros,Educación y Convivencia,Civismo,Gitanos. ";"<p>Vivo en el barrio de Vallecas desde hace un par de años y no entiendo el poco civismo y respeto que hay en este barrio(sin generalizar por supuesto)llamenme clasista o lo que quieran pero:Un numero muy elevado de dueños de perros considerados de raza peligrosa(por aqui los hay a cientos)los llevan sin correa y practicamente todos sin bozal,Las mascotas hacen sus necesidades en las aceras y hay se quedan,Algunas personas beben latas de alcohol y litronas y teniendo contenedores y papeleras al lado las dejan en el suelo de los bancos publicos o en los asientos de las marquesinas de bus,Comen pipas y tiran las cascaras,Dejan bolsas de basuras al lado de los arboles etc..Por todo esto esta muy sucio.Aunque se que no es popular el siguiente tema quiero añadir que un gran numero de personas de etnia gitana que masivamente realojaron sin que despues nadie les haya hecho un seguimento de reinsercion,hacen lo que a ellos les da la gana y tienen sus propias normas de convivencia con el resto de personas con lo que las aceptas o tu mismo ya que nadie se atreve a decirles nada por temor a que te aparezcan doscientos:Hacen sus fiestas con musica a todo trapo(sobre todo en verano)hasta la hora de la madrugada que a ellos les da la gana,En algunos casos tiran las bolsas de basura desde sus ventanas,Se sientan en las calles con sus amacas comen y beben y dejan los restos por el suelo etc..No pretendo molestar a nadie con lo que he escrito aqui ya que no es uba critica sobre todo con lo segundo a estas personas si no a los organismos pertinentes,esto es una realidad diaria y muchas personas del barrio piensan lo mismo que yo solo hay que preguntar por las calles.Espero que todo cambie y se instaure el respeto en este barrio tan luchador bonito y tristemente siempre castigado.</p>
";"11/09/2015 13";"30";"26";"4";"2";"897354665";"1906"
"3465";"Sobre la propia Herramienta Gobierno abierto";"<p>Toda herramienta como esta será muy bienvenida para esto pero, si no pretendemos que esto se convierta en una ILP (Que nunca van a nada) el 1% de la poblacion 54000 personas para llevar algo al pleno me parece muy pobre deveras.</p>

<p> </p>

<p>Teniendo en cuenta que, existen grandes bloques de la población que no tienen acceso a internet por motivos varios, tendriamos una participación mínima (Personas mayores propios accesos a internet de mucha gente podemos pensar hasta cierto punto que esto sería una herramienta de Apartheid político más).</p>

<p>Es necesario menos votos para llevar  a censos on-site ciertas propuestas para que sea votada por el máximo número de personas potenciales. En una palabra legitimarla más.</p>

<p>Si no corremos el riesgo de que sea una mera herramienta ""cosmética"".</p>
";"11/09/2015 13";"15";"14";"1";"0";"896027366";"1213"
"3466";"Crear Turismo";"<p>Seria muy interesante, pararse a pensar y realizar un proyecto a largo plazo para conseguir aumentar nuestra cuota de turismo y situar a Madrid en el mundo</p>

<p>Desde las rutas y monumentos clasicos hasta la nueva construcion de emblemas  Madrileños</p>

<p>El turismo, es capital para generar nuevos ingresos</p>
";"11/09/2015 13";"27";"23";"4";"0";"896532654";"1618"
"3467";"Limpieza,Perros,Educación y Convivencia,Civismo,Gitanos. ";"<p>Vivo en el barrio de Vallecas desde hace un par de años y no entiendo el poco civismo y respeto que hay en este barrio(sin generalizar por supuesto)llamenme clasista o lo que quieran pero:Un numero muy elevado de dueños de perros considerados de raza peligrosa(por aqui los hay a cientos)los llevan sin correa y practicamente todos sin bozal,Las mascotas hacen sus necesidades en las aceras y hay se quedan,Algunas personas beben latas de alcohol y litronas y teniendo contenedores y papeleras al lado las dejan en el suelo de los bancos publicos o en los asientos de las marquesinas de bus,Comen pipas y tiran las cascaras,Dejan bolsas de basuras al lado de los arboles etc..Por todo esto esta muy sucio.Aunque se que no es popular el siguiente tema quiero añadir que un gran numero de personas de etnia gitana que masivamente realojaron sin que despues nadie les haya hecho un seguimento de reinsercion,hacen lo que a ellos les da la gana y tienen sus propias normas de convivencia con el resto de personas con lo que las aceptas o tu mismo ya que nadie se atreve a decirles nada por temor a que te aparezcan doscientos:Hacen sus fiestas con musica a todo trapo(sobre todo en verano)hasta la hora de la madrugada que a ellos les da la gana,En algunos casos tiran las bolsas de basura desde sus ventanas,Se sientan en las calles con sus amacas comen y beben y dejan los restos por el suelo etc..No pretendo molestar a nadie con lo que he escrito aqui ya que no es uba critica sobre todo con lo segundo a estas personas si no a los organismos pertinentes,esto es una realidad diaria y muchas personas del barrio piensan lo mismo que yo solo hay que preguntar por las calles.Espero que todo cambie y se instaure el respeto en este barrio tan luchador bonito y tristemente siempre castigado.</p>
";"11/09/2015 13";"58";"52";"6";"3";"900628469";"4124"
"3468";"Retirada parquímetros fuera M30 (barrio La Paz y barrio de El Pilar)";"<p>Me gustaría proponer que se complete la retirada de los parquímetros que se instalaron de forma injustificada fuera de la M30 por parte del anterior consistorio.  
Se que se consiguío que se retirasen de Fuencarral, Carabanchel y Hortaleza pero los vecino de parte del barrio de La Paz (barrio 85) y barrio del Pilar (barrio 84, zona ciudad de los periodistas) seguimos pagando por un servicio innecesario, ya que en estos barrios el problema de aparcamiento se da por las noches cuando los residentes vuelven a casa, no por el día como en el centro de Madrid donde si tienen sentido.</p>

<p>gracias saludos</p>
";"11/09/2015 13";"67";"44";"23";"2";"894428927";"1379"
"3469";"Declaración en apoyo de Leopoldo López";"<p>El Gobierno presidido por Manuela Carmena debe aprobar una declaración en apoyo de Leopoldo López y del resto de presos políticos y de conciencia de Venezuela y en la que se inste a su Gobierno a dejar de perseguir a los opositores</p>
";"11/09/2015 13";"55";"34";"21";"7";"892941161";"803"
"3470";"La Iglesia tiene que pagar tributos muncipales (IAE, IBI, etc.)";"<p>Hola a todos: creo que ya es hora de que se modifique la exención que tiene la Iglesia del pago de estos tributos. La Iglesia tiene inmuebles no dedicados al culto, sino dedicados a fines lucrativos (pisos, garajes, colegios , etc.) por los que no paga ni IBI ni basuras. Y también realiza actividades lucrativas por las que quuizás debería abonar IAE,</p>

<p>Como ejemplo, podeís  imaginar qué bien estará el Sr. Rouco en su ""pisito"" de la calle BAilén , con vistas a la Sierra, sin que la Iglesia católica tenga que pagar un duro de IBI y basuras.</p>

<p>Creo que ha llegado el momento de acabar con estos privilegios y debemos exigir a este Ayuntamiento que haga todo lo que esté en su mano para que esta institución  tan ""solidaria"" contribuya como todos al sostenimiento  de los servicios publicos.</p>
";"11/09/2015 13";"124";"97";"27";"4";"900178449";"5475"
"3471";"Precios razonables para las escuelas de música municipales";"<p>En la actualidad el precio de las Escuelas de Música Municipales es tan alto que solo unas pocas familias pueden permitirse que sus hijos estudien en ellas.</p>

<p>Hubo un tiempo en que el 100% de los alumnos entraban por sorteo debido a su alta demanda, en aquel entonces el Ayuntamiento de Madrid subvencionaba una parte de la cuota. En la actualidad, muchas de esta plazas se cubren de manera libre,  sobran plazas sobre todo en los niveles más altos debido a los precios actuales que solo pueden pagar algunas familias lo que saca de la escuela a muchos niños a lo largo del curso.</p>

<p>Propongo que se vuelva a subvencionar una parte de esta enseñanzas con criterios sostenibles y en función de la renta de las familias.</p>
";"11/09/2015 13";"37";"34";"3";"0";"899392287";"2848"
"3472";"Denegación de nuevas licencias de apertura a locales no accesibles";"<p>La propuesta es sencilla, estoy cansado de ver decenas de locales nuevos que abren cada día en Madrid y que cuentan con un escalon nada más entrar, no hablo de escaleras, un simple escalón.
Por suerte no tengo problemas de movilidad pero creo que se debería obligar a todos los nuevos locales a eliminar esa simple barrera arquitectónica, no cuesta nada y facilitaría la vida a la gente mayor, gente con carritos de la compra o de niños y personas con movilidad reducida.</p>

<p>gracias</p>
";"11/09/2015 13";"28";"17";"11";"1";"890541482";"364"
"3473";"Diferencia entre botellón y beber en la calle. 600 euros por beberte una lata...";"<p>Actualmente beber una simple lata de cerveza en la calle, sin molestar a nadie, te puede costar 600 . En mi opinión esa es una sanción extremadamente desproporcionada, sobre todo teniendo en cuenta que es la misma sanción que se aplica a quienes, durante un botellón, generan ruidos molestos hasta altas horas de la noche, dejan todo lleno de basura y en ocasiones hasta rompen mobiliario urbano. Obviamente estoy completamente a favor de sancionar esta segunda actitud, pero me parece una grave injusticia castigar la primera.</p>

<p>Multas razonables para educar y no recaudar por el botellón. Una vergüenza:  340 euros si lo admites en un plazo de 10 días. 600 euros (si recurres) que se pueden incrementar a 800 euros cuando se ha dado la fase de apremio. Yo no digo que no se pague, pero que se pague una cantidad razonable y proporcionada.</p>

<p>Por eso creo que es oportuno modificar esta LEY 5/2002, de 27 de junio, sobre Drogodependencias y otros Trastornos Adictivos que se encuentra en el TITULO PRELIMINAR - Disposiciones generales. a) Las bebidas alcohólicas de graduación superior a 1 grado porcentual de su volumen subiendo y poniendo como limite 4,8 de grado porcentual para considerarlas como bebidas alcohólicas. </p>

<p>Sin mas dilación creo que es UN ROBO A MANO ARMADA A LA PERSONA QUE SE ENCUENTRA TRANQUILAMENTE SENTADA EN UN BANCO BEBIENDOSE UNA CERVEZA.</p>

<p>Ya que si seguimos leyendo lo dicho en la ley podemos encontrar lo siguiente:</p>

<p>Artículo 59.- De la cuantía de las sanciones </p>

<p>1. Las infracciones de la presente Ley se sancionarán con multas cuyas cuantías se regirán de acuerdo a la siguiente graduación: </p>

<p>a) Infracciones leves, con multa desde 300 hasta 30.050 euros.</p>

<p>b) Infracciones graves, con multa desde 30.051 hasta 60.101 euros. </p>

<p>c) Infracciones muy graves, con multa desde 60.102 hasta 601.012 euros.</p>

<p>Las leyes están para preservar el orden en la sociedad, no para andar sablando a la gente por cualquier razón totalmente carente de un componente inmoral. Si quieren recaudar que recauden pero con las personas que cometan una infracción y se lo merezcan.</p>
";"11/09/2015 13";"67";"46";"21";"2";"895388277";"1716"
"3474";"Utilizar al Atlético de Madrid y al Real Madrid como reclamos de turismo.";"<p>Organizar partidos amistosos entre el Real madrid y el Atlético de madrid, con acuerdos razonables con los clubes, que entren dentro de paquetes turisticos para incentivar el reclamo internacional. Si a una persona le incluyes en un paquete turístico un partido con entrada reservada a ese partido ""gratis"" pues va dentro del paquete y solo para turistas, se crearía un marketing excelente para Madrid y como aliciente unido a otros sería muy eficiente.</p>
";"11/09/2015 13";"37";"19";"18";"0";"885730911";"51"
"3475";"PRECIOS TURÍSTICOS";"<p>Hola,</p>

<p>todos tenemos claro, que Madrid es una ciudad Turística pero porque tenemos que ser los principales perjudicados los habitantes de dicha ciudad?</p>

<p>Por ejemplo,para ir al zoo hay que ir preparando mínimo 50  dos personas incluyerndo transporte y entrada.</p>

<p>Propogno disponer de precios especiales para habitatentes y conciudadanos madrileños, descuentos epseciales por estar empadronados.</p>

<p>Saludos y gracias</p>

<p>Rocío</p>

<p> </p>
";"11/09/2015 13";"17";"13";"4";"0";"893052863";"688"
"3476";"Regar mientras llueve";"<p>Hola, hay una cosa siempre que lo veo me llama mucho la atención y es que, hay algunas veces que mientras está lloviendo hay aspersores funcionando, con la pérdida de agua que conlleva ¿Hay alguna forma que eso se pueda controlar?</p>

<p>Gracias.</p>
";"11/09/2015 13";"45";"42";"3";"0";"900618582";"3640"
"3477";"Fomentar el voluntariado social con medidas fiscales y económicas";"<p>Todas las personas que realicen voluntariados sociales deberían de ser recompemsadas con rebajas en cosas tan simples como el abono transporte o bonos de trasporte cualesquiera, aparcamiento gratuito en zonas de pago, etc, (son solo dos ejemplos de las decenas que se pueden adoptar) para que la gente se anime a participar en un acto que hace que la propia sociedad se ayude a si misma y que no sea solo la poitica la que deba encargarse de todo pues la economía no lo está permitiendo. Todo ello con sentido común, acompañando a medidas de crecimiento y apelando a una creatividad y eficiencia práctica y real para poder mejorar la sociedad.</p>
";"11/09/2015 13";"19";"13";"6";"0";"891564560";"478"
"3478";"Declarar BIC el Palacio de la música (Gran Vía)";"<p>Declarar el inmueble como BIC evitaría que el antiguo cine, hoy en propiedad de la Fundación Montemadrid, se convirtiera en una tienda.</p>

<p>En la actualidad el inmueble puede convertirse en otra tienda si cae en manos equivocadas.</p>

<p> </p>
";"11/09/2015 13";"36";"30";"6";"1";"897342590";"2000"
"3479";"Concienciación de horarios de descanso";"<p>Plantear una campaña de concienciación sobre el ruido en los horarios de descanso en nuestra sociedad: digamos que hasta las 0h entre semana, quizás hasta la 1 de la madrugada los fines de semana, una hora después de comer... al menos para los ruidos más molestos (obras, música, gritos ...). Entiendo que tampoco hay que ser radical, pero es injusto que existan barrios ""residenciales"" en los que todos saben que no se puede hacer ruido, y luego el centro, en el que todo está permitido, venga la gente de donde venga, y puedes gritar a las cuatro de la madrugada, sin pensar que hay niños que duermen, trabajadores que madrugan ...</p>
";"11/09/2015 13";"55";"50";"5";"2";"900893965";"4090"
"3480";"Bicimad en Fuencarral-El Pardo";"<p>Creo que ya es hora de otra ampliacion del Bicimad para la gente que vive en la periferia de madrid o como minimo terminar los caariles bicis que llevan años parados que unirian todas las zonas del distrito con el centro atraves del anillo cicista o por la castellana. Seria una inverson de poco coste ya que en el distrito las calles son suficiente anchas como para poner los cariles en la calzada y tendia un impacto enorme en el trafico ya que desde el distrito ir a todas partes de madrid es bajada lo cual animaria a la gente.</p>
";"11/09/2015 14";"55";"48";"7";"4";"900014246";"3578"
"3481";"Espacio municipal como la Sala Multiusos de Zaragoza, podria ser en Legazpi.";"<p>En Madrid hay un problema con la música en directo. Estos años de burbuja han desaparecido salas medianas y solo quedan pequeñas y bastante malas o grandes pabellones que grupos medianos no tienen la capacidad de llenar pero las salas pequeñas se les quedan pequeñas. En Zaragoza tienen la sala multiusos que vale para grupos grandes o medianos. Se puede hacer en una de las naves del Mercado de Legazpi, sin que moleste a todo lo que se vaya a hacer ahí. No es normal que en una ciudad como Madrid muchos grupos no vengan porque no hay salas apropiadas. Economicamente si nos ponemos a mirar eso también sería de utilidad tanto para el ayuntamiento como para la economía general. Saludos amigos. Ah si, y que se dejen de censurar bandas de musica como si el ayuntamiento fuese la mafia siciliana.</p>
";"11/09/2015 14";"41";"35";"6";"0";"898353329";"2475"
"3482";"Promover las ""fachadas castizas""";"<p>La típica fachada madrileña de la mayoría de los edificios en la almendra central, esa con balcón de hierro forjado, balaustrada y ornamentación, debería promoverse como algo característico y muy nuestro, teniendo en cuenta, además, que la arquitectura de una gran ciudad aporta un valor añadido.</p>

<p>De esta forma, la construcción de nuevos edificios en la almendra central debería respetar, en lo relativo a su fachada, unas carcterísticas arquitectónicas definidas previamente por los arquitectos municipales de lo que podríamos llamar ""fachada castiza"".</p>

<p>Ello armonizaría arquitectónicamente el centro, dándole mas valor y creando una ciudad más visual y por tanto, más atractiva para el turismo.</p>
";"11/09/2015 14";"47";"40";"7";"1";"898846766";"2808"
"3483";"Cumplir ley anti tabaco en locales de fiesta y terrazas";"<p>En Madrid hay cada vez mas discotecas en las que se puede fumar sin que nadie haga nada por evitarlo. En cumplimiento de la ley anti tabacoy por respeto al resto de ciudadanos y ciudadanas, se deberian poner los medio para acabar con esto a traves de la la policia o las inspecciones pertinentes. Quiero recordar que la excusa de la menor asistencia si se prohibia fumar se demostro falsa con la entrada en vigor de la ley cuando si se cumplia durante los primeros meses.</p>

<p>Por otro lado, la mayoria de las terrazas en invierno, pero tambien algunas en verano, incumplen la ley anti tabaco (Ley 42/2010) al permitir los locales el fumar en terrazas que disponen de techo o mas de 2 paredes incluyendo la propia de acceso a la terraza. En este sentido, la definicion de espacio abierto donde SI se puede fumar es la siguiente: ""2. A efectos de esta Ley, en el ámbito de la hostelería, se entiende por espacio al aire libre todo espacio no cubierto o todo espacio que estando cubierto esté rodeado lateralmente por un máximo de dos paredes, muros o paramentos."" Y por lo tanto, hay que recordar que en espacios cerrados esta prohibido fumar y el incumplimiento penado con multas economicas.</p>
";"11/09/2015 14";"62";"46";"16";"6";"897157590";"2225"
"3484";"Edad única para ser ""joven"" ";"<p>Hola! Ante todo comentar que creo que hay cosas de este estilo que no son competencia del ayuntamiento si no en algunas de otros organismos, pero bueno,por algo se empieza y si esto no corresponde aquí, pido disculpas.

Cuando hablo de edad única para ser joven,me refiero a que exista una edad unica que se considere joven para todas las cosas, como puedan ser abono transportes(creo que eso es cosa de cifuentes, es decir, de la CCAA), y otros tipos de papeleos como puedan ser edad para optar a carnet joven, ser joven en contratos de trabajo o practicas,ser joven para autonomo...etc 

<strong>Insisto</strong>,no se si por parte del ayuntamiento se podría empezar a mover esto ya que entiendo que haya cosas que no dependen de ellos,pero por favor,no puede ser que para una cosa 26 años sea joven,para otras 30, etc... y yo por mi parte,pondría joven hasta los 30, sin mas. 

Saludos y gracias.</p>
";"11/09/2015 14";"17";"9";"8";"1";"886467924";"52"
"3485";"Madrid capital de rock una vez al año";"<p>Me gustaria que una vez al año en verano Madrid fuera la capital del rock como la ciudad de Wacken en Alemania, no solo supone un beneficio para el ayuntamiento en personas que visitarian Madrid sino un gran intercambio cultural, siempre hablando con un cartel de bandas bien conocidas y haciendo que el festival durara tres dias con zona de acampada, para que queremos la infraestructura de madrid rio esta abandonada es una pena pues se podria utilizar no solo para este evento sino para otras cosas.</p>

<p> </p>
";"11/09/2015 14";"45";"28";"17";"1";"892603639";"684"
"3486";"Iluminación en pasos subterráneos para vehículos";"<p>En mi opinión, la intensidad de la iluminación, especialmente a la entrada y a la salida, de un paso subterráneo para vehículos debe adaptarse a la intensidad que hay en el exterior.</p>

<p>Es muy frecuente encontrarse deslumbrado al entrar por la noche en uno de estos subterráneos y no ver nada al abandonarlo. en otros, en cambio, al entrar de día, no hay suficiente iluminación y al salir deslumbra la claridad exterior.</p>

<p>En resumen, la iluminación de estos tramos debe ser similar a la que hay en el exterior.</p>

<p>Muchas gracias por vuestra atención.</p>
";"11/09/2015 14";"22";"19";"3";"1";"896557251";"1381"
"3487";"Motos, bicis y peatones";"<p>Entre que en las aceras de más de 3m de ancho está permitida la circulación de bicicletas, se pueden aparcar las motos y los kioscos de  prensa que venden de todo y exponen sus productos, no nos queda casi espacio a los peatones que vamos con carros de compra, los que circulamos con cochecitos de niños o para personas mayores que no caminan con mucha seguridad.</p>

<p>Ya se ha hecho un carril bici se tendría que suprimirr el permiso para circular por las aceras.</p>

<p>Sobre el aparcamiento de motos se debería multar a todos aquellos motoristas que recorren varios metros por las aceras montados y en marcha. Me parece que ya está bien con que se les permita el aparcar pero que lo hagan con el motor parado y empujando la máquina.</p>

<p>Sobre los kioscos de venta de prensa que al exponer sus productos y con gente comprando ocupan más de la mitad de aceras, tendría que habilitarse una fórmula para que estos comercios ocupasen menos espacio ¡ojo! no que paguen más por ocupación sino que ocupen menos.</p>
";"11/09/2015 14";"31";"12";"19";"1";"882910794";"-270"
"3488";"Ley de Memoria Histórica. Unifiquemos criterios.";"<p>A cambio de la eliminación del nombre actual de determinadas calles de Madrid ""asociadas al franquismo"" propongo lo siguiente con respecto al ""bando republicano"":</p>

<p>- para no herir sensibilidades eliminar asimismo las calles de estos personajes; y</p>

<p>- dado que nadie es proclive a olvidar esa parte de la historia...homenajear al bando republicano poniendo sus nombres a las basuras y papeleras que con tanto ahínco solicitan en este foro. Habrá basuras para todos. </p>
";"11/09/2015 14";"38";"17";"21";"1";"883568517";"-178"
"3489";"AL CONTRAER MATRIMONIO SE OBTENGA LA SEPARACION DE BIENES";"<p>Como en otros paises y aqui en España concretamenmte en Cataluña, en el momento de contraer matrimonio sea del tipo que sea, por el juzgado o eclesiastico, se obtenga automaticamente la separacion de bienes sin necesidad de tener que hacerlo ante notario. De esta forma se evitarian problemas a la hora de una posible separacion y en caso de fallecimiento quedaria solo vigente el certificado de ultimas voluntades (testamento )</p>
";"11/09/2015 14";"41";"27";"14";"3";"893703498";"856"
"3490";"Trabajadores de calle y policía de barrio.";"<p>Hay muchas zonas en Puente de Vallecas, fuera de las calles principales, donde es conveniente la labor de los trabajadores de calle y la presencia habitual de la policía municipal.</p>
";"11/09/2015 14";"43";"37";"6";"3";"899133952";"2667"
"3491";"RESTAURACION DE LA ANTIGUA ESTACION DEL NORTE EDIFICIO PRINCIPAL";"<p>El edificio principal de la antigua estacion de Norte, <strong>(PRINCIPE PIO)</strong> se encuentra abandonado y sin ningun tipo de utilidad desde que se cerro dicha estacion. Esta en la actualidad lleno de pintadas y en muy mal estado  y conservacion. Es un edificio historco y lleno de historia, ya que esra el acceso a los tres de largo trayecto hacia el Norte de España y Galicia. Se podria dar una utilidad para que los disfruraran los madrileños y visitantes, adecuando sus instalaciones para biblioteca, centro cultural, sala de exposiciones, e incluso lugar de confererencia de cualquier tipo. </p>
";"11/09/2015 14";"68";"64";"4";"6";"903078830";"5647"
"3492";"Parques de invierno";"<p>Es necesario que el Ayuntamiento habilite lugares gratuitos, amplios y seguros donde ir con los niños durante el invierno. </p>
";"11/09/2015 15";"27";"18";"9";"0";"892770050";"600"
"3493";"Prohibido arrojar colillas.";"<p>Quede prohibido arrojar cigarrillos al suelo tanto a pie, como por supesto desde un vehículo. Ya no sólo por el riesgo de incendio, en espacios infantiles y parques que pueda haber niños que se las echen a la boca, por el tema de limpieza, vmos por todo...</p>
";"11/09/2015 15";"63";"59";"4";"1";"902741095";"5150"
"3494";"Crowdfunding para aumentar la capacidad de acogida de refugiados";"<p>En la línea de las medidas a llevar a cabo para hacer de Madrid una ciudad-refugio, el Ayuntamiento podría habilitar y gestionar un crowdfunding orientado a recibir donaciones de la ciudadanía madrileña. Este dinero se destinaría íntegramente a la acogida de familias refugiadas que huyen del horror de la guerra.</p>

<p>Así se podría incrementar la capacidad de acogida de nuestra ciudad; empoderando a la ciudadanía para ayudar, en la medida de sus posibilidades, a mitigar este terrible drama.</p>

<p>Sería también interesante extender esta vía de financiación a otras causas y a proyectos de corte social que se requieran en la ciudad.</p>
";"11/09/2015 15";"42";"11";"31";"3";"882966240";"-523"
"3495";"Compensación económica sobre la actividad contaminante.";"<p>Bien por medio de una tasa a los propietarios de vehículos a motor que residan en zonas de alta contaminación o por bonificaciones fiscales a los ciudadanos que residan en estas zonas y no posean uno de estos vehículos. Creo que es una forma de obtener fondos para contrarrestar la contaminación o compensar a los que la sufren.</p>
";"11/09/2015 15";"28";"20";"8";"0";"894189953";"857"
"3496";"Funcionarios";"<p>Marcar objetivos. Realizar valoraciones semestrales a los funcionarios. Ser polivalentes. Productivos, y por favor que les impartan cursos de atención al público con las materias (amabilidad, educación, respeto).</p>

<p> </p>
";"11/09/2015 15";"36";"26";"10";"0";"895207268";"1155"
"3497";"Vigilancia para que los puntos limpios no sean puntos sucios";"<p>Poner los medios necesarios para que los puntos limpios no se conviertan en lugares señalados donde dejar bolsas de basura a cualquier hora del día.</p>
";"11/09/2015 15";"26";"22";"4";"2";"897259564";"1523"
"3498";"Penalizar a los dueños de viviendas que estén vacías más de dos años";"<p>Como se está haciendo desde el Ayuntamiento de Barcelona. Es incomprensible que haya viviendas vacías y a la vez gente que no pueda independizarse. Que algunos propietarios se dediquen a especular con el precio de la vivienda me parece patétito y ruín, por lo que deberían darle salida al alquiler, ya sea bajando el precio o dando ayudas.</p>

<p>En lugares como Holanda, se puede ocupar un inmueble si lleva más de un año desocupado. Yo no digo de ocupar, pero si agilizar el alquiler y penalizar a los especuladores.</p>

<p>Por lo tanto propongo que haya en el Ayuntamiento un censo de viviendas en venta y alquiler, para llevar un control de aquellos inmuebles que lleven más de dos años desocupados.</p>
";"11/09/2015 15";"70";"31";"39";"4";"882678640";"-354"
"3499";"Mejoras urgentes del material de la línea 9 del Metro";"<p>Desde que malvendieron hae ya 2 años la serie 6000 al SUBTE de Buenos Aires (a dia de hoy todavia siguen parados alli), la linea 9 progresivamente se ha ido degradando con el paso del tiempo.</p>

<p>Actulamente la linea 9, esta operada los trenes de la serie 5000, sin reformar, 5500 y algunos 9400 , procedentes de la línea 10.</p>

<p>Me pareceria una gran idea, que Metro de Madrid, dedicase una partida presupuestaria a renovar  de forma urgente (Al igual que los trenes 5000 de la Línea 6), los 5000 y 5500 que operan la línea 9.</p>

<p>Gracias </p>
";"11/09/2015 15";"19";"14";"5";"2";"893776389";"663"
"3500";"CARMENA Y TODO SU EQUIPO A LA CALLE";"<p>Yo propongo que el nuevo Gobierno deje su cargo y sigan dedicandose a asaltar capillas, desear la muerte a los demás, enfrentarse a la policía y a sus manifestaciones no pacíficas.</p>
";"11/09/2015 15";"97";"19";"78";"6";"882996601";"-1155"
"3501";"Crear un servicio de atención sexual para personas con discapacidad. ";"<p>Cuando se habla de servicios sociales para satisfacer necesidades básicas se olvida que además de la vivienda, la atención sanitaria y la alimentación, el sexo supone una necesidad humana y natural que muchos no pueden satisfacer. No se trata de hacer un servicio de prostitución público a domicilio, sino de que exista personal específico en asuntos sociales que pueda ayudar mediante la masturbación a aquellas personas sean del sexo que sean cuya discapacidad les impida satisfacerlo por sí mismos y carezcan de compañero sexual que pueda hacerlo. </p>

<p>Esto que en un principio puede parecer una locura no lo es y ya se da en otras partes del mundo. En Japón hay asociaciones de voluntarios que acuden al domicilio del ciudadano que lo necesita para masturbarle. Sin embaro considero que esta necesidad no puede ser dejada a la caridad de las asociaciones ni de los voluntarios y que la satisfacción sexual es una necesidad humana tan importante física y psicológicamente hablando como la vivienda, la educación o la comida. De hecho en Dinamarca el Estado ha entedido esta necesidad como un derecho y existe una subvención específica asociada a determinadas minusvalías por las que el Estado se hace cargo del pago de profesionales sexuales especializados en la atención a personas con minusvalía. </p>

<p>Por último quiero aclarar que no propongo que los empleados de Asuntos Sociales se hagan cargo del asunto, sino que creo que habrá que convocar plazas públicas o contratar a personal especializado para tales quehaceres. </p>

<p>Un saludo. </p>
";"11/09/2015 15";"43";"28";"15";"5";"894182550";"846"
"3502";"PARALIZAR LAS AGRESIONES HOMÓFOBAS";"<p>Como todo el mundo sabe o casi todo el mundo sabe, estan aumentando las agresiones homófobas en Madrid, principalmente en las inmediaciones del barrio de Chueca, ello crea inseguridad hacia las personas LGTB que al salir del barrio, un importante número de ellas ven cohibida su condición sexual y su comportamiento, principalmente en el caso de tener pareja. </p>

<p>Con ello hago un llamamiento al ayuntamiento de Madrid para que se refuerce la seguridad u otras medidas que el ayuntamiento cree conveniente para paralizar estas agresiones y estas injusticias, principalmente fines de semana y noches que es cuando más agresiones se suelen producir. Aprovecho también para felicitar a la nueva alcaldesa por la buena gestión que esta llevando a cabo desde que fue nombrada.</p>

<p>muchas gracias</p>

<p>Un cordial saludo</p>

<p>Carlos</p>
";"11/09/2015 16";"63";"45";"18";"4";"897048232";"1928"
"3503";"Museo del Retiro";"<p>Instalar y abrir al público un Museo del Retiro en alguno de los edificios del parque (Casa de Vacas, Casa de Velázquez...) en el que se recupere la historia del Retiro, uno de los centros turísticos más visitados y concurridos de la ciudad y de los más queridos por los madrileños y madrileñas. Al margen de su historia oficial y su relación con la realeza, serviría para recuperar otras historias desconocidas que formaron parte del Retiro, como los velódromos donde se celebraron las primeras carreras ciclistas de Madrid, actividades y espectáculos en el estanque (el equilibrista Blondin, batallas navales, carreras de traineras, fuerabordas y natación, experimentos científicos, los diferentes embarcaderos...), el Teatro del Retiro, la Real Fábrica de Porcelanas, etc. Hay documentación y grabados o fotografías de todo ello.</p>
";"11/09/2015 16";"48";"41";"7";"0";"899797065";"2904"
"3504";"Regulación del precio de las ITVs y mayor control sobre los mecaninos";"<p>El precio de las ITVs es demasiado elevado para la función que realizan, está bien que exista un control sobre el estado de los vehículos, pero el actual sistema es ineficaz y un negocio muy negro, si eres amigo, familiar de compañero, policía...te la pasan a menos que tengas el coche completamente destrozado, mientras que a una persona normal le sacan todos los fallos.</p>

<ol>
	<li>EL precio debería estar fijado por el ayuntamiento, y para mí, debería rondar los 10 o 15 euros, por no decir que debería ser gratis ya que es seguridad para todos los ciudadanos, tanto los que conducen como los que no.</li>
	<li>Debería haber mucho más control sobre los operarios para que no puedan omitir errores en el vehículo por ser de un familiar o amiguete.</li>
</ol>
";"11/09/2015 16";"23";"20";"3";"0";"897422604";"1478"
"3505";"Aprobación del Distrito Castellana Norte (Operación Chamartín)";"<p>Creo que ya es hora de que se apruebe tras 20 años la operacion Chamartin, lo cual daria 120.000 empleos directos y llenaria las arcas del ayuntamiento que tan necesitadas estan para realizar servicios sociales para los mas necesitados, es mentira que tendria un coste para el ayuntamiento ya que los terrenos al ser del ayuntamiento tienen por decirlo de alguna manera un coste de alquiler para las constructoras.</p>
";"11/09/2015 16";"89";"55";"34";"5";"895088107";"1297"
"3506";"Recuperar la primera carrera pedestre de Madrid";"<p>Recuperar el recorrido de la primera carrera pedestre que se disputó en Madrid el 23 de abril de 1905, con un trayecto de ida y vuelta entre la plaza de Colón y la actual plaza del Duque de Pastrana (antigua plaza del pueblo de Chamartín de la Rosa). La prueba se celebró durante cuatro años hasta 1908, pero el recorrido se mantiene igual que entonces, con subida por el paseo de la Castellana y el paseo de la Habana hasta la plaza del Duque de Pastrana, en el distrito de Chamartín. Bautizar la prueba como ""Memorial Manuel Rodríguez Arzuaga"", en memoria de su impulsor, el mecenas deportivo Manuel Rodríguez Arzuaga.</p>
";"11/09/2015 16";"21";"12";"9";"1";"889672377";"171"
"3507";"Devolver las abejas al Abejero del Parque de El Capricho";"<p>El Abejero de El Parque de El Capricho es un edificio único. Una construcción de recreo que se creó para el goce y esparcimiento de sus visitantes, el desarrollo e  interés por la ciencia y la naturaleza, y como una eficaz herramienta para polinizar el jardín y campos aledaños.</p>

<p>Recientemente restaurados su interior y fachada, sólo faltaría dotarle de su uso original: las colmenas de observación que desde hace años nuestra asociación de Apicultura Urbana de Madrid (http://www.mieldebarrio.wordpress.com) reclama al Ayuntamiento de Madrid.</p>

<p>Con ello, se conseguiría devolver a su uso original este singular hito urbano, se podrían organizar visitas, crear uncentro de investigación, etc. Incluso se podría solicitar su inclusión en la lista de edificios patrimonio de la humanidad a la UNESCO, debido a sus espaciales caracerísticas y uso original. Siendo el único edificio de esa lista en la ciudad de Madrid.</p>

<p>Por favor, apoyen esta iniciativa a favor de la Apicultura Urbana en Madrid.</p>
";"11/09/2015 16";"54";"50";"4";"1";"902211700";"4259"
"3508";"Excrementos en parques y zonas infantiles.";"<p>Me gustaría que los parques  infantiles, zonas de recreo y zonas verdes fueran usadas por todos los ciudadanos con respeto y cuidado pero como no es así el ayuntamiento debería tomar medidas, ya bien sea a través de multas o mayor vigilancia o el método que mejor llegue a su fin. Pero es vergonzoso llevar a nuestros hijos a los parques y además de jugar con el cubo y la pala lo hagan con los excrementos de los perros con los consiguientes y hasta graves problemas de salud que pueden producir en nuestros pequeños. Hablo de la zona de Arganzuela, pero me imagino que es un problema que se extiende a todo Madrid y que se produce en todos los parques pero sobretodo en parques tranquilos con poco trasiego de gente y de tráfico donde dueños poco civilizados dejan pasar a sus perros a zonas donde no deben y hacen allí sus necesidades. </p>

<p>Por favor, solucionen estos problemas por higiene y salud. </p>

<p>Muchas gracias</p>
";"11/09/2015 16";"90";"86";"4";"1";"905110418";"7835"
"3509";"¿Que les pasa a los trabajadores sociales del Centro Social Pablo Casals?";"<p>He acudido a él desde que mis padres, por degracia, cayeron enfermos. Nunca han acudido a su domicilio para comprobar su situación y siempre me han dado malas contestaciones, entre ellas, que fuera a contratar a alguien a la iglesia, o que venda o alquile mi casa.¿Quien recibe las ayudas?, un ejemplo es el de alguna vecina que tiene 50 horas de ayuda a domicilio, pero en nuestro caso, mi padre con EPOC y aparato de oxígeno desde hace 12 años y mi madre enferma de Alzheimer con un grado 3 de dependencia, nada de nada.</p>

<p>Ahora ya nos obligaron a pedir la Ley de Dependencia, pero el Ayuntamiento se ha ahorrado un montón en ayudas para mis padres. La única que ha soportado los gastos he sido yo, su única hija, menos mal que les he salido medianamente buena (creo yo) porque no los he abandonado a la suerte del Ayuntamiento de Madrid.</p>

<p>Por cierto, hoy he visitado a la Trabajadora Social, y no ha cambiado nada, como si hablara con una pared. Gracias.</p>
";"11/09/2015 16";"18";"16";"2";"0";"897015460";"1244"
"3510";"PUBLICIDAD EN ANDAMIOS";"<p>Con la excusa de las obras dueños de los edificios del centro de Madrid reciben cantidades ingentes de dinero, afeando la ciudad y perpetuandose sin motivo, cometiendo lo que se llama un fraude de ley. Y ahora que vienen las navidades más.</p>

<p>El Ayuntamiento debe prohibir dichos anuncios, aunque cobre una exhigua tasa por ellos, que tanto afean la ciudad y eternizan las obras para mal de los vecinos, viandantes y belleza de la ciudad y que solo benefician a los dueños de esos edificios (normalmente empresas) y publicistas.</p>

<p>Basta que el arquitecto municipal verifique la duración que tiene que tener una obra y comprobar que se pide la publicidad por muchos más meses que dicha duración.</p>

<p>¿Cuántos meses lleva el edificio Metrópolis, una de las imágenes emblemáticas de Madrid, cubierto por publicidad? ¿Hasta cuando va a durar? Hasta que el Ayuntamiento quiera.</p>

<p> </p>

<p>Más información aquí:</p>

<p>http://elpais.com/diario/2010/08/27/madrid/1282908255_850215.html</p>

<p>http://www.elmundo.es/elmundo/2007/06/15/suvivienda/1181924450.html</p>

<p> </p>
";"11/09/2015 16";"25";"18";"7";"2";"894501859";"792"
"3511";"Legislación música callejera";"<p>Creo que se debería revisar la legislación municipal en cuanto a la música callejera en varios aspectos.</p>

<p>1. Se prohibe la percusión y la amplificación, por ejemplo, de guitarras, en cambio cualquier viento puede tocar libremente. No es cuestión de instrumentos sino de decibelios. Hay que limitar el exceso de ruido pero no a costa de sacrificar ciertos instrumentos que por el ruido ambiente de la calle no se oyen.</p>

<p>2. Habilitar algún momento y lugar determinados para que se pueda tocar libremente, por ejemplo, las plazas los domingos por la mañana.</p>

<p>3. Aunque la mejor prueba es el gusto del público, no me parece mal que se realicen pruebas para tocar en la calle, pero que exista la posibilidad de solicitar el permiso en cualquier momento o que haya pruebas periódicas.</p>

<p>Por último, comentar que todo músico o artista necesita un público, que muchas veces tocamos por amor al arte y con riesgo de ganarnos una multa y que a mucha gente le agrada encontrarse música por la calle.</p>
";"11/09/2015 16";"39";"32";"7";"1";"898405406";"2051"
"3512";"Farolas LED con cobertura 4G";"<p>Hoy he leido una noticia, que en Santander han instalado unas farola LED que también dan cobertura móvil. http://www.xatakamovil.com/conectividad/las-farolas-4g-llegan-a-espana-de-la-mano-de-ericsson</p>

<p>Creo que es una buena idea, para desmontar las antenas existentes, sustituir las farolas por otras que hagan menos gasto y den servicio móvil. Pudiendo aprovechar, para llegar a acuerdos con los operadores móviles, para que sufragan el gasto del cambio.</p>

<p>Tendríamos doble servicio, luz y cobertura y el gasto le correspondería al operador u operadores.</p>
";"11/09/2015 16";"36";"25";"11";"1";"894935646";"972"
"3513";"Crear empresas que sean capaces de crear luz con energías renovables.";"<p>Algunos países ya tienen disponibles la luz renovable gracias al sol y a las energías renovables. Por eso, podemos crear unas empresas que sean capaces de producir energías renovables para así, formentar el crecimiento de la economía y para paralizar el proceso de las energías contaminantes. Así, podremos ahorrar dinero y formentar el buen uso de las energías que tenemos disponibles en el mundo. Además, gracias al sol podemos aprovecharlo para hacer que las casas tengan luz con energías renovables.</p>

<p> </p>

<p><strong>¿ Qué necesitamos ?</strong></p>

<p><strong>- Parques eólicos</strong></p>

<p><strong>- Placas solares</strong></p>

<p><strong>- Y sobre todo, una empresa capaz de iniciar el proyecto energías renovables.</strong></p>

<p>Proceso:</p>

<p>1. Instalar nuevos ventiladores y parques eólicos cerca de la empresa.</p>

<p>2. Instalar nuevas placas solares en la empresa</p>

<p>3. Y sobre todo, esa energía recogida se transladará a los aparatos que promueven la energía y que producen la luz.</p>

<p><strong>BENEFICIOS:</strong></p>

<p>* Las personas podrán ahorrar un 20% en las facturas</p>

<p>* Disminuirá la contaminación</p>

<p>* Disminuirán las energías contaminantes.</p>

<p>* La luz será natural y no será contaminante</p>

<p>* Gracias a estas centrales, podrán parar el cambio climático.</p>

<p>* Y sobre todo, que la ciudad notará muchos beneficios, por ejemplo: Disminuir los índices de contaminación en los días de sofocante calor.</p>

<p>* Los animales vivirán mejor y la naturaleza se recuperará (lentamente, aunque los cambios se notarán)</p>

<p>* Y una cosa impresionante: La empresa crecerá más.</p>

<p>¿<strong>Os gusta la iniciativa</strong>?</p>

<p> </p>
";"11/09/2015 16";"30";"27";"3";"1";"899447411";"2160"
"3514";"Cambiar la estatua de Carlos III de Sol  por Otra a los Caídos por los Recortes ";"<p>Cambiar la estatua de CarlosIII de Sol por una escultura conmemorativa en honor a todos los ciudadanos españoles y europeos caidos(deshaucios, suicidios) por los recortes sociales a toda la ciudadanía y el empobrecimiento de toda la clase media en aras del rescate minoritario de bancos privados y grandes fortunas de los conservadores españoles y europeos con los recursos de toda la ciudadanía. Esta celebración podría celebrarse en todas las Capitales Europeas y en España podría ser el 12 de Ocubre. </p>
";"11/09/2015 16";"47";"9";"38";"2";"884110643";"-555"
"3515";"Crear servicios de urgencia para viajes largos.";"<p>Mucha gente hace viajes largos, porque va de vacaciones, o bien, a un camping. Mayoría a veces tienen que asear y no saben donde hacerlo, y lo hacen en la calle. Esto parece ser un problema más grave de lo que pensamos, ya que ensuciaría mucho la ciudad y la ciudad tendrá un olor a orina. También, algunos hacen excrementos en la calle y después huelen mal.</p>

<p>Para solucionar este problema, tenemos que crear servicios de urgencia necesaria, para que así la gente que no pueda aguantarse en los viajes largos pueda hacer sus necesidades en esos servicios especiales. No son difíciles de crear y además, formentarían un mejor uso de la calle.</p>

<p>Además, supondría muchos beneficios a Madrid como un mejor uso del medioambiente y sobre todo, la ciudad estaría limpia y sin olores malos.</p>
";"11/09/2015 16";"16";"7";"9";"1";"885886295";"-87"
"3516";"Ayudar a que las pequeñas librerías no mueran";"<p>Buenos días.</p>

<p>Creo que sería interesante abrir un debate para ver cómo se puede ayudar a las pequeñas librerías de Madrid, que están desapareciendo a toda velocidad porque no pueden competir con las grandes superficies comerciales. No sólo por el valor del conocimiento y la experiencia que el librero comparte con nosotros; ni tampoco para no entregar a los grandes oligopolios la totalidad del negocio del libro, sino también porque, en sí mismas, las pequeñas librerías son espacios preciosos, de creación, charla e intercambio, que tenemos que cuidar.</p>

<p>¿Qué medidas se os ocurren que podrían ayudar en este sentido?</p>

<p>Un saludo.</p>
";"11/09/2015 16";"52";"38";"14";"3";"897253132";"1753"
"3517";"Poner más papeleras y cubos de basura.";"<p>A veces, mucha gente no tiene a disposición una papelera para tirar los papeles y mayoría los acaban tirando al suelo. Este problema es debido a que el número de papeleras en la ciudad y en los campos de Madrid son muy limitados y muy pequeños.</p>

<p>Por eso, para acabar este grande problema que hace que la ciudad siempre esté sucia, se necesitan poner más papeleras y más cubos de basura para que la gente tenga a disposición una papelera cercana para tirar los papeles, o bien, un chicle o un plástico. Además, mucha gente también tiene que tirar los cubos de basura y no los pueden tirar, bien, porque no hay un cubo de basura cercano a su casa, o también, porque mayoría están llenos y no permiten más objetos y bolsas. Para solucionar este problema, se necesitan poner más cubos de basura y sobre todo, que sean más grandes, porque mayoría son algo pequeños y eso hace que el problema se agrave aún más.</p>

<p>Beneficios:</p>

<p>1. La ciudad estaría más limpia</p>

<p>2. La ciudad estaría como nueva</p>

<p>3. La ciudad no tendría tantas cosas al suelo</p>

<p>4. La gente podría tener a disposición una papelera</p>

<p>5. Y sobre todo, el medioambiente estaría mejor.</p>
";"11/09/2015 16";"35";"29";"6";"3";"898470480";"1905"
"3518";"Techos verdes y Jardines Verticales. Naturalización urbana en Madrid.";"<p>Implantar techos verdes y jardines verticales en la ciudad de Madrid de forma intensiva. Como medida de lucha contra la insostenibilidad del modelo urbano actual. Iniciar un proceso de transición estructural hacia un modelo de ciudad sostenible y de calidad. La naturalización urbana y la recuperación de la biodiversidad es una herramienta fundamental en la rehabilitación de zonas residenciales en una transición necesaria hacia ecobarrios, frente a los desfases generados por el desarrollo urbano basado en el ladrillo, el asfalto y el hormigón. </p>

<p>La naturalización urbana también está vinculada a la necesidad de recuperar los espacios comunes como elementos de gestión vecinal, donde jardineras, parques, solares o jardines puedan ser transformadas en espacios de encuentro y participación ciudadana, generando tejido social, cultura cívica y solidaridad. Espacios funcionales a las necesidades vitales de los vecinos que incentiven la participación vecinal a través de huertos urbanos, huerto-jardineras, parques caninos, centros culturales y zonas deportivas...  </p>

<p><strong>Beneficios para el ecosistema</strong></p>

<ul>
	<li>Retención del agua pluvial (reducción de la probabilidad de inundaciones y aprovecha recursos hídricos)</li>
	<li>Reducción de emisiones de CO2 y de combustibles fósiles (ahorro energético)</li>
	<li>Reducción del efecto isla de calor (calor absorbido por superficies edificadas e irradiación posterior aumentando la temperatura ambiente)</li>
	<li>Mejora del clima urbano. Reduce el calor atmosférico y favorece la humedad ambiental.</li>
	<li>Reduce la contaminación atmosférica. La vegetación sirve como filtro natural que absorbe gran parte de las partículas en suspensión mejorando la calidad del aire.</li>
	<li>Espacio vital adicional. Aprovechamiento de superficies adicionales como las edificaciones verticales y los techos-azoteas para crear biodiversidad.</li>
	<li>Corredores de biodiversidad que sirven de hábitat de fauna local y de especies migratorias.</li>
	<li>Reducción de la dependencia de combustibles fósiles y aprovechamiento de recursos propios (biomasa)</li>
</ul>

<p><strong>Beneficios económicos</strong></p>

<p>Ahorro y eficiencia en el control del gasto:</p>

<ul>
	<li>Reducción consumo eléctrico y combustibles fósiles.</li>
	<li>Reducción dependencia exterior</li>
	<li>Reducción costes sanitarios derivados de la mejora de calidad ambiental y la reducción de la contaminación</li>
	<li>Mayor disponibilidad de recursos económicos para invertir</li>
	<li>Sector de Mercado emergente I+D+i, innovador y sostenible</li>
	<li>Creación de trabajo directo e indirecto</li>
	<li>Reconversión del sector de la construcción</li>
	<li>Revalorización urbana potenciando comercio local y turismo</li>
</ul>

<p><strong>Beneficios sociales</strong></p>

<ul>
	<li>Embellecimiento arquitectónico</li>
	<li>Concienciación ambiental</li>
	<li>Mejoras equipamientos colectivos</li>
	<li>Bienestar psicológico y amabilización del paisaje urbano</li>
	<li>Espacios comunes y participación ciudadana (tejido social)</li>
	<li>Mejora de la salud pública</li>
	<li>Colectivización de lo público e instituciones sociales funcionales</li>
	<li>Soberanía alimentaria</li>
</ul>

<p><strong>Beneficios particulares para el uso residencial</strong></p>

<ul>
	<li>Eficiencia energética y ahorro económico.</li>
	<li>Regulación térmica del edificio (oscilación térmica)</li>
	<li>Reducción de la erosión de las fachadas por radiación solar</li>
	<li>Mejora de la evapotranspiración del edificio</li>
	<li>Embellecimiento y revalorización de la propiedad.</li>
	<li>Aprovechamiento de las fachadas y azoteas para usos alternativos.</li>
	<li>Aprovechamiento de aguas pluviales.</li>
</ul>
";"11/09/2015 16";"103";"96";"7";"5";"905285395";"8295"
"3519";"Harto,Astiado,Cansado del ruido en centro,municipales de paisano.";"<p>Cansado del ruido que desde el jueves a domingo noche,por culpa de gente que se comporta mas irracionalmente que un animal,rompiendo botellas,dando patadas a los coches,tirando cubos de basura,gritando como si estuvieran en un campo de futbol,harto del botellon incontrolado.Toda mi vida llevo viviendo en la calle Toledo de Madrid,siempre he conocido garitos y practicamente nunca hemos tenido problemas en la zona,hasta que al gobierno del PP,se le ocurrio la brillante idea de dar licencia a una discoteca,antes antiguo teatro en el centro de Madrid,tiene cientos de denuncias,una sala donde pueden entrar 2000 personas,con todo lo que ello conlleva.He llamado muchas veces a la policia municipal,por el tema del botellon,suelen venir,pero al aparecer con coches patrullas,la gente los ve y tiran las botellas debajo de los coches,logicamente al llegar,parecen que no han roto un plato en su vida,esto ocurre desde la fuentecilla (vergonzoso como se pone la fuente de gente hasta altas horas de la madrugada) hasta calles aledañas,asi que pido al ayuntamiento de Madrid,que la Policia pueda patrullar con coches de incognito y de paisano,a ver si de una vez por todas,gente mayor,niños y demas personas podemos dormir en paz,gracias.</p>
";"11/09/2015 16";"55";"48";"7";"4";"901239189";"3578"
"3520";"Por un comercio local rico y diverso";"<p>Hola a todos,</p>

<p>Seguro que aquellos de vosotros, visitante o residentes en el centro de Madrid (aunque cada vez más presente en otros barrios), os habréis dado cuenta que la dinámica del comercio de los últimos 10 años es que cierran comercios tradicionales y abre un 'alimentación' o 'ultramarinos'. </p>

<p>Como tal, me parece que se está perdiendo la diversidad y riqueza del tejido comercial local, si vais por Malasaña, Lavapiés o La Latina, puedes llegar a encontrar hasta 6 tiendas de alimentación por calle.</p>

<p>¿En serio hace falta? ¿No podría regularse la apertura de nuevos comercios cuando ya existe multitud de negocios iguales?</p>

<p>Si tuviera que abrir un comercio, nunca lo haría al lado de uno igual, sin embargo en estos barrios se está dando este proceso.</p>

<p>Por un comercio local diverso y de valor añadido, regulación de apertura de negocios según tipología de negocios cercanos, ya.</p>
";"11/09/2015 17";"63";"51";"12";"2";"900065344";"3157"
"3521";"Autobuses con recorrido más largo";"<p>En Madrid existen muchas líneas de autobús que crean un entramado muy tupido, sin embargo, muchas de esas líneas tiene un recorrido verdaderamente corto, casi inútil para algunos de los vecinos. Por ello, propongo la creación de unas líneas que vertebren Madrid, como las líneas nocturnas (los búhos), que por el mismo precio hacen un recorrido verdaderamente útil para los usuarios. Es más, podrían crearse líneas que unan los diferente puntos cardinales de Madrid pasando por el centro, por ejemplo del este (Alameda de Osuna o Barajas) al oeste (Moncloa o Príncipe Pío) y del norte (Plaza Castilla) al sur (Villaverde o Aluche) de Madrid.</p>
";"11/09/2015 17";"30";"24";"6";"0";"897177160";"1440"
"3522";"Descuentos en parquímetros a profesionales con horarios poco habituales";"<p>Soy técnico de sonido y vivo en Leganés. Muchos días me ocurre que tengo que ir a Madrid a trabajar a eso de las 17:00 y salgo de madrugada, con lo que no puedo coger la Renfe porque acaba a las 12 y el metro me hace tardar una hora y media en llegar a casa. Además tenemos el inconveniente de que en mitad de la prueba de sonido o del preparativo del evento hay que ir a cambiar el tique o llevarse el coche a otro barrio porque en ese ya no se puede. Por favor arreglen esto y busquen una solución, que no hay derecho a dejarse un 10% del sueldo en estacionar el coche o 2 horas y media en transporte público. Gracias.</p>
";"11/09/2015 17";"34";"14";"20";"0";"883938326";"-247"
"3523";"Museos públicos gratuitos.";"<p>Por lo menos con un carné de identidad Español. El patrimonio cultural es de todos, lo mantenemos todos y lo disfrutamos todos.</p>
";"11/09/2015 17";"64";"51";"13";"3";"899834357";"3028"
"3525";"Fomento de una cultura de innovación local";"<p>Ayudas municipales para pequeños emprendedores innovadores (que aporten valor añadido a un sector).</p>

<p>Por ejemplo por industria: agroalimentaria (i.e. cerveceras artesanas), restauración (i.e. nuevos conceptos de hostelería), tecnología (i.e. startups digitales), etc.</p>

<p>La provisión de espacios colaborativos de trabajo, en los que los emprendedores puedan recibir asesoramiento gratuito por parte de expertos legislativos, financieros o contables. </p>

<p>La concesión de micro-créditos y subvenciones condicionadas a la creación de empleo y valor (ingresos que repercuten en el ayuntamiento en forma de impuestos sobre el volumen de negocio generado).</p>
";"11/09/2015 17";"37";"30";"7";"0";"898261667";"1864"
"3526";"Concursos públicos que valoren a las empresas que favorezcan la igualdad";"<p>Las Administraciones Públicas, haciendo uso de sus competencias y con el fin
de avanzar en la igualdad efectiva de mujeres y hombres en el mercado de trabajo
pueden establecer determinadas cláusulas de contratación que favorezcan, de una
forma indirecta, una mejora en las condiciones laborales de las mujeres. Es el Artículo
33 de la Ley Orgánica 3/2007, de 22 de marzo.</p>

<p>Entre otros aspectos que pueden ser valorados se encuentran:
- Las medidas de conciliación de la vida personal, laboral y familiar.
- Las medidas de responsabilidad social de la empresa.
- La obtención del distintivo empresarial en materia de igualdad: Igualdad en la
Empresa.</p>

<p>Ejemplo:</p>

<p>El Ayuntamiento de una localidad ha establecido en el pliego base de las
contrataciones municipales que se valorará las ofertas de empresas que favorezcan la
paridad en sus plantillas. Además, aquéllas entidades sancionadas por trato
discriminatorio no podrán optar a ayudas. En concreto, considera que la configuración de
una plantilla paritaria en las ofertas de las empresas que concurran a licitaciones en el
Ayuntamiento sumará puntos.</p>

<p> </p>

<p>Ejemplo :</p>

<p>Que la licitación no permita presentarse a empresas que no tengan el distintivo empresarial en materia de igualdad: Igualdad en la
Empresa. O que dote de muchos puntos a las empresas que lo adjunten en el pliego del concurso público.</p>

<p> </p>

<p>Así favorecemos que ninguna empresa que discrimine a las mujeres sea adjudicataria de un concurso público.</p>
";"11/09/2015 17";"46";"27";"19";"1";"892611189";"469"
"3527";"instalar dee nuevo o réplica de los templetes del metro de Antonio Palacios ";"<p>La idea seria levantar de nuevo los templetes del metro de Antonio Palacio.Que estaban en La Red de San Luís (Estación de Gran Vía) y en Sol.Que se hicieron cuando se hicieron la linea 1.Fueron quitadas hace décadas.Tenían gran valor de tipo arte deco,.Hace unos años.Cuando la reforma de La Red San Luis,iban a poner una réplica.Que se iba a utilizar como oficina de turismo.Pero al final no la pusieron.Sería buena de volver a recuperar esa idea.</p>
";"11/09/2015 17";"31";"25";"6";"5";"897826899";"1532"
"3528";"Instalar un monumento o fuente en el centro de la Plaza del Callao";"<p>Con la última reforma se ha convertido en una plaza bastante dura.Sin ningún tipo de decorativo.Ya que solo se utiliza para poner puestos y la pista de hielo en navidades.Estaría bien poner un monumento o una fuente, para que la plaza fuese mas amena y agradable</p>
";"11/09/2015 17";"32";"20";"12";"2";"893177514";"500"
"3529";"Eliminar el paso inferior de la Cuesta de San Vicente, Bailén,Plaza España";"<p>Por ser horrible,antiestético,suciedad,contaminación de coches,inseguro, rejugio de indigentes y destroza el entorno del Palacio,Plaza España,Parque del Oeste,Jardines de Sabatini,Campo del Moro y Madrid Rio.</p>

<p>Lo suyo.Sería ampliar,el túnel de Bailen hasta la Calle Ferraz y Paseo de Rosales.Y convertirlo en peatonal y jardines.Así uniendo la Plaza Oriente,España y el Templo de Debod.</p>
";"11/09/2015 17";"52";"40";"12";"1";"898598646";"2153"
"3530";"Conocer la decisión del nuevo ayuntamiento sobre las obras de Azca";"<p>Antes de que finalizase la anterior legislatura, con el anterior equipo del ayuntamiento, se plantearon unas obras de remodelación y saneamiento en los patios y escaleras de cemento que bordean el edificio de Azca.</p>

<p>Necesitan un buen saneamiento, porque las losas de cemento se caen por momentos, los escalones se tambalean y en general está todo hecho un asco.</p>

<p>No pretendo que se invierta en una obra faraónica si no lo desea el ayuntamiento, ni un lujoso nuevo centro comercial ni nada por el estilo, sino algo básico porque las losas y baldosas están muy desgastadas. Si quieren hacer algo parecido a lo que dejó proyectado el anterior ayto, me vale, pero si no por lo menos que hagan lo básico.</p>

<p>¿Se podría saber si esas obras se acometerán después de valorarlas por el nuevo gobierno o acaso las han cancelado?</p>
";"11/09/2015 17";"21";"19";"2";"0";"898597960";"1538"
"3531";"Construir nuevos parques de entretenimiento para los niños o renovarlos.";"<p>Lo mejor que un niño puede tener es un parque. Es un lugar de muchas personas, diversión y de entretenimiento. Sin embargo, algunos de estos parques pueden destrozarse con el paso del tiempo y mayoría de la construcción está rota y con deteriodos. Para solucionar esto, necesitamos un equipo que sepa hacer parques nuevos para que el parque no esté roto. Además, algunos de los parques de Madrid están con problemas y con grietas.</p>

<p>Si ya hay un equipo, por favor, queremos que Ahora Madrid pida a ese equipo reconstruir los parques y hacer otros nuevos, para que no falten parques y sobre todo, que no estén rotos o deteriorados. Gracias a esta reforma, muchos de los parques de diversión de Madrid podrían estar siempre en buen estado y en buena conservación. Este problema está aumentando mucho en Madrid.</p>
";"11/09/2015 17";"26";"17";"9";"1";"893498740";"523"
"3532";"Devolver los anteriores colores de los taxis de Madrid";"<p>Que vuelvan ser negros con la franja horizontal roja.Son más característicos,personalidad y mas llamativos.Como pasa en los de Barcelona,Nueva York o Londres.</p>
";"11/09/2015 18";"60";"31";"29";"8";"890471353";"103"
"3533";"Modernización e implementación de cubos de reciclaje";"<p>Actualmente algunos distritos cuentan con contenedores de basura rotos y muy deteriorados. Además el número de contenedores ha ido bajando y algunos fines de semana es mucha la cantidad de basura que se acumula en el suelo y los aledaños de los contenedores.</p>

<p>Añadido a esto contenedores como el de Vidrio y papel son muy escasos y la gente se ve obligada a andar 5 o 6 calles hasta encontrar uno. A priori no supone un problema, pero a la gente discapacitada o mayor se le hace casi imposible seguir reciclando si tienen los contenedores a una distancia tan lejana de su domicilio.</p>

<p>Me gustaría solicitar la implementación de más contenedores, sobretodo de vidrio y papel y el cambio de a algunos contendores de basura y envases que hay actualmente. Añadir además algunos de estos últimos en algunas zonas, sería muy conveniente también.</p>
";"11/09/2015 18";"39";"34";"5";"3";"900391215";"2528"
"3534";"Huerto urbano / museo agrícola en AZCA";"<p>Creo que el parque de AZCA se encuentra muy descuidado y bastante infrautilizado. Qué os parecería crear un gran huerto que tuviera un uso aparte de lúdico, también docente, donde los colegios puedieran realizar excursiones y acercar el campo a los niños de esta ciudad. Además, creo que el contraste con los rascacielos generaría una gran belleza al lugar, desplazando la imagen eminentemente comercial y laboral que tiene la zona.</p>
";"11/09/2015 18";"34";"18";"16";"0";"889224737";"105"
"3535";"ARREGLO Y LIMPIEZA EN CARABANCHEL";"<p>Estan las aceras muy viejas y levantas en algunas zonas del barrio, es un barrio muy poblado y no es la primera vez que hay algun susto con eso, ademas de que no estaria de mas algo de limpieza en las calles.</p>
";"11/09/2015 18";"61";"58";"3";"3";"904252671";"5229"
"3536";"Fomentar el uso de coches eléctricos en el centro de Madrid";"<p>Fomentar el uso de coches eléctricos dentro del anillo de la m30. Un subidón para la industria del automóvil y otro para la calidad de vida. No vale con poner un enchufe, hay que dar ayudas para que la gente pueda cambiar su coche por uno eléctrico. Aúnque es obvio, se reduciría drásticamente el ruído y la contaminación del aire.</p>
";"11/09/2015 18";"62";"49";"13";"1";"899984604";"2845"
"3537";"Mejorar la parada de autobús Recoletos-Cibeles en sentido norte";"<p>La parada de autobús se encuentra en el lateral del paseo de Recoletos, que en ese tramo está compuesto por una acera minúscula, un carril bus y dos carriles de circulación en sentido Colón, uno de ellos ciclocarril. La estrecha acera no permite por motivos físicos la instalación de una marquesina, por lo que esta ha sido sustituida por dos postes. El PMV (panel que informa del tiempo de espera del autobús) está situado al otro lado de la calzada, por lo que puede resultar difícil verlo para personas mayores. Por ello sugiero quitar un carril de circulación  y en ese espacio, instalar una marquesina con PMV. </p>
";"11/09/2015 18";"21";"18";"3";"0";"897827213";"1285"
"3539";"Barrios verdes ";"<p>Ciudad LIneal es un barrio de Madrid con muchas diferencias. Una de ellas son las zonas verdes. Simplemente con cruzar una plaza (la plaza de las dos fuentes antigua Cruz de los Caidos) para ver la diferencia de barrios y de ajardinamiento. Mientras los vecinos de Arturo Soria tienen sus calles limpias y verdes, los vecionos de H. García Noblejas solo pueden disfrutar de un jardín que no se puede utliizar en medio de la avd. Desde la calle Alcala hasta Largo Caballero hay zonas de tierra que en primavera se llenan de malas hierbas convirtiendose en verano en un secarral. No se cual es la solución, podría ser ajardinar o crear huertos hurbanos. Creo que con una pequeña inversión nuestros barrios pueden ser más sostenibles, más verdes, más limpios sin que haya tanta diferencia entre los barrios pudientes y los humildes.</p>

<p>Muchas gracias</p>
";"11/09/2015 18";"41";"38";"3";"1";"902124996";"3243"
"3540";"colocación de cámaras de seguridad en toda la ciudad";"<p>Colocación de cámaras de seguridad en la vía pública de la ciudad al objeto de prevenir y en su caso reprimir posibles delitos. Hoy en día cualquier particular con un móvil tiene derecho a tomar imágenes nuestras en la vía pública  para cualquier proposito y nadie se escandaliza, pero cuando está captación de imágenes se realiza para nuestra seguridad de manera señalizada, por funcionarios públicos y para unos fines determinados, todos invocamos el derecho a la intimidad. Señores seamos coherentes o se niega la captación de imágenes a cualquiera en vía pública o hagamos uso de estos medios para garantizar nuestra seguridad. Sin entrar en demagogias pensemos la de casos no resueltos por la policía que de existir una simple imagen habrían sido resueltos al momento, hace no mucho esta ciudad vivió uno de esos casos con un tal pederasta de Ciudad Lineal.</p>
";"11/09/2015 18";"53";"27";"26";"11";"890462218";"50"
"3541";"Acabar con los Notarios o crear Notarios Low Cost";"<p>Se podria hacer algo para acabar con los notarios? o crear una especie de notario low cost -notarios de buena fe- que diesen sus servicios gratis. Piensen en toda la gente que no pueden pagar las tasas notariales. No se podria crear un banco de notarios sin animo de lucro?</p>

<p>Yo soy partidario de eliminarlos, como en UK o en USA o en Colombia, pero si no se puede pues mejor crear un servicio sin animo de lucro.</p>
";"11/09/2015 18";"45";"30";"15";"2";"895753768";"1000"
"3543";"Cerrar el centro de Madrid a vehículos privados peatonalizando calles.";"<p>Abro este debate para tratar el tema de cerrar el centro de Madrid a vehículos privados solo permitiendo el paso a bicicletas, motos, transportes públicos, camiones de descarga de mercancía, vehículos que tengan algún carácter profesional, uso prioritario (minusválidos, etc) u otros usos dentro de una lógica. Las antiguas vías principales se modificarían reduciendo la cantidad de carriles y peatonalizando los sobrantes, incluyendo en ellos carriles bici y una red de tranvías en superficie que junto con los servicios de alquiler de bicicletas, taxis, buses y metro absorban el flujo de personas que se mueven por el centro. Todo esto insertando en las nuevas vías peatonales zonas verdes que se integren con la funcionalidad de la ciudad. Las calles más pequeñas seguirían el mismo destino de convertirlas en exclusivas para peatones continuando el modelo que se esta empleando ahora. El plan debería hacerse por fases poco a poco empezando por cerrar el centro puro como lo conocemos hasta llegar a la M-30. Las ventajas serian claras, desde devolver la ciudad al ciudadano hasta una mejora de la salud. No habría contaminación ambiental, ni acústica y la cuidad seria mas hermosa que nunca sin ver las calles llenas de coches aparcados ya que estos están alrededor del 80% de su vida sin ningún uso. Se crearían zonas de aparcamiento a las afueras cerca de los transportes públicos de tal forma que la gente que venga de otras partes pueda aparcar el coche y dirigirse al centro ya sea por trabajo u ocio.</p>
";"11/09/2015 18";"86";"53";"33";"5";"896023614";"1232"
"3544";"Parkings seguros para bicis cerca del metro";"<p>Esto permitiría poder localizar aparcamientos, ir a una zona y despreocuparte, o decidir combinarlo con el metro seria posible, fácil y cómodo.</p>

<p>Una de las limitaciones que tiene la bicicleta es la inseguridad que genera dejarla en la calle. Sería interesante que se habilitarán unos espacios seguros (cerrados, o cercados, con cámaras... Lo que resulte más conveniente) y que estén situados al lado de las estaciones de metro.</p>
";"11/09/2015 18";"54";"48";"6";"0";"902275999";"3733"
"3545";"Peatonalizar o hacer las aceras mas anchas en la Carrera de San Jerónimo";"<p>Del trayecto desde la Puerta del Sol hasta la Calle Cedaceros.Justo donde el Congreso de los Diputados.Casi no se puede caminar,porque las aceras son pequeñas con la cantidad de gente y te obligan andar por la calzada.Ya que es bastante peligro de atropello con la cantidad de vehículos.</p>

<p>Lo mejor es peatonalizarlas o aceras mas anchas.</p>

<p> </p>

<p> </p>
";"11/09/2015 18";"38";"29";"9";"2";"897889857";"1526"
"3546";"Campaña de concienciación vial de la bici";"<p>dar a conocer de una manera efectiva los derechos y las obligaciones de las bicis en Madrid, para que se respeten y se ganen el respeto.</p>
";"11/09/2015 18";"33";"29";"4";"2";"900234834";"2196"
"3547";"Habilitar foto denuncia en esta página";"<p>Sería muy útil habilitar un espacio en esta u otra página municipal para poder mandar fotografías para demostrar o apoyar nuestras propuestas. De manera visual se entienden mejor algunas de las ideas que intentamos transmitir.</p>
";"11/09/2015 18";"78";"72";"6";"1";"904709956";"6092"
"3548";"Fin de los parquímetros en zonas que no tienen problemas de movilidad";"<p>Hace ya unos años, el alcalde Gallardón instaló el SER en zonas de Madrid como el Barrio del Pilar en el distrito Fuencarral-El Pardo que no tiene problemas de movilidad asociados a la falta de estacionamiento.</p>

<p>Existen puntos especialmente evidentes (calle Monforte de Lemos) que no necesitan la utilidad del parquímetro porque no existe dificultad de encontrar lugar de estacionamiento y en el que el Ayuntamiento  mantiene una medida abusiva recaudatoria.</p>

<p>Es el momento de reducir el SER a las zonas que realmente lo requieran y no mantener unas medidas abusivas encaminadas a la recaudación.</p>
";"11/09/2015 19";"58";"46";"12";"1";"900125098";"2696"
"3549";"Locales esclavistas y blanqueadores de capitales ";"<p>El comercio esta acabado.</p>

<p>Todos podemos observar como los comercios van cerrando sus puertas ,especialmente,  en los barrios,  uno tras otro, debido principalmente a la excasez de sus ventas.</p>

<p>Y se esta dando en muchas ocasiones,  un fenómeno inexplicable,  estos comercios son sustituidos por otros que tienen aun peores ventas, pero que curiosamente esto no les afecta . Es lo que se denomina locales blanqueadores de capitales. </p>

<p>Al mismo tiempo encontramos que donde había varios trabajadores ahora tenemos un falso autónomo, sin horario,  o en su defecto trabajadores dados de alta , en número insuficiente, para cubrir sus prolongadas jornadas laborales y días de apertura.</p>

<p>Es lo que se conoce como locales esclavistas. </p>

<p>Desde el ayuntamiento se debe proteger a las pymes de esta competencia desleal e inasumible</p>

<p>Solamente haciendo que justificarán sus plantillas se crearía los puestos de trabajo a miles.</p>

<p>Huelga decir que los demás lo tenemos como obligación. .</p>

<p> </p>

<p> </p>
";"11/09/2015 19";"26";"22";"4";"9";"899110948";"1523"
"3550";"Rehabilitación mercados y galerías comerciales";"<p>Propongo realizar un estudio para rehabilitar los mercados y galerías comerciales como ejes del comercio y la vida en los barrios. Muchos de ellos se encuentran en un estado lamentable y la rehabilitación solo se ha enfocado en el distrito centro. Un ejemplo sería el mercado de la Teja en el distrito de Moncloa o el mercado de la Cebada en la Latina. Es necesario impulsar al pequeño comercio también y no sólo a grandes centros comerciales</p>

<p> </p>
";"11/09/2015 19";"52";"46";"6";"2";"902245465";"3538"
"3551";"En la zona derecha de la web no aparece la posibilidad de seleccionar Chamartín";"<p>En la zona derecha de la web no aparece la posibilidad de seleccionar Chamartín, y sí hay debates con esa etiqueta.</p>
";"11/09/2015 19";"11";"7";"4";"4";"891887934";"190"
"3552";"CONTENEDORES RECICLAR PLÁSTICO";"<p>Hola,</p>

<p>quería comentar lo difícil que es reciclar en la zona de Canillas, en Hortaleza, porque los contenedores para reciclar plástico no están dispuestos permanentemente en las calles, sino que los sacan tres o cuatro veces por semana. Es un lio recordar qué dias está o no el contenedor disponible. Más de una vez he bajado y me he tenido que volver a casa con las bolsas llenas de plásticos y botellas para reciclar, porque me he equivocado de día. No soy la única, así que más de uno ha dejado en el contenedor de basura orgánica los plásticos, después de tirarse toda la semana guardándolos. Creo que la solución sería dejar contenedores fijos, como los del papel y las botellas. La población de esta zona es gente mayor, que está concienciada y tiene buena fe (pero no hay que complicarles mucho la vida) y las casas son pequeñitas, no creo que sea práctico estar guardando los plásticos hasta que te llegue el día, porque te quitan espacio de la casa y te desmotivas.</p>

<p>Gracias</p>
";"11/09/2015 19";"31";"27";"4";"1";"900012963";"2003"
"3553";"Prohibicion de alcohol por un dia";"<p>Me gustaria saber que pasaria si por 24 h (un dia) cada año se prohibiera totalmente vender y beber alcohol porque asi por ejemplo fomentariamos mas la seguridad habria menos ""desfase"" entre los jovenes.</p>
";"11/09/2015 19";"46";"9";"37";"2";"885250216";"-547"
"3554";"Las hojas no son basura";"<p>Espero que este otoño invierno vuelvan a dejar de ser las hojas basura común y haya campaña de hoja y asi evitaremos multitud de caídas, gracias.</p>
";"11/09/2015 19";"33";"28";"5";"1";"899793524";"1951"
"3555";"Cinturón Verde del Suroeste, Campamento y Arroyo Meaques.";"<p>En el Suroeste de Madrid se encuentran los terrenos que el ministerio de Defensa pretende vender tras el abandono de los campamentos militares de la zona. Una operación largamente aplazada por el estallido de la burbuja inmobiliaria.</p>

<p>Estamos hablando de alrededor de 10 Km cuadrados de terreno, una parte ocupada por antiguos campamentos, menos de 2 Km cuadrados, y el resto como campo de maniobras. Buena parte del terreno ha querido ser edificado en distintas ocasiones, el ayuntamiento de Madrid debe afrontar en el PGOU una serie de disposiciones para que la ciudad disponga en esa zona de un amplio espacio verde que mejore la calidad de vida de los barrios ya existentes, de los hipotéticos futuros barrios y darle conectividad a la Casa de Campo con el campo abierto.</p>

<p>Mi propuesta es destinar, al menos, el 50% del terreno a un parque periurbano. Concretamente entre el arroyo Valchico y el límite municipal con Somosaguas. Llegando por el Suroeste hasta el límite con Alcorcón en Venta de la Rubia. Habría que negociar con Pozuelo una zona de unión, alrededor del arroyo Meaques, con La Casa de Campo y con Alcorcón la creación de una zona protegida que permita una unión con el Parque Regional del Guadarrama. Tanto para que la fauna pueda movirse libremente desde la Casa de Campo hasta el Guadarrama, como para dotar al extremo suroccidental de Madrid de un amplio espacio verde que cierre la ciudad por ese extremo, mejorando su calidad de vida y asegurándola de cara al futuro. Seguirían quedando 5 Km cuadrados aptos para viviendas, oficinas, instalaciones públicas y zonas verdes de corte urbano (parques y jardines).</p>

<p>Convendría reservar una zona para una posible unión con el arroyo Butarque en el extremo sureste de la parcela, este arroyo ha sido convertido ya en zona verde entre la ciudad de Madrid y las de Leganés y Alcorcón en varios de sus tramos. Siguiendo los descampados de la M-45 aún podría utilizarse como pasillo verde hasta el parque Regional del Manzanares a largo plazo creando un cinturón que abarcaría todo el sur y todo el Oeste de la ciudad.</p>

<p>En cualquier caso la ciudad de Madrid tiene la oportunidad de crear un amplísimo espacio verde en su extremo suroeste, darle continuidad a la Casa de Campo y permitir una ruta que una el centro de la ciudad con el río Guadarrama. Una arteria verde que dé calidad de vida a ese límite de la ciudad y que le sirva de broche ecológico y de ocio. Gracias a que fue usado como campo de maniobras y a los años que lleva sin intervención humana la recuperación de la zona puede ser muy sencilla y barata e independiente de lo que se acabe haciendo en las zonas que seguirían siendo urbanizables.</p>

<p>También es una garantía para Madrid de cara al futuro, recordemos que en la parcela contigua, Venta de La Rubia, pretendía construirse el Eurovegas de Alcorcón y, a su vez, en el propio Campamento el proyecto de macroedificación de Wanda. Resumiendo, la zona podría quedar colapsada en asfalto y viviendas con malas dotaciones y la Casa de Campo quedar completamente rodeada si no se hace una gestión adecuada. Con la definición de esta zona verde la ciudad de Madrid y sus ciudades vecinas deberán llevar a cabo sus planes teniendo en cuenta unos mínimos y la ciudad se resguardará de sufrir excesos al no haber coordinación ni limitaciones en estas zonas de frontera entre municipios. La creación de este parque periurbano garantizaría para décadas un control saludable del crecimiento urbano en el suroeste de la ciudad y su zona urbana.</p>
";"11/09/2015 19";"48";"42";"6";"3";"901912305";"3150"
"3556";"Regulación seria de los carriles-bici";"<p>Como usuario de los carriles bici de Madrid, propongo:</p>

<p>1) que se regule por normativa municipal (si es que no lo está ya) la prohibición de usarlo por peatones,</p>

<p>2) en la misma línea que se sancione de verdad a las personas que los invaden depositando objetos en ellos de forma casi permanente (Pasillo verde por ejemplo), circulan en grupos , o con carritos de niños (Dehesa de la Villa,...), o no respetan la señalización que separa una parte para peatones y otra para bicis (Valdebebas,...)</p>

<p>En particular ya he denunciado en anteriores ocasiones lo peligroso del carril en la Dehesa de la Villa, donde en sentido bajada se alcanza más velocidad (hablo de los que respetamos la permitida, la mayoría) y hay continuamente que ir esquivando peatones, grupos, padres que pasean los carritos de niño por el carril bici, etc,... llegándose al extremo de que al advertirles en algún caso de lo peligroso de hacer esto y señalarles que tienen la senda peatonal paralela te discuten o insultan y se atribuyen el ""derecho"" a circular por el carril bici. ¿Es carril para bicis entonces o para todos?</p>

<p>Aprovecho para proponer además:</p>

<p>3) que se instale en todos , o al menos en los principales , (entre los que están los mencionados): una separación física, de bordillo o bolardos</p>

<p>4)  que se pongan señales cada pocos metros recordando que es un carril para bicis,</p>

<p>5) que , al menos, en los días de mayor afluencia (fines de semana o festivos) la policía municipal pasee por allí (creo que había un servicio de policias dotado con bicicletas actuando en el Retiro , sería ideal para los carriles bici también)</p>

<p>6) que se reparen los múltiples destrozos existentes en las zonas de descanso en el carril que circunvala Madrid,y se limpien las calzadas pues parece que no lo hacen nunca.</p>

<p>7) que se asfalte o dote de algún suelo que no se embarre la senda paralela al carril de la Dehesa de la Villa, para evitar que los peatones invadan el carril bici con la excusa de que ha llovido y está intransitable</p>
";"11/09/2015 19";"59";"49";"10";"2";"901566799";"3238"
"3557";"Economía social";"<p>Priorizar en los contratos públicos de proveedores a empresas pequeñas que entren dentro de la denominación de economía social definida por la ley 5/2011 de 29 de marzo (http://cepes.es/pagina_cepes=24), así como como todas aquellas que, en el ejercicio de su servicio o contrato favorezcan un desarrollo sostenible, como sería la contratación de comercializadoras de energia 100% renovable para el alumbrado público, productos de comercio justo para las máquinas y servicios de cafetería dependientes del ayuntamiento, puntuar mejor a las empresas con una menor huella ecológica, con menos accidentes laborales, con menor conflicto laboral... En resumen, dar más importancia en la contratación pública a los aspectos medibles que favorezcan una economía más social y sostenible, frente a la prioridad de la mejor propuesta económica.</p>
";"11/09/2015 20";"41";"33";"8";"1";"899763174";"2012"
"3558";"Acceso a FP Grado Superior";"<p>Me gustaria que para poder pasar a FP Grado Superior desde un Grado Medio se acceda directamente como si tuviera Bachillerato.No entiendo porque hay que hacer primero un cursillo para preparar la prueba y eso es un añonmas que gasto de mi vida ademas tambien porque se nos olvida lo que aprendimos en el curso anterior.Da igual desde que Grado Medio accedamos simplemente que pasemos directamente ya que tambien es de la misma rama.</p>
";"11/09/2015 20";"25";"13";"12";"3";"889631230";"52"
"3559";"Mas  lineas de autobuses para Entrevías o metro ";"<p>El barrio de Entrevias   tiene muy pocas lineas de autobuses  y paradojicamente las q van al centro como  la linea  24 y el 102  acaban en atocha ,  por que no ponen lineas que nos lleven a    más sitios  tenemos las cocheras al lado  de la EMT  y ninguna para para ir a Sol o a  Diego de León  por ejemplo  tenemos q cojer 2  autobuses o  metro o autobús   cin el consiguiente  gasto  , por q no ponen metro en  Eentrevías ? , estamos muy mal enlazados con el centro solo tenemos cercanias y  dos lineas de autobuses al centro  ( atocha) , somos los  grandes olvidados</p>
";"11/09/2015 20";"30";"21";"9";"3";"896335373";"839"
"3560";"proteger y recuperar edificios antiguos";"<p>Mi propuesta es para todos los edificios de Madrid, que merecen la pena y que estan abandonados . Yo les hablo de uno  en concreto un edificio que hay en la Avda. de Carabanchel Alto. Es un palacete que esta en un estado lamentable y que debio ser muy bonito , Creo que es de particulares pero pienso que el Ayuntamiento  deberia en estos casos obligarles a tenerlo en condiciones, como hace con nuestras viviendas que nos obliga a pasar la ITV por supuesto por nuestra cuenta. Por que a ellos no?. Si no lo hacen deberian multarles o expropiarselo pues afean las ciudades.</p>
";"11/09/2015 20";"55";"49";"6";"1";"903161147";"3830"
"3561";"Convocatorias  de habilitación de Guía de Turismo ";"<p>Hasta hace unos años era posible obtener (haciendo un extenso exámen de por medio) la habilitación para ejercer como guía de turismo en la ciudad.</p>

<p>Las últimas pruebas tuvieron lugar en 2009, fecha a partir de la cual se liberalizó el sector.</p>

<p>Lo que en un principio, podría parecer algo positivo refleja una realidad muy diferente: Las agencias exigen el carnet oficial de guía de turismo (o el permiso de Patrimonio Nacional que dejó de convocarse en 2013) para contratar y se multiplican por la ciudad los grupos guiados por guías amateur, no profesionales que dan una información errónea, incoherente y en ocasiones hasta absurda dejándonos sin un trabajo digno a toda una  generación que realmente lo necesitamos.</p>

<p>Dada la coyuntura económica que estamos pasando, sería de vital importancia  que se convocarán las pruebas de habilitación de guía de turismo en un futuro no muy lejano y se nos permitiera ejercer una profesión de una forma coherente y legal para las que nos hemos formado. (En mi caso tengo licenciatura en Historia del Arte, Master en Bienes Culturales y tres idiomas)</p>

<p>Es injusto que solamente unos ""cuántos afortunados y privilegiados""( cada día es más visibles las desigualdades que hay en este país) que pudieron presentarse en su momento a las pruebas estén ejerciendo la profesión mientras se nos cierren las puertas a una generación muy preparada que podríamos aportar mucho a la empobrecida cultura de este país y se nos aisle sistemáticamente del mercado laboral.</p>

<p>Exigimos que se regularice y legalice está situación lo antes posible para que haya más oportunidades de empleo.</p>
";"11/09/2015 20";"43";"35";"8";"2";"900322919";"2197"
"3562";"Condena sobre la sentencia a Leopoldo López ";"<p>Declaración de condena sobre el atentado a los DDHH y a la libertad en Venezuela, sufrida por el opositor Leopoldo López </p>
";"11/09/2015 20";"49";"33";"16";"8";"897356074";"1144"
"3563";"Recogida de basura antes de las 12 de la noche";"<p>Hay barrios de Madrid en que pasan los camiones de basura de madrugada, en mi barrio a las 2, haciendo un ruido insufrible con la alarma de cuando dan marcha atrás y golpeando repetidamente los cubos ( justo debajo de mi casa son 3) para que caiga todo.  Mi barrio en la zona de San Isidro en Carabanchel bajo... A lo mejor es por eso.... </p>
";"11/09/2015 20";"62";"50";"12";"6";"901652964";"3064"
"3564";"Intervencion espontánea  ---->  cuesta ""retornar"" al mismo Debate tras registro.";"<p>Buscas cuestiones, ojeas propuestas, comparas... y en cuanto ves algo interesante, procedes con tu ""sesión"" para ¿ir hacia dónde...?  Pues (tras haber presentado tu clave) otra vez, <strong>al principio</strong>.  Desde donde nuevamente tienes que VOLVER A BUSCAR qué era y dónde estaba aquél asunto de relevancia al que deseabas aportar tu opinión... ¡pero bueno! ¿de verdad hay que estudiar <em>lógica Informática</em> para poder ""quedarse"" precisamente <u>allí donde introdujimos</u> nuestra Clave sin que nos ""saquen"" del tema?.</p>

<p>A ver esos DISEÑADORES que tanto se han apresurando con el prototipo: esto COJEA ostensiblemente  (no es grave, pero queda poco ""profesional"" ¿verdad?)</p>
";"11/09/2015 21";"15";"11";"4";"3";"895313466";"513"
"3565";"Reivindicar el Consejo de las Comunidades Castellanas creado en el año 2000.";"<p>El Consejo de las Comunidades Castellanas es un organismo creado en el año 2000 por los entonces presidentes autonómicos de la Comunidad de Madrid, Castilla y León y Castilla-La Mancha: Alberto Ruiz-Gallardón (PP), Juan José Lucas (PP) y José Bono (PSOE) respectivamente y abierto a Cantabria (hasta 1981 <em>provincia de Santander</em> en <em>Castilla la Vieja</em>) y La Rioja (hasta 1982 <em>provincia de Logroño</em> en <em>Castilla la Vieja</em>).</p>

<p>Son frecuentes los acuerdos firmados entre la Junta de Castilla y León, la Comunidad de Madrid y la Junta de Comunidades de Castilla-La Mancha para impulsar la implantación común de determinadas iniciativas o para coordinar acciones administrativas. Son numerosos los convenios establecidos entre las tres comunidades (en algunos casos ampliados a Cantabria, La Rioja o Extremadura) orientados a mejorar la gestión en Medio Ambiente, proyección económica, infraestructuras del transporte, actividades educativas, sanitarias, culturales o investigadoras.</p>

<p>La creación del <strong>Consejo de las Comunidades Castellanas</strong> tenía como principal objetivo la proyección al conjunto de España del peso real de Castilla en las grandes decisiones de Estado en un Modelo Autonómico que mantiene a Castilla dividida en cinco comunidades autónomas desde la Transición.</p>

<p>Madrid, con su potente economía y demografía, hace crecer a provincias como Guadalajara Toledo o Segovia multiplicando por cuatro, tres y dos respectivamente el ritmo estatal de crecimiento por el establecimiento de nuevos pobladores procedentes de la capital; el tránsito de personas en todas las provincias de Castilla y León y Castilla-La Mancha tiene como principal destino Madrid; madrileñas son las principales inversiones industriales y empresariales en estas dos comunidades castellanas, y madrileños son, mayoritariamente, los turistas que las visitan o quienes construyen sus segundas residencias en ellas.</p>

<p>Pero Madrid también percibe los efectos beneficiosos de tener como vecinas a las comunidades de Castilla y León y Castilla-La Mancha:</p>

<ul>
	<li>como pulmón ecológico</li>
	<li>espacio de expansión económico</li>
	<li>lugar de procedencia de la mayor parte del agua, energía y materias primas que consume</li>
	<li>vínculo cultural e histórico</li>
	<li>por albergar entre sus seis millones y medio de habitantes a más de un millón de personas de ambos territorios castellanos</li>
	<li>porque las universidades madrileñas son las preferidas por los estudiantes de ambas Castillas que marchan fuera para realizar sus carreras.</li>
</ul>

<p>Es por ello que la ciudad de Madrid puede y debe actuar como nexo de unión y aprovechar su poder político y mediático para exigir la recuperación del <strong>Consejo de las Comunidades Castellanas</strong> como una herramienta urgente para mejorar la eficiencia administrativa, evitar despilfarros innecesarios y coordinar la prestación de determinados servicios. No existen razones objetivas para que los servicios sanitarios, educativos, sociales, agrarios o ambientales entre las diferentes comunidades autónomas castellanas no sean comunes pudiendo producirse un ahorro de hasta 5.000.000.000 de euros según diversos análisis.</p>
";"11/09/2015 21";"36";"22";"14";"2";"894490689";"488"
"3566";"Perros sueltos en los parques: en los lugares habilitados";"<p>Hay parques por mi barrio - Las Rosas - que tienen zonas delimitadas para que estén los perros sueltos (arena y barreras de madera) que curiosamente siempre están vacías; los perros y sus dueños están siempre en la zona de césped,  impidiendo que los demás (incluidos niños o gente que le pueda tener miedo o respeto a los perros) pueda estar ahí tranquilamente. Además suelen ser grupos numerosos que se dedican a charlar durante largo tiempo mientras sus perros corren alegremente por el césped, teniendo ocupada la zona verde un día detrás de otro.</p>
";"11/09/2015 21";"90";"70";"20";"13";"902396069";"3888"
"3567";"Controlar los pisos Okupados ";"<p>En la zona nueva del ensache de Vallecas desde hace un par de años hay un edificio en concreto ocupado que está creando un mal ambiente en el barrio ya que crea preocupación y inseguridad habría que controlar por parte de la Comunidad de Madrid si esos pisos son de propiedad de esas personas o por el contrario como se dice son ocupados para echar a los inquilinos anteriores. </p>
";"11/09/2015 21";"94";"87";"7";"5";"906582978";"7404"
"3568";"Formato de intervenciones  ---->   titulación de Cabeceras resulta insuficiente.";"<p>(Sólo para <em>técnicos</em> y amantes del interfaz)  Los titulares de cada aportación <u>se limitan</u> a un bloque de casi ochenta caracteres, aun disponiendo de ""real estate"" suficiente para un texto algo más prolongado... sin embargo, lo más curioso es que se RE-FORMATEA inopinadamente la <strong>presentación</strong> definitiva del texto original  (p.e. substituyendo ""mayúsculas"" por su equivalente en ""minúsculas"")  el cual no obstante continúa  -en caso de reedición-  apareciendole al Autor bajo su inscripción inicial, con el mismo formato asignado en principio.  Algo no cuadra.</p>

<p>Fernando  (Cmdd Aut Mdr)</p>
";"11/09/2015 21";"13";"11";"2";"2";"897189926";"761"
"3569";"Eliminar la plusvalia municipal cuando con la venta del piso no se gane dinero";"<p>Si alguien vende un piso por menos de lo que le costo en su dia, es decir perdiendo dinero, ¿por que ha de pagar plusvalia? La plusvalia entiende del valor catatral de la vivienda, y el aumento de este valor no depende de quien compra o vende la casa, sino del Ayuntamiento que de vez en cuando actualiza al alza los valores catastrales de los inmuebles, lo cual es una incongruencia en estos tiempos de crisis inmobiliaria donde la practica totalidad de los inmuebles han perdido valor.</p>

<p>En definitiva, que el ayuntamiento libere de pagar este impuesto a los que vendan su piso por debajo del precio que en su dia pagaron por el.</p>

<p>PaLoS</p>

<p>www.vecinosdelpleni.es</p>
";"11/09/2015 21";"90";"83";"7";"3";"906379441";"7008"
"3570";"Prohibir Papa Noel por capitalista y consumista";"<p>Prohibir Papa Noel por capitalista, consumista y mal gusto en su vestimenta</p>

<p>Además de usurpador, el verdadero benefactor de los niños fue San Nicolas de Bari.</p>

<p>Celebrar San Nicolas de Bari tal y como hacen otros paises tan poco avanzados como Paises Bajos, Alemania y Austria, el 6 de Diciembre</p>

<p>https://es.wikipedia.org/wiki/Nicol%C3%A1s_de_Bari</p>

<p> </p>
";"11/09/2015 21";"41";"18";"23";"2";"886091211";"-219"
"3571";"Mandar a la legión a Oriente Medio";"<p>Mandar a la legión a Oriente Medio para que estas Navidades puedan llegar los Reyes Magos sanos y salvos a Madrid.</p>

<p>Es necesario que la legión los escolte evitando que sean victimas de las guerras, los rebana cuellos y otros inconvenientes en el camino.</p>

<p> </p>
";"11/09/2015 21";"28";"9";"19";"2";"885802968";"-321"
"3572";"Que los ediles paguen de su salario cada metedura de pata, bulo o contradicción";"<p>Pues, eso cada vez que metan la pata, nos engañen, ...,etc, 500 de multa de sus sueldos a las arcas municipales.</p>

<p> </p>
";"11/09/2015 21";"46";"23";"23";"7";"889825790";"0"
"3573";"Eliminar la porra de los policías";"<p>Eliminar la porra de los policías y sustituirla por una vara de almendruco que es mas flexible y pica mas.</p>

<p>Además es mas barata que la porra y no pesa tanto.</p>

<p> </p>
";"11/09/2015 21";"65";"15";"50";"0";"885531243";"-807"
"3574";"Plantar árboles Kiri o paulonia imperial para combatir la contaminación";"<p>El árbol kiri o paulonia imperial tiene unas propiedades imbatibles a la hora de combatir la contaminación:</p>

<p>- absorve 10 veces más dióxido de carbono que cualquier otro árbol.</p>

<p>- expulsa mucho más oxígeno.</p>

<p>- crece muy rápido.</p>

<p>- tolera suelos poco fértiles.</p>

<p>- etc*.</p>

<p>* Información obtenida de http://elblogverde.com/la-revolucion-del-kiri-el-arbol-que-puede-salvar-al-mundo/</p>

<p>Para que todos tengamos un aire un poco más limpio y saludable, propongo que se fomente en las calles de Madrid la plantación de estos árboles, por ejemplo en los alcorques vacíos a los que hace referencia la propuesta ""Un árbol por cada alcorque"":  https://decide.madrid.es/debates/224</p>
";"11/09/2015 21";"60";"52";"8";"5";"903513345";"3813"
"3575";"Venta ambulante en zona Atocha/Méndez Álvaro";"<p>Por favor, hagan cumplir las Ordenanzas. La venta ambulante es ilegal en la calle Méndez Álvaro frente al colegio público Menéndez Pelayo. Se vende objetos robados y articulos viejos. Generan ruido, suciedad, inaceptable frente a un colegio al que acuden los niños del barrio...Bloquean la salida de emergencia del AVE. Y generan un gasto desorbitado ya que el Selur acude diariamente pudiendo utilizar ese dinero en ayudas sociales. Diseñen un plan. Estamos muy agradecidos a la Policía Municipal que acude <u>siempre</u> que los llamamos. Acude un patrulla con dos agentes. Este problema requiere un plan de actuación que erradique la venta ambulante ilegal. Insisto, hagan cumplir las Ordenanzas. </p>
";"11/09/2015 22";"34";"28";"6";"2";"900342213";"1811"
"3576";"Cargos políticos -> Servicios públicos";"<p>Hola,</p>

<p>En organización de empresas enseñan que hay que ""alinear"" los intereses del empresario con los de la empresa para que no haya conflicto de intereses.</p>

<p>Manteniendo esta idea, creo los cargos públicos políticos, es decir, aquellos que cobran un sueldo público, pero que no accedieron al puesto vía oposición, deberían hacer uso exclusivo de los servicios públicos.</p>

<p>Con esto, lo que se buscaría es que los diversos cargos del staff político, tengan que utilizar la sanidad pública, la educación pública, el transporte público y así experimentar en ""carne propia"" los fallos y deficiencias.</p>

<p>Me resultaría un poco paradógico que un consejero de sanidad no se atendiera por la sanidad pública, o que un consejero de educación enviara a sus hijos a un colegio privado, etc.</p>

<p>Un saludo.</p>
";"11/09/2015 22";"18";"13";"5";"3";"896045415";"577"
"3577";"Gimnasios sostenibles";"<p>Hola,</p>

<p>A veces veo en los gimnasios tanta gente ""pedaleando"" y pienso en toda la energía que se escapa sin aprovechar.</p>

<p>¿No habrá alguna manera de poder canalizar esa energía hacia a red eléctrica?</p>

<p>Un saludo.</p>
";"11/09/2015 22";"41";"33";"8";"2";"900596601";"2012"
"3578";"Agrupar temas similares de debate para que los votos no se dispersan.";"<p>Pasando por las páginas de los debates (77 en este momento!) veo muchos temas repetitivos. Sumando los votos de cada uno, se incrementaría la cantidad de votos sobre ese tema. Así no hemos de repasar todos los debates para poder votar lo que más nos interesa.</p>
";"11/09/2015 22";"90";"86";"4";"3";"907596782";"7835"
"3579";"Proclamar la III República el 7 de Enero de 2016";"<p>Proclamar la III República el 7 de Enero de 2016, después de los Reyes Magos, para que los niños tengan regalos. Asi no habrá conflicto legal entre SSMM y la III República.</p>

<p>Además para un dia de trabajo que tienen al año esta feo que no les dejemos</p>

<p> </p>
";"11/09/2015 22";"66";"15";"51";"5";"885620159";"-818"
"3580";"Autobuses EMT";"<p>¿Por qué no se hacen unas paradas que ocupen más extensión en el eje Castellana-Recoletos-Paseo del Prado? Hay lugares donde tienen su parada tres y cuatro líneas. Pudiendo bajar o subir viajeros mientras el autobús de delante carga y descarga, los conductores están obligados a abrir las puertas sólo en la zona habilitada como parada. La paradas más cercanas a Cibeles o el Museo del Prado son un buen ejemplo. Por favor, habiliten una zona más extensa. Los viajeros ahorraríamos tiempo, el recorrido se haría en menor tiempo y se gastaría menos energía.</p>
";"11/09/2015 22";"27";"23";"4";"1";"900277276";"1618"
"3581";"Orientadores laborales para ayudar a desempleados";"<p>Me gustaría abrir un tema de debate sobre la necesidad de mejorar el servicio de orientación laboral de la Agencia para el Empleo. Aunque hay grandes profesionales, llevan muchos años ya completamente desbordados por la gran cantidad de desempleados que demandan un servicio más personalizado. </p>
";"11/09/2015 22";"54";"45";"9";"5";"902560458";"3000"
"3582";"Que ""Ahora Madrid"" devuelva MADRID a los ciudadanos";"<p>Me parece <strong><em>lamentable </em></strong>que una agrupación o grupúsculo politico se haya apropiado de ""Madrid"" en sus siglas. <u>MADRID ES DE TODOS</u>. Propongo que, en vista de sus contradicciones y su ""donde dije digo, digo diego"", se cambie el nombre de ""<strong>Ahora Madrid</strong>"" a ""<strong>Ahora si, Ahora no</strong>""</p>
";"11/09/2015 22";"91";"21";"70";"2";"885517308";"-1130"
"3583";"Estoy hasta el moño de las Pastelerías Mallorca";"<p>Estoy hasta el moño de que las Pastelerías Mallorca utilicen la calle Juan Pérez Zuñiga como si fuera su propio muelle de carga y descarga.</p>

<p>Ocupan las aceras con su flota de vehículos, ocupan aparcamientos como si la calle fuera su parking privado, tienen el suelo sucio y no lo limpian, mantienen los motores encendidos mientras realizan sus quehaceres, importunan la fluided del tráfico.</p>

<p>Resultan molestos máxime cuando utilizan el espacio público como si fuera propio.</p>

<p>A cien metros escasos son propietarios de un solar vacío que podrian habilitar para sus negocios sin necesidad de molestar a los vecinos.</p>

<p>Ya hace algunos años el ayuntamiento reconvirtio la calle de dos sentidos a solo un sentido para que ellos pudieran ejercer su trabajo en mejores condiciones y por que ademas producian constantes atascos a  los autobuses de la linea 21.</p>

<p>¿Hasta cuando estos amiguitos van a tomar la calle como si fuera de su propiedad?</p>

<p>Por favor, regulen estos muelles de carga y descarga ilegales, estos parking fraudulentos, estos chiringuitos que algunos se motan por el morro.</p>

<p> </p>
";"11/09/2015 22";"36";"21";"15";"0";"894104423";"350"
"3584";"Plantar olivos y viñas en Madrid";"<p>Plantar olivos y viñas en Madrid, ya que necesitan gran cantidad de mano de obra lo que crearía puestos de trabajo, además se puede usar como actividad de ocio y tiempo libre el podar, vendimiar y recoger la aceituna.</p>

<p>Los beneficios para la salud soin múltiples, aire fresco y la tonificación de músculos que creemos que no existen perfecta.</p>

<p>Se neceita gente para podar, cavar,  y sobre todo para la recolección, vamos un autentico filón de empleo.</p>

<p>Luego ya si se usan tikeras de podar o azadones bajo los efectos del alcohol podemos hablar de deporte de riesgo.</p>

<p>Lo que se va a ahorrar la gente en gimnasios y ropita de sport, con unc cachucho, rastrillo y tijeras de podar....apañao</p>

<p>Vendimia o muerte!!!!!</p>

<p>No habrá ensalada sin su aceite!!!!</p>

<p> </p>
";"11/09/2015 23";"43";"17";"26";"6";"885913128";"-355"
"3585";"Bajar/eliminar tasas, zona SER, IBI,... e implantar IRPF (tramo municipal)";"<p>Los impuestos indirectos (tasas, copagos servicios públicos, IVA, impuestos especiales, IBI, zona SER residentes,...) son injustos, ya que gravan igual a los ciudadanos con mayor y menor renta. Para lograr una auténtica progresividad fiscal, se deberían ir reduciendo estos impuestos indirectos, e ir substituyéndolos por impuestos directos (IRPF y sociedades), eliminando los actuales tramos, y substituirlos por una función continua logarítmica, en la que cuando se gane 1 más se pague cada vez un ratio (%) mayor...</p>
";"11/09/2015 23";"29";"10";"19";"9";"886303942";"-310"
"3586";"Fomento del Park & Ride";"<p>Es frecuente en ciudades europeas encontrar aparcamientos de tipo Park and Ride (P+R).</p>

<p>Para quien no conozca el concepto, se trata de aparcamientos alejados del centro conectados con éste mediante transporte público.</p>

<p>He visto varias propuestas en estos foros para sacar a los coches del centro (peatonalización, cierre de calles o eliminación de carriles, peaje urbano) pero si queremos que la gente deje el coche fuera del centro, debemos ponérselo fácil. No basta con dificultar el acceso y así forzar el uso del transporte público. Un modelo de P+R facilitaría el objetivo último de descongestionar el centro.</p>

<p>Existen diferentes modelos de explotación de P+R, desde aparcamientos completamente gratuito a pago de una tarifa que incluya ida y vuelta para todos los ocupantes del vehículo (como es el caso de Estrasburgo).</p>

<p>¿Opiniones?</p>
";"11/09/2015 23";"41";"36";"5";"0";"902709862";"2721"
"3588";"Prioridad semafórica para autobuses";"<p>Estaría bien estudiar que se implante la prioridad semafórica para autobuses, ya que éstos ya paran bastantes veces con sus paradas y en ocasiones, cuando se pillan todos los semáforos en rojo, es insufrible y se puede llegar a multiplicar el tiempo de viaje.</p>
";"11/09/2015 23";"39";"22";"17";"0";"893648960";"282"
"3589";"Feria en la Casa del reloj en Legazpi en las Fiestas de la Melonera";"<p>Hola buenas noches acaba de empezar las fiestas de la melonera 2015 y he visto que no hay feria y eso me ha molestado mucho entiendo que los demas vecinos se hayan quejado del ruido y por eso lo hayan quitado pero se puede poner la feria y la musica a un moderado volumen entiendo yo y ademas es que soy joven y quiero disfrutar de la vida para una semana que dura se puede aguantar perfectamente y para las pocas fiestas que hay en mi barrio y que no voy a mas ferias.</p>
";"11/09/2015 23";"33";"20";"13";"3";"895133296";"424"
"3590";"Madrid Río / Ferias";"<p>Es conocido que este tipo de eventos suponen un aumento de turistas en aquellos pueblos de la región que los hacen. Un ejemplo es el ""Mercado Medieval"" que se celebra todos los años en el centro de Alcalá de Henares.</p>

<p>La propuesta consistiría en utilizar la zona de Madrid Río, por ejemplo el espacio entre Puente del Rey y Puente de Toledo para realizar eventos de este tipo. Pienso que podría ayudar no solo a promocionar el turismo sino también a revitalizar la economía de esta zona de Madrid. Esta zona cuenta con varias líneas de metro, autobuses y la estación de tren de Príncipe Pío que facilitarían el acceso. Una alternativa a la propuesta del Mercado  Medieval podría ser: ferias del libro, ferias artesanía, productos de Madrid,.....</p>
";"11/09/2015 23";"36";"27";"9";"0";"899209963";"1350"
"3591";"bandera ayuntamiento";"<p>Que el día de la fiesta nacional, 12 de octubre, se cuelgue del ayuntamiento una gran bandera de nuestra nación, a semejanza de la que se colgó el día del orgullo gay.</p>
";"12/09/2015 00";"83";"36";"47";"13";"885946736";"-477"
"3592";"Falto el homenaje a Salvador Allende";"<p>Porque se nos ha vuelto a adelantar Barcelona? Maravilloso por su parte y, en vez de apoyar condenas de golpistas no hubieramos hecho un homenaje a una buena persona, un gran proyecto de gobierno de Unidad Popular ( que tanto necesitamos).</p>

<p> </p>

<p>Y de paso aqui si la condena a los subversivos que murieron en la cama tranquilitos?</p>
";"12/09/2015 00";"41";"11";"30";"1";"886667545";"-509"
"3593";"Falto el homenaje a Salvador Allende";"<p>Porque se nos ha vuelto a adelantar Barcelona? Maravilloso por su parte y, en vez de apoyar condenas de golpistas no hubieramos hecho un homenaje a una buena persona, un gran proyecto de gobierno de Unidad Popular alli establecido y, que tanto necesitamos aqui.</p>

<p> </p>

<p>Y de paso condenar a los subversivos que murieron en la cama tranquilitos del 11 de septiembre de 1973.</p>
";"12/09/2015 00";"39";"11";"28";"1";"886700756";"-479"
"3594";"Madrid capital cultural";"<p>Madrid cuenta con excelentes museos. Pero el panorama musical y cinéfilo necesita un empuje por parte de las instituciones. La Gran Via estaba ligada al cine. La ciudad contaba con una oferta de conciertos espectacular. Y recuperar eso sería volver a llevar a la capital al circulo de las ciudades culturales del mundo.</p>
";"12/09/2015 00";"49";"39";"10";"0";"901869398";"2308"
"3595";"Impecciones y vigilancia callejera";"<p>Se sugiere para erradicar el vandalismo de las pintada s,los botellones, el orinar en la calle, tirar basura a la calle, así como  controlar desperfectos en aceras y señales de trafico ,  que además de dar instrucciones a la policía mucipal, hubira mas vigilantes que inspeccionaran y denunciaran estas conductas para poder multados los infractores, ya que prácticamente quedan impunes.</p>
";"12/09/2015 00";"50";"42";"8";"4";"903334417";"2856"
"3596";"Más trabajos comunitarios y talleres cívicos";"<p>Quien puede  ensuciar la ciudad puede y debe  limpiarla y lo mismo si intencionadamente rompe mobiliario urbano, se debería extender más los trabajos comunitarios pero en la misma zona o barrio donde se ha causado el daño y asistir a talleres donde se tome conciencia de ciudadanía. Esto es más efectivo que la multa.</p>
";"12/09/2015 00";"39";"31";"8";"0";"901182288";"1828"
"3597";"Suciedad en la ciudad";"<p>Sra. Carmena, por favor deje ocurrencias como que las servilletas de los bares tengan dibujos de Madrid, para atraer a los visitantes se necesita una ciudad agradable, limpia y no como esta que es repugnante. Resuelvan los contratos con las concesionarias de la limpieza por manifiesto incumplimiento o negocien con ellas incrementos de medios y una adecuada programación de las diferentes actuaciones a realizar. Además le sugiero que se cambien las papeleras, las actuales tienen una abertura que parece la de un buzón de correos, Eeste verano he estado en Barcelona y a pesar de las masas de transeúntes por sus calles, la mayoría turistas, sus calles están limpias, tienen cantidad de papeleras grandes y accesibles.</p>
";"12/09/2015 01";"66";"51";"15";"4";"902643987";"2781"
"3598";"Autobuses nocturnos de la EMT a Aravaca";"<p>Actualmente, y a pesar de que el barrio de Aravaca es oficialmente del municipio de Madrid, a partir del último autobús de la EMT que sale de Moncloa a las 23:30, Aravaca pasa a no ser del mismo municipio. O eso es lo que parece por la situación en el transporte público nocturno en Aravaca. La única manera de llegar a Aravaca y a Valdemarín es mediante los búhos interurbanos del Consorcio, cuyas tarifas tratan a Aravaca como zona B1, como si no fuera barrio de Madrid vamos. Todo lo contrario que durante el día, en el que hay tres líneas urbanas que dan servicio, más el cercanías cuya estación está en zona A.</p>

<p>Por ello, propongo solucionar este sinsentido creando una nueva línea nocturna de buses de la EMT, con las tarifas normales, o, en su defecto, prolongar los horarios de las líneas existentes, todo desde Moncloa. Por supuesto, por su nivel socioeconómico, Aravaca no necesita frecuencias muy altas por el alto uso del transporte privado, pero no significa que los vecinos no tengan derecho a un mínimo transporte público nocturno urbano. Sería suficiente con un bus cada hora y media o incluso dos horas y solo conectando con Moncloa, pero que exista.</p>
";"12/09/2015 02";"30";"23";"7";"0";"900160805";"1226"
"3599";"Ascensor: un derecho del s. XXI";"<p>En el siglo XXI, en el barrio de Moratalaz nos encontramos con que la mayor parte de los edificios no tienen ascensor. Con una población envejecida, son muchos los que tienen dificultades para poder salir de sus casas por el esfuerzo que les supone. </p>

<p>A nivel de seguridad, ¿os imagináis lo que es tener que esperar a los servicios de emergencia para que suban y te puedan bajar en camilla por algún problema de salud? Nosotros lo hemos visto con nuestros vecinos varias veces ya. Sin embargo, aunque la ley es un poco más benevolente con este colectivo para obtener la instalación del ascensor, la realidad es que sigue supeditada a la mayoría por junta. Teniendo en cuenta que la mayoría de los edificios sin ascensor son de 4 plantas nos encontramos con que bajos y primeros se oponen siempre y, para poder obtener la instalación, tendrían que estar de acuerdo segundos, terceros y cuartos sin excepción.</p>

<p>Así se ha conseguido poner ascensor en bastantes edificios del barrio pero necesitamos que el ayuntamiento ayude aún más con la legislación. No puede ser que gente con más de 80 años no pueda salir a la calle porque sus vecinos prefieran destinar el dinero a otras cosas. Debería ser obligatoria su instalación si hay gente mayor, con discapacidad o movilidad reducida siempre que haya espacio para su instalación. Y, a ser posible, ofrecer ayudas para su instalación en estos casos. </p>

<p>Incluso para los que no estamos en ninguna de esas situaciones, un esguince o una rotura de una pierna supone un suplicio y no es normal estar así en pleno siglo XXI. </p>
";"12/09/2015 08";"64";"41";"23";"16";"902260342";"1153"
"3600";"Parar el Top Manta";"<p>Mala imagen para la ciudad, comercio injusto. No se recaudan impuestos y están controlados por mafias. Ayer viernes por la noche, lleno preciados, la puerta del sol y la calle arenal. Además de sucias las calles principales como ya han indicado en otros debates.</p>
";"12/09/2015 09";"57";"40";"17";"2";"903446673";"1614"
"3601";"Independencia energética del Ayuntamiento de Madrid ";"<p>Buenos días, se ha planteado el Ayuntamiento de Madrid tener un sistema de electricidad propio e independiente, asociandose con empresas que trabajan las energías alternativas como por ejemplo la solar?, supondría un ahorro económico considerable y un mayor respeto al medio ambiente, Alemania ya está notando las ventajas</p>

<p>Un saludo</p>

<p> </p>

<p> </p>

<p> </p>
";"12/09/2015 09";"49";"42";"7";"0";"907061282";"3000"
"3602";"Peatonalización del centro";"<p>Buenos días.</p>

<p>Ando mucho por el centro histórico, me gusta mucho.</p>

<p>Creó que hay actuaciones que deberían realizarse pronto.</p>

<p>El centro necesita ser cada vez más peatonal. Creó que es especialmente importante comenzar por calles que lo piden a gritos ya que la gente ni respeta las aceras y camina por la carretera al colapsarse las aceras. Habló de calles como Carretas, Mayor o el comienzo de la Carrera de San Jerónimo. Carretas se podría peatonalizar entera y la Carrera de San Jeronimo, si no entera porque pasan autobuses desde Sol, dejar un sólo carril y ampliar las aceras.</p>

<p>Por otro lado, las baldosas de las calles del centro están salidas son un peligro, por ejemplo en los pasos de cebra entre calles de las Gran vía o en el barrio de las letras, cuyas calles tienen los baldosines en muy mal estado.</p>

<p>Por último, quizá no tan prioritario, creó que hay algo que a todos nos gustaría cambiar.</p>

<p>Se trata del centro Gallego que esta en la plaza detrás de Sol, en frente del teatro Calderón. No se si es posible o no, pero ya que están rehabilitando los edificios de la plaza como el teatro y alguna casas, me gustaría saber si es posible hacer algo con el edificio horripilante, descuidado y desproporcionado del centro Gallego. Creó que todos evitamos verlo cuando pasamos por el centro. Es verdad que hay edificios feos en el centro pero este es para hacer algo e intentar transformar la fachada o cambiarlo de alguna manera ya que mata la plaza y todo el entorno. Una cuidad turística del nivel de Madrid no se puede permitir tener en su corazón algo tan tremendamente feo.</p>
";"12/09/2015 09";"68";"48";"20";"3";"904456983";"1976"
"3603";"No a las obras sin ahorros.";"<p>La propuesta va encaminada a que se tengan que afrontar obras únicamente cuando estas sean finalizables para evitar que queden paradas e inutilizadas.</p>

<p>Es decir, no afrontar obras, salvo extrema necesidad, si no se dispone del capital total para hacer frente la obra. Durante la crisis se han quedado muchas obras en Madrid a medio terminar y que pasado un tiempo se han retomado los trabajos.</p>

<p>El caso es que es mejor afrontar 2 obras de 4, poder terminarlas y disfrutarlas que tener 4 a medias porque no se pueden afrontar los pagos. El resultado final es el mismo, pero permite tener unas cuentas saneadas, menos incertidumbre, ahorro en los materiales rotos/perdidos debido al parón y el deterioro del paso del tiempo en la obra sin terminar. Además los vecinos y demás ciudadanos sufren las menores molestias posibles.</p>
";"12/09/2015 10";"27";"23";"4";"0";"905253777";"1618"
"3605";"Colegios. Coches invadiendo aceras";"<p>Estamos cansados de que a la salida y entrada de los alumnos en algunos colegios, las aceras sean invadidas por vehículos, dificultando el paso de las personas que caminan. Alguno entraría con el mismo coche hasta el patio del colegio si pudiera.</p>

<p>En los peores casos muchos de estos vehículos se encuentran con el motor en marcha para que su ocupante se sienta más confortable, calentito en invierno y fresquito cuando aprieta el calor. Mientras los alumnos y acompañantes que acuden a pie son gaseados por sus tubos de escape.</p>

<p>Se debería poner fín a estas actitudes tan insolidarias, contaminantes e incívicas.</p>

<p>Saludos</p>

<p> </p>
";"12/09/2015 11";"67";"56";"11";"1";"908514558";"3761"
"3606";"Festival artístico anual en las calles de Madrid.";"<p>Organizar un Festival anual en las calles de Madrid como el que se celebra cada año en el mes de agosto en Edimburgo, en el cual varias calles del centro de la ciudad se convierten en un escenario en el cual se mezclan todo tipo de artes y artistas profesionales y no profesionales. Esos días Edimburgo tiene una magia especial que atrae a cientos de miles de visitantes.</p>
";"12/09/2015 11";"42";"31";"11";"2";"904484121";"1476"
"3607";"No enchufar a familiares en cargos de libre designación";"<p>Por coherenia con los principios y líneas éticas defendidas, se debe prescindir de proveer cargos de libre desginación de naturaleza política-directiva a familiares o personas cercanas al entorno, como ha sucedido recientemente en varios casos que afectan directamente a Madrid y a sus concejales. La decisión es injustificable y muestra claramente la falacia del discurso que se realizo en la campaña electoral, amen de defraudar a miles de electores que apostaron por la regeneración y por nuevas prácticas políticas honestas.</p>

<p>Como los nombrados no son los únicos cualificados ni tampoco son lo más cualificados para el cargo, como evidentemente no se les ha nombrado por méritos, debe prescindirse de nombrar a familiares y realizar un proceso selectivo guiado por principios transparantes y basados en mérito y capacidad para proveer cargos libres. Y aunque fuesen los más cualificados (cosa que pongo en dudo) si quiera por ética y estetica se debería haber evitado nombrarlos. Es obvio que están ahí por ser familiares de quien son, no se empeñen en justificarlo.</p>

<p> </p>

<p>De igual forma se debe cambiar la normativa que regula la contratación de personal directivo de responsabilidad en el ámbito local, para impedir que sigan siendo cargos a dedo. Basta de nepotismo. Basta de enchufismo. Corruptos fuera. Se llamen Ahora Madrid, PP o PSOE.</p>
";"12/09/2015 11";"68";"56";"12";"3";"908463818";"3623"
"3608";"Las pintadas degradan la ciudad , multas YA";"<p>Las pintadas NO son arte, degradan la ciudad, la afean ,la deprecian y la contaminan visualmente.Sugiero que pongan sustanciosas multas a los que pillen ""in fraganti"", y que les obliguen a realizar el trabajo social de limpiar su propia pintada y pagar los materiales y productos necesarios, para que se den cuenta de lo que cuesta , en tiempo y en dinero, restituir el muro a su situación inicial.</p>

<p> </p>
";"12/09/2015 11";"79";"69";"10";"4";"910445938";"5153"
"3609";"Rotonda ";"<p>Creo que seria bueno que en la intersección de paseo de Pontones con paseo de Melancólicos se hiciera una rotonda regulando el tráfico y descendería muchos la velocidad de todas las vías. Ya que es un cruce muy peligroso para peatones y coches.</p>
";"12/09/2015 11";"17";"9";"8";"0";"894945337";"52"
"3610";"Semáforos y peatones";"<p>Por seguridad, convendría centrarnos en buscar fórmulas para acabar con los cruces de calles con el semáforo en rojo por parte de los peatones, e incluso hacerlo mientras se atiende al teléfono móvil, aunque nos esté permitido el cruce por semáforo en verde.</p>
";"12/09/2015 12";"13";"8";"5";"0";"897983568";"184"
"3611";"Replanificación y optimización de las rutas de autobuses";"<p>Cuando se consiga un bono transportes que permita el transbordo entre medios estaría bien que las líneas de autobuses se dividieran en radiales y circulares para no tener que acercarse al centro y volver a alejarse si quieres desplazarte entre dos barrios de fuera de la m30</p>
";"12/09/2015 12";"39";"35";"4";"3";"908589177";"2782"
"3612";"Cambiar la luminaria de la ciudad por bombillas LED";"<p>Aún cuando supone un coste inicial elevado, está más que demostrado que se amortiza la inversión en poco tiempo. Por consumo y durabilidad, debería ser algo a considerar. Adicionalmente, sería bueno recortar también los ingresos de las eléctricas y que busquen sus ingresos fijos de formas más creativas.</p>
";"12/09/2015 12";"57";"49";"8";"1";"909065459";"3524"
"3613";"Volver a celebrarse las noche en blanco";"<p>Hace cinco años.Que se le celebró la última edición de la noche en blanco,que se estuvo celebrando en Madrid unos pocos años.En principio se dijo,que se iba a celebrar cada dos años.Pero luego no se ha vuelto a organizar.Es una pena que no se celebre.Ya para uno que Madrid abrian los museos y actividades en la calle.</p>

<p>Seria buena idea que se volviesen a celebrar.Ampliando los museos abiertos y su horario y el de los transportes y ampliar las actividades por todos los barrios.No solo en el centro.</p>

<p>Sería muy buena idea que se volviese a celebrar.</p>
";"12/09/2015 12";"98";"85";"13";"1";"911303561";"6244"
"3614";"Parques  urbanos";"<p>Viendo el lamentable estado en que están la mayoría de los parque de los barrios de la periferia no estaría de más que se volviera a rehabilitarlos plantando árboles , fuentes, bancos , cesped, caminos para transitar, y que no se conviertan en secarrales donde sólo habitan los coches mal aparcados, los perros , grafiteros, delincuentes y demás fauna, pájaros tropicales que se han cargado a los pobres jilgueros, y algo de vigilancia para que la gente incívica no destroce lo que nos cuesta un dinero a todos, y de paso acabar con este mal estructural de la suciedad , de espacios llenos de tierra que se convierten en lodazales en invierno, reparar los solados de los barrios, y dar una imagen más moderna y no tercermundista , que conste que el problema es estructural, nunca se ha invertido en los barrios de trabajadores, sólo en el centro y en hacer obras faraónicas para algunos alcaldes de infausto recuerdo, sin aportación ninguna  a la ciudad, no incluyo los futuros planes de reordenación o creación de nuevos barrios que sí pueden enriquecer y crear puestos de trabajo a la ciudad.</p>
";"12/09/2015 12";"42";"39";"3";"3";"909735356";"3342"
"3615";"Semáforos mal sincronizados";"<p>El tramo de la Avda. Cardenal Herrera Oria desde La Salle hasta Ventisquero de la Condesa, creo que estan mal sincronizados, sales del primero y automaticamente se cierra el segundo en apenas 150 m., supongo que este problema será en muchos mas sitios.</p>
";"12/09/2015 12";"38";"32";"6";"5";"907346333";"2189"
"3616";"Crear mercadillos para pequeños artesan@s";"<p>l@s artesan@s necesitan mas atencion a través del ayuntamiento, en mercadillos, puestos, recintos, donde el alquiler sea proporcional a la venta optenido, es decir en foncion de la ganancia , k sea un tanto por ciento donde las dos parte puedan consiliar actualmente existen ""empresas privadas"", k obligan a l@s artesan@s en pagar un  puesto :alquiler ,por dias sin saber si vendera lo suficiente, y eso es prejudicial</p>

<p>Mercadillos donde fomentan y facilitan a pequeños artezanos poder vivir de su trabajo</p>
";"12/09/2015 12";"52";"41";"11";"2";"906976153";"2365"
"3617";"Restauración del frontón Beti Jai";"<p>Se encuentra totalmente abandonado y semiderruido.Está protegido por el ministerio de cultura y la comunidad.Es el único frontón que queda en Madrid de principios del siglo XX.Sería una pena que se perdierse.</p>

<p>Estaría bién que volviese a reformarse a su estado original y que se pueda utilizar por todos los madrileños.</p>
";"12/09/2015 12";"75";"68";"7";"0";"911571173";"5530"
"3618";"Las paradas de bus contra mendigos ,malo.Los centros de acogida con butacas peor";"<p>En la actualidad y en parte de las plazas que tiene el ayuntamiento para acoger a las personas sin hogar(PSH),el sistema de pernocta se hace en butacas que castigan con su incomodidad la ya precaria situacion social y de salud de quienes las ocupan.Es una lamentable herencia recibida de quienes tenian como"" gran labor social"" el hecho asistencial y caritativo.Urge erradicar esta situacion.</p>
";"12/09/2015 12";"28";"17";"11";"1";"900243832";"364"
"3620";"Habilitar urinarios públicos como los de Ámsterdam ";"<p>La noche madrileña es cada vez más movida y todos estaremos de acuerdo con el hecho de que los meados son un problema bastante serio que no se resolveran con multas. </p>

<p>Para mi, la opción más barata/eficaz sería habilitar urinarios semejantes a los que podemos encontrar en Ámsterdam, son simplemnte unos metales que te tapan y con una boca de alcantarilla en el suelo que permiten mear sin problema, se limpian con un par de manguerazos a presión (en Madrid siempre pasan los de limpieza con la manguera, así que no pasaría nada con eso). </p>

<p>El coste sería el de su instalación y reparación de vez en cuando. Os dejo un par de fotos de lo que hablo: </p>

<p>http://whygo-eur.s3.amazonaws.com/www.amsterdamlogue.com/files/2008/11/streeturinal.jpg</p>

<p>http://blog.ricksteves.com/wp-content/uploads/2014/07/Amsterdam-public-urinal-cleaning.jpg</p>

<p>Se podrían instalar en zonas como Malasaña, Huertas, y en distintas calles del centro, no es necesario que estén en plena puerta del sol, se pueden poner en distintos puntos alrededor. </p>

<p>Otra opción también es la que leí justo en este foro de poner los baños en el metro de Madrid (entiendo que en la zona donde no es necesario ticar para entrar), creo que es algo más caro, pero se pueden poner en puntos concretos de forma paulatina. </p>

<p> </p>
";"12/09/2015 13";"90";"78";"12";"5";"911288048";"5720"
"3621";"Hay que acabar con los posters de publicidad MULTAS YA";"<p>Es terrible ver, sobretodo en zonas de Chueca, como un edificio sin dueño se convierte en carnaza para posters publicitarios. Al principio se hace normal, pero es asqueroso cuando ya hay 3-4 posters encimas uno de otros, en algunos sitios hasta se empiezan a caer y quedan colgando, me parece que dan una imagen tremenda de decadencia en la ciudad. </p>

<p>Obviamente hablo de cosas como esta: </p>

<p>http://farm2.static.flickr.com/1056/1274024863_76429933ca_m.jpg</p>

<p>El que quiera publicitarse que no lo haga a costa de degradar la ciudad, debemos tener algo más de respeto por nuestros edificios. </p>

<p>Creo que el Ayto. de Madrid debería dar trabajo a X personas, como los controladores de aparcamiento, dedicadas a: </p>

<ul>
	<li>Ver los posters callejeros y echarles una foto</li>
	<li>Enviar una multa a la empresa responsable que este por encima del costo de limpieza</li>
	<li>Asegurarse de que esa multa se pague</li>
</ul>

<p>Como digo, al principio es asumible, pero llega un punto donde es bastante lamentable. </p>
";"12/09/2015 13";"51";"45";"6";"0";"909585513";"3441"
"3622";"PARQUÍMETROS POR BARRIOS - zona azul y verde";"<p>Hay diferentes empresas que gestionan las multas de los parquímetros. Como consecuencia han dividido su gestión por barrios y esto supone muchas multas injustas teniendo en cuenta que el coste del aparcamiento es el mismo en cada barrio.</p>

<p>Si aparco y tengo a 7m un parquímetro y otro a 50m uso el que tengo cerca, que está en la misma calle pero SIN SABERLO pertenece a otro barrio. Esto supone multa de 60 solo porque lo gestiona una empresa distinta. ESTO NO ES DAR UN BUEN SERVICIO NI YO TENGO QUE CONOCER LOS LÍMITES DE LOS BARRIOS, LO ÚNICO QUE DEBE IMPORTAR ES QUE PAGO Y DE BUENA FE. La solución sería tan sencilla como que el controlador cuando compruebe la matrícula indique en su PDA el número de barrio. Un pequeño gesto que marca la diferencia de un buen servicio a uno malo. ¿por que no hacen esto ya?... no me queda más remedio que pensar que no se hace todavía porque se están poniendo muchas multas por este concepto que hay que pagar sin solución alguna. El ayuntamiento liberaliza este servicio pero DEBE HACERLO SIN PERMITIR QUE NOS ESTAFEN DE ESTA MANERA YA QUE LAS SANCIONES SON PARA CORREGIR MALAS ACTITUDES HABIÉNDO ESTACIONADO SIN PAGAR Y NO POR QUIEN GESTIONA ESE SERVICIO - HABIENDO YO CUMPLIDO Y PAGADO MI ESTACIONAMIENTO.</p>
";"12/09/2015 13";"30";"25";"5";"1";"906609198";"1666"
"3623";"Cerrar el tráfico de coches en la Cava alta y Cava Baja";"<p>Las calles acaba Alta y Baja sin dos calles que no solucionan ningún tipo de accesibilidad para los coches, actualmente el tráfico en estas dos calles convive problemáticamente con los peatones.</p>

<p>La peatonalizacion de estas dos calles contribuiría a crear una zona mucho más agradable para transitar, los negocios (que son fundamentalmente hosteleros) lo agradecerían y el barrio ganaría un precioso espacio peatonal.</p>

<p>Zona peatonal con acceso estrictamente comercial en su horario correspondiente.</p>

<p>Seria un gran paso para luchar por un Madrid mas limpio,cómodo y paseable.</p>

<p> </p>

<p>Compartir !!!!!</p>

<p> </p>

<p>Saludos</p>
";"12/09/2015 13";"91";"71";"20";"0";"909094656";"3979"
"3624";"Nombrar alguna plaza o calle en honor a la Segunda República Española";"<p>Multitud de reyes y presidentes (no democráticos) del siglo XIX-XX tienen calles en Madrid, asi como al menos 200 calles de personajes afines a la Dictadura de Franco, pero apenas hay calles a personas del Congreso de la Segunda República (Manuel Azaña, Alcala Zamora, Victoria Kent, etc.) </p>

<p>En Getafe las hay, y no tiene sentido que en la capital política de España se ningunee ese periodo democrático e histórico.</p>
";"12/09/2015 13";"107";"41";"66";"1";"890442645";"-957"
"3625";"Abono anual Bicimad ilimitado";"<p>Hola, soy un usuario muy activo de Bicimad y la utilizo de media 2 o 3 veces al día. Para mí se ha convertido en un medio de transporte básico y creo que debería existir la posibilidad de comprar un abono anual ilimitado que sea más caro que el actual (pongamos 60-70 euros o incluso 100 euros) pero que permita al usuario la total libertad de utilizar las bicicletas sin coste alguno (por supuesto solo durante la primera media hora) y evitar así la necesidad de estar cargando el saldo cada quince días. Creo que es así como funciona en otras ciudades de Europa (ejemplos Barcelona, Gotemburgo o Lille) donde únicamente hacen un único pago anual (más elevado) pero tienen derecho a utilizar las bicicletas sin coste alguno). Aunque si bien es verdad, mantendría la opción actual para usuarios que utilicen la bicicleta esporádicamente.</p>

<p>Espero que os guste mi propuesta para los usuarios diarios de Bicimad como yo!</p>
";"12/09/2015 13";"93";"81";"12";"2";"911879642";"6009"
"3626";"Mosquitos en Arganzuela";"<p>Buenos  dias.  </p>

<p>Soy un vecino de Arganzuela que lleva 52 años viviendo en este distrito. Llevamos unos años, desde la inauguración del parque Madrid Río, que es imposible descansar por la noche por la cantidad de mosquitos que hay. Concretamente, en el punto de calle Fernando Poo, a la altura del número 50, probablemente por los árboles que hay en el parque recreativo.</p>

<p>He puesto todos los medios que tengo a mi alcance pero los insectos aprovechan cualquier momento para colarse en casa. No podemos estar con las ventanas cerradas todo el día, es necesario abrirlas en determinados momentos.</p>

<p>Es imposible dormir, nos están causando trastornos del sueño.  Esto diminuye considerablemente la calidad de vida, incluso te planteas cambiar de domicilio. Necesitamos medidas urgentes.  En mi caso, tengo reacciones alérgicas y me causan serios problemas.</p>

<p>Hemos llamado varias veces al 010, para plantear la queja pero el departamento correspondiente no ha solucionado el problema. El año pasado, tuvimos mosquitos de febrero a noviembre porque las temperaturas no fueron demasiado fías y no desaparecieron.</p>

<p>Creo que el Ayuntamiento de Madrid debería tomar serias medidas y acabar definitivamente con el problema.</p>
";"12/09/2015 13";"26";"18";"8";"0";"902755547";"692"
"3627";"Integrar el Salón de Reinos en el Museo del Prado.";"<p>Se lleva planeando este cambio durante cierto tiempo, y va siendo hora que se haga realidad.</p>

<p>El Actual Salón de Reinos se lleva utilizando para varias exposiciones o museos desde hace tiempo, pero lo ideal sería integrarlo en el museo del Prado. Las razones son las siguientes:</p>

<p>- Es parte de la historia de la ciudad (Madrid de los Austrias, Felipe IV).</p>

<p>- Potenciar la oferta turística de la ciudad, al tratarse de lo que eran salas reales de primer orden.</p>

<p>Y la razón más importante:</p>

<p>- Todos los cuadros que estaban expuestos en el antiguo salón de reinos están expuestos en el museo del Prado, y se tratan de obras de Primer Nivel de Velázquez o Zurbarán entre otros, cosa que en parte asegura el éxito de su reabertura, al estar dotado de obras muy importantes dentro del museo.</p>

<p>Además, se daría la oportunidad de poder ver los cuadros originales, en la sala original en la que fueron colgados y (si así se cree conveniente a la hora de hacer el plan de exposición en general) colgarlas en la situación donde estaban, con mobiliario de la época incluido.</p>
";"12/09/2015 14";"25";"22";"3";"4";"907299364";"1672"
"3628";"Mercado de la Cebada";"<p>El Mercado de la Cebada se encuentra en un estado ruinoso e infuncional, el proyecto de remodelación, de construcción del centro deportivo estancado.</p>

<p>Que se impulse el proyecto del Mercado de la Cebada y se informe a los vecinos acerca de esto</p>
";"12/09/2015 14";"70";"64";"6";"3";"912027616";"5302"
"3629";"Inclusión de Bicimad en el abono transporte";"<p>Hola, me gustaría proponer la inclusión de Bicimad dentro de la red de transportes de la ciudad de Madrid de tal manera que con el abono transportes zona A tengas también derecho a utilizar la bicicleta sin coste alguno (por supuesto dentro de la primera media hora). Habría que pensar como adaptar los Totems para que puedan tener acceso las tarjetas Transporte Público pero creo que, siendo Bicimad también un medio de transporte de la ciudad de Madrid, debería ser considerado plenamente como tal, y por tanto ser incluido dentro de la tarjeta abono transporte.</p>

<p>Espero que os guste mi propuesta!</p>
";"12/09/2015 14";"149";"127";"22";"0";"913084039";"8949"
"3630";"Investigar porque  hubo tanta insistencia en celebrar unas olimpiadas en Madrid.";"<p>Recientemente se han dado multiples casos de corrupcion a la hora de adjudicar un evento deportivo como el Mundial de Futbol.</p>

<p>Seria conveniente investigar porque hubo tanta insistencia durante tantos años, en celebrar unas olimpiadas en Madrid ,que intereses ocultos habia .</p>
";"12/09/2015 14";"65";"40";"25";"4";"903302583";"923"
"3631";"Soterrar todo el cableado y contenedores de basuras";"<p>Los beneficios son muchísimos:</p>

<ul>
	<li>Mayor seguridad</li>
	<li>Descontaminación visual</li>
	<li>Mejor accesibilidad</li>
	<li>Beneficio higiénico</li>
</ul>

<p>Solo veo un problema el tema dinero, requieren cuidado  especialmente el cableado aunque en algunos barrios esto no parece un problema ¿Por que nos cobran a todos por igual? Si se multa a las empresas este dinero se puede destinar a solucionar estos problemas que venimos arrastrando de mucho tiempo atrás. Las obras de estas empresas también se pueden planificar.</p>

<p> </p>

<p> </p>

<p> </p>

<p> </p>

<p> </p>

<p> </p>
";"12/09/2015 14";"67";"54";"13";"1";"908918253";"3304"
"3632";"Asfaltar los aparcamientos de la calle Lenguas en Villaverde alto";"<p>Hay varias explanadas en medio del barrio que son utilizadas para arreglar coches,  abandonar vehículos y aparcar entre otras cosas. Dan una pésima imagen al barrio y necesitan ser acondicionadas, deben asfaltarse como mínimo o bien poner un parque.</p>
";"12/09/2015 14";"24";"15";"9";"1";"900971091";"375"
"3633";"Ampliar el servicio de BiciMAD, de forma que llegue hasta Carabanchel Alto.";"<p>Actualmente el servicio de bicis no cruza el río, y creo que sería una gran mejora que se extendiese hacia los barrios de la zona sur de la ciudad. </p>
";"12/09/2015 14";"79";"69";"10";"3";"911615808";"5153"
"3634";"Comunicacion rapida con la policia municipal a traves de whatssap";"<p>Estoy cansado de ver como en el centro de Madrid roban a los turistas, como ciudadanos incívicos depositan bolsas de basura en la calle, de conductores que no respetan el descanso de los ciudadanos y como energumenos hacen uso de sus claxon a cualquier hora , de como se hace botellón en cualquier esquina, de la desconsideración de la gente que en su diversion nocturna, grita, canta, destroza y hacen sus necesidades en la calle y a cualquier hora del dia y de la noche. Si tubieramos contacto directo con la policia podriamos comunicarles este tipo de acciones y algunas más e incluso adjuntarles fotos.</p>
";"12/09/2015 14";"51";"43";"8";"0";"909153434";"2950"
"3635";"Habilitar paneles en los barrios donde la gente pueda colocar anuncios";"<p>Si se te ha perdido un animal, si quieres vender, hacer un trueque, si quieres entablar alguna comunicación en tu barrio, tienes que pegar un cartel en una farola o lugar prohibido. Con un panel público en la calle y cubierto para la lluvia, se podría facilitar la comunicación vecinal.</p>
";"12/09/2015 14";"57";"43";"14";"2";"907251484";"2187"
"3636";"Comedores de pago o catering a domicilio";"<p>Comprar la comida, cocinarla y guardar los ingredientes, es un rollo. Un catering (si hay varios se puede elegir: por tipo/calidad de comida y por precio) puede ofrecer la comida ya preparada, le incluye más ingredientes (generalmente tienen mas ingredientes que nosotros -en muchas ocasiones los combinan mejor-) y suele tener mejores medios (mejor calidad de producto) para preparar las cosas.</p>

<p>Si algunos municipios ""comparten"" instalaciones (piscinas, polideportivos, bibliotecas...) se puede compartir la cocina (y todo lo que conlleva: guardar cosas y limpieza).</p>

<p>En caso de que prepare ""otro/a"" la comida nosotros tendríamos un frigo más pequeño que cuesta menos y consume menos (es el elctrodoméstico que mas consume: está las 24 horas enchufado), no nos gastaríamos el dinero en comprar accesorios de cocina y no tendríamos que enchufar la placa (ni comprarla).</p>

<p>Habría diferentes comidas (para niños, oriental, tradicional española, italiana, peruana, etc). Los postres (frutas, yogures, gelatinas, bollos, flanes...) serían más variados.</p>

<p>Quien quisiera un comedor (donde dan todo) elegiría esta opción, quien quisiera comer en casa usaría un catering (como los que limpian la calle, los carteros, el sevicio a domicilio de los supermercados...) que le lleva la comida a domicilio. Si alguien no quisiera seguiría como hasta ahora.</p>

<p>Si la inciativa la tiene alguien como el ayuntamiento (una entidad pública, si es iniciativa privada costaría mucho) podría hacerse y el precio sería económico.</p>
";"12/09/2015 14";"24";"5";"19";"0";"893793918";"-291"
"3637";"Legalizar drogas blandas como el cannabis";"<p>Que lo vendan en algún tipo de tienda, de calidad y barato, legalización, basta de prohibición.</p>
";"12/09/2015 15";"71";"24";"47";"2";"891747862";"-777"
"3638";"colegios e institutos. seguridad";"<p>Experiencia que podría ser útil en Madrid. En las cercanías de una zona escolar, donde se concentran varios centros educativos, de infantil, primaria, ESO, bachiller y Formación Profesional. La policía Municipal de ese pueblo, cierra la calle de acceso a los mismos y se colocan en los extremos de ella. Tanto a la hora de entrada como de salida de los mismos. De tal forma que los alumnos salen y entran con completa seguridad. Los padres que van a buscar a sus hijos en coche, si hay aparcamiento, se tienen que quedar en esa posición hasta que se abra la calle, porque ya no quedan alumnos en la misma. Evitando el peligro que podría suponer para los estudiantes estar cerca de las maniobras de los citados coches. Los que no encuentran aparcamiento en las salidas de los colegios, se tienen que ir fuera de ese área, aparcar, coger a sus hijos andando y llevarlos a sus coches. Y si incumples esta actuación, se dirigen a los coches y les avisan, les obligan a posicionarlo en la plaza de aparcamiento y toman las matrículas. Si persisten en esta actitud otro día, les multan. Este tipo de actuaciones las he visto en Canada, y varios países europeos. Los alumnos y padres que van a buscar a sus hijos, claro está no se pueden quedar en ese área más de 10 o 15 minutos desde la salida de las aulas. Ya que es la propia policía la que evita esos grupos para dar fluidez y seguridad al área.</p>
";"12/09/2015 15";"30";"24";"6";"0";"906431406";"1440"
"3639";"Publicación de nombres y salarios de Asesores, Directores Grales., etc";"<p>Hola, me gustaría proponer al servicio de Transparencia del Ayto. de Madrid que publiquen los nombres completos y salarios de todos los cargos de libre designación del ayuntamiento, es decir, Directores Generales, Asesores y demás cargos de personal no electo y no funcionario. Creo que es importante que sean públicos los nombres de esta serie de cargos cuya remuneración procede de las arcas municipales. Entiendo que los cargos se publican en el BOCM pero creo que sería mejor si se publicasen también del mismo modo que actualmente aparece la información de los concejales de ayuntamiento. Idealmente creo que también sería bueno y sano publicar una pequeña biografía de estos asesores y cargos de responsabilidad dentro del ayuntamiento.</p>
";"12/09/2015 15";"77";"76";"1";"2";"914938433";"7402"
"3640";"Reconstruir las piscinas La Isla";"<p>Seria de hacer de nuevo las piscinas que había en en el Manzanares en un isla en medio.Tenía forma de barcoa.Estaba a la altura del Puente del Rey y Príncipe Pío.Que estuvieron hasta mediado del siglo pasando. Sería una equipación para los vecinos de la zona y una atracción para los turistas.</p>
";"12/09/2015 15";"31";"24";"7";"1";"906029407";"1316"
"3641";"publicación de subvenciones a ONG";"<p>Para no ser gubernamentales muchas de ellas trincan del dinero público, el dinero de todos, por ello se debe conocer quienes son, propósitos que persiguen, correlaciones con el poder, etc....</p>
";"12/09/2015 15";"43";"42";"1";"2";"912457528";"4004"
"3642";"Traslado almacén de butano";"<p>Traslado almacén de butano situado en el eje de los gallegos al polígono industrial y aprovechamiento de la parcela para  nueva creación de biblioteca/cetro cultural que oferte cursos y ocio para niños y jóvenes de este barrio en desarrollo.</p>
";"12/09/2015 16";"12";"9";"3";"1";"902846513";"450"
"3643";"Traslado almacén de butano";"<p>Traslado almacén de butano situado en el eje de los gallegos al polígono industrial y aprovechamiento de la parcela para  nueva creación de biblioteca/centro cultural que oferte cursos y ocio para niños y jóvenes de este barrio en desarrollo.</p>
";"12/09/2015 16";"14";"12";"2";"1";"905548959";"857"
"3644";"App Participación Ciudadana";"<p>Hola, creo que sería interesante que se cree una App accesible desde el móvil para este portal de participación ciudadana. Así, se hace más cómodo y fácil el participar, crear propuestas o apoyar/rechazar propuestas.</p>

<p>Espero que os guste mi propuesta!</p>
";"12/09/2015 16";"41";"36";"5";"1";"910124257";"2721"
"3645";"Chinches en distrito Centro ( barrio de Embajadores )";"<p>Propongo que el Excelentisimo Ayuntamiento , ponga TODOS los medios posibles ( incluso alguno más ) para erradicar a las chinches de TODO Madrid - en Lavapies  ya llevan muchos meses/años.</p>

<p>http://eldistrito.es/frontend/eldistrito/noticia.php?id_noticia=31811&amp;id_seccion=34</p>

<p> </p>
";"12/09/2015 16";"63";"61";"2";"2";"914179363";"5712"
"3646";"EDUCACION INFANTIL";"<p>Me alegro que sea haya abierto este foro de participación. Soy maestra de infantil, de toda la etapa (de 0 a 6 ) y aunque en la campaña electoral parece que habia un consenso entre Ahora Madrid y PSOE para llevar a cabo un cambio en la politica privatizadora de las escuelas infantiles de la Red Pública, no he oido nada mas al respecto. Como muchos sabreis las tasas de las escuelas han expulsado a  mas de 4.000 alumnos en los ultimos años, provocando que los mas desfavorecidos se queden sin poder asistir a un centro educativo y otros que se beneficien de los 34 millones que dedico la Consejeria a las guarderias privadas. La propuesta de bajar las tasas, al menos en la escuelas del Ayuntamiento no se ha producido, por lo que me gustaria saber que piensan hacer desde la Concejalia de educación, si es que existe. Deciros además que a los niños menores de 1 año se les penaliza además con 60 por ser bebes, por si no fuera poco la cuota establecida.</p>
";"12/09/2015 17";"40";"31";"9";"5";"908023501";"1705"
"3647";"Restricciones de tráfico más allá del centro: Aire limpio también en periferia.";"<p>Tenemos un problema de contaminación provocado por los coches, que sólo se solucionará restringiendo su uso allá donde más se usa<strong>.</strong></p>

<p><strong>El coche se usa mucho más en los barrios más periféricos, </strong>y no hay medida alguna para evitarlo: aparcar es gratis, no hay apenas calles peatonales, no Áreas de Prioridad Residencial, no hay Zona de Bajas Emisiones, etc. </p>

<p>Es bonito plantear más carriles-bici o mejor transporte público, pero la realidad es tozuda: eso no evita un uso del coche cada vez mayor. Toca <strong>una política fuerte de restricción del uso del coche, </strong>quizás impopular para el tercio de ciudadanos que usan el coche, pero beneficiosa para todos, usemos el coche o no. </p>

<p> </p>
";"12/09/2015 17";"62";"42";"20";"6";"906743606";"1490"
"3648";"Recarga de vehiculos eléctricos en las farolas";"<p>Si la electricidad llega a cada farola, por qué no habilitar al menos algunas para recargar vehiculos eléctricos? Para echar gasolina hay que ir a las gasolineras que son sitios con una ubicación a veces incómoda o insegura y casi siempre alejada del sitio donde se aparca. Sin embargo, la electricidad llega a todos lados. Si se quiere evitar la contaminación atmosférica y acústica con el vehículo eléctrico habrá que habilitar donde cargarlos. Se hace con las bicis de bicimad, por qué no con los coches?. Se podría poner un precio acorde con el incentivo que se quiera dar a ese tipo de vehiculos.</p>
";"12/09/2015 18";"44";"32";"12";"21";"907962397";"1454"
"3649";"Habilitar má piscinas cubiertas de gestión pública";"<p>Hay algunas que llevan años cerradas como la del Fernando Martín. Es un deporte muy recomendable para la tercera edad que es de lo que más hay y va a haber en la ciudad. Debería haber muchas más de las que hay y a precios populares.</p>
";"12/09/2015 18";"64";"60";"4";"1";"914010918";"5250"
"3650";"Habilitar espacios en la calzada para que cada finca deje los cubos de basura.";"<p>Los cubos de la basura no tienen una espacio delimitado en la calzada para que sean accesibles tanto desde la acera como desde la calzada por los servicios de recogida. Si los cubos tuvieran un lugar concreto y accesible, se simplificaría la operación de recogida. El espacio debería estar señalizado y convenientemente protegido. Esto no es nuevo. Ya se hace en muchas ciudades y Madrid también pueden hacerlo. Esta práctica facilitaría la circulación de los peatones en calles estrechas y sería una acción deseable del ordenamiento del espacio urbano, sobre todo en el centro de la ciudad.</p>
";"12/09/2015 18";"35";"25";"10";"1";"906133840";"1071"
"3651";"Convocar más plazas en la Escuela Municipal de Arte Dramático";"<p>Cada año se presentan cientos de niños y adolescentes para acceder a la Escuela de Arte Dramático y sin embargo, tras pasar todos una prueba sólo pueden acceder tres niños. Cientos de sueños tirados por la borda. Muchos talentos desaprovechados para tanta Cultura.</p>
";"12/09/2015 18";"18";"10";"8";"0";"899385850";"111"
"3652";"Clausurar la incineradora de Valdemingómez";"<p>Esta instalación es obra de la entonces concejala de medio ambiente, Esperanza Aguirre. Su funcionamiento ha estado siempre bajo la sombra de la contaminación con dioxinas y furanos y por la producción de cenizas toxicas. Esta mala fama está alimentada por el continuado secretismo sobre sus emisiones y su rentabilidad. Habría que auditar los costes y los contratos de esta instalación. La incineración de basuras no tiene sentido cuando no se ha abordado nunca un plan de reducción y reutilización de los RSU y fundamentalmente de los envases.   Es una forma de justificar la proliferación de envases y más envases, que paga el consumidor, para que acaben en la basura. La supuesta producción de electricidad que iba a dar esta instalación se pospuso tantasbya tantas veces que ya nadie cree en ella. Hay que cambiar el enfoque. </p>
";"12/09/2015 18";"61";"49";"12";"4";"910494301";"2972"
"3653";"contaminacion acústica en el distrito centro";"<p>Me gustaría hablar sobre el exceso de ruido en el distrito centro, concretamente en el barrio de Justicia, calle Regueros, Belén, Barquillo, calles próximas a la plaza de Chueca. En muchas de estas calles hay bares, discotecas y locales similares, en calles estrechas que alteran la convivencia vecinal e impiden el descanso nocturno. No es la insonorización de los locales los que generan molestias sino los comportamientos en la calle de las personas que acuden a estos locales. Para fumar salen a la calle y allí montan tertulias y beben y aunque llames a la policía no pasa nada, de hecho se les sanciona pero ahí siguen abiertos. Si no se toman medidas va a ser imposible residir en el centro de Madrid, Por favor hagan algo para que estos barrios sean hablitables y se respeten nuestros derechos como vecinos.</p>
";"12/09/2015 18";"51";"42";"9";"4";"910418708";"2717"
"3654";"Reforma urbana en Barrio de Palos de la Frontera.";"<p>Las Calles anchas de este barrio, Paseo de Santa María de la Cabeza, Palos de la Frontera, Ferrocarril..... son de las más anchas de Madrid, con muchos carriles y algunas (Santa María de la Cabeza y Palos) no tienen demasiado tráfico por lo que se podría establecer un sistema de aparcamiento en batería (como se hizo, por ejemplo, en algunas calles en el Barrio de Salamanca) para poder quitar los coches de las calles estrechas. Yo vivo en la Calle Tarragona y tiene dos filas de aparcamiento (como otras calles del barrio) y es imposible materialmente pasar con un carro o con una silla de ruedas, los ancianos no pueden deambular...... es necesario cambiar el urbanismo y en esta zona sería muy fácil. Además, si se dejara la calzada y la acera al mismo nivel (si hubiera dinero para ello) se mejoraría la limpieza urbana. También podría reformarse la calle de Batalla del Salado puesto que podrían ensancharse sus aceras o hacer carril bici. En mi comunidad de propietarios acordamos dirigirnos al Ayuntamiento para por lo menos conseguir que quiten coches de nuestra calle, a ver si es verdad que el equipo de gobierno escucha a la ciudadanía.</p>
";"12/09/2015 18";"29";"24";"5";"1";"908460177";"1572"
"3655";"Instalar un ascensor panorámico en el viaducto de la calle Segovia";"<p>Estaría puesto en uno de los pilares que va de la Calle Segovia a la Calle Bailén.Originalmente estaba proyectado cuando se hizo el viaducto.Estaría bien como atracción turística con las vistas a la Casa de Campo y a la sierra del Guadarrama.</p>

<p> </p>
";"12/09/2015 18";"42";"17";"25";"1";"894255292";"-323"
"3656";"Empadronamiento";"<p>¿ para poder votar las propuestas  , tengo  que estar empadronado en Madrid ?</p>
";"12/09/2015 19";"31";"17";"14";"9";"901828546";"164"
"3657";"Artistas de calle";"<p>Hay muchos buenos artistas de calle en esta ciudad pero no pueden trabajar. En estos tiempos de crisis profunda, creo que ampliar los espacios donde este tipo de artistas puedan ofrecer sus espectáculos a cambio de la voluntad de la ciudadanía, es una buena manera de que entre algo de dinero en las maltrechas economías de una forma honrada. Ahora sólo pueden estar, hasta donde yo sé, en el paseo del estanque del retiro, en sol y alguna calle aledaña y en la plaza mayor. Habilitar más zonas del retiro, más plazas amplias de la ciudad (Colón, Plaza España, etc), haría que se ampliara la oferta artística en otras zonas además de no concentrar a todos los artistas en espacios que se quedan pequeños, de esta forma todos prodrían trabajar mucho mejor, y la gente disfrutaría con estos espectáculos. Ya es bastante duro trabajar en la calle para que encima tengas que hacerlo de mala manera. Gracias</p>
";"12/09/2015 19";"31";"18";"13";"1";"902178946";"290"
"3658";"Nuevos tranvías en Madrid Rio,Avda de los Poblados y Avda Valladolid";"<p>Son zonas que no disponen de metro o cercanías.Con unos tranvías estarían bién comunicados.</p>

<p>La Lineas podrian ser Madrid Rio:Puente de los Franceses-Ciudad Universitaria hasta Legazpi.Con Paradas a lo largo del Mazanares,Paseo de la Florida y Avenida de Valladolid.</p>

<p>Y Hospital 12 de Octubre-Ciudad Jardín.Con paradas en la Avenida de los Poblados y Aluche.</p>
";"12/09/2015 19";"81";"52";"29";"6";"907019195";"1476"
"3659";"Que se rebajen las multas de tráfico y se permitan sus pagos fraccionados";"<p>Sancionar está muy bien, puesto que es una manera de mentalizar a la gente y castigar si no hacen caso. Además que ya de paso se recauda, que está bien, lo que ya no está bien es cuando se usa como recurso para recaudar, todos me han entendido. Lo que me refiero con el enunciado es que se rebajen las sanciones a condustores un tanto por ciento en general (por ejemplo un 10% -o- un 20%) en importe y se permita/imponga un pago fraccionado como norma general y por ley. Por ejemplo, si a una persona por exceso de velocidad o por aparcar mal le ponen una multa, no es lo mismo, y pomgo cifras simbolicas, no es lo mismo pagas 60 euros -o- 120 de golpe, que pagar comodamente 5 -0- 10 euros al mes hasta su pago integro. Sería un beneficio para todos, puesto que se pagaría por el infractor de manera instantanea y constante por su hecho, puesto que no le supondría apenas gasto relativo, y el ayuntamiento se aseguraría mensualmente un dinero seguro. Parece una tontería, pero dentro de la rigidez que debe existir en las sociedades, dar cierta fleexibilidad como norma establecida, es lo más inteligente de manera aplastante. Eficiencia dentro del sentido común y las reglas a seguir.</p>
";"12/09/2015 19";"40";"19";"21";"12";"898108203";"-95"
"3660";"Declarar todo el interior de la M30 como ZBE";"<p>La ciudad crece y el número de coches en ella también. </p>

<p>El problema de contaminación es importante, especialmente en el centro. Por lo que cuando antes la declaración de Zona de Bajas Emisiones (ZBE) se centraba en unos pocos barrios del centro parece necesario que se amplíe a todo el centro, cubriendo todo el interior de la M30.</p>

<p>De esta manera, las actuaciones que está declaración implica se extendería a un área mucho más amplia que lo necesita. </p>

<p>Saludos,</p>

<p> </p>
";"12/09/2015 19";"49";"35";"14";"3";"907688334";"1500"
"3661";"Necesitamos una nueva piscina pública";"<p>Vivo en el barrio de Arganzuela, y para 2 barrios (Peñuelas y Arganzuela) tenemos solo una piscina pública, bastante pequeña para estos dos barrios y mucha gente esta esperando cola desde las 9 de la mañana para poder entrar cuando abren a las 11;30 y mucha  se queda fuera.Seria bueno que construyan una nueva instalacion.Gracias</p>

<p>PD: Ya hicimos una peticion en change,adjunto pagina</p>

<p>https://change.org/p/ayuntamiento-de-madrid-nueva-piscina-pública-municipal-en-arganzuela</p>
";"12/09/2015 19";"44";"31";"13";"1";"907011384";"1268"
"3662";"Parque futuro en los terrenos del Estadio Vicente Calderón";"<p>Converitir el EstadioVicente Calderón en un parque cuando el Atlético del Madrid se mude a la La Peineta.</p>

<p>En vez de los rascacielos,que se proyectaron allí.Mejor convertirlos en un parque y enterrar la M-30 y asi terminaría la obra de Madrid Rio.Poner algo que recuerda al Estadio.Un monumento o llamarlos Parque Vicente Caldeón o Parque Atlético de Madrid.</p>
";"12/09/2015 19";"60";"41";"19";"3";"907445979";"1503"
"3663";"los alquileres sociales de los bancos vencen este año, habria que prorrogarlos";"<p>Los primeros alquileres sociales de los bancos vencen este año, ya que empezaron en 2014, y van a vencer en junio del 2016. Creo que es de justicia que, al menos los que están al corriente de pago, se prorroguen otros 3 años. Para la gente que está ahora en las casas, tener una fecha de alzamiento (a nosotros ya nos ha llegado la carta) es un motivo de angustia, que podría evitarse. Y los bancos van a estar encantados: inquilinos agradecidos, buena prensa, y le sacan unos durillos al piso!</p>

<p> </p>

<p> </p>

<p> </p>

<p> </p>
";"12/09/2015 19";"40";"27";"13";"0";"905999075";"945"
"3664";"Soterrar tramo de carretera de Extremadura";"<p><strong><em>En el año 2008 se aprobo en pleno del Ayuntamiento  la remodelación del tramo del paseo / carretera de extremadura desde la salida del tunel de M30 hasta Campamento. Al igual que se llevó a cabo en el tramo de Avenida de Portugal. Es de entender que en este periodo de crisis no se haya podido realizar, pero deberian de retomarlo y llevarlo a cabo cuanto antes. Somos muchas familias que vivimos afectadas por la gran cicatriz estetica y acustica que supone la gran carretera; Viviendas pegadas a la via, falta de aceras, o en condiciones deplorables, pasos subterraneos sucios e inmundos, alambradas , vallas o barreras muy antiguas y oxidadas . En algunos tramos existen descampados con restos de excombros suciedad incluso animales muertos </em></strong></p>

<p><strong><em> Por no decir el trastorno que ocasiona la separación fisica entre barrios cómo Lucero, Batan, Aluche, Colonia jardin, Campamento a la hora de el dia a dia: Comprar, ir al Banco, al colegio de los niñosy un largo  etc...</em></strong></p>
";"12/09/2015 19";"55";"45";"10";"5";"911093194";"2863"
"3665";"Como este ayuntamiento es ""enrollado"", estaciono donde y como quiero .";"<p>Ocupacion de los carril bus.Estacionando en segunda fila ocupando calzadas arteriales.Carga y descarga donde mejor convenga a modo de vehiculos de emergencias.etc etc etc.Un Madrid con muchisimos mas vehiculos de lo soportable no se puede permitir tanto comportamiento incivico continuado y no sancionado-,ni acorde con el deterioro vial que ocasiona ,ni de ningun otro modo-.</p>
";"12/09/2015 20";"46";"15";"31";"1";"894433314";"-521"
"3666";"Mercadillos de barrio en cada barrio cada semana o cada mes";"<p>Mercadillos de barrio cada semana o cada mes donde la gente puede vender las cosas de segunda mano o que no utiliza(abierto a matices)</p>
";"12/09/2015 20";"57";"38";"19";"1";"907096178";"1266"
"3667";"Artistas de calle";"<p>Hay muchos buenos artistas de calle en esta ciudad pero no pueden trabajar. En estos tiempos de crisis profunda, creo que ampliar los espacios donde este tipo de artistas puedan ofrecer sus espectáculos a cambio de la voluntad de la ciudadanía, es una buena manera de que entre algo de dinero en las maltrechas economías de una forma honrada. Ahora sólo pueden estar sin ningún tipo de permiso, hasta donde yo sé, en el paseo del estanque del retiro, en sol y alguna calle aledaña y en la plaza mayor. Habilitar más zonas del retiro, más plazas amplias de la ciudad (Colón, Plaza España, Dalí etc), haría que se ampliara la oferta artística en otras zonas además de no concentrar a todos los artistas en espacios que se quedan pequeños, de esta forma todos prodrían trabajar mucho mejor, y la gente disfrutaría con estos espectáculos. Ya es bastante duro trabajar en la calle para que encima tengas que hacerlo de mala manera. Gracias</p>
";"12/09/2015 20";"67";"51";"16";"0";"910295007";"2664"
"3668";"Mejorar buscador página web";"<p>Buenas,</p>

<p>No sé si será posible mejorar el buscador con el que cuenta la web para que al buscar, por ejemplo: ""Bici Carabanchel""; te salgan todas las propuestas en las que estén incluidas ambas palabras. Por otro lado, si pones el nombre completo y exacto de la propuesta, que te salga la primera. En resumen, que el buscador de unos resultados parecidos a los que te da google cuando buscas algo. De esta forma, antes de proponer algo puedes encontrar con facilidad si esa propuesta ya está y así intentar no repetir.</p>

<p>Un saludo y muchas gracias por su atención.</p>
";"12/09/2015 21";"21";"18";"3";"1";"908961619";"1285"
"3669";"Solo mesas, sillas y sombrillas en las terrazas de bares y restaurantes.";"<p>La mayoría de los bares y restaurantes de Madrid tienen terraza, y llevo observando como crecen el número de establecimientos que realizan obras en la vía pública para colocar porches y toldos, en el espacio que no les corresponde. Además esto supone una molestia para los viandantes que ven reducidos los espacios que les pertenecen y se apropian de un espacio que si bien pagan por usarlo no les pertenece.</p>
";"12/09/2015 21";"66";"55";"11";"4";"912861838";"3666"
"3670";"Revertir la titularidad Pública de la EMT";"<p>Ahora que se ha privatizado, le encantará a la gestora de la nueva y privatizada EMT que un vecino abra la propuesta de apagar de una santa vez todos los autobuses cuando lleguen a sus finalizaciones de parada.</p>

<p>Deberían también poder hacer que los conductores no sean tan poco sutiles, tan poco considerados y tan poco ahorradores de combustible y humo para la ciudad.</p>
";"12/09/2015 22";"43";"30";"13";"2";"908179690";"1186"
"3671";"Suprimir los parquîmetros ";"<p>Mi propuesta es que se supriman los parquimetros en todos los distritos excepto en el Distrito centro,por razones obvias.Los vecinos y vecinas de Madrid ya pagamos demasiados impuestos como para estar pagando el parking de cerca de nuestra casa</p>

<p> </p>
";"12/09/2015 23";"73";"27";"46";"2";"894889198";"-702"
"3672";"Eliminar la información acerca de corridas de toros en web turismo";"<p>Me ha llamado la atención que en la versión inglesa de la web turismo de Madrid, dentro del apartado ""Cultura"" haya una sección dedicada a Bullfighting (apartado que solo está disponible en inglés). Creo que la cultura española y madrileña tiene muchos otros puntos a destacar que no implican el maltrato animal y me gustaría que esa sección sea retirada. ¿Qué opinan ustedes?</p>

<p>http://www.esmadrid.com/en/bullfighting-madrid</p>

<p>P.D. He presupuesto que la web mencionada anteriormente pertenece al ayuntamiento, si no es así les ruego que me disculpen.</p>
";"12/09/2015 23";"134";"86";"48";"9";"910255999";"2438"
"3673";"Talar arboles";"<p>Con la cantidad de arboles que se estan cayendo ultimamente,seria muy bueno talar los mas antiguos porque ""parece"" q estan deseando que se muera gente para empezar a hacerlo</p>
";"13/09/2015 00";"40";"9";"31";"1";"896979414";"-495"
"3674";"Más colegios públicos en el Ensanche de Vallecas";"<p>Practicamente desde que empezó a construirse el barrio denominado como ""Ensanche de Vallecas"",se viene pidiendo que se construyan Colegios Públicos,ya que actualmente sólo hay 3,uno de ellos aún en construcción,todos los demás son concertados,soy una madre muy preocupada por este tema ya que entiendo que la educación es muy importante para la sociedad,y cada vez nacen más niños y nacerán,todos los años hay el mismo problema y seguirá habiéndolo,mientras no hagan caso a las peticiónes de la gente que lo esta viendo todos los días,la solución no es abrir 6 lineas en un colegio pensado para 3,como el Jose de echegaray,ni abrir otra linea en ""El Quijote"",en villa de Vallecas,para poner un parche,por favor hagan caso a los vecinos que sabemos de que hablamos y que problemas hay en el dia a día y pongan mas colegios publicos,EDUCACIÓN PÚBLICA Y DE CALIDAD!!!!</p>
";"13/09/2015 00";"93";"82";"11";"2";"916421871";"6260"
"3675";"Soterrar la m30 en el puente de vallecas";"<p>la gente que vivimos en vallecas también queremos ver la m30 soterrada, tenemos derecho a tener las mismas instalaciones q disfrutan nuestros vecinos de Madrid Río, porque Vallecas también es Madrid</p>
";"13/09/2015 00";"69";"49";"20";"10";"910952546";"2059"
"3676";"Que se aclaren los vínculos entre el ayuntamiento y el pequeño Nicolás";"<p>Que se aclaren los vínculos entre el ayuntamiento y este personaje llamado el pequeño Nicolás y si existió algún trato de favor y quienes fueron las personas responsables.</p>
";"13/09/2015 00";"36";"26";"10";"0";"909040395";"1155"
"3677";"Violencia de género e infancia ";"<p>Quisera proponer que se realizara una campaña sobre la violencia de género y la infancia. En medios audiovisuales y con la misma intensidad que se utilizan para las campañas de tráfico, limpieza o consumo responsable del agua. A pesar que se intenta educar en los centros de educación, hay muy pocas campañas de este tipo y sobre la violencia en la infancia. NINGUNA.</p>

<p>Gracias</p>
";"13/09/2015 01";"25";"13";"12";"0";"900431607";"52"
"3678";"Ciclo de Conferencias, Profecías del Fin de Los Tiempos.";"<p>La gente tiene que ser informada correctamente y propongo un ciclo de conferencias por expertos contrastados en profecías, visiones y apariciones marianas, ya que se sabe que media humanidad desaparecerá antes de un año pero no será el fin del mundo temido, sino el final de un ciclo y el comienzo de otro maravilloso, sin políticos ni financieros. Hay mucho desconocimiento, ceguera y mofa, pero ya se están cumpliendo y queda muy poco tiempo para explicarlo.</p>
";"13/09/2015 01";"41";"6";"35";"6";"897977093";"-424"
"3679";"Crear también portales de Gobierno abierto a nivel de distrito o de barrio";"<p>Me parece una idea estupenda esta del portal de Gobierno abierto de participación ciudadana. Y como parece buena idea, ¿porqué no extenderla a nivel de distrito o de barrio? Se podría crear uno en la página web de cada Junta Municipal. La problematica que se plantearía bajaría un peldaño aproximandose aún más a la ciudadanía</p>
";"13/09/2015 01";"45";"39";"6";"0";"913875950";"2860"
"3680";"Impuesto de bienes Inmuebles";"<p>Madrid se ha convertido en la ciudad con fachadas más horrorosas por metro cuadrado. Y ello es debido al uso masivo de cierres de terrazas de forma desordenada y arbitraria. Pero lo más indignante de esto es que el aprovechamiento de una terraza como vivienda que supone un aumento de la superficie útil de una vivienda no tiene ningún efecto en términos impositivos. ¿no debería reflejarse dichas actuaciones en el aumento del impuesto de bienes inmuebles puesto que dicho impuesto grava el valor que tienen los inmuebles? Claramente se puede entender que dicho valor aumente cuando se cierra para aprovechar una terraza que sobre el proyecto original tenía un uso de espacio abierto.  Esto tambie implia cpara aquello vecinos sabios que utilizan la fachada para instalar su aire acondicionado cuando dicho aire se encuentra en el interior de su edifcio habieno pagado por toda la ciudad una bonificación de aumetno de aprovechameinto de edificabilidad. Y todo esto no sólo el Ayuntamiento no impone un mayor impuesto sino que lo permite y tolera, con tal de cobrar una infíma licencia de obra. </p>
";"13/09/2015 01";"25";"10";"15";"1";"897986542";"-200"
"3681";"CREAR UN ENLACE PARA ""MIS DEBATES EMPEZADOS""";"<p>Creen un enlace donde pone ""Mi Cuenta"" por ejemplo, para que podamos ver los debates que hemos creado, y así meternos para modificarlos, añadirle o quitarle una etiqueta, o ver los comentarios y votos de los demás usuarios. </p>
";"13/09/2015 02";"34";"32";"2";"0";"914808553";"2823"
"3682";"ZONA VERDE ILEGAL. REGLAMENTO GENERAL CIRCULACIÓN. MULTAS S.E.R.";"<p>Automovilistas Europeos Asociados (AEA) denuncia que el Ayuntamiento de Madrid no está utilizando legalmente las señales del Reglamento General de Circulación, ya que el color verde no existe en su catálogo y el azul es el único posible para delimitar las zonas de estacionamiento limitado. Por otro lado, los vigilantes de S.E.R. son empleados de una empresa privada y no agentes de la autoridad (Jueces o Policías), por lo que su denuncia es considerada como la de un mero ciudadano, sin que ésta tenga la consideración de presunción de veracidad. Que solo gozan de esta veracidad la Policía. Con lo cual es como si un vecino va a denunciar a otro al ayuntamiento por pasarse la hora de la zona azul. Lo que hacen se la llevan luego a un Policía Muncipal que está en el ayuntamiento que se dedica a firmar todas las que le entregan estos empleados. También se dedican a multar por aparcar en carga y descarga cuando eso es una función de la Policía Municipal o Agentes de Movilidad. La OCU, el Defensor del Pueblo Andaluz, varias asociaciones y medios de comunicación ya han denunciado estas ilegalidades, y ""limbo i/legal"". Y todo sigue igual. A ver si se aclara todo esto ya y queda bajo la legalidad total de una vez. Y no nos vacilan.</p>
";"13/09/2015 03";"31";"19";"12";"3";"906753356";"429"
"3683";"Cambio durante fin de semana mi piso a un politico";"<p>Vivo en el centro de Madrid,entre Puerta de Toledo y la Latina y como ya he dicho en el titulo del post,me gustaria cambiar mi casa durante un fin de semana,con algun politico influyente,con poder de decision en el ambito que nos toca.Mi piso esta bien situado,con dos balcones a la calle y con una vida nocturna que paso a relatar.</p>

<p>Aburrirte de jueves a domingo,imposible,empezamos los jueves,aunque antes un bar situado estrategicamente y que cierra todas las noches cerca de las 2:00 nos ameniza con clientes en el exterior capazes de cantar opera en cualquier teatro,pero volviendo al jueves,empezamos con documentales de animales,que van entonando cantos silvestres,arriba,abajo,arriba,abajo,asi hasta el domingo,hay otro tipo de documentales,se suele ver como hacen los animales sus necesidades,bastante cultural e incluso deportes,como el lanzamiento de cubos de basura o el futbol coche,que consiste en usar a un coche como un balon,pero tambien disponemos de peliculas,las hay de boxeo,de zoombies,estas suelen verse sobre las 4 - 5 de la mañana,comedias con muchas risas ,pero sobre todo musica,eso si,a capela,gutural,con palmas,etc,etc,por eso si algun politico quiere comprobar el nivel de cachondeo y cultural que tengo en mi piso,no dude en ponerse en contacto conmigo,a ver si es capaz de aguantar tantas emociones en solo 4 dias.</p>
";"13/09/2015 03";"36";"24";"12";"13";"909358191";"800"
"3684";"Calles nudistas";"<p>Yo practico el nudismo en las playas nudistas y en las piscinas que lo permiten cuando lo permiten, y quiero poder practicar mi naturismo tranquilamente y de forma legal en Madrid; Poder disfrutar de la Puerta del Sol sin textiles, o del Retiro o viajar en metro.</p>

<p>Creo que es un derecho que debemos reclamar todos los que hacemos nuestra vida en Madrid y estamos a favor del naturismo.</p>
";"13/09/2015 04";"88";"16";"72";"14";"898234253";"-1018"
"3685";"Permitir que un taxista sea vih positivo";"<p>Me gustaría que se derogase la normativa municipal que no permite que una persona vih positiva sea taxista. No tiene ningún sentido esto, más que discriminar un sector de población.</p>

<p>Se hizo incluso una campaña en change.org para que esto cambiara. Os paso link con toda la información.</p>

<p>https://www.change.org/p/ayuntamiento-y-comunidad-de-madrid-las-personas-con-vih-sida-tambi%C3%A9n-pueden-ser-taxistas</p>
";"13/09/2015 06";"78";"64";"14";"5";"916607977";"4102"
"3686";"Poder descansar tranquilo: cerrar todos los AFTER que hay en Madrid.";"<p>Hola a todos y todas.</p>

<p>Como ustedes saben un ""after"" es un local que abre después de las 04:00 y permanece abierto hasta más allá del mediodía. Siguen vendiendo bebidas alcohólicas, ponen la música muy alta y entre sus intereses no está la convivencia ciudadana con sus vecinos. Algunos artículos periodisticos los vinculan a mafias y han recibido denuncias por ruido, venta de drogas e intimidación. Sin embargo el ayuntamiento no parece coordinar bien sus esfuerzos y los locales siguen abiertos pese a acumular más de 100 denuncias.</p>

<p>Como pueden ver en los enlaces que abajo les pongo hay muchos casos. Los suficientes como para que el ayuntamiento acuda prontamente para proteger al ciudadano.</p>

<p>Inicio este debate para sumar ciudadanos que apoyen la redacción de una normativa clara y tajante que permita a la policía cerrar física y administrativamente cualquier local de estas características en cuestión de horas.</p>

<p>Enlaces de interesante lectura:</p>

<p>- http://ccaa.elpais.com/ccaa/2015/03/02/madrid/1425330996_809279.html</p>

<p>- http://www.20minutos.es/noticia/2416393/0/afters-abren-madrid/denuncias-vecinos/burlan-controles-policiales/</p>

<p>- http://www.somosmalasana.com/un-after-ilegal-amarga-la-vida-a-los-vecinos-de-la-calle-antonio-grilo/</p>

<p>- http://www.telemadrid.es/?q=programas/buenos-dias-madrid/ruidos-insoportables-en-malasana</p>

<p> </p>
";"13/09/2015 08";"61";"43";"18";"10";"913728577";"1762"
"3687";"Mejorar el acceso peatonal del barrio de Entrevías";"<p>Salir caminando del barrio de Entrevías hacia Méndez Álvaro es un acto heróico. Tenemos al lado un parque como el Tierno Galván que es un lujo, y que en linea recta no llega a un kilómetro, pero si intentas ir caminando puede convertirse en una odisea. Tienes que cruzar los dos sentidos de la M-30, hacer cambios de lado de ""acera"" (donde hay) etc. Quien lo haya intentado sabe de lo que le hablo.</p>

<p>La solución ideal sería ampliar el soterramiento la M-30 desde el nudo sur hasta el Puente de Vallekas, pero siendo realistas, no parece muy viable y económicamente seguro que hay otras partidas donde dedicar presupuesto que no necesiten cemento.</p>

<p>Una idea podría ser construir una pasarela peatonal que conectara la Avda. de Entrevías con Méndez Álvaro. Sencillita, modesta. Con la décima parte de lo que costaron cualquiera de los puentes supermegaguays de Madrid Rio seguro que sería suficiente. No hace falta que la diseñe Calatrava.</p>

<p>No sé, es una idea. Si alguien tiene otras... bienvenidas.</p>

<p>Saludos</p>
";"13/09/2015 08";"50";"47";"3";"1";"919156638";"4136"
"3689";"Utilizar la Caja Mágica para conciertos y demás eventos";"<p>El pastón que nos está costando y está muerta de risa. Solo se utiliza una semana al año. Se le podría dar más utilidad.</p>

<p>Uniendo la propueta con esta otra, en la que se habla del triste panorama musical en Madrid https://decide.madrid.es/debates/291</p>
";"13/09/2015 09";"124";"120";"4";"1";"923949724";"11225"
"3690";"Contaminación lumínica";"<p>Es sabido que en las grandes ciudades no es posible tener un cielo limpio para poder obervar en todo su explendor las estrellas, astros, plantes y galaxias del firmamento a simple vista, no digamos la via lácteca a la que pertenecemos. Eso sí, podemos intener buscar medios prácticos que minimice ese problema, y entre ellas hay varias opciones. Empezaría por aquellas farolas que deberán iluminar siempre hacia abajo, Otras medidas serían que a partir de cierta hora de la noche se apaguen la mitad de las farolas que existen en las calles principales y plazas -me refiero a las destinadas para el tráfico- aunque sería aún mejor regular la intensidad de todas ellas en general, ya que el número de vehículos circulando es insignificante y, por último, apagar el alumbrado de edificios (públicos o privados), estatuas, monumentos, etc., también a partir de cierta hora de la noche donde la afluencia de personas o visitantes extranjeros es mínimo.</p>
";"13/09/2015 11";"69";"60";"9";"4";"919629469";"4434"
"3691";"Un paseo por las nubes";"<p>Vivo en el centro y si no me marcho es porque ahora mismo no puedo, de lo contrario, créanme que lo haría. Cada mañana me levanto y me encuentro la calle llena de basura orgánica, orines, excrementos (humanos muchos de ellos), latas, vidrios rotos, papeles, etc. Propongo que las señoras Carmena y Sabanés tengan que pasear al menos una vez al mes temprano por la mañana (<strong><u>sin avisar del recorrido ni del día exacto</u></strong>) por el centro y vean ellas mismas el estercolero en el que vivimos los ciudadanos. Tal vez la dulce fragancia a orines y alcohol mezclados con el de la basura, la visión de la porquería, pisar unos cuantos vidrios y unas baldosas sueltas, cruzarse con los borrachuzos que gritan y no dejan dormir a los vecinos, y comprobar que los 'after' abren como les da la gana les hagan comprender que el problema es realmente grave. Y es que desde las ventanas de Cibeles todo se ve muy bonito.</p>
";"13/09/2015 11";"43";"39";"4";"5";"918856795";"3174"
"3692";"Autobuses, taxis, coches de policía, ambulancias, etc, coches eléctricos.";"<p>La mejor manera de enseñar es con el ejemplo. Entiendo los muchos factores que existen en cuanto a contratos con empresas para adquisición de vehúculos, la presión de paises productores y emrpesas de refinado para potenciar y alargar el uso de vehiculos de propulsión interna y demás factores en el mundo en general. Pero se debe de apostar de manera fuerte por causas necesarias y eficientas. Las próximas adjudicaciones de vehículos en sus parques concretos deben de eempezar a tener una gran parte del mismo, en cada sector público como incido, de vehículos el.ectricos o en su defecto híbridos o mínimo con sistemas de star stop, emisines mínimas por eficiencia de motores con poca cilindrada pero mayor caballaje y par motor por tecnología, etc. Se debe de hacer para empezar a reducir la contaminación desde el sector público en su medida y dar un claro ejempo a los usuarios que, sin duda, será de lección que funcionará para concienciar desde quién debe de mandar y dar ejemplo, el gobierno en este caso regional. Autobuses, coches de policía, en la medida de lo posible normativas y ayudas para taxis en ese sector concreto, ambulancias, vehiculos municipales como los de ayuda a dependientes, vehiculos de empresas encargadas del mantenimiento como los parques y la limpieza pública, camiones de basura, caminones y vehiculs de bomberos, vehículos oficiales, etc, etc, etc. Todo en sus renovaciones necesarias cuando llegue su momento, no cambiar por cambiar porque no está la economía para eso, y dentro de la medida de existencia de vehículos existentes, valga la redundacia, en el mercado para cada sector y necesidad de los mismos y la posibilidad económica de adquisición haciendo un esfuerzo en la apuesta por los mismos. Se pueden llegar a acuerdos con las fábricas para poner en cada vehículo oficial los beneficios de esos vehículos en alguna parte de los mismos para que lo vea todo el mundo y sea un marketing para ellos aun sin poner marca, solo en beneficio, pues la marca ya va en el propio vehiculo por defecto, para que hagan ofertas que hagan que la adquisición sea muy favorable económicamente para la renovacion de los parques de vehículos. Me refiero en este caso concreto para este hilo, por supuesto que se deben de tomar más medidas como restricciones de tráfico con niveles alto de contaminacion, prevalecer el uso del transporte público ante el coche privado en su uso para gente que solo vaya y venga de ly al trabajo y pueda usar transporte publico de una manera locuaz y pragmática y demás medidas. Vamos a darnos salud para todos y mejorar la economía, pues si se reduce la polución seremos más felices por tener mejor salud y será un menor gasto público en sanidad pues se reducirán, y se comprobrá de manera irrefutable, las enfermedades y patologías en personas.</p>
";"13/09/2015 11";"66";"58";"8";"5";"919767552";"4393"
"3693";"Permitir a la gente bajo un control plantar vegetación en sitios públicos";"<p>Imaginense el beneficio de tener cuanta más vegetación, mejor. La vegetación se come literalmente la polución y renueva el aire. Si a cuatro milloes y pico de personas se les permite, bajo un cierto control, plantar en lugares públicos plantas y arboles, imaginense el beneficio sin coste que supondría los mismos. Si se piensa en el agua, pues que se adopten medidas para que sea vegetación con bajos recursos de riego, etc. Nunca es poco lo que se puede tener como vegetación y el beneficio es increible.</p>
";"13/09/2015 11";"42";"29";"13";"4";"913309793";"1104"
"3694";"Crear campañas como ""ponga una planta en su terraza"".";"<p>La vegetación tiene muchos beneficios pues renueva el aire y se come la polución. Imaginemonos que en miles y miles de casas, se empiezan a poner plantas que no existían. Eso ayudaría en gran manera a mantener un aire limpio por todo Madrid. Beneficio para la salud y menos gasto público en sanidad por bajar en su medida las enfermedades y patologías.</p>
";"13/09/2015 11";"50";"42";"8";"6";"917856341";"2856"
"3695";"Imágenes en los debates";"<p>Dar la capacidad de insertar imágenes en los debates. A veces una imagen complementa muy bien una exposición.</p>

<p>saludos!</p>
";"13/09/2015 11";"23";"20";"3";"0";"915596393";"1478"
"3696";"Mejorar el captcha de esta web.";"<p>El captcha antirobots es bastante sencillo, fácilmente descifrable por un algoritmo. Hacedlo un poco más enrevesado para evitar que algún troll inserte 1000 debates sin sentido.</p>

<p> </p>

<p> </p>
";"13/09/2015 11";"20";"16";"4";"1";"913635273";"960"
"3697";"Propuesta sentido común de la ciudadania en ayuda a la convivencia";"<p>Los presupuestos están como están y son lo que son. Es cierto que debería estar todo mucho mejor, pero es lo que hay. Aparte que se debe de manejar de la manera más eficiente los presupuestos existentes, aparte de ello, debemos de entender que no se puede sacar, aun usándose con la mayor eficiencia, de donde no hay (exceptuando que si se puede sacar en casos concretos de donde si hay, quién más poder económico tenga, que pague más impuestos en cada caso de manera relativa y exponencial a sus posibles). Si tenemos suciedad en algún lugar y no la recogen, quejarnos de maner formal y con fuerza, a la vez que intentamos entre las comunidades limpiarlo para un beneficio mutuo. No es hacer el trabajo del consistorio, no, es ayudarnos a nosotros mismos por la situación a mejorar nuestras vidas. Quejarnos mucho a la vez que mejoramos nuestro alrededor. Al igual me gustaría que cada persona, en la medida de lo posible, ayudara en maner aindividual o en comunidad, a quién lo necesite tanto si vive en un piso y no tiene recursos, como si vive en la calle. Los poliíticos y los gobiernos son los que deben de ocuparse de todo lo que deben, cierto, pero si utilizamos el sentido común, lucharemos tanto por que así sea y se cumpla o intente cumplir siempre, como por ayudar en lo que no se hace y podemos ayudar por nuestro propio bien y el del prójimo, además de quejarnos con razón, que debemos hacerlo, poner de nuestra parte en solucionarlo porque así es un beneficio para nosotros mismos.  QUEJARSE POR LO QUE DEBE DE SER Y QUEJARSE MUCHO, PERO A LA VEZ PONER DE NUESTRA PARTE AL MISMO TIEMPO QUE NOS QUEJMAOS.</p>
";"13/09/2015 11";"13";"7";"6";"1";"905365285";"53"
"3698";"Cómo se está pagando este portal?";"<p>Pues eso, que sería interesante que el Ayuntamiento informara en todos los servicios sobre el coste que tienen y cómo se desglosan esos costes</p>
";"13/09/2015 11";"41";"21";"20";"7";"906977818";"51"
"3699";"Fomento de las Matemáticas";"<p>El Grupo de Innovación Educativa de la Universidad Politécnica de Madrid (UPM)  Pensamiento Matemático ha puesto en marcha el Aula Taller-Museo de las Matemáticas -ensa, un espacio para disfrutar con las Matemáticas. Tiene su sede en la ETS de Ingenieros de Caminos, Canales y Puertos de la UPM.</p>

<p>La creación de un Aula Taller-Museo de las Matemáticas surge de la intención de que este espacio se convierta en un centro cultural para la comunidad educativa y el público en general donde se desarrollen diferentes actividades relacionadas con las Matemáticas. Consideramos que es muy importante fomentar el gusto por una ciencia tan importante y aplicada como las Matemáticas, muchas veces rechazada por los estudiantes y en general,  por gran parte de la sociedad.</p>

<p>Es un proyecto sin ánimo de lucro abierto al público de forma gratuita. Toda la información puede consultarse en http://innovacioneducativa.upm.es/museomatematicas/.</p>

<p>Queremos dar a conocer este espacio. El esfuerzo en poner en marcha este tipo de proyectos es en vano si no se difunde su existencia y el público no tienen conocimiento de ello.</p>
";"13/09/2015 12";"45";"38";"7";"3";"917824907";"2617"
"3700";"Que se retiren las marcas de debates inadecuados a debates con sentido común";"<p>Hay gente que por ignorancia o incluso malos valores, no le parecen adecuados ciertos debates que no buscan ningún beneficio privado y si un beneficio común. Por lo que como cualquiera puede poner un signo de debate inadecuado y en si me parece bien, que alguien con dos dedos de frente perteneciente al ayuntamiento deje marcados los inadecuados e incluso puedan ser retirados, y los que se marcan sin razón aparente pues son debates con sentido común, que se les retire como marcados como debate inadecuado, e incluso que no se les pueda marcar ya como tal. No es quitar opciones a este sitio y a la gente, es ponerle sentido común.</p>
";"13/09/2015 12";"23";"14";"9";"35";"912750750";"304"
"3701";"SI SE QUISIERA SE PODRÍA SOLUCIONAR LA LIMPIEZA EN MADRID SIN APENAS COSTE.";"<p>Sé que puede ser políticamente incorrecto lo que voy a decir, pero creo que todo el que reciba una Renta Mínima de Inserción (RMI) o que se favorezca de alguna manera de papá Estado debería dar algo a cambio.</p>

<p>Hay muchas personas cobrando RMI's que, igual que reciben del Estado, deberían dar al Estado. En forma de 2 o 4 horas de servicio a la Comunidad. Ahora el tema es limpieza, pues limpieza. Después es el tema de Bibliotecas, apoyo a Bibliotecas, etc. Creo que así ellos se sentirían mejor profesionalmente hablando porque ya no estarían tan ""al margen"" de la sociedad y todo iría mucho mejor. Aparte lograrían experiencia en varios sectores para trabajos futuros. Esto sí qúe sería una reinserción real.</p>

<p> </p>
";"13/09/2015 12";"89";"57";"32";"8";"914437327";"1601"
"3702";"Modificación de la normativa sobre horario y ocupación de las terrazas de bares";"<p>El 30 de julio del año 2013 por motivos espurios y de medro personal de algunos componentes del gabinete de gobierno del Ayuntamiento de Madrid se modificaron los horarios y los permisos de ocupación del suelo público a las empresas de hostelería permitiendo abusos de todo tipo sin análisis previo ni control de las ubicaciones. Para una gran parte de la ciudadanía comenzó así una pesadilla que no ha terminado a día de hoy.</p>

<p>Si la normativa anterior ya era lesiva para aquellos que tenemos hostelería a menos de cinco metros de nuestras viviendas, la normativa de julio de 2013 terminó de rematar la pesadilla.</p>

<p>Muchos de nosotros soportamos un nivel de ruidos, malos olores de cocina y suciedad durante 15 horas al día. Denunciada en debida forma esta situación, nunca fuimos escuchados. A día de hoy seguimos con plazas y aceras de menos de cinco metros ocupadas por ¿terrazas? que parecen tener permisos ilimitados para ocupar el espacio público como les parezca. Sin control de ningún tipo y a pesar del dilatado espacio que ocupan en tiempo y lugar, abusan cerrando cuando les parece, no recogiendo sus desechos, elevando el nivel de ruido hasta más allá de las 3 de la madrugada y, en suma, no respetando el entorno.</p>

<p>Seguimos solicitando de este ayuntamiento lo que ya llevamos años solicitando: Derogación de la normativa de 30 de julio del año 2013 sobre los permisos a bares y terrazas. Control de la ocupación del suelo, control horario especialmente en aquellas zonas sensibles en medio de las zonas de viviendas, por otra parte permisos que nunca se debieron dar sin restricciones y recuperación sensata del espacio público para la ciudadanía. Es muy deseable que cambien algunos lemas y en lugar de Nos vemos en los bares podríamos decir Nos vemos en los parques, en la biblioteca</p>
";"13/09/2015 12";"70";"53";"17";"9";"917312353";"2725"
"3703";"Unión líneas 56+156 EMT Av. America- Legazpi ";"<p>Deberian unir la línea 56 y 156 de la EMT Y pasaria a denominarse 56 Avenida de America- Plaza de Legazpi </p>

<p>Sentido Legazpi: Desde Av. Ciudad de Barcelona 2058 deberia girar a Cerro Negro continuar el recorrido como la línea 148 hasta la Av. Planetario.</p>

<p>En la vuelta realizaria parada junto a la línea 113 en Cerro Negro-Gandia (5860) y continuaria su recorrido por C. de Barcelona. </p>

<p>La línea 156 solo perderia la parada de Pedro Bosh-Mendez Alvaro pero su alternativa seria muy cerca en la Est. Sur.</p>

<p>La línea 56 pierde su cabecera en la parada bajo la M30 (1000) pero realizaria la parada de Cerro Negro 5860 ( solo es cruzar el semaforo) </p>

<p>Se conseguiria reducir la frecuencia de ambas líneas y en lugar de finalizar en Diego de León podria realizar el cambio de sentido justo antes de Av. America, seria como mucho un par de minutos y enlazaria mucho mejor con el Intercambiador, ese par de minutos en el recorrido son los que ahorra al llegar a Puente de Vallecas desde Cerro Negro y no hacer cambio de sentido en Puente de Vallecas, con el mismo tiempo mejor aprovechado llega sin problemas a Av. America.</p>

<p>Beneficiaria a la línea 148 en su tramo Pte. Vallecas-Legazpi. </p>

<p>Reduciria la frecuencia del 156 a la mitad y ligeramente la de la línea 56.</p>

<p>Es mas eficiente y ecologico ya qué con el mismo coste la frecuencia de paso es mayor y amplia zonas de servicio.</p>

<p> </p>
";"13/09/2015 13";"34";"31";"3";"2";"918832111";"2552"
"3704";"Carriles y bici y PGOU";"<p>Debido al creciente e imparable interés por la movilidad en bicicleta, creo que ya es hora de que por norma (o por ley) figure la construcción de carriles bici.</p>

<p>Una forma de realizarlo podría ser que constase en el PGOU la obligatoriedad de que las nuevas vías y/o las que se remodelen, por operación asfalto o cualquier otra intervención, proyecten un carril bici segregado tanto de la circulación de coches como de la acera.  </p>

<p>Asimismo debería constar como prohibición tajante que los carriles bici dividan las zonas peatonales cuando están en la acera.</p>
";"13/09/2015 13";"47";"34";"13";"1";"915182778";"1519"
"3705";"Fachadas y cierres de comercios sin graffitis";"<p>El tema de los graffitis en mi barrio es preocupante, aunque no creo que sea el único que tenga este mismo problema.</p>

<p>Al hecho ya añadido de que las calles están llenas de basura y que apestan, todas las fachadas están llenas de graffitis. Todo esto en su conjunto da un aspecto de abandono y dejadez al barrio bastante deprimente.</p>

<p>Lo que propongo para acabar poco a poco con las pintadas es, además de otras posibles medidas, obligar además que cada propietario sea responsable de mantener las fachadas limpias. Y aquí incluyo, especialmente, los cierres de tiendas y bares.</p>

<p>Cuanto más sucio se ve un sitio, menos nos preocupamos de mantenerlo limpio. Quiero decir, que cuando aparezca la primera pintada, se debería limpiar o pintar para taparlo, evitando así que el problema vaya <em>in crescendo</em>.</p>

<p>
Se agradece que algunos comerciantes se preocupen de mantener los cierres y su establecimiento limpios y libres de grafitis, ¿por qué no lo hacen el resto? Entiendo que es un fastidio que te pinten la fachada y tener que limpiar lo que ha ensuciado otro, en mi edificio también pintan y tratamos de mantenerlo limpio, ¿pero es que nadie se ha dado cuenta que los grafitis sólo atraen más grafitis? ¿y que cuanto más limpio esté un sitio es más difícil que se ensucie?</p>

<p>Alguien comentaba en una propuesta la existencia de ""nuevo revestimiento antigraffi no tóxico"", que permitia la limpieza de éstos solamente con agua, ¿no se podrían discutir propuestas como ésta y otras para combatir los pintadas callejeras?</p>

<p>Está claro que el Ayuntamiento es responsable de los edificios públicos o del mobiliario publico, ¿pero qué pasa con todo lo demás?</p>

<p> </p>

<p>Muchas gracias</p>
";"13/09/2015 13";"71";"64";"7";"7";"921543837";"5138"
"3706";"Construir un nuevo Rockodromo como el que había en la Casa de Campo.";"<p>Como el que había en los 80 y 90.Donde está hoy el Madrid Arena.Estaría bien ponerlo donde está el Estadio Vicente Calderón o en el Mercado de Frutas de Legazpi,al lado del Matadero.</p>

<p>Así ofrecer festivales,conciertos,teatro o actividades....Como se hacía en el de la Casa de Campo.</p>
";"13/09/2015 13";"45";"28";"17";"4";"912440990";"684"
"3707";"Madrid sea sedes de festivales como el BBK de Bilbao,Sonar de Barcelona........";"<p>Unos festivales musicales como que se hacen en estas ciudades.Son bastantes conocidos en toda Europa y en el mundo.Traería un monton de gente de todas partes,promoción para la ciudad,empleo y dinero.</p>

<p>Sería gestivales de todo tipo de musica:Alternativo.metal,electronica,Jazz,Blues........</p>
";"13/09/2015 13";"59";"42";"17";"2";"915774336";"1779"
"3708";"Pago de los plazos de coches híbridos por el colectivo anti coches de esta web";"<p>En los comentaristas de esta web hay una criminalización de las personas que tenemos un coche contaminante (es decir antiguo) y que tenemos que usarlo (por el tipo de trayectos,  por el trabajo,  por los hijos, por nuestros mayores....). Como el hecho de que tengamos coches a antiguos,  muchas veces de segunda mano, ea porque no tenemos fondos ni de lejos para tener coches eléctricos o híbridos propongo que entre todos los que nos quieren cerrar el paso al centro de la ciudad, subirnos todo tipo de tasas, y los que no dejan de criticarnos como si fuéramos unos snobs, nos paguen o bien un coche no contaminante o bien una bicicleta eléctrica con posibilidad de llevar varios niños o ancianos en días de lluvia: nosotros también estamos por el medio ambiente, pero no somos tan privilegiados como los que pueden permitirse una vida hippie sin responsabilidades.</p>
";"13/09/2015 14";"52";"20";"32";"5";"901712516";"-461"
"3709";"Las Fiestas de Usera, que vuelvan a los barrios ";"<p>En 2005, la junta municipal de Usera sugirió (impuso) la celebración de las fiestas de Usera, eliminando así las fiestas de cada uno de los barrios de Usera. La premisa no era mala: Unir los presupuestos de todas las fiestas (salvo San Fermín, que las conserva) para hacer una mejores fiestas. Y así fue durante los años de gracia económica. Al Parque Pradolongo, donde se celebran las fiestas, han venido a cantar David Civera, Marta Sánchez, El Arrebato, Malú... y se celebraron muchas actividades con las asociaciones, actividades infantiles, guiñoles, deportes, etc</p>

<p>Pero llegó la crisis, y bajadas sucesivas cada año de los presupuestos de las fiestas, hasta convertir las fiestas del distrito en algo de mucha peor calidad que lo que se hacía en los barrios. Además, las fiestas nunca fueron del agrado de muchos, que no las sintieron como suyas, pues echan de menos las fiestas tradicionales de sus barrios.</p>

<p>Por favor, devuelvan las fiestas a los barrios, o mejoren considerablemente las que hay, en colaboración con las asociaciones y vecinos que quieran aportar, organizando más actividades, más música, y mas fiesta, mejor y para todos.</p>

<p>NOTA: El mínimo para que esto se vote es el 2% del censo, 53.000 habitantes, y vecinos de Usera somos 103.000. Es difícil que lleguemos al mínimo exigido, pero sería interesante que los vecinos del distrito pudieran votarlo en caso de que haya un número importante de personas interesadas en ello, o que se hablara en el pleno en la junta municipal de Usera.</p>

<p>Que se haga cuando se pueda o corresponda, se sobreentiende que no es lo más urgente por solucionar.</p>

<p>Un saludo a tod@s</p>
";"13/09/2015 14";"38";"25";"13";"0";"912972785";"789"
"3710";"Protección Civil fuera de SAMUR";"<p>Creo hoy  Madrid NO tiene un departamento de protección civil concreto. Desde que SAMUR integró a los voluntarios de protección civil  por una guerra entre la Comundiad y el Ayuntamiento esta disciplina ha desaparecido y se ha desgajado en varios departamentos como bomberos, policia y SAMUR y esto crea ineficiencia de su trabajo. </p>

<p>Madrid necesita un departamento de protección civil que no sea de corte SOLO sanitario, pues la protección civil es algo mas amplio que el magnifico servicio de ambulancias de emergencia que Madrid posee. </p>

<p>La porteccion civil que Madrid deberia de tener es un departamento integrador de varias acciones que hacen distintos cuerpos que hoy por hoy están dispersos, policia municipal en apertura de locales, recepción de planes de autiprotección, revisión de la seguridad de actos masivos en la calle, preplanes de actuación, diseño de actuaciones preventivas de efectivos en la calle, creación de planes de emergencia e implantación ( hoy se subcontrata) tanto en edificios públicos y fiestas y actos del ayuntamiento, creación de inventario de emergencias,  integrar la formación tanto de voluntarios, profesionales y colectivos que hoy se dedica el CIFSE pero que va por su lado y no hay organismo que decida que formación se da. </p>

<p>En definitia que tenemos grandes organismos en el ayuntamiento que llevan un trocito de la protección ciivl y nadie da las directrices comunes, sino que cada organismo toma las decisiones que le interesa, y así no tenemos una dirección clara de por done va la seguridad integral.Un plan de autoprotección pasa por bomberos y por la policia municipal y por el SAMUR y todos te lo piden y no hablan entre ellos.</p>

<p>El plan de mergencia de Madrid PEMAM es un gran desconocido no puede verse en la web municipal y no se enseña en los colegios y en los colectivos que muchas veces  que tienen que ponerlos en marcha. </p>

<p>En definitiva se pretende crear un organismo único MULTIDISCIPLINAR que integre varias visiones de la emergencia para llegar a resolverla integrando profesionales de varios campos, policias, bomberos, SAMUR, técnicos muncipales, limpieza y técnicos en protección ( que los hay) y que estudie nuevos riesgos que puede tener la ciudad con soluciones, con conexiones con la universidad y contemplano la formación como  un actividad indispensable en la protección civil. </p>
";"13/09/2015 14";"25";"19";"6";"4";"914666592";"988"
"3711";"Barbacoa en Comunidades de Vecinos";"<p>Por los estatutos de tu comunidad puede estar o no regulado el uso de barcoa, pero si no lo está, solo te queda el uso del art. 7.2 de la LPH. </p>

<p><em>""2. Al propietario y al ocupante del piso o local no les está permitido desarrollar en él o en el resto del inmueble actividades prohibidas en los estatutos, que resulten dañosas para la finca o que contravengan las disposiciones generales sobre actividades molestas, insalubres, nocivas, peligrosas o ilícitas.""</em></p>

<p>En concreto, me gustaría sugerir que en periodo de verano se prohiba el uso de barbacoas de leña y que exclusivamente se puedan usar de gas o electricidad.</p>

<p>Estas actividades causan molestias al resto de los vecinos, el gas que explusan es nocivo y puede provocar incendio en la comunidad, así como resultar peligroso el hacer fuego en una vivienda.</p>
";"13/09/2015 14";"42";"13";"29";"3";"902182946";"-495"
"3712";"Evitar que la religión tenga que ver con el tiempo";"<p>¿Qué es eso de empezar a contar desde que ""nació"" jesucristo?</p>

<p>Estamos tan oprimidos por la religión que ya ni pensamos en las cosas importantes, propongo empezar la cuenta desde 0, o por ejemplo desde que nació podemos.</p>

<p>Estamos en el año 1 DDP, Despues De Podemos.</p>

<p>Basta de cristofascismos</p>
";"13/09/2015 14";"50";"10";"40";"2";"902946667";"-600"
"3713";"Prohibir forocoches";"<p>No veo para nada normal que ese foro tenga tanto poder, lo veo un lobby MUY PELIGROSO y claramente de derechas, propongo prohibir el acesso a él, al menos desde Madrid.</p>

<p>Un saludo.</p>
";"13/09/2015 14";"42";"9";"33";"6";"902786156";"-514"
"3714";"Mapa con localización exacta de las paradas de autobuses";"<p>Ayer al intentar ir a las ferias de Fuenlabrada decidí usar el transporte público para volver a mi casa, pero fue una tarea complejísima. Encontré que había 2 lineas nocturnas: la N-806 y la N-803</p>

<p>http://www.redtransporte.com/madrid/transporte-publico-fuenlabrada.html</p>

<p>El problema es ¿¿donde se cogen?? No hay ninguna referencia a ninguna calle, no hay mapa, no hay forma posible de localizar la parada salvo por el nombre que se le ha asignado a dicha parada en función de un criterio desconocido. Dichos nombres son tan descriptivos como ""Real"" o ""Barrio Naranjo"". A lo mejor a los habitantes de esa zona si que les dice algo ese nombre (no obstante, un barrio es demasiado amplio como para poder ubicar la parada), pero a los que venimos de fuera nos es críptico, ¿será esa nuestra parada? ¿no? quien sabe. Al final no me quedó más remedio que coger el coche.</p>

<p> </p>

<p>He usado el caso concreto de Fuenlabrada, que es el que tengo más reciente, pero es un problema que se extiende a cualquier linea de autobuses en cualquier región de Madrid. El problema es que no puedes utilizar un autobús si no lo has usado previamente, o tienes un conocido que ya lo ha usado y te lo cuenta o esperas a hablar con el conductor de dicho autobús, con lo cual no puedes planificar nada con anterioridad.</p>

<p> </p>

<p>Mi propuesta consiste en la creación de una pagina web que sirva como referencia, con el nombre de cada parada asociado a la calle y número donde se ubican. Asi mismo, seria de gran ayuda contar con un mapa donde poder visualizar el trazado del recorrido seguido por cada linea.</p>

<p> </p>

<p><strong>IMPORTANTE: </strong>lo de Fuenlabrada es solo un ejemplo para ilustrar la problemática. No obstante, me refiero a solucionar lo que compete a nuestro ayuntamiento.</p>
";"13/09/2015 14";"37";"32";"5";"15";"918954455";"2335"
"3715";"Castigar de verdad quien mea por la calle.";"<p>Es asqueroso y antihigiénico, ¡no puedo más!</p>
";"13/09/2015 14";"91";"75";"16";"2";"920695061";"4862"
"3716";"Polideportivo en el barrio de Opañel";"<p> el barrio de Opañel con 31.646 habitantes carece de una infraestructura deportiva de titularidad municipal. Es urgente que este barrio tenga una infraestructura deportiva</p>
";"13/09/2015 14";"36";"31";"5";"0";"918291373";"2238"
"3717";"Ampliación línea 74 hasta San Juan Bautista";"<p>Ampliación de la línea 74 de la EMT desde el Parque de las Avenidas hasta San Juan Bautista, ubicándose su final en la calle Torrelaguna esquina Avda de Ramón y Cajal Actualmente sta línea va medio vacía durante la mayor parte de su recorrido</p>
";"13/09/2015 14";"20";"18";"2";"2";"917121844";"1440"
"3718";"Volver los Buhometros";"<p>Eran muy buena alternativa a los buhos convencionales y al no querer abrir el metro los findes de semana por las noches.Así habia mas opciones de moverse por la noche en trasnsporte pública ya que hacían el trayecto del metro.Asi habría menos accidentes por la gente que cocje el cohe bebida.Y más empleo.</p>
";"13/09/2015 14";"92";"87";"5";"3";"924352740";"7754"
"3719";"Creación linea 225 (Principe Pío-La Peseta)";"<p>Pues aquí la propuesta para coexionar mejor la ciudad y puntos relativamente ""cercanos"" que carecen de comunicación.</p>

<p>-Intercambiador Principe Pío, Pte de Segovia, Gta del Puente Segovia, Ermita del Santo , 15 de mayo , Antonio Leyva-Marqués de Vadillo, Antonio Leyva, Plaza Eliptica, Via Lusitana, Centro Comercial Isla Azul, Av de la Peseta junto al Metro.</p>

<p> </p>

<p>Con esta linea creamos de un plumazo una conexion entre la Peseta y Principe Pío sin dar mucha vuelta, además de unir puntos intermedios como es la calle A.Leyva con PPio, complementamos el 116 que es como un autobús fantasma que pasa de vez en cuando, y unimos parte del distrito de Latina con el de Carabanchel a través del Paseo Ermita del Santo con la Plaza Eliptica. Además gracias a la parada en Marqués de Vadillo, a los vecinos de la Peseta se les ofrece la posibilidad de acceder al parque Madrid Río de una forma mas rápida ya que el 35 y el 118 no se caracterizan precisamente por ser lineas rápidas y directas, y que además están saturadas sobre todo en fin de semana en Isla Azul saliendo de allí hasta los topes, esta linea 225 también serviría para descongestionar el acceso en transporte público a dicho centro de ocio y compras.</p>
";"13/09/2015 15";"40";"38";"2";"0";"921206348";"3419"
"3720";"Villaverde ";"<p>     Al Sr. Concejal presidente del distrito de Villaverde:</p>

<p>    Después de años de barrios de primera y barrios de segunda, los madrileños nos hemos dotado por fin de un Ayuntamiento para que aplique las mejoras y la normativa municipal igual en Villaverde que en Chamartín.</p>

<p>     Señor Concejal presidente, la normativa municipal de Madrid (incluido este distrito) obliga a los bares que ponen música a tener dos puertas y entre ellas un compartimento estanco. Esta norma se cumple en Centro, Chamberí y el resto de distritos mimados por la anterior Administración. </p>

<p>     Señor concejal presidente, los vecinos de Villaverde Alto confiamos en que haga cumplir la ley a doscientos metros de su despacho en la Junta: en el Paseo de Alberto Palacios.</p>

<p>     NO NOS FALLES, ZAPATA.</p>

<p>     Un fraternal abrazo.</p>

<p>     </p>
";"13/09/2015 15";"35";"34";"1";"3";"921353014";"3205"
"3721";"Autobús vallecas-tanatorio M40";"<p>Desde que se abrió el tanatorio de la M40, muchos vecinos de Vallecas llevan a sus seres queridos a este Tanatorio por ser más cercano, pero para llegar a este, en Metro se tarda una hora en llegar y la estación no esta cerca, en autobús hay que coger dos ( 130 y 23) y uno de ellos sólo para una parada y tardan 30 min en pasar. </p>

<p>Para ir altanatorio sur hay autobuses a la puerta, el de la M30, también hay mejor transporte público, asi que pueden plantearselo</p>
";"13/09/2015 15";"32";"30";"2";"0";"920142420";"2625"
"3722";"Cierre total al trafico en la Casa de Campo. Linea 33 (EMT) ;100% ecológica ";"<p>Creo que es necesario y urgente restringir en su totalidad el trafico a la Casa de Campo, no se puede permitir que en el parque mas grande de nuestra ciudad y pulmon esencial sigan saturado de coches que acceden al parque de atracciones o al zoo. A este último muchas veces los particulares saltandose la prohibición de los accesos limitados en los alrededores donde claramente pone las señales  que unicamente puede transitar EMT y bici. Por no hablar de la zona de Lago, que practicamente hay mas coches que personas aparcadas. Se ha trabajado muy bien limitando el transporte privado y haciendo carriles bicis en condiciones, no como los que había antes, pero hay que dar un paso mas, y señalar que la Casa de Campo no puede continuar siendo contaminada por el transporte privado aunque sea parcialmente, es como si a dia de hoy si permitiera el acceso en coche al Retiro en ciertos tramos. Esta zona es perfectamente accesible por Metro a través de Lago, Batán y el mismo Metro de Casa de Campo, ademas de varias lineas de EMT como la 33 que trascurre por el interior. Si fuera necesario esta linea deberia ser incrementada en frecuencia sobre todo en verano, o como se hacia en el pasado creando una lanzadera entre el parque de atracciones-zoo y el metro de Casa de Campo, pero esto sería asumible con una buena frecuencia del 33, que aprovechando que el Pisuerga pasa por Valladolid, reclamo que esta linea pase a ser servida por autobuses mas ecologicos como GNC o hibridos, ya que trascurre por una zona de especial proteccion como debería ser esta, y no por Scania Versus, que siendo bastante modernos, actualmente son mucho mas contaminantes, que otros mas antiguos que poseen un filtro, y que solo van destinados a lineas que trascurren por la almendra central.</p>
";"13/09/2015 16";"62";"44";"18";"1";"916836795";"1845"
"3723";"Censo de árboles cortados y no repuestos";"<p>¡Buenas!</p>

<p>Vivo en Madrid entre los barrios de Oporto y Vistalegre y en los últimos años he estado observando que bastantes árboles han sido talados en las calles pero no repuestos, queda el hueco vació o el tronco cortado, un peligro añadido para personas invidentes además de empobrecer la belleza de las calles. Sin duda, los árboles cambian el aspecto del barrio, lo hacen acogedor y saludable. El valor ornitológico, y por tanto de control de plagas, también es enorme y a tener en cuenta.</p>

<p>Les pido, por favor, sean tan amable de tomar en consideración mi petición, para lo cual les facilito a continuación un listado del censo de árboles que debieran volver a las calles, son 22 árboles:</p>

<p>- Calle Muñoz Grandes, faltan 5 árboles en los números 5, 13, 20, 25 y 56.</p>

<p>- Calle Humanitarias, falta 1 árbol en la plaza frente al número 3.</p>

<p>- Calle Matilde Hernández, faltan 2 árboles, 1 a la altura del número 73, y 1 frente a la entrada del Corte Inglés.</p>

<p>- Calle Avecilla esquina con calle Alondra, falta 1 árbol a la altura del número 10.</p>

<p>- Calle Alondra, faltan 6 árboles, 1 en el número 31,  2 en el número 33, 1 en el 35, 1 en el 42 y 1 en el 50.</p>

<p>- Avda. Plaza de Toros, falta 1 árbol en el número 7.</p>

<p>- Calle Oca, faltan 3 árboles, 1 en el 27, 1 en el 34 y 1 pegado al muro de la Finca Vistalegre frente al número 212.</p>

<p>- Calle Portalegre, falta 1 árbol en el número 68.</p>

<p>- Calle Manuel Lamela faltan 2 árboles, frente al número 1 en la plaza.</p>

<p>Este censo lo he realizado simplemente en los trayectos que frecuento pero desgraciadamente son muchos más los que debieran ser repuestos en todo nuestro municipio. Animo a todos los ciudadanos a publicar censos similares sobre su zona con el fin de conseguir un Madrid mejor.</p>

<p>Espero y confío en que le den la importancia que tiene y actúen en consecuencia desde la convicción ecológica y el bienestar de los vecinos.</p>

<p>Gracias anticipadas.</p>
";"13/09/2015 16";"101";"97";"4";"7";"925786773";"8931"
"3724";"Cierre de establecimientos centenarios ";"<p><u><strong>Históricos y emblemáticos deberían de estar protegidos.</strong></u></p>
";"13/09/2015 16";"49";"45";"4";"1";"921874274";"3765"
"3725";"Finca Vistalegre ¡Parque público, YA! ";"<p>¡Buenas!</p>

<p>Si hay en Carabanchel una reivindicación histórica, siempre prometida electoralmente pero nunca cumplida, esa es la utilización de la Finca Vistalegre como parque público, el Retiro de Carabanchel. Existe una solicitud de declaración de Bien de Interés Cultural por parte de los vecinos y un Plan del Ayuntamiento de Madrid de recuperación y reutilización de los edificios, que nunca llega.</p>

<p>Durante varias legislaturas todos los partidos gobernantes y sus opositores, lo han incluido como promesa electoral, al igual que el gobierno municipal actual. Por eso, pedimos que definitivamente se cumpla.</p>

<p>La Finca Vistalegre no siempre estuvo cerrada a los ciudadanos, fue durante un tiempo parque público. En sus 44 hectáreas no sólo puede albergar la ubicación de algunos edificios institucionales, sino que debe abrirse a todos los ciudadanos como zona verde. La distancia a los parques más cercanos impide que sean disfrutados por familias con niños, ancianos, deportitas y vecinos en general que, sin embargo, viven al lado de la Finca. Hay que sumar también, el patrimonio condenado al olvido y al deterioro, dos palacios, una ría navegable, fuentes, jardines... </p>

<p>Pueden ver una muestra de lo que es la finca en estos enlaces: </p>

<p>https://artedemadrid.wordpress.com/2009/08/27/finca-vista-alegre-patrimonio-desaparecido/</p>

<p>http://historias-matritenses.blogspot.com.es/2009/09/la-quinta-de-vista-alegre-carabanchel.html </p>

<p>http://eprints.ucm.es/24202/1/Documento1.pdf</p>

<p>Y de las reivindicaciones históricas de los vecinos reflejadas en medios de comunicación a esperas de cumplirse:</p>

<p>http://www.elmundo.es/elmundo/2011/10/10/madrid/1318227316.html</p>

<p>http://ccaa.elpais.com/ccaa/2012/07/31/madrid/1343762458_807693.html</p>

<p>http://www.madridiario.es/noticia/416724/medio-ambiente/la-finca-de-vista-alegre:-50-anos-de-recreo-y-150-de-decadencia.html</p>

<p>La apertura de la Finca Vistalegre cambiaría el aspecto del barrio, haciéndolo más acogedor y saludable. Pedimos al actual gobierno que por un Carabanchel mejor, por un Madrid mejor, cumpla su promesa hacia los ciudadanos sin más demora.</p>

<p>Espero y confío en que le den la importancia que tiene y actúen en consecuencia desde la convicción ecológica y el bienestar de los vecinos.</p>

<p>Gracias anticipadas.</p>

<p> </p>

<p> </p>

<p> </p>
";"13/09/2015 17";"102";"95";"7";"7";"925446599";"8196"
"3726";"Club de Campo de Madrid";"<p>El Club de Campo de Madrid es una instalación deportiva que desde 1993 debería ser pública y que los alcaldes Alvarez del Manzano y Ruiz Gallardon con sucesivas actuaciones han hecho que siga siendo privado hasta más allá de 2030.</p>

<p>El 75% de las acciones están en manos del Ayuntamiento de Madrid y de Patrimonio del Estado. El acceso es exclusivo para socios ya que aunque en el papel no es así, en la práctica sólo pueden entrar los socios que pagan una cuota inicial y una cuota anual y unos cuantos privilegiados a los que el Ayuntamiento u otras Instituciones les dan tarjeta VIP para poder acceder a las instalaciones. </p>

<p>También teóricamente se gestiona con el dinero de las cuotas de los socios y el pago por los servicios utilizados por los usuarios de los mismos pero esto no es tan cierto ya que las grandes obras las ha pagado el Ayuntamiento de Madrid. Entre los años 2004 y 2011 el Ayuntamiento gastó en el Club al menos 14 millones de  en diferentes obras e instalaciones.</p>

<p>Opino que se debe abrir al público en general y que la entrada al espacio sea libre y cada usuario pague por lo que use. Muy cerca del Club de Campo está el Centro Deportivo Puerta de Hierro que funciona con el sistema de entrada libre y pago por lo que se usa (golf, tenis, padel, canchas, rugbi, etc..) y pienso que es un ejemplo de buen funcionamiento. </p>

<p>No se trata de desmontar lo que hay sino de que sirva para el uso y disfrute de los ciudadanos en general y no sólo de los pocos que se pueden pagar la cuota o que se la han regalado mediante tarjeta VIP. Hay unas buenas instalaciones (incluido el campo de golf) que en mi opinión hay que mantener, cuidar y preservar para todos los que deseemos usarlas. </p>

<p> </p>
";"13/09/2015 19";"74";"59";"15";"1";"921128996";"3508"
"3727";"Festivales y conciertos";"<p>Creo que deberían tener en cuenta para estos eventos, crear autobuses especiales para ello o ampliar las líneas de autobuses normales o búhos, ya que por las noches es más difícil.</p>

<p>Ayer, sin ir más lejos, se celebró en el Campus de Ciudad Universitaria el DCODE y de madrugada al acabar el festival, miles de personas saliamos del recinto y la única manera de salir bien de allí era ir andando hasta la calle Princesa. Sólo un búho desde Ciudad y sin apenas servicios de taxis, porque era imposible. Sé que estos eventos no sin a diario, pero se deberían mejorar estos servicios y estar mejor organizado.</p>

<p>Gracias.</p>
";"13/09/2015 19";"42";"32";"10";"2";"918407124";"1676"
"3728";"arreglar bulevares de Ibiza y Sainz de Baranda y algo más";"<p>A los bulevares les hace falta un repaso</p>

<p>Imagino que en estos momentos hay otras prioridades y cuestiones más urgentes en la ciudad. No obstante, llegado el momento, cuando mejoren las cosas y haya posibilidad, no estaría de más pensar en arreglar dos de los pocos bulevares que quedan en Madrid. Especialmente tras haberse arreglado la calle Narvaez.</p>

<p>Haría falta asfaltado, aceras, ampliar unas aceras muy estrechas, poda de árboles (no sea que se nos caigan encima), reposición de los talados, multar a las terrazas de los bares que ocupan más de la mitad de la acera (eliminando lo que es el lugar: un paseo). Dado que cada 100 metros hay un paso de cebra por razones evidentes, el área de paseo, debería ser una zona 30 Km/h, para evitar los rallies de ciertos coches y motos, en un barrio con una población envejecida y lo que eso conlleva, lentitud, sillas de ruedas.. y a sumar un hospital en Ibiza...</p>

<p>Además de otras cuestiones que hay en otro debates abiertos, limpieza general, cagadas de perro, que habría que multar por no recogerlas los dueños. Aumentar a tres días (dos en la actualidad) la recogida de plásticos. Poner un punto limpio de recogida de desperdicios más y con más horas o días no sólo los martes de 4,30 a 6,30.</p>

<p>Un saludo y gracias</p>
";"13/09/2015 19";"40";"33";"7";"3";"920037407";"2145"
"3729";"Bancos públicos, más altos y nivelados ";"<p>Mi madre vive en Moratalaz, de toda la vida. Sería el año 1965, nuevo barrio en Madrid, barrio tranquilo, felicidad absoluta. Mi madre tenía 36 años. Con esa edad todo le parecía bien, ninguna queja. Se sentaba en el banco de la Avda. de Moratalaz 97 y veía a su hija jugar con sus amigas. Pasan los años, su hija ya no juega en el portal, pero ella sigue sentándose en el banco y habla con las vecinas de toda la vida. Qué bonito es ver a las señoras sentadas en un banco hablando del tiempo, de la salud y haciéndose compañía mutuamente. Pasan más años, mi madre se rompe la cadera, pero aunque no puede ir muuy lejos, sigue sentándose en el banco de su casa. Todos los días. Es su rutina, una rutina de toda la vida. Ahora tiene 86 años. Mi madre ha cambiado pero el banco es el mismo, el mismo banco que instaló el ayuntamiento hace 50 años. Mi madre es más pequeña por la edad, el banco le resulta muy bajo, y le gustaría que estuviera más alto. El banco no está nivelado. Nunca ha estado nivelado y nunca se ha quejado, pero ahora le resulta muy complicado sentarse.  Además, este banco, al igual que otros de la avenida, se encuentra astillado, estropeado, algunos de ellos grafiteados o pintados, incluso con sus tablones hundidos.
Por los mayores, por estas personas que hacen los barrios de Madrid más agradables, por favor pueden estudiar si se pueden colocar nuevos bancos (con 50 años creo que el de mi madre ya está amortizado) y que sean más altos y estén nivelados?
Creó que se lo merecen.
Gracias
 </p>
";"13/09/2015 19";"39";"36";"3";"2";"922372357";"3046"
"3730";"mejor conducción de autobuses municipales";"<p>Como es lógico no todos, pero sí bastantes de los conductores de los autobuses de la EMT, por alguna razón, cumplimiento de horarios u otras que desconozco, conducen como si estuvieran en las carreras, sin tener en cuenta que llevan personas, muchas de pie y mayores, enfermas o con minusvalías. La velocidad inadecudamente alta, sumada o acelerones y frenazos, convierte muchos viajes en autobús en una peripecia urbana de supervivencia, en especial para gentes de cierta edad. </p>

<p>En mi opinión, el autobús de la EMT debería ir a una velocidad adecuada, limitada y constante para seguridad y comodidad de los viajeros. Algo que debería inculcarse a los conductores cuando ingresan en esa labor. Con todos mis respetos para la mayoría de los conductores que lo hacen bien.</p>

<p>Un saludo y gracias.</p>
";"13/09/2015 20";"66";"60";"6";"12";"924336305";"4909"
"3731";"Olor a orines";"<p>A los que somos un poco mayores nos han educado a no hacer pis en la calle. Si necesito hacer pis puedo entrar en una cafetería a tomar algo y con la consumición tengo derecho a ir al baño, puedo ir al cine y también hay baños, puedo incluso ir a El Corte Inglés o la Fnac y de momento (espero que siempre sea así) aunque no compre nada, puedo ir al baño. Si es por la noche y estoy tomando algo, puedo ir al baño del local donde esté tomando algo. Si hay mucha gente, me aguanto, ya me tocará mi turno. 
Hace años no se veía a tanta gente hacer pis en la calle (y de toda la vida ha habido gente que ha salido a tomar una copa por la noche) ¿Por qué ahora la gente hace más pis en la calle que antes? ¿Qué ha cambiado? Pienso en varias razones, por ejemplo que un día una persona decidió hacer pis en la calle, le vieron unas cuantas y como ""no pasa nada por una vez"" el contagio es rápido y ahora no nos resulta raro ver a alguien hacer pis en la calle. No hace falta estar borracho ni que sea por la noche, a cualquier hora del día hay alguien haciendo pis (por ejemplo en la Avda. del Mediterráneo pasan con el coche, paran, hacen pis delante de todo el mundo y siguen tranquilos en su coche hacia su destino). 
Como posibles puntos para debate, propongo: 
1) campaña publicitaria de educación (en radio, televisión y buzoneo) promovida por parte del Ayuntamiento para que los ciudadanos no miccionen en la calle y no arrojen basura indiscriminadamente a las vías o jardines públicos
2) aumento de papeleras/contenedores cada pocos metros </p>

<p>3) relacionado con el punto 2): limpieza de dichas papeleras/contenedores de una manera regular, ya que a veces las papeleras están tan llenas que la gente empieza a tirar las latas en el suelo porque no caben en las papeleras
4) baños públicos (con empleados de mantenimiento, así hay más trabajo y los baños públicos estarán limpios)
5) penalización económica a todo aquel que sea sorprendido. Dar publicidad de dicha penalización para evitar que la gente imite a los infractores.</p>

<p>Ya se que es complicado, pero Madrid es de todos.</p>

<p>Saludos
  </p>
";"13/09/2015 20";"66";"63";"3";"9";"925534006";"5727"
"3732";"contenedores y puntos limpios móviles";"<p>En los últimos tiempos, debido a la crisis, se ven con frecuencia gentes con camiones que van vaciando los contenedores de papel y cartón, supongo que para venderlo. La cuestión es que dejan el entorno de los contenedores llenos de porquería con todos los papeles sueltos que no les interesan volando por las aceras y ensuciando más unas calles ya de por sí sucias.</p>

<p>¿No sería posible llegar a un acuerdo con estas gentes, por parte del Ayuntamiento, para que recojan sólo el cartón que dejan fuera de los contenedores o algo por el estilo? Dejarles actuar puesto que están sobreviviendo pero sin producir molestias y suciedad innecesaria? Antiguamente pasaban a recoger los papeles, periódicos, chatarra, etc.. </p>

<p>Otra cosa, los puntos verdes móviles que ahora existen me parecen escasos y con unos horarios muy reducidos, lo que te desmotiva a acercarte a ellos con cosas para el reciclado o te obliga a tener un aramario lleno de desechos de pilas, ropa vieja, etc...</p>

<p>Un saludo y gracias</p>
";"13/09/2015 20";"37";"35";"2";"2";"922846940";"3121"
"3733";"conducción ocasional excesivamente rápida autobuses EMT (2)";"<p>Este debate sustituye, por alusiones, a otro anterior en el que solicitaba que los conductores de autobús de la EMT procuraran conducir más despacio y sin brusquedades.</p>

<p>Afortunadamente, para algo va a servir el debate de estas páginas. Según me informa KikeMad, a quien agradezco la información, el problema está en la falta de unidades de bus, lo que provoca retrasos y prisas para cumplir los horarios de los conductores. </p>

<p>En este caso, la solicitud sería que el Ayuntamiento hiciera el favor de contemplar en algún momento lo que parece ser una demanda sindical que también lo es vecinal. Si no hay dinero suficiente, y menos en estos momentos, para aumentar la flota de autobuses, parece que hay alternativas que arreglarían, al menos en parte, el tema, evitando en el futuro que los usuarios tengamos que estar dando bandazos en algunos viajes y alguna persona mayor pueda sufrir un accidente, debido a velocidades poco adecuadas.</p>

<p>Más carriles bus, semáforos preferentes para la EMT, eliminar la venta de billetes a bordo, revisar las distancias entre paradas, entre otras cosas. Sería de agradecer que los responsables de la EMT se tomaran algún tiempo para anotar de algunas de estas cuestiones e intentar mejorar el servicio en ese tema concreto.</p>

<p>Un saludo y gracias</p>
";"13/09/2015 21";"37";"32";"5";"1";"921238173";"2335"
"3734";"Convertir las pistas de Golf de Canal en un parque o pistas deportivas";"<p>No hay más que darse un paseo por las instalaciones de Canal para darse cuenta de algo que salta a simple vista: Nadie usa las pistas de golf. Da igual la hora a la que se pase o el dia de la semana, lo mismo da que se trate de un domingo por la tarde o de un martes por la mañana: las pistas están desiertas. Es muy muy difícil, realmente, encontrarse a más de dos o tres personas dando golpes con sus palos en esos gigantescos campos de golf, dimensionados para muchos más golfistas.</p>

<p>Mientras tanto, al mismo tiempo, y a menos de 100 metros, la gente se esfuerza, especialmente durante los fines de semana, por encontrar un banco donde sentarse, o prácticamente tienen que empujarse unos a otros para poder correr por el único carril de las ¿pistas? de atletismo. Así mismo, es complicado encontrar un hueco libre para reservar una de las pistas de fútbol o de pádel, que prácticamente tienen gente a cualquier hora del día, lo cual da una idea de la cantidad de usuarios que practican estos deportes.</p>

<p>Ahora, una vez tenemos esta imagen en mente, vayamos por un momento a Google Maps y veamos desde el aire el recinto deportivo. ¿ Cuánto ocupan las pistas de golf ? ¡¡ Más del 50% del espacio disponible !! ¿ De verdad, cuántos golfistas aficionados hay en Madrid ? ¿ En serio se necesita el espacio de 7 campos de fútbol ? Supongo que pensando en un espacio de deporte para todos, no cabían deportes ""minoritarios"" como el baloncesto, el tenis, voleibol, balonmano ... y sí un deporte al que como es bien conocido, todos los madrileños jugamos. ¿Quién no tiene un set de palos de golf en casa?</p>

<p>Por no decir que lo más sangrante de todo es que las zonas verdes, porque no creo que se le pueda dar el nombre de parque, quedan reducidas al que sobra en los bordes del recinto, al lado de la carretera. Esto es aún más sangrante teniendo en cuenta que en esta zona de Madrid no es que abunden los parques por lo que poder pasear o respirar un poco.</p>

<p>Realmente no creo que ni siquiera le salga rentable a la empresa concesionaria de las pistas de golf el tener el recinto vacío.</p>

<p>Saludos</p>
";"13/09/2015 21";"139";"112";"27";"6";"924542291";"6848"
"3735";"SEGURIDAD DE ARGANZUELA ";"<p>La seguridad de arganzuela es mala tirando a pesima , entre las cundas de embajadores , entre los robos a pisos y entre los alunizajes , y los robos a negocios el barrio esta bastante mal </p>

<p>La policia municipal que hay en el distrito es insuficiente reconocido por algunl de ellos incluso </p>

<p>Me gustaria que hubiera mas policia municipal en el distrito , pasas por la comisaria y hay un monton de coches parados que podrian estar patrullando</p>

<p>y hay zonas como parte del tierno galvan que ni la pisan .</p>
";"13/09/2015 21";"63";"57";"6";"4";"924451573";"4614"
"3736";"Mejora bicimad ";"<p>Bicimad gratuito la primera hora a personas con tarjeta o billete de transporte público</p>
";"13/09/2015 21";"92";"75";"17";"2";"923390048";"4728"
"3737";"Línea Expres Cercanías Doce de Octubre-Puente de Vallecas ";"<p>Cabecera Cercanias DOCE DE OCTUBRE. Parada 2865 con una pequeña obra de adaptación.</p>

<p>1º parada  5271 Av. Cordoba- Entrada Principal 12 Octubre</p>

<p>2ª Parada  2872 Metro L3 Hospital 12 Octubre.</p>

<p>3º 1000 Metro Puente de Vallecas.(en la marquesina que realizan descenso líneas 58 y 111)</p>

<p>4º 2866 Entrada Ppal. 12 de Octubre</p>

<p>5º 2865 12 Octubre-Dr. Tolosa Latour</p>

<p>Son 4,1 Km de Ida y 4,3 de vuelta aproximadamente , sin trafico incluso haciendo el recorrido con las paradas no supera los 10 minutos.</p>

<p> </p>

<p>En hora valle podria ser 2 buses cada 12 minutos.</p>

<p>En hora punta Sentido Puente Vallecas pueden ser entre 15/18 minutos y Sentido 12 de Octubre unos 3 minutos más que en condiciones normales de trafico. </p>

<p>Por la tarde a la hora de trafico podrian ir a 15 minutos entre las 18.30 y 21.00.</p>

<p>Por las mañanas si se quisiera dar cada 10 minutos el horario se necesitarian 3 buses con 20 sentido P. Vallecas y 10 sentido Doce de Octubre.</p>

<p>De este modo se unen muy rapido y evitar tener que dar que ir en la L3 hasta Sol Y L1 hacia Puente Vallecas.</p>

<p>O a las personas que utilizan desde Villaverde y desde el Hospital el autobuses tener que ir hasta Atocha, en lo que el 22, 59,79, 85 y 86 llegan a Legazpi esta línea esta en Puente de Vallecas.</p>
";"13/09/2015 21";"41";"38";"3";"1";"923369787";"3243"
"3738";"Establecimientos chinos";"<p>hola queria referirme alos comercios chinos de alimentacion ,el tema es que porque no cumplen las normas de calidad como todos los establecimientos,nadie les pasa controles por contaminacion ,cruzada,ventas de alcohol,pan sin condiciones hijienicas,comen dentro ,enfin todo lo que esta proibido,solo pido que les esijan lo mismo que alos demas ,yo soy un dependiente en un supermercado y por comer un chiche me sancionan ,o por tener una alianza puesta etc</p>
";"13/09/2015 21";"110";"101";"9";"5";"927210312";"8447"
"3739";"Multas de 600 por beber en la calle";"<p>Buenas noches, me parece un abuso que por estar bebiendo en la calle en Madrid te pongan una multa de 600. </p>

<p>Lo primero es que muchas veces cuando ponen estas multas es por estar bebiendo en un parque una cerveza con un par de amigos y eso no se puede considerar botellon porque ni se esta molestando a nadie ni nada por el estilo.</p>

<p>Aunque existan multas por beber en un botellon, no me parece normal que una multa por conducir un coche borracho sea de menos importe que por beber una bebida con alcohol por las calles de Madrid, ya si conduces borracho estas poniendo en peligro la vida de los demas y por hacer botellon no.</p>

<p>Ademas no debemos olvidar porque los jovenes de Madrid tenemos que hacer botellon, porque los hosteleros de esta ciudad se piensas que esto es un pais de locos y en todas las discotecas cuestan las copas 12 y de alcohol adulterado, eso si me parece una verdadera verguenza y con eso nadie se mete.</p>

<p>Por ultimo, me gustaria decir que como el botellon esta prohibido hacerlo, no me parece justo que el castigo para los jovenes por hacerlo sea una multa economica que al final acabaran pagando sus padres porque ellos no tienen dinero para pagarlo, lo justo seria que el castigo fuese trabajos apra la comunidad o algo asi, no una multa de 600.</p>

<p>Un saludo</p>
";"13/09/2015 22";"76";"49";"27";"3";"918000852";"1418"
"3740";"Derribar el Santiago Bernabeu para construir una huerta";"<p>Ya que será imposible acabar con el fútbol (el opio del pueblo en la actualidad) de momento, propongo expropiar el bernabeu y poner en su lugar una huerta para dedicarla a al agricultura y así acabar con ella con la ola de hambruna que asola madrid en la actualidad (como bien dijo Carmena cuando se presentó a alcaldesa para el Ayuntamiento de Madrid).</p>

<p>Ventajas que veo a esta medida:</p>

<p>Se evitaría la especulación del señor Florentino, no es de recibo gastar esa millonada en tiempos de crisis</p>

<p>Bajaría el paro</p>

<p>Pararíamos la hambruna que asola Madrid.</p>

<p>-En el caso de que esta medida no fuera suficiente para acabar con el hambre se barajaría hacer lo propio con el Vicente Calderón y dedicarlo a la ganadería.</p>

<p>Un saludo.</p>
";"13/09/2015 22";"90";"33";"57";"4";"904222173";"-879"
"3741";"Finalizar cuña verde odonell";"<p>El parque conocido como cuña verde de odonell tiene todavía una porción sin finalizar. Esa zona sirve como área de depósito de escombro, basuras, y en verano, de foco de pequeños incendios de pasto. Creo que sería positivo finalizar esa porción de parque, que considero bastante bonito, gracias al abundante arbolado que hace parecer que uno está en el bosque.</p>

<p> </p>
";"13/09/2015 22";"48";"44";"4";"0";"924014362";"3666"
"3742";"Contaminación, ruidos y suciedad en Conde de Casal";"En la Avda. del Mediterráneo 55 a 67 existe la parada de los autobuses que van a los pueblos de la Nacional III (Rivas, Arganda, etc) así como en la acera que se encuentra enfrente, al otro lado de la Avda. del Mediterráneo. 
 
Estos autobuses, dependiendo de la hora del día, pueden tener una frecuencia de entre 10, 20  minutos o incluso frecuencias superiores, hasta una hora. Dependiendo del tiempo de espera, en ocasiones pueden coincidir gran número de personas esperando en las paradas ubicadas en las estrechas aceras de la Avenida (realmente esta acera ya forma parte de la Nacional III). Si es invierno hace un frío inmenso y si es verano realmente no se como pueden soportarlo. La marquesina tiene un tamaño en el que caben un número muy limitado de personas. El resto de las personas se quedan ahí a la intemperie. Dado que el tiempo de espera es alto, algunas personas deciden comer y beber algo (un sándwich, una lata de cerveza por ejemplo) y puesto que existen escaso número de papeleras y muchas veces están llenas, otros deciden tirar los residuos (las bolsas de los sándwich, las latas, el envoltorio del bollo, etc) al suelo, a la vía pública, y cuando hay viento se ven remolinos de bolsas de plástico por la Avenida del Mediterráneo, dejando un entorno realmente desolador. Además de lo anterior, otras personas, si en algún momento tienen una necesidad fisiológica, dado que tienen que esperar tanto tiempo, al no existir baños públicos cerca, directamente deciden vaciar sus líquidos en la vía pública, sea la hora que sea.
 

Por otra parte, la presencia continuada de gran número de autobuses estacionados en los números indicados al comienzo, pertenecientes a la Avenida del Mediterráneo, producen en las viviendas próximas grandes molestias debidas a los ruidos procedentes de los motores de los autobuses permanentemente en marcha, sin olvidar la contaminación que emiten a la atmósfera y que se percibe en estas viviendas, además de las vibraciones que también se hacen sentir.

 

Resumiendo: el hecho de que las paradas de los autobuses se encuentren donde están actualmente (Nacional III a la altura de Avda. del Mediterráneo 55 a 67) es incómodo para los usuarios de estos autobuses, ya que no pueden resguardarse del sol ni de las lluvias, implica que haya gran cantidad de residuos por la vía pública, implica que haya olores cuando alguna persona hace sus necesidades y provoca molestias de ruido y contaminación que producen los autobuses.  

 

Pienso que es preciso dar una solución urgente a este problema. 

 

Un saludo
";"13/09/2015 22";"35";"33";"2";"3";"923567467";"2922"
"3743";"Aprovechar lo que ya está hecho";"<p>El puente del carril bici sobre la M-40 a la altura de la Peineta lleva muchos años cerrado y sin embargo está construido. ¿cual es la razón para mentener esta parte del carril bici cerrado y que no pueda ser aprovechado por las personas? No hay ninguna razón para mantener un carril bici cerrado obligando a todos a dar una vuelta mientras esta infraestructura se estropea por el mero paso del tiempo. </p>
";"13/09/2015 22";"60";"58";"2";"2";"926450788";"5413"
"3744";"Formación actual inadecuada para la creación de empresas por el ayuntamiento";"<p>El ayuntamiento dispone de varios centros donde formar a emprendedores. Son charlas cortas, que dan una pequeña orientación y que en muchos casos se orientan a que los asistentes puedan contratar los servicios de las empresas de los ponentes.</p>

<p>Deben impartir cursos serios, enseñando a elaborar un plan serio de viabilidad, a elegir el mejor tipo de sociedad, a ayudar a elegir el local más adecuado,...</p>

<p>Y, relacionado con lo anterior, deberían empezar a cerrar negocios que sirven para blanquear dinero. Hay muchísimos. No cuadran los gastos de muchos locales con los ingresos. Por esta causa y por la especulación, los precios de los alquileres son inafrontables para quienes intentamos poner en marcha un negocio de manera honrada.</p>
";"13/09/2015 23";"30";"27";"3";"2";"922106685";"2160"
"3745";"Crear la calle de las Víctimas del comunismo";"<p>100 millones de víctimas en todo el mundo durante los últimos cien años merecen que una gran ciudad como Madrid les dedique una calle.</p>
";"13/09/2015 23";"80";"28";"52";"9";"904868047";"-839"
"3746";"Reducir o prohibir el uso de bolsas de plastico";"<p>Las bolsas de plastico tienen un papel importante: Son muy comodas pero son muy contaminantes para el medioambiente y el mar. En Francia se va a iniciar esta reforma para reducir la contaminacion. </p>

<p>Para que la contaminacion pare de subir por este problema, hay que prohibir o reducir moderadamente el uso de estas bolsas ya que contienen sustancias que son contaminantes para el medioambiente y el mar.</p>

<p>Muchos de los peces mueren por la culpa de estas bolsas que repercuten muy negativamente en el medioambiente. Y ademas de eso contamina todo y crea muchas molestias. </p>

<p>Si reducimos el uso de estas bolsas muy contaminantes, la ciudad estaria mas limpia, mas libre de impurezas y con menos contaminación. Ademas, a veces por la culpa de estas bolsas, ensucian la ciudad y cuando vuelan, es una gran molestia. </p>

<p>Y lo peor es que estas bolsas a veces pueden dañar o disminuir la salud de algunas personas. </p>
";"13/09/2015 23";"77";"57";"20";"0";"921389241";"2738"
"3747";"Despedir a todos los asesores del Ayuntamiento de Madrid";"<p>Para evitar más casos de nepotismo es necesario eliminar los puestos de libre designación.</p>
";"13/09/2015 23";"89";"75";"14";"7";"924972062";"5140"
"3748";"Madrid Rio unido por el sur al parque Enrique Tierno Galván";"<p>Madrid Rio es una zona estupenda para hacer deporte y comunicar zonas de Madrid por medio de un parque. Actualmente une la casa de Campo y el parque lineal del Manzanares en el Barriomde San Fermin.</p>

<p> </p>

<p>Sin embargo en la zona sur hay una pista de BMX, en Madrid Rio y a escasos 200metros esta el parque Tierno Galvan sin ningun tipo de conexion.  seria estupemdo ganar mas zonas verdes en el Madrid Rio uniendo este parque.</p>
";"13/09/2015 23";"145";"139";"6";"8";"930293425";"12749"
"3749";"Recuperar la cultura en Madrid";"<p>Hace unos años Gallardón habló de hacer una Gran Vía parecida a Brodway con neones, teateos y cines. Sin embargo, el panorama que podemos encontrar es el de cines que se cierran, que se convierten en bares o en tiendas.</p>

<p>Mi debate y propuesta es la implicaciónbdel Ayto en todo esto. Recuperando espacios como los cines y teatros que cierran o, por ejmplo, la Estación del Norte, que está abandonada por completo para crear allí un espacio cultural como pudiese ser un teatro, un cine o una sala de exposiciones, incluso, un museo. De la misma manera que el Beti Jai.</p>

<p>Además de ello, podría llegar a acuerdos con empresas privadas para fomentar la explosión cultural patrocinando o cediendo espacios. Es una iniciativa que haría de Madrid una ciudad cultural y ayudaría a que la sociedad cambiase de aires.</p>
";"14/09/2015 00";"86";"77";"9";"4";"926654484";"6088"
"3750";"¿Qué hacemos con los orines de los miles de perros de Madrid?";"<p>Cuando llueve, el agua levanta esta suciedad acumulada y en algunas zonas el olor es insoportable.</p>
";"14/09/2015 02";"126";"111";"15";"19";"928526816";"8457"
"3751";"El Metro TFM que va desde Puerta de Arganda a Arganda del Rey es una vergüenza.";"<p>Es una auténtica vergüenza y un despropósito que el final de la línea 9 del Metro de Madrid (TFM)c que recorre las estaciones de Puerta de Arganda a Arganda del Rey pasando por Rivas Vaciamadridc cierre sus puertas a las 23:00 de Lunes a Jueves y que el Viernes cierre una hora más tarde siendo hasta las 00:00, siendo el ÚNICO metro de todo Madrid con este horario tan INFAME el cual impide a los trabajadores de la zona regresas a sus casas en Madrid obligando a utilizar un vehiculo propio, solicito que se abra hasta las 00:00 como MÍNIMO A DIARIO para que podamos volver con dignidad a nuestras casas.</p>
";"14/09/2015 03";"28";"22";"6";"2";"921058016";"1257"
"3752";"Listas de espera para acceso a la función pública";"Un asunto controvertido y que requeriría un cambio en el actual modelo, es el uso de las listas de espera para el acceso a la administración municipal por causas de urgencia o como refuerzo para servicios que lo requieran. Hasta ahora se han venido utilizando las listas de espera generadas tras la última oposición de cada categoría, algo que objetivamente parece justo, pero que se está desvirtuando por el uso que se está haciendo de ello. Si algo se echa de menos en este asunto, es la transparencia y publicidad, tanto de la composición de las listas como de su evolución. No es razonable que alguien que esté interesado se dirija a Personal y obtenga por respuesta ante su interés por la marcha de alguna lista concreta ""será lo que Dios quiera""; tampoco parece sensato, que las organizaciones sindicales aparezcan como meros negociadores sin ninguna capacidad para conocer y realizar un seguimiento del proceso, es algo que debería cambiar radicalmente. Otra cuestión que merece nuestra atención, es la vigencia de listas generadas por oposiciones celebradas hace mucho tiempo, lo que debería hacernos reflexionar sobre la idoneidad de buscar alguna salida alternativa a este método; ¿no sería razonable pensar en elaborar listas de espera públicas, con perfiles muy determinados y con la colaboración del Servicio Público de Empleo?, quizás habría que planificarlo detenidamente, intentando que no se generasen bolsas de empleo gigantescas e ingobernables, pero con unos parametros de búsqueda bien elaborados, seguramente encontraríamos la fórmula, posiblemente no ideal, pero si más ajustada a la realidad de nuestra ciudad y de nuestros servicios.
En definitiva, quizás habría que aprovechar la negociación del nuevo convenio colectivo, para poner en marcha un cambio que es necesario, urgente y que debería acabar con ese velo de opacidad y secretismo que envuelve este mecanismo en la actualidad.";"14/09/2015 08";"24";"17";"7";"0";"920420132";"708"
"3753";"Retrasar cierre del parque de El Retiro hasta las 24:00 en octubre";"<p>El horario de este parque es de abril a septiembre hasta las 24h, y solamente hasta las 22h el resto de meses. Entiendo que en invierno tiene mucha menos actividad que en verano y de ahí el cambio de horario. Sin embargo durante el mes de octubre hace todavía buen tiempo, mucha gente bajamos a correr, patinar, pasear o simplemente como camino para ir a casa... y se nos queda corto un cierre tan temprano.
Como el mes de octubre está a la vuelta de la esquina <strong>propongo que se prolongue el cierre hasta las 24h durante el mes de octubre</strong>, sin perjuicio de que posteriormente se revise el horario para el resto del año</p>
";"14/09/2015 08";"72";"60";"12";"4";"927606676";"4000"
"3754";"polideportivo de gestión pública en el ensanche de Vallecas ";"<p>El ensanche de Vallecas tiene una extensión mayor que la del resto del distrito (casco histórico y santa Eugenia) y una población actual en torno a 30.000 personas. Pero no existe ninguna instalación deportiva pública.</p>

<p>Si queremos practicar algún deporte o llevar a nuestros hijos, tenemos que desplazarnos al polideportivo del cerro Almodóvar. La construcción del polideportivo se recogía en el plan inicial de este PAU. Pero a día de hoy no hay ni asomo de que se vaya a construir. Es un agravio comparativo con otros barrios.</p>
";"14/09/2015 08";"81";"71";"10";"5";"929464470";"5346"
"3755";"Contratos del ayuntamiento.";"<p>Que el ayuntamiento, a la hora de contratar a empresas, tenga en cuenta también estas cuestiones:</p>

<p>-Respeto a los trabajadores: deberían tener prioridad las empresas queden un salario digno a sus trabajadores, y se debería tratar de no contratar con empresas que usen salarios muy bajos o despidan a muchos trabajadores.</p>

<p>-Respeto al medio ambiente: se debería tener en cuenta el respeto al medioambiente que tenga la empresa, por ejemplo, en caso de contratar la electricidad, se debería priorizar las empmresas que la obtengan a través de las renobables.</p>

<p>-Fomento al cooperativismo, las compañías éticas y el comercio local: Se debería intentar dar ls contratos a cooperativas, compañías éticas y empresas locales.</p>
";"14/09/2015 09";"52";"45";"7";"1";"927617928";"3288"
"3756";"Jardineria en ""Las Rosas""";"<p>Este verano los jardines de los parques del barrio de las Rosas y del carril bici los han dejado secar, incluidos lavandas, rosales, romero, árboles..... Los cardos crecen a sus anchas por parques y jardines, una verdadera pena.</p>

<p>Esto significa que no hay ningún mantenimiento de nuetros jardines y que nadie los riega, ¿no queremos todos una ciudad verde?. Luego habrá que gastar xxxxxx en reponerlos, y eso en el mejor de los casos.</p>

<p>Lo que hay que hacer es cuidar lo que hay y con el presupuesto anual destinado a jardines mejorarlo.</p>
";"14/09/2015 09";"39";"35";"4";"3";"927526736";"2782"
"3757";"Semáforo inútil";"<p>Hay un semáforo en la avenida 25 de septiembre en su cruce con la glorieta Ricardo Velázquez Bosco en sentido C/ Alcalá. Está amarillo parpadeante para avisar de la glorieta y ceder el paso. No hay paso de cebra, en el otro lado sí. Se pone rojo, no se sabe por qué razón, porque para regular el tráfico está la glorieta. Y no pasa ningún peatón ni favorece el tráfico. Sólo entorpece y organiza atascos. Por favor, déjenlo en amarillo.</p>

<p>Gracias</p>
";"14/09/2015 09";"13";"9";"4";"1";"919044149";"346"
"3758";"No más baños en Madrid";"<p>Antes de entrar en materia creo conveniente rogar a los participantes del foro que tengan en cuenta la recomendación que se hace al iniciar un hilo: que siendo un foro de discusión, no deben plantearse propuestas, que más adelante se abrirá la sección correspondiente. Sin embargo, he comprobado que aproximadamente el 98,72% de los hilos seon auténticas propuestas y no apertura de debate. Creo que cuesta muy poco, en lugar de prponer, por ejemplo ""que se suprima el ruido en Carabanchel"" se plantee el debate ""¿debería suprimirse el ruido en Carabanchel?"". Esto se ajustaría más al propósito de la magnífica idea puesta en marcha por la corporaci´pn municipal.</p>

<p>El asunto que aquí se plantea viene derivado del hecho de que un gran porcentaje de las propuestas (aproximadamente el 28,51%) se refiere a la presunta necesidad de instalar baños en la ciudad. Creo poco acertadas estas propuestas por:</p>

<p>1. Exigen que los  usuarios lleven mochilas portadoras de toalla, jabón, champú, desodorante, etc.</p>

<p>2. Probablemente las propuestas se planteen tras haber realizado un viaje en metro en hora punta de verano. Una fumigación de los vehículos con Zotal solucionaría el problema.</p>

<p>3. En todo caso, por razones ecológicas deberían instalarse duchas y no baños.</p>

<p>Nota final: La cuidadosa revisión de mi escrito me hace apreciar que he cometido el error apuntado al principio. Debe leerse el título como: ""Debatamos si es conveniente instalar baños en Madrid"".</p>
";"14/09/2015 10";"29";"4";"25";"3";"912183297";"-289"
"3759";"Apertura instalaciones deportivas de los colegios propiedad del Ayuntamiento";"<p>Muchos barrios de Madrid tienen pocas instalaciones deportivas de acceso libre y las que hay suelen estar siempre llenas. Mientras, las instalaciones deportivas de los centros escolares permanecen cerradas los fines de semana, que es cuando hay más demanda, y se podrían utilizar y servir de alternativa, en especial para los más jóvenes, a estar en casa, por la calle o en un parque.</p>

<p>La propuesta es, a través de AMPAS o asociaciones de barrio, probar a abrir estas instalaciones y ver si se usan y que problemas pueden surgir.</p>

<p>Por parte del Ayuntamiento tendría que haber un compromiso de reparar inmediatamente cualquier desperfecto que se produzca en las instalaciones por su uso fuera del tiempo lectivo.</p>

<p>Sería conveniente informar a las personas que accediesen que, en caso de uso inadecuado de las instalaciones, se corre el riesgo de que se cierren y no se vuelvan a abrir.</p>

<p> </p>
";"14/09/2015 10";"68";"63";"5";"2";"930731036";"5373"
"3760";"Reducir la contaminación acústica";"<p>Los ruídos de algunas motos y algunos coches son tan exagerados, que en ocasiones se escuchan en barrios enteros. No se podría controlar el nivel de ruído de estos vehículos para tener una ciudad un poco más habitable. Gracias.</p>
";"14/09/2015 10";"103";"100";"3";"3";"933752665";"9417"
"3761";"Un modelo de instalación deportiva municipal con participación ciudadana";"<p>Hola a todos</p>

<p>Soy un vecino de Hortaleza, zona Cárcavas.</p>

<p>Me gustaría presentar a todos aquellos que no lo conozcan una iniciativa de <strong>Valdebebas Sport Club, Club Deportivo y Social</strong> un colectivo vecinal (deportivo y social) del cual formo parte.</p>

<p>Desde el Club <u>tramitaron oficialmente ante el Ayuntamiento el pasado 2 de marzo</u> para poder llevar a cabo el desarrollo del C<strong>OMPLEJO DEPORTIVO MUNICIPAL VALDEBEBAS</strong>, una instalación que daría servicio a zonas de Hortaleza (Sanchinarro, Cárcavas, Valdebebas,) y norte de Madrid (Ensanche Barajas, Las Tablas,) que demandan instalaciones deportivas como la que plantean.</p>

<p>Tal como detallan en su web (<strong>http://valdebebas-sportclub.com/reunion-con-concejala-hortaleza-yolanda-rodriguez-martinez/)</strong>, desde VSC proponen <strong>un modelo de desarrollo de colaboración entre la administración y los propios vecinos</strong> contando con la participación de distintas empresas (PYMES). Este modelo de gestión pública, social y empresarial que plantean es nuevo en el municipio de Madrid. <strong>Un modelo en el que los madrileños podamos ser y formar parte directa, no sólo como usuarios</strong>.</p>

<p>Su propuesta busca <strong>cambiar el modelo social en determinados aspectos</strong>: mayor implicación del ciudadano, relación directa con la administración pública cambiando la actual sensación de falta de comunicación, control directo del usuario sobre las empresas para garantizar servicios de mayor calidad y condiciones laborales y salariales justas de sus trabajadores, en definitiva una participación directa de los vecinos en la gestión, incluyendo una parte del beneficio resultante reinvertido en el colectivo al carecer éste de ánimo de lucro.</p>

<p>Por todo ello, ya no solo por la repercusión y servicio de las instalaciones, si no por el modelo propuesto en el que los vecinos tenemos implicación directa y el Club tiene la financiación sin que le cueste un céntimo a los ciudadanos <strong>con precios de uso municipales y entrada abierta </strong>a todos los madrileños, creo que debe ser atendido por este Ayuntamiento del cambio y valorada su aplicación en otras zonas.</p>

<p>Muchas gracias</p>

<p>Saludo</p>

<p>Citizen Kane</p>

<p> </p>
";"14/09/2015 10";"125";"109";"16";"29";"931960232";"8109"
"3762";"Barrido y recogida de hojas y otros residuos, deberían ir unidos en el mismo act";"Existen zonas en las que los barrenderos únicamente amontonan hojas y residuos, pero no lo recogen, por lo que con el aire se vuelve a esparcir toda la basura y su trabajo no ha servido de nada; es decir han realizado un trabajo inútil que supone un gasto innecesario (ya que la zona termina quedando como al principio: sucia). Para optimizar la limpieza viaria se debe realizar la recogida de las hojas inmediatamente a continuación del barrido.";"14/09/2015 11";"51";"46";"5";"2";"929297465";"3698"
"3763";"Cambiar Calles por mujeres ilustres de la generación del 27";"<p>Con el término Generación del 27 se conoce al que seguramente es el grupo de literatos y artistas más influyentes y conocidos de la cultura española. Su legado es ampliamente conocido siempre y cuando hablemos de ELLOS. 
¿Pero qué sucede con ELLAS? ¿Es que acaso no había mujeres?
Nada más lejos de la realidad. Dentro del Grupo del 27 existieron, crearon y triunfaron una generación de mujeres pintoras, poetas, novelistas, ilustradoras, escultoras y pensadoras, de inmenso talento que no sólo gozaron en su tiempo de éxito nacional e internacional, sino que a través de su arte y activismo desafiaron y cambiaron las normas sociales y culturales de la España de los años 20 y 30.
Mi propuesta es la siguiente: Es devolver de alguna manera eso que nunca tuvieron por culpa de la guerra y después por la dictadura franquista y el exilio en el extranjero en la gran mayoria de ellas y de otras el exilio interior obligatorio por una época de nuestra historia de las mas oscuras.
Una sociedad madura y que quiere crecer tiene la obligación de dar a conocer y darle el reconocimiento que se deben sus poetas, pintoras, escritoras y pensadoras que a lo largo de la historia mas reciente no han teniado ese reconocimiento.
Ahora que nos planteamos cambiar nombres de Calles con nombres franquistas y de exaltación a la dictadura que mejor reconocimiento que una ciudad como Madrid empieze a homenajear y a dar a conocer a sus mujeres mas ilustres de la Generación 27.
Me parece que una sociedad que quiere ser mas igualitaria y menos machista tiene la obligación de reconocer a sus mujeres ilustres que lo tuvieron más complicado que ellos por ser mujeres y mujeres que quisieron cambiar y transformar la sociedad que les toco vivir.
Aqui dejo algunas de ellas pero son muchas mas. 
ERNESTINA DE CHAMPOURCÍN (Vitoria 1905 - Madrid 1999)
Poeta española.
MARÍA TERESA LEÓN (Logroño 1903 - Madrid 1988)
Escritora española.
CONCHA MÉNDEZ  (Madrid 1898 - México 1986)
Poeta y editora española.
MARUJA MALLO (Lugo 1902  Madrid 1995)
Pintora española.
MARÍA ZAMBRANO  (Vélez-Málaga 1904  Madrid 1991)
Filósofa española.
 ROSA CHACEL (Valladolid 1898  Madrid 1994)
Novelista española.
JOSEFINA DE LA TORRE (Las Palmas de Gran Canaria 1907  Madrid 2002)
Escritora, poeta y actriz española.
 MARGA GIL ROËSSET (Madrid 1908  Madrid 1932)
Escultora e ilustradora española.
 LUISA CARNÉS (Madrid, 1905 - México DF, 1964)
Escritora y #periodista....
ÁNGELES SANTOS TORROELLA (Portbou 1911 - Madrid 2013)
Pintora.</p>
";"14/09/2015 11";"99";"56";"43";"2";"921127448";"735"
"3764";"Instalaciones deportivas públicas de uso libre y gratuito";"<p>En el distrito de Chamberí no existen instalaciones deportivas de libre acceso. O bien están cedidas a empresas de gestión privada o a federaciones deportivas. En todos los casos, los adolescentes y jóvenes de la zona (que constituyen un colectivo muy heterogéneo en cuanto a procedencia y poder adquisitivo) se han visto <strong>privados de lugares donde jugar al fúbol, al baloncesto u otros deportes de equipo de forma libre y gratuita.</strong></p>

<p>El ejemplo más claro lo tenemos en la cesión de una parte de los terrenos del antiguo polideportivo Vallehermoso a la empresa GO FIT, que ha montado un gimnasio exclusivamente para socios. Sin discutir los méritos de este complejo (que ciertamente funciona con unos niveles de calidad de lujo a unos precios razonables), la fórmula resulta excluyente para muchos vecinos del barrio y, muy especialmente, para los chicos y chicas.</p>

<p>Algo parecido ocurre con los campos de golf, pádel y fútbol del parque de Santander o las pistas de tenis del Canal de Isabel II.</p>

<p>El ayuntamiento de una gran ciudad debería preocuparse de habilitar lugares de libre acceso y gratuitos (campos de baloncesto, fútbol, juego libre...) para el colectivo de jóvenes (no solo parques infantiles para los niños más pequeños), pues la oferta de este ocio traería consecuencias muy positivas:  les ofrecería la oportunidad de iniciarse en un ocio saludable y ayudaría a su socialización (tan complicada en el centro de una gran ciudad)  y a la integración de todos los chavales del barrio: vengan de donde vengan y pertenezcan a la clase social que pertenezcan. La calle debe ser para ellos educadora, generadora de valores, socializadora, una prolongación de la escuela pública y no un entorno excluyente y de aislamiento.</p>

<p>Ni siquiera sería necesario subvertir las políticas anteriores: los terrenos del Vallehermoso que han quedado sin utilizar tras la demolición del polideportivo son enormes y permitirían dar una respuesta al barrio más que satisfactoria.</p>
";"14/09/2015 11";"74";"65";"9";"0";"930114593";"4918"
"3765";"Actualizar y modernizar el diseño cutre de los taxis de Madrid";"<p>Que se proponga un pequeño concurso para actualizar el diseño de los taxis de la capital, de manera que sea más moderno, reconocible e iconico. Homogeneizar el parque movil de taxis con modelos mas apropiados para la actividad, tendiendo hacia modelos hibridos y electricos.</p>
";"14/09/2015 11";"76";"46";"30";"3";"922189744";"968"
"3766";"Educación pública para no tirar basura a la calle + ¿multa?";"<p>Hoy leyendo la carta escrita por la Concejala de Medio Ambiente y Movilidad (http://diario.madrid.es/blog/2015/09/14/cinco-claves-para-entender-que-pasa-con-la-limpieza-de-madrid/) sobre el trabajo que están haciendo para conseguir que Madrid sea una ciudad limpia me ha hecho pensar sobre la capacidad que tiene la ciudadanía de Madrid en colaborar sobre estas tareas. </p>

<p>Veréis, los dos años que he estado viviendo en Madrid lo he estado haciendo en Ventilla. Un barrio que no es peligroso pero que es sucio y tiene un ambiente un tanto especial. La suciedad propia de Ventilla no está derivada de la falta de atención por parte de los servicios de limpieza de Madrid sino de lo sumamente desconsiderados que son parte de sus vecinos en cuanto a lo que limpieza de sus calles se refiere. En esos dos años he visto situaciones que no son nada agradables para un viandante y muchos menos para la convivencia del barrio. Cacas de perro en todas partes (muchas, no recogidas por sus dueños), latas de cerveza de medio litro depositadas en cualquier sítio (hasta 10 y 15 latas amontonadas en rincones), muebles depositados sin ningún miramiento en cualquier parte, vecinos que escupen por la calle u orinan en las esquinas.

Ahora, por suerte para mi, no vivo más en la calle donde vivia. Por suerte para mi estoy pasando una temporada en una ciudad mucho más limpia que Madrid. Por suerte para mi en esta ciudad sus vecinos mantienen muy limpias sus calles porque el Ayuntamiento ha llenado la ciudad de papeleras y cubos de basura donde depositar las cosas, hay parques creados solo para los perros, hay bolsas de basura para recoger las cacas de perro prácticamente en cada esquina, hay una conciencia cívica hacia el otro muy alta. Ni que decir tiene que esa ciudad no está en España. 

Creo realmente que el trabajo que está haciendo Ahora Madrid es muy bueno. Aunque personalmente no les vote. Pero me gustaría que desde el papel de la ciudadanía se tuviera más conciencia de los recursos públicos y de lo que pertenece a todos, en lugar de solamente exigir. Entre otras cosas para ponerle la tarea de la limpieza a Ahora Madrid más sencilla y para aprovechar más el gasto público que ya se ha hecho. Creo realmente que en una situación como esta, la carta escrita por la Señora Sabatés (la cual es muy explicativa y clara) debería también ser algo exigente con la ciudadanía y no quedarse en el miedo a no gustar al votante con frases que puedan ser impopulares. El contrato de limpieza es una trampa mortal, eso lo sabemos, pero quizás el trabajo del ayuntamiento tambien sea conseguir por parte de sus ciudadanos una educación cívica excelente para una ciudad excelente.</p>
";"14/09/2015 11";"111";"107";"4";"8";"934404958";"9928"
"3767";"Espacios Infantiles Madrid Centro";"<p>El centro de Madrid es un espacio diría hostil para los niños; aceras estrechas, espacios reducidos, grandes aglomeraciones, etc. Se ha perdido el respeto por la infancia y su necesidad de juego en la ciudad. Por eso desde aquí, lo primero, reivindico el uso de plazas y plazoletas como espacios de juego, y por tanto su acondicionamiento, limpieza y desinstalación de terrazas que quitan espacios públicos en favor de negocios privados. Y en segundo lugar EXIJO que los espacios específicamente destinados a los niños (parques de arena y de tartán) estén LIMPIOS. Actualmente es imposible que jueguen descalzos o que los más pequeños puedan estar sin supervisión constante por el riesgo de cristales, latas, colillas, etc. Los parques son utilizados para botellones y perros, sin el más mínimo respeto por los que cada día juegan allí (y son los únicos espacios que tienen para jugar). Por favor, más respeto por los niños en Madrid y sobretodo en el centro. </p>
";"14/09/2015 12";"58";"55";"3";"2";"931461491";"4931"
"3768";"diseñadores profesionales en Madrid";"<p>Quisiera abrir el debate sobre la situación de nuestra profesión en Madrid, y en España en general.</p>

<p>¿alguien por ahí?</p>

<p>Después de años de experiencia y trabajo constante, apasionado, detallista.... estoy convencida de que estamos en tal mala situación porque no se conoce qué hacemos realmente. Ni siqueira nuestros clientes saben como trabajar con un diseñador.
Es nuestra responsabilidad hacernos respetar como colectivo. Deberíamos ser didácticos, pensar como transmitir el sentido de lo que hacemos y nuestros modos de hacer. Trabajar en estas áreas no es pura fiesta creativa!! Después de años trabajando con éxitos y reconocimiento, aún así la mayor parte de las veces no llegamos a ganar 10  por hora.
El papel del Ayuntamiento: Las veces que he entrado a DIMAD (supuestamente la asociación de diseñadores de Madrid) con intensión de asociarme he dado la vuelta sin hacerlo porque ¿cómo vamos a pagar una cuota mínima de 200 y pico  anuales si no tenemos un duro?. ¿Para quienes existe esta asociación que se supone que es publica y financiada por e Ayuntamiento de Madrid? El DIMAD debería ser grátis para profesionales, llenarse de gente y de vida, ofrecer debate, hacer pedagogía del diseño y del valor que aporta a cualquier tipo de comunicación, ambiente, entorno....
El diseño de la comunicación pública en Madrid es un verdadero desastre, más allá de gustos, no tiene dirección ni sentido de conjunto, los elementos para turistas están solo en castellano.... (El otro día paramos a ver con mi familia (nos encanta caminar), un chirimbolo que encontramos en la Pza Jacinto Benavente que en plan ""ecologógico"" propone rutas a pie y manda unos itinerarios absurdos, un pobre turista que decida seguir alguno de ellos hará 20 km andando por avenidas llenas de tráfico y no verá monumentos y lugares de interés que estaban a 200 metros de donde inició el recorrido por mala señalización.
Hay miles de absurdos en la comunicación de nuestra ciudad y esta asociación sería un instrumento para su buen desarrollo si no fuese solo un centro para ""mercadillos de emprendedores"" a los que se les cobra caro por participar!</p>
";"14/09/2015 12";"26";"9";"17";"1";"912056633";"-276"
"3769";"Redistribución Empleados Públicos Municipales";"<p>Todos tenemos la impresión de que falta personal en algunos servicios (inspecciones de consumo, disciplina urbanística, atención al ciudadano...) y que en cambio en otros sobra personal...propongo que se haga un estudio serio, basado en indicadores, en el que se mida la actividad y el tiempo de respuesta a los ciudadanos a sus requerimientos y en función de ello se determinen las verdaderas cargas de trabajo que tienen las Juntas Municipales y el resto de Direcciones Generales...En línea con esto que se suprima cualquier servicio que esté subcontratado con empresas privadas y se sustituya (seguro que el coste es menor) por funcionarios ya sean del propio ayuntamiento o de otras administraciones públicas.</p>
";"14/09/2015 12";"65";"63";"2";"0";"932528007";"5912"
"3770";"Reducción de precios en polideportivos en horarios menos usados. ";"<p><strong>       Soy un usuario habitual de polideportivos y en muchas ocasiones se ven pistas vacías, sobre todo en franjas horarias como pueden ser de 14 a 17 un sábado o un domingo. Creo que el deporte debería ser para todos y que la gente con menos medios también tendría que tener derecho a usar los polideportivos. Por lo tanto propongo tarifas valle por utilización del polideportivo. Si hay 8 pistas y sólo hay usadas 2 por ejemplo se podría bajar el precio de la tarifa</strong></p>

<p><strong>        También plantearía que un campo del polideportivo se pudiera alquilar a un precio simbólico. Por ejemplo, si hay 8 pistas de tenis una se alquilará al precio de 1 la hora. De esta manera todo el mundo tendría acceso a realizar deporte</strong></p>

<p> </p>

<p><strong>Deporte para todos en una instalción pública que ahora parece de uso exclusivo para la gente que tiene dinero</strong></p>
";"14/09/2015 12";"184";"176";"8";"6";"936599458";"16069"
"3771";"AVISOS EN CALLES Y PLAZAS DEL DERECHO DE DESCANSO DE LOS VECINOS";"<p><strong>En Madrid asistimos en muchas calles y plazas a gente que no respeta el descanso de los vecinos. Es importante educar y recordar que hablar alto hasta altas horas de la madrugada es perjudicial para el decanso de los demas.</strong></p>

<p><strong>Para recordar esto a la gente que esta en la calle, pondría carteles de advertencia. Estos carteles pueden ser disuasorios y se pone el mensaje y una posible multa basada en la ordenanza de ruidos y derecho de descanso de los demas.</strong></p>

<p><strong>Esta petición ayudaría a educar y recordar a la gente que el descanso de los vecinos no puede ser descuidado.</strong></p>

<p> </p>
";"14/09/2015 12";"185";"175";"10";"9";"936350709";"15608"
"3772";"Aparcamiento gratuito para residentes en zona azul";"<p>La zona verde no es suficiente para todos los residentes dando como resultado residentes dando vueltas para aparcar mientras la zona azul esta vacía. </p>

<p>El estacionamiento limitado no debería limitar al residente, si lo que queremos es evitar que la gente se mueva en coche y no recaudar no entiendo porque el residente no puede aparcar donde sea.</p>
";"14/09/2015 12";"69";"45";"24";"3";"924135995";"1369"
"3773";"Prostitución en las calles, legalización y regularización";"<p>Aparte de la mala imagen que da a Madrid la calle Montera , Desengaño y similares ..... Creo que alguien debe por fin regularizar a estas señoras y señores que practican la prostitución (los que lo hacen libremente claro)</p>

<ul>
	<li>Alta obligatoria en autónomos</li>
	<li>Facturación mínima</li>
	<li>Test médicos cada X tiempo</li>
	<li>Facturas oficiales</li>
	<li>Tpv</li>
	<li>Prohibición de exhibirse en las calles, o habilitar una calle para ello .... Tipo Barrio rojo ....</li>
	<li>Persecución y regularización de las ""casas de putas"" , anuncios en clasificados y similar</li>
	<li>Hacienda somos todos ... ¿De verdad?</li>
</ul>

<p>Llamádme loco .... pero se ingresarían millones de euros ....</p>
";"14/09/2015 13";"88";"70";"18";"9";"929569484";"4136"
"3774";"Crear un cuerpo de vigilantes de paisano velando por las normas municipales";"<p>Creo que casi todos estaremos de acuerdo en que seria una buena idea multar a los que no cumplen las normas municipales, no recogen los excrementos de los perros, tiran papeles o chicles al suelo, por no hablar de las colillas, a los que orinan en la via publica, los que llevan al perro sin correa, las bicicletas que circulan por donde no deben, o cualquier otra normativa o ley que se os pase por la cabeza y que lo habitual es que no se cumpla.</p>

<p>Mi sensación es que muchas veces no se cumple por que nadie está ahi para que la hagas cumplir, evidentemente si mi perro hace caca en la calle y veo que hay un policia mirandome, seguramente lo recogeré por miedo a que el agente me multe, ¿pero que pasa si no hay ningun policia cerca? pues para muchos incibicos ahi se queda ""el regalito"", este ejemplo es aplicable a muchos otros comportamientos incibicos.</p>

<p>Mi propuesta consiste en crear un cuerpo de agentes de paisano que circularian por nuestras calles rastreando este tipo de comportamientos y multando en el acto a los infractores, de esta forma se crearia un poco mas de conciencia, por no decir psicosis entre los infractores de que cualquiera en cualquier momento me puede multar, asi que será mejor que cumpla las normas.</p>

<p>Se que esta no se la mejor via, que la mejor via es la educación y la concienciación del ciudadano, pero como lamentablemente para algunos ir por las buenas no funciona, quizas a base de multas reaccionen.</p>

<p>Una manera que se me ocurre de crear este cuerpo en el ayuntamiento sin que le suponga una inversión seria atraves de una empresa externa la cual conformaria este equipo de vigilantes y recibiria el (por ejemplo) 50% de lo que multe, el otro 50% irá a las arcas del ayuntamiento.</p>

<p>Es decir se conseguirian en un primer lugar que se cumplan un poco mas las normas y tambien unos ingresos extras que siempre vienen bien.</p>

<p>Esta idea es extrapolable a coches camuflados vigilando en las calles el comportamiento de otros conductores, multando al que habla por el movil, al que tira el cigarro por la ventana, al que no pone el intermitente, al que toca el claxon, etc. Pueden parecer pequeñas tonterias, pero el que habitualmente tira el cigarro por la ventanilla si ve que detras tiene un coche de policia no lo hará, por eso la única forma que se me ocurre de castigar este tipo de comportamientos es con un sistema como este.</p>

<p> </p>
";"14/09/2015 14";"139";"101";"38";"15";"929263713";"4577"
"3775";"Publicar un mapa con las zonas de SER azules y verdes";"<p>Buenos días, primeramente felicitaros y daros las gracias por dejar hacer propuestas ciudadana de una forma tan facil. Mi propuesta que llevo años intentando buscar sin apenas resultados, y es que se publique un mapa con las zonas de SER azules y verdes por cada barrio para que cuando necesitemos ir a algun barrio ver las plazas e utilizar una zona u otra según prioridades.</p>

<p>Gracias de antemano</p>

<p> </p>
";"14/09/2015 14";"42";"37";"5";"3";"929433736";"2819"
"3776";"Recuperar el estadio vallehermoso";"<p>Hace un par de años decidieron derribar el Estadio vallehermoso y decían que iban a levantar uno nuevo.Que lleva años paralizado el proyecto.Estaría bién devolverlo para los deportistas madrileños y de la zona.</p>
";"14/09/2015 14";"66";"60";"6";"3";"931974053";"4909"
"3777";"Solución de baños públicos en Madrid: baños de las estaciones de Metro";"<p>No se si existen en todas las estaciones, pero yo una vez utilicé los baños de la estación de arganda del rey (por conocer al encargado de seguridad que me dejó) algo que parece de leyenda urbana, y que me da la sensación que por ley debería dejarse utilizar a todo el mundo pero que carecen de toda señalización. Ésto sumado a un servicio de metro 24 horas o que por lo menos uno pueda entrar en las estaciones hasta la parte de los baños cuando están cerrados, sería una forma de evitar esos momentos de necesidad y carencia de baños portátiles.</p>
";"14/09/2015 15";"100";"90";"10";"1";"933466651";"7200"
"3778";"El Pardo para todos";"<p>La mayor parte del monte de El Pardo está reservado como coto de caza para la familia real, permitiendose el acceso solo a unos pocos privilegiados. Deberia poder abrirse más a los ciudadanos de Madrid para que disfruten de esta preciosa zona de Madrid.
 </p>
";"14/09/2015 15";"150";"134";"16";"9";"935071216";"10541"
"3779";"Un icono del 15-M en mitad de la Puerta Del Sol";"<p> </p>

<p>Como persona ilusionada con lo que representó y representa el 15-M en mi ciudad (y creo que el gobierno de Carmena es un ejemplo) me encantaría que en el epicentro de las protestas que desencadenaron los cambios políticos y sociales en nuestro país existiese un claro homenaje a dicho movimiento, bien en forma de estatua u otra forma, me gustaría abrir de ate para aportar ideas si los registrados en el portal están de acuerdo.</p>

<p> </p>

<p>En mi caso, imagino el homenaje como una estatua, que al igual que el oso y el madroño debería convertirse en referente para todos los Madrileños.</p>

<p> </p>

<p>Imagino la estatua de una chica alrededor de los veinti muchos años de edad, quizá con rostro serio para mostrar la indignación, sentimiento clave en el movimiento. En sus ropas podrían verse reflejados símbolos claves de las mareas ciudadanas que han estado siempre en la primera fila de la defensa de los servicios públicos, se me ocurre una camiseta de la marea verde sobre la educación pública para todos, símbolos de la marea blanca y su defensa de la sanidad pública, las marchas de la dignidad, la marea granate que apoya a los exiliados económicos, etc. y por supuesto reivindicaciones sobre el feminismo (no se si sería recomendable una tan polémica como la del aborto, o quizá algo orientado a la lucha contra la violencia de género, para eso existe éste foro de debate)</p>

<p> </p>

<p>Una de las poses que mejor quedaría para la estatua sería una postura de pie, con brazos en alto haciendo el ""grito mudo"", las dos manos en alto, palmas abiertas y girandolas, que me parece simboliza tambien el aplauso en el lenguaje de signos.</p>

<p> </p>

<p>Creo necesaria tambien una alusión a las redes sociales, con una tablet, smartphone o cámara de video que fuese visible de alguna forma (el móvil en la mano impediría el ""grito mudo"", pero quedaría muy bien)</p>

<p> </p>

<p>Imagino que la ropa debería de ser urbana, lo mismo con el calzado (¿deportivas, camiseta y pantalones de verano?)  </p>

<p> </p>

<p>Habría que pensar si poner o no una placa, quizá el no tenerla ayuda a que sea más un símbolo, como el oso y el madroño, aunque sería muy bonito que la estatua estuviera dominada por una placa que explicase lo que consiguió el movimiento de los indignados, que para mi supuso la reivindicación de otra forma de hacer política, el rechazo a ser meras mercancías en manis de políticos y banqueros, el hecho de que la política connmayúscukas es patrimonio de la gente, que el protestar puede, de hecho cambiar las cosas... No se, se me ocurren muchas cosas pero en una placa es difícil poner todas.</p>

<p> </p>

<p>La ubicación, evidentemente, no podría ser otra que la mismísima puerta del sol, aunque debería ser un sitio destacado que no obligue a desplazar otros en mi opinión.</p>

<p> </p>

<p>¿Que opináis? ¿Os gustaría algo así en la plaza más importante de nuestra ciudad? ¿Que más cosas se os ocurren que mejoren o contradigan mis propuestas? Agradecería vuestra opinión y votos a favor.</p>
";"14/09/2015 15";"90";"18";"72";"4";"912919870";"-1080"
"3780";"Recogida de los cubos amarillos: martes, jueves y DOMINGO.";"<p>En muchos distritos madrileños ya solo tienen servicio de recogida de los cubos amarillos los martes, jueves y sábados.</p>

<p>En muchos fincas el portero no trabaja los sábados, y por tanto no saca a la calle los cubos de ""dos ruedas"", con el resultado que, cuando llega el martes, tienes acumulado cinco dias de envases y plásticos en casa.</p>

<p>Propongo que, en lugar de una recogida de martes, jueves y sábados, que la recogida sea de martes, jueves y <strong>domingo</strong>.</p>

<p> </p>
";"14/09/2015 15";"21";"17";"4";"1";"925650158";"1052"
"3781";"Publicidad en los suelos de las calles";"<p>No es de recibo que el Ayto. gaste un presupuesto importante en antener limpias las calles y no pase un día y ya estén sucias. </p>

<p>Uno de los grandes problemas es la publicidad que se coloca en los coches o se da a la puerta del Metro, sobre todo el primero.</p>

<p>Creo que el Ayto. debería regular este tema y, esas mismas personas que en otro debate se han propuesto para multar a quien no recoge excrementos podrían tomar fotos de estas publicidades que ensucian las calles, para cobrarles un impuesto.</p>
";"14/09/2015 15";"65";"60";"5";"1";"932684549";"5076"
"3782";"Ruido nocturno y maltrato mobiliario urbano";"<p>Vivo en una calle donde entre nuestra fachada y los siguientes pisos hay 25 metros.</p>

<p>Entre medias hay un parquecito infantil para niños menores de 3 años y unos aparatos para personas de la tercera edad.</p>

<p>El parque no lo suele utilizar nadie para su cometido, pero entre 21-24 horas, grupos de adolescentes lo utilizan para montarse en los aparatos.</p>

<p>En cuanto al lugar para la tercera edad, lo utilizan los mismos además de muchachos de hasta más de veinte años como gimnasio. Faltan pedales, que se han llevado, y las tablas donde se explican los ejercicios están partidas por supuestos boxeadores y karatekas que bajan ahí a entrenar. A veces son las 2 de la mañana y ahí siguen dando golpes y voces.</p>

<p>Además de educarles con paneles que dispongan el horario que se pueden utilizar, ¿no podría pasar la Policía Municipal de vez en cuando?. Pasar a 10 por hora, claro, por qué a la velocidad que pasan cuando se les llama siempre pasan de largo.</p>

<p>Se ha dado el caso de haber arrancado o partido algún árbol. </p>
";"14/09/2015 16";"82";"80";"2";"5";"935193077";"7609"
"3783";"Impuesto de Tracción Mecanica: Que pague mas quien mas contamine";"<p>El <strong>Impuesto de Vehiculos de Tracción Mecánica</strong>, ITVM, en turismos se paga en función de la ""potencia Fiscal"".</p>

<p>La regulación de este impuesto se encuentra en el Texto Refundido de la Ley reguladora de las Haciendas Locales
(Real Decreto Legislativo 2/2004 de 5 de marzo).</p>

<p>Aunqe el cálculo de la cuota no corresponde directamente al Ayuntamiento (que si se encarga de su recaudación) éste,
como indica la ley puede aplicar bonificaciones:</p>

<p>Hasta el 75% de la cuota del impuesto en función de:</p>

<p>    -La clase de carburante que consuma el vehículo y a la incidencia de la combustión de dicho carburante en el medio ambiente.
    -Las características de los motores de los vehículos y su incidencia en el medio ambiente.</p>

<p>Propongo:</p>

<p>Que el ayuntamiento aplique bonificaciones en función de la antiguedad y normativa anticontaminación de los coches. Es decir
que paguen mas los mas antiguos o los que, siendo nuevos mas contaminan.</p>

<p><u>No tiene ningún sentido que se vendan nuevos vehiculos que están exentos de Impuesto de Matriculación por sus bajas emisiones
y que a su vez, paguen un ITVM altísimo por su potencia fiscal.</u></p>

<p>Además, aplicando estas bonificaciones, <u>se fomentaría el rejuvenecimiento del parque movil y la venta de vehiculos de menos emisiones.</u></p>

<p><strong>Si ya se aplica el criterio de contaminación para bonificaciones en el Impuesto de Matriculación, si ya se aplica en lo que se paga por estacionar en las zonas reguladas ¿Por que no hacerlo en el ITVM?</strong></p>
";"14/09/2015 16";"95";"68";"27";"8";"928458077";"2934"
"3784";"Prohibición sin excepción del TIRO de PICHÓN -CLUB DE TIRO DE SOMONTES (MADRID) ";"<p><strong>Prohibición sin excepción del TIRO de PICHÓN y prácticas similares en el único campo de tiro dentro de Madrid Capital: EL CLUB DE TIRO DE SOMONTES (en el Pardo, Madrid)</strong></p>

<p>Le pedimos a Manuela Carmena que no autorice esta masacre en suelo madrileño. Es la Comunidad de Madrid quien autoriza las tiradas, pero usted, Carmena, al estar en su territorio, puede cerrar esta actividad de maltrato animal. </p>

<p>ES UN DELITO: Está infringiendo la Ley 1/1990 de Protección Animal artículo 4.3: Se prohíben en todo el territorio de la Comunidad de Madrid la lucha de perros, la lucha de gallos de pelea, <strong>el tiro pichón</strong> y demás prácticas similares.</p>

<p>En el <strong>artículo 4.4</strong> indica que se puede realizar tiro de pichón bajo excepción, pero ¿cada fin de semana del año, cada semana del año, a todas horas que gusten en Somontes, eso es una excepción? ¿Esto es que se entiende maltrato animal por el tiro de pichón, pero vamos a autorizar maltrato animal cuando nos parezca?</p>

<p>No tiene ningún mérito matar pobres aves lanzadas a máquina o tubo o a brazo cual pelota de tenis. Aves criadas en granjas, en condiciones lamentables de higiene, hambre y enfermedad. Te gusten o no las palomas y codornices, ESTO ES UNA VERGÜENZA NACIONAL y no debería ser una decisión individual, sino una cuestión de maltrato animal. </p>

<p>----</p>

<p>El <strong>tiro de pichón y prácticas similares</strong> (palomas a brazo, codornices a máquina...etc) es una práctica que en el año 2015 consideramos <strong>ilegal</strong>.</p>

<p>Ilegal pues incurre en <strong>maltrato animal avalado, financiado y respaldado por la Administración</strong> en contra de las <strong>leyes de protección animal y código penal de nuestro país.</strong></p>

<p>Como <strong>el que hace la ley hace la trampa</strong>, las administraciones autonómicas que prohíben estas prácticas añaden una cláusula de excepción que finalmente se materializa en permitir y financiar esta masacre de animales. </p>

<p>Se <strong>crían, capturan y lanzan</strong> para su disparo palomas que han vivido en condiciones lamentables. Así acaban sus vidas muertas por el<strong>capricho</strong> de un escopetero que bien podría disparar a un plato. <strong>Las víctimas ascienden a 250.000 palomas y 200.000 codornices en campeonatos puntuables, imaginad la cifra total si hubiera conteo de tiradas de entrenamiento y sociales. </strong>Existen campeonatos locales, provincial, a nivel de comunidad autónoma, nacional e internacionales. </p>

<p>Existiendo la <strong>modalidad deportiva del tiro al plato</strong> no podemos tolerar que se siga justificando y protegiendo esta práctica que supone miles de palomas muertas cada fin de semana. En competiciones morirán pero más lo harán en entrenamientos que podrás matar  cuántas puedas pagar.</p>

<p>No hay visión económica que nos vaya a cambiar que este sacrificio de animales recauda dinero o da puestos de trabajo. En el siglo 21 <strong>no consentimos que la economía se imponga al bienestar animal y avance social</strong>. </p>

<p>A nivel nacional, en la Operación ""Stop Tiro de Pichón 2015"" van 223 aves rescatadas, y 19 acciones de las cuales, 5 son manifestaciones.</p>

<p>----</p>

<p><strong>MADRID. </strong>Cuenta con tres campos de tiro, el de Villarejo de Salvanés, el de Aranjuez y el de <strong>Somontes</strong> en pleno corazón de la ciudad. Éste último con su propia granja de cría de palomas y codornices. Cada fin de semana, se masacran miles y miles de palomas entre los tres campos de tiro. Que cambien de una vez paloma por plato, que además es una modalidad que se practica en todos ellos. #madridmaltratoanimal #stopbloodingsports</p>

<p>VIDEO MANIFESTACIÓN CONTRA EL CLUB DE TIRO DE SOMONTES (13 de septiembre 2015 - acción 18 StopTirodePichón2015):</p>

<p><u>https://www.facebook.com/MisAmigasLasPalomas/videos/921895444531311/?pnref=story</u></p>

<p>Si quieres conocer todo sobre el tiro de pichón aquí.</p>

<p>VER VÍDEO EXPLICATIVO: https://youtu.be/V6dvTnWpkxY?list=PL1xtzgQvlf5NDHSIz7OizXZ90_2-DPTQm</p>

<p>#cambiaaveporplato</p>

<p>#noalclubdetirodesomontes</p>

<p>#noaltirodepichón</p>

<p>#acabemosconelmalratoalaspalomas</p>

<p>Gracias</p>

<p>Patricia </p>

<p>Mis Amigas Las Palomas</p>

<p>A parte de esta lucha contra el Club de Tiro de Somontes, a nivel nacional y comunitario puedes ayudar a terminar con esta práctica aberrante en:</p>

<p>Campaña change.org para acabar con el tiro de pichón a nivel nacional (ya van casi 9.000 firmantes):</p>

<p><u>https://www.change.org/p/prohibici%C3%B3n-sin-excepci%C3%B3n-del-tiro-de-pich%C3%B3n-y-pr%C3%A1cticas-similares-campa%C3%B1a-nacional-firma-internacional</u></p>

<p>Campaña change.org para acabar con el tiro de pichón en la Comunidad de Madrid en fiestas (ya van casi 800 firmas y 3 de 11 pueblos que ya lo han dejado este año):</p>

<p><u>https://www.change.org/p/no-queremos-maltrato-animal-en-sus-fiestas-en-forma-de-tiro-de-pich%C3%B3n</u></p>

<p> </p>

<p> </p>

<p> </p>
";"14/09/2015 16";"166";"131";"35";"10";"932765797";"7575"
"3785";"Transporte publico gratuito el primer fin de semana de cada mes ";"<ol>
	<li>Transporte publico gratuito o con precio reducido los fines de semana o el primer fin de semana de cada mes</li>
	<li>Que una vez al mes, durante un fin de semana se restrinja la circulación del trafico rodado en las principales zonas de la capital, para fomentar así el deporte, una mejor calidad del aire, etc..</li>
	<li>Avanzar hacia un modelo donde se restrinja a diario el numero de vehículos circulando con la vista puesta en el objetivo final de que los vehículos privados que circulen por Madrid sean sólo propulsados por energías limpias</li>
	<li>De manera similar a como funcionan las bicicletas, que se puedan alquilar vehículos eléctricos.</li>
	<li>Cambiar la iluminación de las farolas, reorientarlas para disminuir la contaminación lumínica.</li>
</ol>
";"14/09/2015 17";"68";"32";"36";"2";"914512258";"-188"
"3786";"publicación por part del ayuntamiento de las medidas de ahorro adoptadas y en qu";"<p>Publicación por parte del ayuntamiento de las medidas de ahorro adoptadas, en qué han consistido y cantidad exacta de ingreso en las arcas públicas. Con especial referencia a la anunciada bajada de sueldos de los ediles.</p>
";"14/09/2015 17";"32";"31";"1";"0";"931469355";"2906"
"3787";"Cambiar zona de la O.R.A. del Retiro en frente del 75 de Menéndez Pelayo";"<p>A día de hoy, la acera pegada al Retiro entre la Plaza del Niño Jesús y Mariano de Cavia para aparcar es zona de Residentes y es necesario pagar lO.R.A, pero lo que es un sinsentido, es que ese tramo no corresponda al barrio del Retiro, si no que corresponde al Barrio de los Jerónimos, es decir que el vecino de Jerónimos aparca y se da un agradable  paseo de 25 minutos para llegar a su casa, cosa absurda.  Mi propuesta es que ese tramo ya que tiene O.R.A., que al menos pertenezca a la zona lógica, es decir, Retiro.</p>
";"14/09/2015 17";"23";"16";"7";"1";"923913972";"626"
"3788";"Cambio de nombre de estación de metro: estación ""Luis Aragonés""";"<p>Dado que la candidatura olímpica de Madrid se ha aparcado definitivamente, no tiene sentido llamar a la estación de metro ""Estadio Olímpico"". Dicha estación debe cambiarse a ""Luis Aragonés"", nombre representativo del Atlético de Madrid, equipo que va a jugar en ese estadio, y madrileño ilustre.</p>
";"14/09/2015 17";"153";"96";"57";"36";"927937333";"2447"
"3789";"Plan integral de movilidad ciclista elaborado por todos los agentes ciudadanos";"<p>Madrid merece un plan integral de movilidad ciclista a la altura de otras capitales nacionales e internacionales. El handicap de el retraso que acumula en este sentido, ha de compensarse con un ejercicio de deliberación, debate y decisión en el que todas las partes implicadas participen activamente en su elaboración. No basta con medidas aisladas e incompletas (carril bici, Bicimad), sino que se requiere un plan integral que tenga en cuenta todos los aspectos que un cambio cultural y una lógica de la ciudad (hasta ahora priorizando al vehículo frente al peatón y la bicicleta) como este requieren: conflictos de uso (facilitar el tráfico de bicis de algún modo dificulta el de coches y supone la merma de plazas de aparcamiento en las zonas afectadas), inversión y mantenimiento (no sólo se trata de construir las infraestructuras sino de mantenerlas) y diseño que optimice los recursos existentes. Todo ello acompañado de una política de sensibilización y educativa importante. Y sobre todo, y ese es el quid de la propuesta, elaborado por un equipo multidisciplinar donde estén presentes las instituciones afectadas, ciudadanía organizada especializada (asociaciones ciclistas y de movilidad) y ciudadanos y ciudadanas que quieran sumarse a aportar desde la experiencia.</p>

<p>Muchas gracias por la atención. </p>
";"14/09/2015 17";"82";"69";"13";"5";"932239104";"4712"
"3790";"prohibir las marisquerías";"<p>Prohibir las marisquerías, en estos establecimientos se tortura a los animales, esos pobrecillos seres hervidos vivos para luego ser devorados, no se me ocure una muerte más cruel. Es necesario concienciar a los madrileños que ponerse ciego a marisco va contra el medio ambiente, rompo una lanza en favor de calamar do. En fin aunque muchos piensen que es un tema sin importancia por tratarse de animales pequeños estas personas deben saber que con su falta de respeto al medio marino no va ser posible ni salvar a Wally </p>
";"14/09/2015 17";"96";"21";"75";"17";"913295535";"-1181"
"3791";"APR (área de prioridad residencial) en el Barrio del Pilar y aledaños";"<p>Las áreas de prioridad residencial (APR)  son áreas en las que se restringe el uso de vehículos privados a los residentes de la zona. Me gustaría proponer la creación de una APR en el Barrio del Pilar y zonas aledañas (parte de los barrios de Peñagrande y La Paz)</p>

<p><u>Objetivos globales</u></p>

<ul>
	<li>Reducir la emisión de gases contaminantes, reduciendo así la contribución de Madrid al efecto invernadero y por ende al calentamiento global.</li>
	<li>Aumentar la salud y calidad de vida de los habitantes de Madrid, al reducir la emisión de gases contaminantes, que se relacionan con el aumento de la prevalencia de enfermedades respiratorias y cardiovasculares.</li>
	<li>Reducir la contaminación acústica.</li>
	<li>Reducir el consumo de combustibles fósiles, en gran parte importados del exterior, contribuyendo así a disminuir el déficit de la balanza de pagos.</li>
</ul>

<p><u>Objetivos específicos</u></p>

<ul>
	<li>Reducir el tráfico de coches en las calles situadas dentro de la zona, en particular calles con superpoblación de automóviles, como Betanzos, Melchor Fernández Almagro, Monforte de Lemos y Ginzo de Limia.</li>
	<li>Al ""pacificar el tráfico"", favorecer el uso de medios de transporte menos contaminantes, como la bicicleta y el transporte público.</li>
</ul>

<p><u>Área de implantación</u></p>

<p>El área propuesta abarca desde la avenida de Sinesio Delgado y la calle Valle de Mena al Sur hasta la M-30/calle Santiago de Compostela por el Norte y el Paseo de la Castellana por el Este.</p>

<p>Se haría necesario controlar los accesos a la avenida Monforte de Lemos (desde la M-30 y desde el túnel de Pío XII), avenida de Betanzos, Ginzo de Limia, Camino de Ganapanes, Pedro Rico.</p>

<p><u>Otras consideraciones</u></p>

<ul>
	<li>Debería valorarse a priori cuánto flujo de tránsito se estima que se reduciría, para decidir si la inversión necesaria está justificada.</li>
	<li>Esta medida debería de ir acompañada por otras medidas que incentiven el uso del transporte público y el uso de la bicicleta dentro de la zona. Podría plantearse en este sentido un incentivo económico a los comercios de la zona que ofrezcan el transporte de mercancías a domicilio de forma gratuita.</li>
</ul>

<p> </p>
";"14/09/2015 18";"41";"21";"20";"1";"917920190";"51"
"3792";"Vertedero Las Tablas - Parque forestal de Valdebebas";"<p>Entre la subestación eléctrica de Unión Fenosa, en Las Tablas y el acceso al Monte de Valdelatas hay un sendero de poco más de 300 metros que comunicaría un barrio con más de 60.000 habitantes con un parque forestal de considerables dimensiones que podríamos disfrutar, teniendo en cuenta la escasez de espacios verdes con los que contamos en el barrio. Y digo comunicaría porque, desgraciadamente, se encuentra repleto de todo tipo de desechos al haberse creado en la zona un vertedero de forma indiscriminada. Lo que planteo es que se si se limpiase la zona y se prohibiesen los vertidos, actualmente es un lugar insalubre y peligroso, creo que saldríamos ganando. Creo que con una inversión muy reducida, se podría dar a los vecinos de Las Tablas un acceso fácil y cómodo para practicar deporte al aire libre.  </p>
";"14/09/2015 18";"61";"59";"2";"2";"934615727";"5513"
"3793";"No pagar por aparcar en la calle/reducir la zona ser muy considerablemente";"<p>Creo que el Ayuntamiento de Madrid debería reducir muy considerablemente el horario de la zona SER. Yo diría que una ciudad moderna y envidiable debería abolir esta creación de recaudar dinero absolutamente antilibertaria. La gente pagamos un impuesto de circulación, como para pagar por aparcar en la calle. Siempre que lo hablo con la gente me dicen ""eso nunca ninguno lo va a quitar, da mucha pasta"". Quiero pensar que hay gente que sí lo haría, al menos ya digo reducirlo considerablemente, ponerlo sólo por las mañanas y dejarnos respirar las tardes y por supuesto quitarlo los fines de semana. No sé algo. Por ejemplo hay un pasadizo entre el museo del Ferrocarril y el Cercanias de Delicias, que es una absoluta vergüenza que tenga zona verde, ya que el pavimento está absolutamente destrozado. Por favor, quiten la zona esta, vivimos en sociedades que es absolutamente surrealista vivir, no podemos levantar cabeza, porque sino es por pagar, es por tener que ir a pagar, el caso es no dejarnos vivir.</p>

<p>Gracias</p>
";"14/09/2015 18";"73";"28";"45";"4";"912929467";"-652"
"3794";"Taxis y autobuses ecológicos";"<p>Si bien la EMT ha hecho un gran esfuerzo por dotarse de autobuses ecológicos en los últimos años, fuera de la Zona de Bajas Emisiones los servicios se siguen prestando en gran medida mediante autobuses que funcionan con gasóleo. Mucho más preocupante es el caso de los taxis, en los que sigue reinando el gasóleo tanto en el centro, como en el resto de la ciudad.</p>

<p>Creo que, por lo que respecta a la EMT, se debería aspirar a una flota 100% ecológica (autobuses GNC y eléctricos). Por supuesto, en un plazo razonable que permita amortizar los vehículos existentes.</p>

<p>Por lo que respeta al taxi, se debería prohibir la adquisición de nuevos vehículos que funcionen con gasóleo, estando sólo permitidos los vehículos híbridos/gasolina; eléctricos; GNC; y GLP. Con una pequeña subvención municipal, únida al menor coste de ejercicio de estos vehículos, el taxista no notaría el efecto (y los ciudadanos bastante).</p>

<p>El impacto en los presupuestos municipales sería relativamente bajo: 1.000 euros por vehículo x 1.500 vehículos/año (asumiendo que hay 15.000 taxis, con una vida media de 10 años) = 1.500.000 euros al año.</p>
";"14/09/2015 18";"177";"171";"6";"7";"939158124";"15940"
"3795";"Que vuelvan los trenes al Metro de Madrid";"<p>Se lo he pedido a Manuela a través de su perfil en Facebook, y también se lo he pedido a Cifuentes a través del Consorcio de Transportes. Ahora abro debate por aquí para preguntar a los Madrileños si apoyan esta iniciativa, pero dirigiéndome a vosotros en el siguiente escrito:</p>

<p>Solicito a través de este debate, pedir que por favor vuelvan los trenes de Metro a Madrid. Tanto a Carmena como a Cifuentes les he mandado una fotografía del andén de la línea 3 de Moncloa dirección Sol, el pasado viernes 11 de Septiembre, a las 18:20h. A vosotros --lectores-- no os hace seguramente falta que os explique la necesidad que tenemos los usuarios de metro de que se incremente el número de trenes que circulan EN TODAS LAS LINEAS DE METRO en la Capital. Ya no estamos en verano como si no hubiera gente que necesitase los trenes. Estamos a mediados de Septiembre y desde el final de Agosto, llevamos observando como tanto en horario punta como en horario normal tenemos a muchos usuarios, demasiados, desbordando los andenes de metro de diferentes líneas. A Carmena sólo le he comentado la situación del Viernes en Moncloa porque sé que Carmena es usuaria del Metro de Madrid y no hace falta que le diga mucho más. Por otro lado, a Cifuentes sí la he tenido que exponer que incluso en los días laborales, en la línea 6 a la altura de Pacífico, entre las 7:30 y las 8h de la mañana, en plena hora punta... el paso entre trenes es excesivo. Los autómatas marcan 4 minutos pero todos aquí sabemos que no siempre son 4 reales.</p>

<p>Con la crisis aumentó el número de usuarios, pero también de turistas, y sin embargo, Metro de Madrid incrementó el precio del billete y de los abonos de transporte, e hizo una quita importante de trenes, que este año se ha vuelto a notar.</p>

<p>No estoy relacionado con nada del metro, ni tengo familiares metidos en esta empresa. Soy un usuario más, un madrileño más, un ciudadano que paga sus impuestos más, como tú --lector-- y como cualquiera. Y como cualquiera, espero que el metro de madrid donde antes su lema era 'Vuela', deje de ser el actual 'Sardina en lata'.</p>

<p>Solicito a través de la apertura de este debate que cada lector exponga su experiencia de los hechos, y que hagamos que mediante la apuesta positiva por este asunto, hagamos entre todos que los trenes VUELVAN al Metro, que no hay que dejar de mencionar que ''para eso los hemos pagado''.</p>

<p>Muchas gracias por vuestro tiempo.</p>

<p> </p>
";"14/09/2015 18";"174";"166";"8";"17";"938870236";"15073"
"3796";"Carteles con consejos en conducción eficiente en gasolineras";"<p>Para ayudar a reducir la contaminación, mejorar la calidad del aire y mejorar la seguridad vial sería conveniente crear una ordenanza municipal para obligar a las gasolineras en Madrid (y por que no también en toda la Comunidad de Madrid) <strong>a tener un cartel o carteles con consejos para una conducción eficiente y de como reducir el consumo.</strong> Los lugares donde se debería instalar estos carteles son: En los surtidores, en la puerta de acceso a la tienda de la gasolinera, donde el llenado de aire, en la entrada del túnel de autolavado o donde las aspiradoras para limpiar los coches.

Puede parecer una tontería, pero mientras un conductor está rellenando el depósito tiene tiempo de sobra a leer 10-15 consejos para reducir el consumo, de forma activa y pasiva (como usar marchas largas lo antes posible, parar el motor para paradas de más de 1 minuto o comprobar el aire de las ruedas mensualmente). Junto a cada consejo o medida se debería poner de forma obligatoria ya que los números es lo que mejor entienden los conductores, el porcentaje de ahorro en combustible de cada medida (mantener el aire óptimo de las ruedas. Ahorro: 3%. Conducir suavemente. Ahorro: 6%, etc).

<strong>Se puede llegar a ahorrar un 15% de combustible y emisiones aplicando estas técnicas.</strong> Al poner en este cartel con las 10 o 15 medidas más importantes, se podría poner en la parte inferior del cartel una dirección web donde se explique en total todas las medidas necesarias para hacer una conducción eficiente (ya que no caben en este cartel). Los carteles con los mensajes serían estandarizados para que en todas las gasolineras fuesen igual.s

Poco a poco, los conductores al leer siempre los mismos consejos se les puede quedar interiorizado y prestar más atención a como reducir el consumo, sobre todo si al lado de cada consejo aparece un porcentaje de ahorro. Es una medida muy económica de implementar aunque las petroleras prefieran que cuanto menos sepamos de conducir de forma eficiente mejor para ellas.

De verdad que aunque parezca una tontería esta sugerencia, estoy 100% convencido que puede ayudar y mucho a los conductores y a reducir la contaminación del aire. Interiorizando consejos que un conductor puede leer todas las semanas ayuda a que ahorre combustible ya que sabe que aplicarlas le ahorrará combustible. Si tanto se apuesta ahora por la continua formación de la gente, que también se haga con estos carteles ya que no me parece buena idea que una persona se saque el carné y luego no tenga que volver a mostrar que sabe los conocimientos teóricos y prácticos nunca más sobre conducción.

<strong>Esto no se ha hecho en ninguna parte del planeta.</strong></p>
";"14/09/2015 19";"30";"15";"15";"1";"917959196";"0"
"3797";"Llega la Navidad con sus luces ¿ponemos menos?";"<p>Al hilo de un comentario en el que una persona indicaba que Madrid está superiluminada, le tengo que dar la razón, al menos en el Centro. No veo necesaria tanta iluminación en el Centro, pero durante las Navidades ya es exagerado.</p>

<p>He abierto este debate ahora porque las luces se colocan ya para mediados de noviembre. Yo sería capaz de no poner una sola luz de Navidad, pero como creo que una media así sería muy drástica, mi propuesta sería<strong> rebajar la cantidad de iluninación navideña del Centro de Madrid</strong>, donde hay calles en las que hay más luces que metros de calle (he exagerado un poco) y, o bien utilizarlas para poner adornos de Navidad en otros barrios si no se ponen, o simplemente acostumbrarnos a no tener tantas luces y ahorrar un poco de dinero para otros menesteres.</p>

<p>Todos los barrios de Madrid deberían tener un centro neurálgico, una plaza, una calle principal, con sus lucecitas de Navidad. Siempre habrá gente a quien le resulte complicado desplazarse y creo que sería agradable que todos los barrios tuviesen sus luces.</p>
";"14/09/2015 19";"155";"115";"40";"8";"932044679";"5564"
"3798";"Por un Madrid más amigable: restricción de los vehículos a motor.";"<p>UNa de las ciufdades más bonitas y con mayor calidad de vida está ahogada por un tráfico insufrible, ruido, contaminación....Es hora de tomar acciones para restringir los vehículos a motor y diseñar una ciudad para las personas, no para los coches. Por cierto se puede vivr sin coche, yo llevo haciéndolo muchos años...</p>
";"14/09/2015 19";"108";"64";"44";"3";"926086999";"1185"
"3799";"Que los políticos trabajen en las horas valle de las eléctricas";"<p>Considero que para un ciudadano de a pié estar todos los días comprobando la tarificación del día siguiente para comprobar cuando puede pasar la aspiradora o planchar. ¡Qué porras! No saber el coste de un servicio que necesitas consumir como es la energía eléctrica es inaceptable. Es como si voy a pintar la casa y el pintor me dice: ""Mire, la brocha son 20 , pero la pintura según la vaya trayendo ya le digo lo que le voy a cobrar por bote...."" Pues mire, el primer día le voy a dar los 20  pero después ya veré lo que tengo en el monedero...</p>

<p>Como alternativa las eléctricas te ofrecen en el mercado libre una tarificación fija pero, por lo menos lo que he comprobado un par de veces, superior a la antigua Tarifa de Último Recuro. </p>

<p>Basándome en estos dos hechos, y como posiblemente nuestros gobernantes no tengan la necesidad de ahorrar en sus casas, propongo que ahorren en la factura que les pagamos entre todos, de modo que <strong>comprueben la tarificación eléctrica del día siguiente y se reúnan en las horas valle</strong>. Que es a las 4 de la mañana... pues a las 4, que al día siguiente a las 5, que al otro a las 3.... y de paso que vayan en transporte público... ¡uyyy pero si no hay! ... ya verás que risa.</p>

<p>Posiblemente esta medida iría más enfocada al Congreso de los Diputados y al Senado, pero es que no me he podido contener.</p>
";"14/09/2015 19";"45";"29";"16";"2";"925625626";"837"
"3800";"Reducir el alumbrado público en toda la ciudad, siguiendo el ejemplo de Berlín. ";"<p>Una parte considerable del presupuesto municipal se consume en energía lumínica nocturna excesiva, que nadie necesita y que a nadie aprovecha salvo a las compañías de suministro. Racionalizar este gasto supondría contar con un ahorro considerable para re.invertir en sostenibilidad energética. También existen grandes zonas de polígonos industriales y comerciales que iluminan vías vacías cada noche. Deberían obligar a poner sistemas de encendido con sensores de presencia de tal manera que permanezcan apagadas mientras no haya actividad humana. De paso generariamos menos contaminación lumínica y veríamos mejor el cielo estrellado.</p>
";"14/09/2015 20";"222";"194";"28";"12";"937855944";"14506"
"3801";"Madrid sin anti-taurinos .";"<p>Basta ya de tanta intrasigencia y tanta falta de tolerancia ,con un arte que es la tauromaquia.</p>

<p>El que no le guste y no lo entienda que se queda en casa y que no moleste!!!!</p>
";"14/09/2015 21";"135";"36";"99";"13";"913786112";"-1680"
"3802";"Madrid moderno, verde y limpio";"<p>Me gustaría ver a Madrid Verde, limpio y moderno que las mejoras que se hagan sean con gusto, modernas y con armonía. He viajado por ciudades pequeñas como Bilbao, Logroño, y ves que han mejorado y cambiado la ciudad porque en sus cambios han sido modernos  y con mucho gusto. Los parques de los niños, son divertidos y a la vista de los viandantes muy coloridos y  bonitos, tienen goma de colores en el suelo en vez de arena. Ponen fuentes ciberrneticas en el suelo, muy divertidas y decorativas, las farolas son con un aire moderno. Esto genera más turistas que dejen dinero en Madrid si la ciudad es bonita y mas trabajo.</p>

<p>En el distrito de fue corral podrían poner  a ambos lados de la M-30 los arbustos que había que ahora están todos rotos y feos.  Hay un bulevar de terrazas y parques de niños, que antes estaban los arbustos y  estabas en el parque con los niños y no veías los coches, y había mucho menos ruido.  Quedaría más bonita la entrada  por la M-30. Cuanto mas frondosos los arbustos mejor para evitar tanto ruido. </p>

<p>Muchas gracias por escucharme.</p>

<p> </p>

<p>Saludos,</p>
";"14/09/2015 21";"87";"83";"4";"3";"936952169";"7536"
"3803";"Mi barrio está cada vez mas sucio";"<p>Vivo en el barrio de Las Rosas (Distrito San Blas, al lado del Estadio de la Peineta). Las calles de mi barrio están cada vez mas sucias. Los papeles, las latas, los restos están por las aceras y por los terrales de los árboles sin que nadie los recoja. Me parece evidente que los servicios de limpieza municipal han dejado de trabajar, o al menos trabajan mucho menos que antes.</p>

<p>Además hay otro problema, Todos los dias pasan ""recogedores"" de papel por los contenedores de papel. Los descargan, y lo que les sirve lo cargan en camionetas y vehículos y se lo llevan, pero lo que no les sirve NO lo meten otra vez en el contenedor, si no que lo dejan tirado en la calle, llenandola de basúra que luego el viento dispersa. </p>

<p>Así que entre que nadie les dice nada a los ""vaciadores"" de contenedoras de papel, y les dejan enguarrar tranquilamente y que los basureros ya no limpian como antes...¡Las calles de mi barrio están asquerosas!</p>
";"14/09/2015 21";"86";"83";"3";"7";"937264851";"7720"
"3804";"Publicar un mapa de ocupación en tiempo real del parking del S.E.R.";"<p>Hay veces que Madrid está colapsado de coches, y es muy complicado aparcar. Otras, está medio vacío y hay muchos huecos libres.</p>

<p>Si se publicase un mapa en tiempo real de la ocupación de los parking del S.E.R., por barrios, se evitaría que muchos coches accedan a la ciudad en los momentos críticos de tráfico. Y es una información que podríamos obtener fácilmente gracias a los parkímetros conectados que se instalaron recientemente.</p>
";"14/09/2015 21";"55";"49";"6";"0";"933430543";"3830"
"3805";"En caso de conflicto bélico ¿cómo protege Madrid a sus ciudadanos?";"<p>Llevamos muchos años sin conflictos bélicos que afecten a España, por lo que estamos de enhorabuena, pero que esto sea así desde hace bastante no quita el hecho de que se pueden producir.</p>

<p>Creo que debería diseñarse un sistema, que utilizando las instalaciones actuales, con usos habituales, sean compatibles en caso de conflicto con la protección de las personas.</p>

<p>En caso de conflicto, y de cortes de suministro, agua, luz, gas, ¿que hacemos?, ¿donde acudimos?, seguro que cuando ocurra nos ocuparemos, pero, ¿por qué no ocuparnos ahora que no hay confictos en crear una ciudad que pueda sobrevivir al desabastecimiento, a la falta de recursos, a la inseguridad.</p>

<p>Tal vez sería interesante que existieran depósitos de agua repartidos por toda la ciudad, o incluso en las viviendas, para garantizar que nunca habrá carencia de agua para beber.</p>

<p>Sería interesante formentar sistemas de captación de energía individuales, que nos permitan disponer de energía en caso de cortes eléctricos.</p>

<p>En cuanto al mayor problema en caso de conflicto bélico que le sucedería a una gran ciudad, el abastecimiento de alimentos, requeriría un mayor esfuerzo.</p>

<p>Invito a todos a proponer en este debate ideas viables, económicas, con las instalaciones actuales, o tal vez algunas más que permitieran con costes mínimos, conseguir que Madrid sea más segura en caso de guerra, que espero que no se produzca, porque seguramente el Madríd actual sería una ratonera.</p>
";"14/09/2015 21";"43";"11";"32";"15";"915330570";"-537"
"3806";"Cinturón verde del Este, Vicálvaro, Vallecas, Moratalaz, Vallecas y San Blas.";"<p>En el este de Madrid existe ya, muy fragmentado, un corredor verde, el que discurre por el parque de La Elipa, la cuña verde de O´Donell, el parque de la vicalvarada y el parque forestal de Vicálvaro. No haría falta un gasto excesivo para unirlos entre sí cubriendo algunos tramos de autovía y avenida, no demasiados, para permitir un corredor verde desde el Parque de Roma y la quinta del Berro hasta Vicálvaro.</p>

<p>Esta cuña verde que uniría el interior de la M-30 con campo abierto es fácilmente ampliable y mejorable, tanto uniéndolo con el parque del Retiro como ampliándolo en el este.</p>

<p>Ampliación 1: Las antiguas canteras y minas de Vicálvaro. Frente al barrio de Vicálvaro se abre un amplio descampado de alrededor de 5 Km cuadrados rodeado por autopistas en su mayor parte, tiene varias lagunas surgidas en las antiguas minas y un terreno degradado que no sería excesivamente difícil ni costoso de convertir en un bosque periurbano con zonas verdes de un carácter más urbano en las cercanías de Vicálvaro y San Blas, con dotaciones deportivas y de ocio, amén de otros usos. Serviría de cierre a la ciudad de Madrid en el extremo oriental con respecto a Coslada, con cuyo bosque periurbano llegaría a unirse creando un amplio pulmón para varios centenares de miles de personas. Este pulmón podría unirse sin mucho coste con el Parque del Capricho y el Juan Carlos I siguiendo el viaducto del tren.</p>

<p>Ampliación 2: Desde Vicálvaro hacia el Este, con un breve falso túnel sobre la R-3 y la M-45, remodelando el PGOU de los PAU de Cañaveral y Ahijones parcialmente para permitir un bosque urbano de 300-500 metros de anchura que avanzase hacia el este hasta alcanzar el término municipal de Rivas y el Parque Regional del Sureste a la altura del río Jarama. No solo se crearía una conexión verde para peatones, ciclistas y fauna desde el interior de la M-30 hasta el parque natural del río Jarama, también restauraría un paisaje muy degradado y ampliaría las zonas de ocio de esos barrios, serviría de límite oriental a la ciudad de Madrid y de punto verde para hipotéticos futuros crecimientos de la ciudad.</p>

<p>Ampliación 3: Unión del parque forestal de Santa Eugenia y el cerro Almodóvar con el bosque periurbano de la Ampliación 2 en la zona del PAU fallido de los Berrocales y Los Ahijones, protegiendo en su seno la antigua ermita de la virgen de la Torre. Permitiría una conexión verde del distrito de Vallecas con el parque regional del sureste y con el interior de la M-30.</p>

<p>Habría que proteger y poner en valor espacios como la ermita de la virgen de la Torre, necrópolis como la visigótica de Vicálvaro, yacimientos prehistóricos del cerro Almodóvar y otros. Unidas a mis otras dos propuestas con una inversión mínima la ciudad de Madrid quedaría rodeada completamente por el oeste, el sur y el este por zonas boscosas, prados, cultivos y espacios protegidos, con evidentes mejoras medioambientales, culturales, urbanísticas al servir de broche al crecimiento de nuestro municipio y los municipios vecinos y, evidentemente, mejoras en cuanto a la calidad de vida de los cientos de miles de vecinos de la zona. Con todo en los amplios descampados abandonados o PAU mal diseñados, aparte del cinturón verde, quedaría espacio más que sobrado para afrontar en las próximas décadas ampliaciones de las zonas urbanizadas, eso sí, con una calidad medioambiental y una ordenación mucho más limitada y reconocible.</p>
";"14/09/2015 21";"189";"184";"5";"1";"941094728";"17426"
"3807";"Debería restablecerse el día de recogida enseres";"<p>Hasta hace unos años, el Ayuntamiento fijaba un día al mes para recoger muebles viejos y enseres. Con esa medida, se reutilizaban muchos objetos, ya que la gente pasaba por las calles para llevarse el que le interesaba, antes de que pasaran los vehículos del ayuntamiento. Esa medida debe volver porque fomenta la reutilización y alivia los vertederos.</p>
";"14/09/2015 21";"299";"291";"8";"4";"943041605";"27542"
"3808";"Ordenación del ciclismo en la Casa de Campo";"<p>La Casa de Campo tiene dos tipos de usuarios básicos; peatones y ciclistas. Estos últimos pululan por todas partes, aun las mas inaccesibles, en una especie de continua carrera y suponen un serio riesgo para la integridad de los primeros. También están contribuyendo a la degradación de los suelos ya que son innumerables las ""pistas"" que continuamente abren y utilizan.</p>

<p>Para evitar estos problemas deberían definirse una serie de recorridos para ciclistas, fuera de los cuales las bicicletas no podrían circular, estos caminos estarían adecuadamente señalizados para que los peatones se mantengan fuera de ellos.</p>
";"14/09/2015 22";"52";"31";"21";"6";"925573409";"596"
"3809";"Monedero compara a Leopoldo López  con los terroristas de ETA";"<p>¿Cual es la opinión al respecto del Ayuntamiento de Madrid? El Sr. Monedero es un miembro importante próximo a Ahora Madrid y a Podemos, en mi opinón es muy grave que se falte al respeto a una persona que esta luchando para que vuelva la democracia a Venezuela comparándole con un vil terrorista de ETA.</p>

<p> </p>
";"14/09/2015 22";"59";"23";"36";"9";"915085462";"-506"
"3810";"monumento en Atocha a los asesinados en los trenes el 11 M";"<p>Con todos mis respetos, creo que el monumento que hay junto a la estación de Atocha es bastante feo y siempre está sucio. Pienso que las víctimas se merecen un monumento más estético. Podían ponerse estatuas realistas que representen a la gente normal, la gente que murió en esos trenes</p>
";"14/09/2015 22";"74";"52";"22";"5";"930090880";"2108"
"3811";"Edificio España";"<p>Estudio arquitectura superior porque siempre me encantaron los edificios y las ciudades, especialmente los rascacielos puesto que pienso dedicarme a ello. Sin embargo gran parte de los arquitectos del mundo puesto que esto no es un problema exclusivo de Madrid o de España, tan solo les importa el dinero. Y los políticos no tienen ni idea de arquitectura. Y los chinos no tienen ni idea del sentimiento que sentimos muchos españoles a cerca de ese edificio ya que lo vemos como algo propio nuestro o por lo menos yo que ni tan siquiera soy de Madrid, soy gallega. Para mi gusto Madrid es la ciudad más bonita de España y lo es por sus edificios, y el edificio España o la Casa del Coño es uno de mis favoritos, puesto que es el edificio de arquitectura clásica más alto de España. Y es que ni tan siquiera en dimensiones hay alguno similar a si que no se porque dijeron lo de que no es un edificio tan importante y la coña es que el que lo dijo fue un arquitecto. Me da vergüenza escuchar esto es que parece que no estudio historia de la arquitectura.</p>

<p> Segundo en las imágenes la fachada no aparece tener ningún problema de conservación ahora claro yo no soy quién para decirlo para ello tienen que contratar al menos un arquitecto superior que inspeccione la fachada, y que él decida pero claro nadie lo hace gratis . Y como no parecen por la labor de pagar porque les importa una mierda el edificio dicen que la fachada esta en un pésimo estado de conservación y si cuela coló, pero una empresa que coño va a saber de arquitectura puede tener la misma razón que una peluquera.</p>

<p>Tercero hace unos años este edificio estaba más protegido puesto que no se podía demoler ninguna parte pero lo cambio el gobierno del pp al ver que esta empresa lo compro  y estaba interesada en demolerlo y permitió que se demoliera por completo. Las leyes están para cumplirlas no para cambiarlas según los intereses de algunos, que yo apostaría a lo que fuese que esta empresa traería beneficios al gobierno. Porque si nos paramos a analizar en que consisten las políticas de derechas es precisamente en beneficiar a las empresas cuanto más grandes mejor, y por lo tanto los gobiernos  tienen que convencer a los empresarios para que pongan su empresa en su país , ciudad ect y para ello hay que ponerle las mínimas trabas posibles o ninguna , y si para ello hace falta cambiar las leyes de un país se cambian, o sea a las empresas hay que darles la razón como a los locos. Lo más injusto de todo esto es que como dije los políticos no tiene  ni idea de arquitectura y la inmensa mayoría tampoco tiene sensibilidad hacia ella ,pero la decisión del cambio de reconocimiento histórico no esta en manos de los arquitectos si no en la de los políticos cuando debería de ser al revés o mejor que estuviese la decisión en manos por una parte de los arquitectos y por otras de los ciudadanos. Puesto que un edificio puede ser privado pero su imagen no, puesto que los madrileños lo disfrutaran y por supuesto los turistas, los edificios nunca son 100% privados ya que forman parte de la vía pública y en este caso del interés cultural e histórico  y no creo que ninguna empresa del mundo por importante que sea se pueda adueñar de ello y ni tampoco del sentimiento que cada persona tiene acerca de ese edificio por eso veo fenomenal una consulta ciudadana y por supuesto tampoco puede faltar un arquitecto que evalué la conservación del edificio y obviamente ese arquitecto tendrá que estar contratado por el ayuntamiento puesto que si lo contrata la empresa ya nos podemos imaginar a quien va a beneficiar.</p>

<p> Cuarto por tratarse de un símbolo de una ciudad debería de estar prohibido demoler y si no lo consideran un símbolo que lo declaren ya. Las ciudades son lo que son por sus símbolos  entendidos los símbolos como elementos muy característicos que las distinguen de cualquier otras, si los eliminamos nos quedaremos con una ciudad corriente como otra cualquiera, puede que si solo eliminamos uno, no o si, depende pero esto es efecto dominó el Edificio España no es el único edificio histórico que no está protegido en Madrid a si que hoy es el Edificio España otro día a saber cual querrán demoler. No tiene sentido demolerlo y volverlo a construir aunque pongan la escusa del material que pasaría si ahora se le diese por demoler la catedral de Santiago o la de Burgos por poner un ejemplo, y hacerla igual al milímetro con la escusa de que las piedras estén deterioradas ya no sería lo mismo, las piedras no serian las mismas, los métodos de construcción no tendrían nada que ver con los medievales ect. Si precisamente una de las cosas que admiramos de las catedrales o de edificios de otros siglos es como se construyeron con los métodos rudimentarios de la época y por mano de los artesanos que en muchos casos dejaban su firma en las piedras porque les pagaban por piedra ya que una piedra había que pulirla y si es una piedra de un arco hay que pulirla al milímetro para que encaje y por supuesto se hacía todo a mano. Vale puede que el edificio España no tenga el acero firmado jajaja pero los métodos de construcción siguen siendo muy distintos  y hacerlo de nuevo desde luego que no iba a tener merito. Hoy en día gracias a la tecnología actual un edificio como ese es muy fácil de realizar, cierto es que mejor reconstruirlo al milímetro que demolerlo y directamente no reconstruirlo.</p>

<p>Cuando escucho este tipo de noticias me entristezco muchísimo hasta el punto que llego  a llorar, me amargo, y me lo paso muy mal como veis me lo tomo de una manera muy personal pero yo soy así y nadie me cambiaran porque mi pasión es la arquitectura. Esto ES UNA BARBARIDAD QUE ME PRODUCE ESCALOFRIOS! POR  FAVOR MANUELA CARMENA NO PERMITA LA DEMOLICIÓN DE NINGUNA PARTE DE ESTE EDIFICIO NO LE PIDO QUE ENTIENDA LA ARQUITECTURA PERO SI QUE LA RESPETE.</p>

<p>¿Y VOSOTROS QUE OPINAIS ? ¿SE DEBE O NO DEMOLER EL EDIFICIO ESPAÑA?</p>
";"14/09/2015 22";"53";"45";"8";"15";"933300353";"3141"
"3812";"crear una tasa turística ";"<p>Como en otras ciudades, en Madrid se tenía que crear una tasa turística, consistente en una pequeña cantidad que tuvieran que abonar los turistas por pernoctar en Madrid. El dinero recaudado se podría destinar a la mejora de los servicios públicos de la ciudad. </p>
";"14/09/2015 23";"90";"30";"60";"4";"914645141";"-1000"
"3813";"Movilización ante la apertura de un centro neonazi en La Guindalera";"<p>Este mismo fin de semana,  uno de los colectivos más radicales del panorama ultraderechista español y madrileño, Alianza Nacional, daba luz pública a la inauguración de su sede social, llamada Baluarte (que durante semanas ha sido literalmente fortificada con rejas y vallas, indicando claramente las intenciones y la actitud conflictiva de este centro), situada en la  Calle Azcona 21, en el barrio de La Guindalera (Distrito de Salamanca), y que tiene intención de ser otro centro público del activismo racista, violento e intimidador de la ultraderecha madrileña.  La sede se encontraba alquilada desde hace varios años pero hasta este momento se mantenía inactiva públicamente.</p>

<p>Alianza Nacional es uno de los partidos más radicales y vinculados a los movimientos skinheads neonazis, ejerciendo públicamente la violencia física como método de hacer política. Hasta hace unas semanas, este partido formaba parte de la coalición ultraderechista La España en Marcha que abandonó por diferencias ideológicas con los otros partidos más moderados del ámbito ultraderechista español.</p>

<p>Como ejemplo de su radicalidad es la figura de su máximo dirigente, el conocido activista ultra Pedro Pablo Peña, que fue condenado en el año 2000 a 7 años de cárcel por posesión de explosivos e intento de asesinato y atentado contra ciudadanos vascos. Su radicalidad la volvió a manifestar nuevamente en el año 2013, cuando defendió y justifico las agresiones violentas de ultraderecha a la librería y centro catalán Blanquerna de Madrid, haciendo además apología del uso de la violencia contra el separatismo y los colectivos antifascistas.</p>

<p>Es conocida su cercanía, además, y su cooperación constante a lo largo de los últimos años con Alberto Ayala Cantalicio, líder de los grupos ultraderechistas del barrio de Canillejas-Madrid y conocido por ser otro de los más violentos líderes de la extrema derecha madrileña.</p>

<p>Ante este aumento de la actividad neonazi en Madrid, a la que se suma el local del Hogar Social Ramiro Ledesma de Chamberí, llamamos a todxs a estar alerta por el mas que probable aumento de actos y agresiones de tipo de racista y ultra en Madrid.</p>

<p>Así mismo, hacemos un llamamiento a la Alcaldesa de Madrid, Manuela Carmena y al Concejal de Distrito de Salamanca, Pablo Carmona, así como al equipo de gobierno de Ahora Madrid en el consistorio madrileño a tomar en consideración la amenaza que supone este colectivo a la convivencia de las y los vecinos del Distrito de Salamanca y de Madrid.</p>
";"14/09/2015 23";"102";"70";"32";"14";"930815903";"2607"
"3814";"mas seguridad colonia el huevo arganzuela";"<p>con el Madrid Río han venido  muy buenos negocios pero también es verdad que hay algunos parques que se han quedado a abandonados tanto en seguridad ciudadana entre ellos está la plaza de Rutilio Gacis en la cual hay ciertas bandas  que campan a sus anchas la inseguridad es patente y necesario un cambio de patrullaje. Se ve drogas,alcohol y delincuencia.mas seguridad es necesaria</p>
";"14/09/2015 23";"38";"36";"2";"4";"934404506";"3221"
"3815";"Recogida de plásticos y envases todos los días";"<p>¿Creéis que ya es hora de que el ayuntamiento vuelva a recoger los cubos de basura amarillos todos los días en lugar de tres días a la semana? No todos podemos guardar basura tres días en casa...</p>
";"15/09/2015 00";"101";"80";"21";"7";"934305309";"4673"
"3816";"Aparcamientos municipales para residentes";"<p>¿Quién revisa que los coches que aparcan son los coches autorizados para hacerlo? Hay mucho alquiler ilegal mientras sigue habiendo largas listas de espera para acceder a una plaza...</p>
";"15/09/2015 00";"48";"41";"7";"2";"933311155";"2904"
"3817";"Aceras mas anchas en el Paseo del Prado";"<p>Quitar un carril al menos en el Paseo del Prado.</p>

<p>Algunas veces con tanta gente.Se puede caminar e ir por la calzada de 3 carriles.Que parece una autopista.En vez de un paseo del siglo XVIII.</p>

<p>También cambiar las baldosas. Que algunas están rotas o sueltas.</p>
";"15/09/2015 01";"68";"49";"19";"3";"931454090";"2161"
"3818";"Creación de una Concejalía de Igualdad de Género";"<p>Similar a como se ha planteado la Concejalía de Feminismos y LGTBI en Barcelona. En Madrid se necesitan implementar los recursos y presupuestos en materias de género para poder acercarnos mínimamente a Andalucía o al País Vasco.</p>
";"15/09/2015 02";"81";"25";"56";"4";"916435508";"-956"
"3819";"Abono transporte en función de la posesión de una nómina de trabajo o no.";"<p>Me gustaría que el abono de transporte se pagara en función de si se tiene una nómina de trabajo o no. No sirve un abono transportes para estudiantes exclusivamente, porque hay numerosas personas jóvenes que han terminado sus estudios, pero que, por el contrario, no han encontrado aún trabajo, dada la situación actual. También está el caso de los parados adultos, larga duración... Para estos grupos de personas no es posible asumir el precio del abono transporte adulto, y deberían poder sumarse al abono de 20 que comienza a implementarse a partir del 1 de octubre de 2015.</p>

<p>Sería un abono mucho más justo y que abarcaría a más colectivos que una única medida enfocada a reducir el coste del abono de parados de larga duración y otra por otro lado de estudiantes. Estas dos ideas, excluyen a los jóvenes de más de 26 años y en paro discontinuo.</p>

<p>Gracias.</p>
";"15/09/2015 07";"168";"111";"57";"4";"934803495";"3567"
"3820";"Custodia compartida";"<p>Custodia compartida YA!!! y real</p>

<p>Basta ya de hacer caminos interminables y de poner zancadillas a los padres que nos tienen alejados y separados de nuestros hijos y solo nos quieren para ser  ""bancos"" evitando eso si, el menor contacto e implicacion en la educacion de nuestros hijos.</p>

<p>Igualdad y equiparacion de derechos de los padres a los de las madres separadas.</p>
";"15/09/2015 08";"71";"46";"25";"4";"932328386";"1360"
"3821";"HABILITAR ZONA CANINA EN BARRIO ";"<p>Buenos dias,vivo en el centro y me gustaria que en algun parque o si se puede contruyeran un area canina para llevar sueltos a los perros sin limite de tiempo,los espacios que hay por el centro son escasos por no decir ninguno lo unico ""decente"" que hay es el parque del casino de la reina,al cual ya no voy porque las condiciones del parque no son optimas para pasear a mi perro,esta lleno de suciedad jeringillas botellas rotas etc etc,no es justo q los usuarios que tenemos perro y cuidamos el medio ambiente nos multen cuando nos pasamos de la hora,y haya gente en las plazas y en los parques que hacen botellon,orinan e incluso defecan y la policia haga caso omiso,y a nosotros dueños de los perros nos multan x ejemplo en mi caso x llevar a mi perro suelto a las 10:15 de la mañana x q se supone q el limite de hora  para llevar suelto el perro son las 10:00,estaria bien que hicieran un parque especia para perros o el mismo parque del casino habilitarlo paara ese fin.</p>

<p>Atentamente un ciudadano</p>
";"15/09/2015 08";"82";"62";"20";"3";"936024062";"3175"
"3822";"Aeroclub de Cuatrovientos";"Soy un vecino del PAU de Carabanchel, y estoy harto de tener que soportar el ruido de los aviones que planean a escasos metros de nuestras viviendas. El ruido no es lo peor, sino la sensación de cualquier día vamos a tener que lamentar víctimas, ya que no es la primera, ni la segunda vez que ocurre un accidente en esta zona. Tristemente las administraciones no toman cartas en el asunto hasta que no ocurre una desgracia. Esperemos que cuando ocurra, no lo tengamos que lamentar. CIERRE DEL AEROCLUB YA!";"15/09/2015 08";"54";"22";"32";"2";"919632311";"-407"
"3823";"Crear ""carriles peatón"" en algunas aceras";"<p>Dada la imposibilidad de caminar por algunas aceras, lo cual nos obliga en muchas ocasiones a tener que ir por la calzada, la propuesta consiste en que en determinados tramos calientes de muchas de nuestras calles se desdoble la acera existente mediante una determinada señalización horizontal, a semejanza de los carriles bici, reservando una parte para los peatones que no deseen pisar cacas. En el caso en aceras no suficientemente anchas, arañar un metro a la calzada para construir en ese espacio el carril peatón.</p>

<p>De esta forma, se dejaría parte o la totalidad  de la acera existente para uso exclusivo de  <em>los dueños con perros que  hacen cacas en medio de las aceras y no las recogen</em>.</p>
";"15/09/2015 08";"40";"19";"21";"2";"922727224";"-95"
"3824";"Mejorar reciclaje en la ciudad";"<p>Mejorar el reciclaje como hacen en países nórdicos, como devolver algunos céntimos por cada envase de vidrio. Aumentar la frecuencia de recogida de contenedores de plástico (la falta de recogida provoca que cada vez más gente esté echando en la basura orgánica todos los plásticos, ya que el contenedor amarillo siempre está lleno) </p>
";"15/09/2015 08";"312";"303";"9";"9";"947719880";"28551"
"3825";"Baldear las calles";"<p>No hace muchos años, todos tenemos el recuerdo de como se regaban muchas de las calles principales de Madrid, sobre todo en el centro. La sensación de suciedad (aparte de que obviamente, Madrid está mucho más sucio), ha subido desde que esta práctica, se dejó de realizar. ¿Es tan complicado utilizar agua reciclada para riego y volver a recuperar, aunque fuera dos o tres veces por semana esta práctica? ¿Al final cuando veamos la escena de la entrada del Conde Duque, donde se riega a Carmen Maura en La Ley del Deseo, tendremos que decir: ""Yo viví de pequeño esa época en la que se regaban las calles y en las que Madrid estaba decentemente limpio""?</p>

<p> </p>
";"15/09/2015 08";"370";"353";"17";"17";"947881675";"32056"
"3826";"sociedad laica y respetuosa";"<p>Dejar libre de todo signo/símbolo religioso todos y cada uno de los establecimientos públicos, institucuiones, organizaciones, etc es una  forma muy fácil de asegurar el respeto a todas las creencias.</p>
";"15/09/2015 09";"186";"141";"45";"11";"938976230";"7277"
"3827";"Paso peatonal y ciclista bajo arcos del puente de Segovia. ";"<p>Todos pos que utilizamos,  Madrid Río sabemos las deficiencias y carecias que este magnífica zona verde de Madrid tiene. Una de ellas es el paso del paseo peatonal por encima del puente de Segovia atravesando el peligroso y caótico cruce semaforico del paseo de Extremadura. </p>

<p>Una solución sería hacerlo bajo los dos arcos  de cada extremo del puente. Al igual que se hace bajo el puente de Toledo.   Con ello el corredor verde no se vería nunca ininterrumpido con semáforos. </p>

<p> </p>
";"15/09/2015 09";"76";"65";"11";"3";"938702081";"4618"
"3828";"Cercado de parques infantiles";"<p>En el ensanche de Barajas hay varios parques infantiles sin vallas. Esto lleva a que algunos perros se paseen libremente por ellos ( con el susto que le pueden dar a los niños) y a que inevitablemente hagan sus necesidades ahí.</p>

<p>Creo que deberían vallarlos al igual que alguno de la zona que ya se ha hecho, juntando un poco mas los columpios para reducir el vallado (que pedí presupuesto para mi comunidad y eran 80 el metro).</p>

<p>aprovecho el debate para recordar la prohibición de fumar en estos parques, esta señalizado y es violento tener que recordarle a otro padre que no debe fumar ahí.</p>
";"15/09/2015 09";"63";"52";"11";"3";"937242657";"3384"
"3829";"Dispositivo disuasorio de movilidad para incidentes puntuales";"<p>Ayer, en la M11 dirección Plaza Castilla, a la altura de Virgen del cortijo, hubo un accidente que mantuvo cortada practicamente la M11 en esa dirección. Esto provocó no solo el colapso de la M11, si no de los accesos colindantes, como son las salidas de Arturo Soria o Sanchinarro. Los coches trataban de salir de esas zonas sin saber donde se encontraba el problema. Muchos de esos vehículos ni si quiera iban en esa dirección, pero se vieron atrapados por la congestión en cruces y accesos. Creo que si existiese un dispositivo de movilidad que simplemente informara en los accesos colindantes de donde está el problema, permitiría a muchos conductores tomar una vía alternativa antes de llegar al atasco, permitiendo reducir el flujo de vehículos. Esto podría incluir incluso que se permitiera, de manera controlada por agentes de movilidad, desahogar las vias permitiendo hacer cambios de sentido en zonas no permitidas, que agentes de movilidad controlasen los cruces con semáforos, etc.</p>

<p>Actualmente el único dispositivo de este tipo que conozco son los paneles luminosos de las grandes vías, que informan de accidentes, cortes, etc, pero que solo son visibles una vez estás dentro de estas vías, y no en los accesos, donde aun los conductores pueden valorar alternativas para no pasar por la zona en cuestión.</p>
";"15/09/2015 09";"28";"23";"5";"0";"934225606";"1478"
"3830";"El Barrio los Rosales (Villaverde) necesita otro autobus.";"<p>Soy una vecina del barrio de los Rosales del Villaverde Bajo. Es un barrio nuevo en el que solo llega la linea 85. En hora punta va muy bien suele tardar 5-7 minutos pero luego tarda hasta 20 minutos. No es normal que viviendo en Madrid te tarde un bus 20 minutos. No echo culpas al conductor ,echo culpas a la EMT. Que nos tiene dejados completamente. Los que tenemos que coger este bus para ir al metro, o el tren no nos queda más remedio y es desesperante. Por favor poner un bus que pase cada 5-10 minutos y recorra el camino del Cruce de villaverde / renfe y los rosales. O bien que amplien la linea 123 y así, si no te viene uno, te viene otro.. Ya que los que vivimos en ese barrio estamos desesperados. </p>

<p> </p>
";"15/09/2015 09";"42";"39";"3";"2";"938435243";"3342"
"3831";"Contaminación acústica ";"<p>Me gustaría que se tomarán verdaderas acciones sobre las personas que no respetan a los demás en forma de ruido, es decir música alta, voces a cualquier hora del día o de la noche....</p>

<p>La policía no tiene la potestad suficiente para llegar y multar a este tipo de personas incivicas como hacen en otras provincias de España como por ejemplo Mojacar donde la multa solo por armar algo de jaleo en casa es de 600 euros.</p>

<p>Se tendría que establecer un clima de respeto entre los ciudadanos ya que considero que hay mucha dejadez en este sentido por parte del ayuntamiento.   </p>
";"15/09/2015 09";"290";"275";"15";"25";"946929269";"24655"
"3832";"Ampliar la Linea 11 de metro hasta Atocha Renfe";"<p>Solicitud para ampliar la linea 11 de metro desde Plaza Eliptica hasta Atocha Renfe por el Paseo de Santa Maria de la Cabeza siguiendo el recorrido del autobus E1 con el fin de vertebrar el sur de la ciudad. En un futuro incluso unir lineas 11 y 8 seria interesante plantearlo</p>
";"15/09/2015 09";"96";"84";"12";"9";"940356732";"6300"
"3833";"Abrir piscinas públicas los fines de semana";"<p>Creo que sería muy bueno el abrir las piscinas públicas los fines de semana, durante todo el año. En concreto, me refiero a la piscina del polideportivo Fernando Martín, en el distrito de Moncloa. Después de estar cerrada durante varios años, por arreglos sucesivos, está abierta al público, todos los días menos los sábados y domingos.</p>

<p>Mi propuesta va dirigida a que podamos hacer uso de la piscinas los fines de semana.</p>

<p>muchas gracias</p>
";"15/09/2015 09";"109";"93";"16";"2";"940116977";"6569"
"3834";"Santiago Bernabéu libre de coches.";"<p>El Santiago Bernabéu tiene en sus alrededores 8 líneas de autobuses de la EMT, una línea de metro y una de cercanías. Sin embargo cada vez que hay un evento deportivo en el Bernabéu, toda la zona se colapsa debido a la innumerable cantidad de seguidores que asisten a los eventos deportivos en su vehículo particular. Probablemente entre 20 y 30.000 vehículos intentan acceder y aparcar en los alrededores provocando el caos en la zona. Esto provoca contaminación ambiental, contaminación acústica, bloqueo del tráfico en la zona y la imposibilidad de que los residentes aparquen en su zona de residencia.</p>

<p>Potenciemos el transporte público. Propongo que se prohíba aparcar a los no residentes en los barrios anexos al Santiago Bernabéu durante la celebración de los eventos deportivos.</p>
";"15/09/2015 09";"91";"59";"32";"2";"933370263";"1750"
"3835";"Metro M-40";"<p>La inexistencia histórica en Madrid de infraestructura pública de transporte entre el sureste y el noreste, coloca a los ciudadanos que residen en el sur, en la disyuntiva de elegir entre utilizar el vehículo particular para desplazarse, empleando poco mas de 20 en trayectos entre Vallecas y Barajas  o emplear mas de 50 en transporte público.</p>

<p>La situación actual obliga a una gran mayoría a utilizar el vehículo privado y cada mañana la M-40, con dirección norte, amanece con frecuencia con tráfico intenso en el trayecto entre Villaverde y Hortaleza.</p>

<p>El uso del transporte público debe ser una opción atractiva para el ciudadano en precio, calidad y sobre todo <u>en tiempo</u>.</p>

<p>Una línea de metro entre Carabanchel y Hortaleza que discurra por la línea de la M-40 que recogiera los ciudadanos de Carabanchel, Villaverde, Vallecas, Vicálvaro, Coslada, San Blas, Barajas, Hortaleza, pudiera ser que motivara el uso de este medio para el desplazamiento en esa zona.</p>

<p>La propuesta es la construcción de línea de Metro (M-40) con estaciones en: CARABANCHEL, VILLAVERDE, VALLECAS, VICALVARO-MORATALAZ, COSLADA, SAN BLAS-CANILLEJAS, BARAJAS y HORTALEZA (JUAN CARLOS I). En aquellos emplazamientos que concentren una mayor población de vivienda, empresas, oficinas, administraciones públicas, etc.</p>

<p>Trayectos directos, a primera hora de la mañana (7:00-7:30), desde cada una de las estaciones con destino final HORTALEZA y también a última hora (16:00-17:00) con destino estación de procedencia. Sin paradas intermedias. Con un tiempo de trayecto reducido, inferior al empleado en vehículo particular. Sin preocuparse en buscar estacionamiento.</p>

<p>Trayectos con paradas en cada una de las estaciones de la línea para aquellos ciudadanos que opten por destinos intermedios u otras circunstancias.</p>

<p>El horario de funcionamiento de esta línea podría establecerse entre las 7:00 y las 18:00 de lunes a viernes (no festivos).</p>

<p>El funcionamiento de una línea de metro como la que se propone, reduciría notablemente la circulación en Madrid y por ende mejoraría la calidad del aire de nuestra ciudad y en definitiva nuestra salud en términos respiratorios y emocionales.</p>
";"15/09/2015 09";"159";"147";"12";"14";"943865749";"12481"
"3836";"Que los puntos limpios móviles recojan PCs y electrodomésticos algo más grandes";"<p>No digo que recojan neveras o lavadoras pero un ordenador personal no es algo tan grande y nos facilitaría la vida tirarlo en un punto limpio cercano. ¿qué se pretende si no?  ¿Qué me eche a la espalda la torre de mi ordenanor viejo y viaje 6Km hasta un punto limpio fijo? teniendo en cuenta que están siempre fatal comunicados y lejos de cualquier transporte público, la tarea se hace imposible. Luego se quejarán de que la gente tira pc's,  televisiones y otros lindos cacharritos a la calle.</p>

<p>Otra posibilidad, que ya he votado, es recuperar la la recogida de trastos viejos una vez al mes. Esa iniciativa, además de divertida, era utilísima para los vecinos. </p>

<p>https://decide.madrid.es/debates/2923</p>

<p>https://decide.madrid.es/debates/3175</p>

<p>Gracias por este espacio. </p>
";"15/09/2015 09";"340";"329";"11";"5";"948290166";"30771"
"3837";"Limpieza de asientos de los autobuses";"<p>Algunos asientos de los autobuses de la EMT están tan sucios, que tienen costras de mugre. Por favor limpien los autobuses porque da asquito sentarse algunas veces.</p>
";"15/09/2015 09";"159";"150";"9";"4";"944365078";"13301"
"3838";"Eliminar PELIGROSAS rejas metro";"<p>Me gustaría promover el que se eliminaran las peligrosísimas verjas del metro que están en las calles y aceras de Madrid y por las cuáles una infinidad de peatones, ciclistas y motoristas han tenido percances, muchos de ellos con consecuencias físicas y económicas.</p>

<p>Creo que se deberían sustituir por algo que no fuera peligroso (supongo que eliminarlas no será posible) ya que nos ponen e un peligro constante a todos los ciudadanos.</p>
";"15/09/2015 09";"31";"16";"15";"6";"925898803";"51"
"3839";"Deficiencias de movilidad en Distrito Telefónica (Las Tablas)";"<p>Buenas,</p>

<p>En la sede central de Telefónica, situada en Las Tablas, trabajan miles de trabajadores que se desplazan diariamente en transporte público o vehículo particular. Paso a detallar algunas deficiencias, algunas fácilmente solucionables, otras más costosas pero de gran valor:</p>

<p>- <strong>Cruce de peatones peligroso.</strong> En la calle Oeste de Distrito Telefónica, la situada entre el edificio Oeste 1 del complejo y los restaurantes Jazmín y Valverde, se producen continuamente situaciones de peligro debido al elevado tránsito de peatones entre las oficinas y los restaurantes y el descampado de aparcamientos situado al lado (este es otro tema aparte). Basta observar a cualquier hora del día, mucho más intensamente a primera hora y a la hora de la comida, decenas de peatones cruzando a la carrera para evitar ser atropellados, sin un paso de peatones que poder utilizar (los dos que hay están a muchos metros de distancia en ambas direcciones). Hace unos meses había un paso de peatones amarillo dibujado (creo que por unas obras que había) pero lo borraron y desapareció.</p>

<p><strong>Propuesta</strong>: pintar un paso de peatones donde estaba el anterior de la obra, señalizarlo correctamente, y quizá poner bandas reductoras de velocidad antes del paso de peatones.</p>

<p> </p>

<p>- <strong>Acceso ciclista y peatonal más adecuado desde el Anillo Verde Ciclista</strong>:  cada vez son más los trabajadores que usan la bicicleta para llegar al trabajo. En Las Tablas tenemos la suerte de que pasa justo al lado de Distrito Telefónica el Anillo Verde Ciclista, ofreciendo una excelente conexión con barrios cercanos como Sanchinarro, Montecarmelo y el resto de Madrid hacia el sur. El problema es que para llegar desde el Anillo Verde Ciclista hasta Telefónica, en el último tramo hay que cruzar el túnel por debajo de la M40. Ese túnel es altamente peligroso, tiene 3 carriles en cada sentido y una acera bastante estrecha (3 peatones en paralelo bastante apretados). Por ahí los coches van a una velocidad bastante elevada, y finalmente la rotonda de entrada es un cuello de botella bastante peligroso.</p>

<p><strong>Propuesta: </strong>eliminación de uno o dos de los 6 carriles para coches, consiguiendo así:</p>

<p>     - Reducción de velocidad de los vehículos a motor, reduciendo el riesgo de colisiones. Además nunca son necesarios los 6 carriles al completo, al haber cuello de botella en ambas rotondas (norte y sur)</p>

<p>     - Acera más ancha para poder caminar a pie más cómodamente (mucha gente transcurre por ahí yendo a comer a Las Tablas al mediodía)</p>

<p>     - Carril bici de subida y bajada conectando con el Anillo Verde Ciclista, salvando la peligrosidad bajo el túnel</p>

<p> </p>

<p>- <strong>Acceso ciclista y peatonal más adecuado desde el carril bici de Alcobendas: </strong>Desde la avenida del Monte Valdelatas de Alcobendas discurre un carril bici que se corta en seco unos metros antes de llegar a Distrito Telefónica. Es entonces cuando peatones y ciclistas que van caminando o en bici al trabajo, tienen que jugarse la vida para hacer esos últimos metros bajo el túnel de la carretera de Fuencarral, habiendo desvíos muy peligrosos donde los coches van rápido y hay poca visibilidad.</p>

<p>Vídeo del punto concreto: https://www.youtube.com/watch?v=TfMiC--W3Wg</p>

<p><strong>Propuesta</strong>: Continuación del carril hasta Distrito Telefónica.</p>

<p> </p>

<p> </p>

<p>Un saludo</p>
";"15/09/2015 10";"68";"59";"9";"4";"939111724";"4338"
"3840";"Accesibilidad";"<p>Creo que sería muy útil la instalación de accesos para discapacitados o gente con dificultad de movimientos en todas las salidas del metro. Sé que hay algunas que todavía no lo tienen como la boca de metro de Artilleros, en la linea 9.</p>
";"15/09/2015 10";"215";"210";"5";"6";"947109630";"20023"
"3842";"Acabar con la masificación de coches y gorrillas en Begoña por los hospitales.";"<ol>
	<li>Expongo: El barrio de Virgen de Begoña está situado entre dos hospitales,La Paz y Ramon y cajal. Están comunicados por metro begoña linea 10 en el mismo hospital de la paz y para ir a Ramon y Cajal solo es bajar una cuesta y aun así, este dispone de renfe.(además de las lineas de autobuses). </li>
	<li>El problema es que a pesar de todo, durante el día, es imposible si eres residente aparcar, que ya de por sí por las noches cuesta, pero como en casi todos los barrios de Madrid, y esto además genera una cantidad espectacular de los llamados Gorrillas que ya no solo se limitan a los aledaños de hospitales, si no que, como saben que la gente por los hospitales aparca en Begoña, suben al barrio y se instalan hasta aproximadamente las 3 de la tarde.</li>
	<li>Nunca he sido defensor de parquimetros,y Begoña está justo al otro lado de donde los hay,de la M30 que pasa por debajo del puente del mismo barrio, pero algo hay que hacer en pro de los residentes o como mínimo,que la policia acabe con el tema de los gorrillas ya que actualmnte la única que se ve es para ir con gruas del ayuntamiento a recoger coches mal estacionados y parece que solo importa hacer caja cuando hay un problema real. </li>
</ol>

<p>Saludos y gracias.</p>
";"15/09/2015 11";"301";"288";"13";"8";"948200493";"26312"
"3843";"SACAR LA PROSTITUCION DE LA CALLE MONTERA";"<p>Me gusta mucho pasear por el centro, pues bien, el otro dia una prostituta me ofrecio sus servicios delante de mi hijo de trece años de edad.me parece un poco fuerte que estas señoritas esten ofreciendo estos servicios en plena calle Montera a la vista y oidos de niños que pasean con sus padres.</p>

<p> </p>
";"15/09/2015 11";"111";"94";"17";"6";"940969884";"6520"
"3845";"Separar carriles bici de la calzada";"<p>Se deberia separar fisicamente los carriles bici de la calzada y de las aceras para evitar accidentes, mediante algún tipo de barrera (plastico o similar).</p>

<p>En la Puerta del Sol, el carril bici tiene sentido contrario al de los coches, lo que provoca que la gente cruce solo mirando a los coches sin darse cuenta de que vienen bici en el otro sentido.</p>

<p> </p>
";"15/09/2015 12";"252";"226";"26";"11";"945720675";"17936"
"3846";"Contra el olor a fritanga de bares y restaurantes. Cumplimiento normativa ¡Ya!";"<p>Llevo un año reclamando al Ayuntamiento de Madrid que resuelva un problema de olores generado por un restaurante que inclumple la normativa. Un año y medio es demasiado tiempo para que este local arregle sus irregularidades. Lo peor es la falta de respuesta por parte del Ayuntamiento y el que los ciudadanos nos resignemos a que ese tipo de problemas nunca se resuelvan. </p>

<p>Me consta que este problema lo sufren muchos ciudadanos en diferentes distritos de Madrid, la solución no es complicada: hacer cumplir la normativa existente. Es inadmisible que no se de respuesta, que la burocaracia sea tan lenta y que no se de una solución. </p>

<p>Por salud e higiene, tomen en serio este tipo de reclamaciones.</p>

<p> </p>
";"15/09/2015 12";"112";"102";"10";"3";"942972620";"8378"
"3847";"Zonas para que los perros puedan estar libres y pipi-can";"<p>Para que la <strong>convivencia con nuestros animales</strong> de compañía sea lo más cómoda posible me gustaría proponer que se habilitasen zonas donde poder soltarlos (<strong>parque para perros</strong>) y también zonas donde puedan hacer sus necesidades.</p>

<p>Según el espacio disponible en cada distrito, se podría habilitar una parte del parque para ""zona reservada perros"" o bien simplemente un pequeño pipi-can donde puedan hacer sus necesidades.</p>

<p>Tenemos un buen ejemplo en el Parque de Polvoranca, donde existe una zona cercada para que los perros estén libres.</p>

<p>En el caso de <strong>Aluche </strong>me gustaría que se <strong>reservara </strong>una <strong>zona grande para los perros</strong>, como podría ser al final del parque donde se encuentra una zona con árboles y una caseta de jardinería.</p>
";"15/09/2015 12";"178";"144";"34";"7";"941716108";"8898"
"3848";"Multar coches mal aparcados los días de Rastro";"<p>Los domingos, los alrededores de El Rastro se convierten en una ciudad sin ley con coches aparcados encima de la acera, en el carril bus, en pasos de peatones y en doble fila.</p>

<p>Al lugar llega un excelente transporte público que se debería utilizar en lugar de dejar el coche molestando.</p>
";"15/09/2015 12";"61";"49";"12";"1";"937797461";"2972"
"3849";"Mafias Recogida de papel";"<p>Si pagamos unos impuestos para que una empresa se encargue de reciclar el papel, ¿cómo es posible que unos cuantos camiones roben ese papel para un beneficio privado?</p>

<p>Es algo habitual ver por las calles de Madrid camiones destartalados recogiendo el papel que los ciudadanos queremos reciclar. </p>

<p>Cuando depositamos nuestro papel y cartón en los contenedores azules esperamos que sea llevado por los servicios municipales a un centro donde se reciclará correctamente ese material pero, si son otras personas las que retiran ese papel, rompiendo los contenedores, ¿dónde va a parar ese papel? ¿Quién se beneficia de ello? Y lo más importante, ¿se recicla?</p>

<p>Es inexplicable que haya decenas de estos camiones circulando por las calles de Madrid, muchas veces con personas en la caja de camión, cosa que es una infracción clara de los códigos de circulación,  y la policía municipal no haga nada. </p>

<p> </p>

<p>Si yo deposito papel en un contenedor azul es para que se recicle, no para que otros se lucren.</p>
";"15/09/2015 12";"448";"427";"21";"27";"950232412";"38696"
"3850";"Carril moto en la M30";"<p>Sería genial habilitar los arcenes de la M30 como carril moto, porque muchos motoristas ya lo usan y es una práctica mucho más segura que ir cambiando de carril, además fomentaría que más gente fuera en moto y reduciría los atascos y las emisiones.</p>
";"15/09/2015 12";"64";"35";"29";"5";"930076392";"328"
"3851";"Continuar paseo peatonal que acaba en Avenida de Arcentales (Central Electrica).";"Mi idea es que se intente construir la continuacion del paseo para caminantes en la Avenida de Arcentales, ya que el tramo donde esta la central electrica es peligroso ir por la acera, los coches van muy rapido, los niños montan en bici y puede ocurrir cualquier percance porque la acera no es muy ancha.";"15/09/2015 13";"24";"19";"5";"0";"934536506";"1108"
"3852";"Separados/divorciados con dos hijos porque no familia numerosa?";"<p>Actualmente las familias monoparentales que tienen a su cargo a dos hijos necesitarían de ayudas al igual que las familias numerosas que como tal son consideradas, sobretodo teniendo en cuenta que hoy en día un progenitor o progenitora viudo/a con dos hijos se encuentra dentro de esta consideración.</p>

<p> Por otra parte generalmente éste último tiene una pensión que recibe del Estado, en el caso de la separación o divorcio también suelen contar con una pensión del otro progenitor pero incluso en algunos casos ni se recibe por distintas causas.</p>

<p>Sería interesante poder contar con esta ayuda, que se les considere Familia Numerosa.</p>
";"15/09/2015 13";"63";"29";"34";"3";"922646978";"-230"
"3853";"Compartir propuestas por Facebook y Twitter.";"<p>Creo que fomentaría enormemente la participación el que tras apoyar una propuesta se te permitiera compartir el enlace para apoyarla por redes sociales, como sucede en plataformas como change.org</p>
";"15/09/2015 13";"35";"21";"14";"2";"931064530";"420"
"3854";"CENTROS PARA PERSONAS TERCERA EDAD";"<p>En Madrid, hay muchos edificios sin ningun tipo de actividad. Se podrian rehabilitar y hacer centros para personas de la tercera edad con escasos o bajos medios economicos. Se daria muy buen uso a los edficios y trabajo a personas en paro de larga duracion por ejemplo. En un viaje a Miami, me sorprendio mucho una urbanizacion de chalets que se quedo sin terminar, el estado local lo  rehabilito y se dio utilizacion  para personas mayores. El pago del  pensionista es del   70% de sus ingresos, mediante el cual se le da todos los ervicios y el resto de su pension para sus gastos. </p>

<p> </p>
";"15/09/2015 14";"174";"169";"5";"4";"947386487";"15928"
"3855";"tasa de basura en funcion del numero de personas que habitan el inmueble";"<p>No pagar por el numero de metros cuadrados de tu vivienda o de la zona donde vivas, sino de cuantas personas vivan en él.</p>

<p>Para redistribucion de la renta ya hay otros mecanismos.</p>
";"15/09/2015 14";"136";"112";"24";"11";"942024791";"7247"
"3856";"Más accesos a vehículos en Zona Centro";"<p>Bueno no me quiero extender mucho.. Yo antes iba mucho al centro con mi coche allá en el 2000 incluso antes..ahora ya desde que cerraron toda esa zona,arenal,puerta del sol,montera,,ya no voy,poruqe me gusta ir en coche disfrutando de las calles de Madrid. Creó que lo han cerrado demasiado..estaría bien que dejasen un poco más de circulación x esa zona con tu propio vehículo.que os parece madrileños? Soy de Mostoles de toda la vida,vecino de Iker Casillas </p>

<p> </p>
";"15/09/2015 14";"83";"13";"70";"3";"923057378";"-892"
"3857";"Un sistemas de contenedores de basura comunes o por comunidad de vecinos?";"<p>Que cada comunidad de vecinos tenga un contenedor propio que saca cada noche es muy poco eficiente. Hay comunidades que lo dejan fuera todo el día, obstaculizando las aceras (ya de por si estrechas) del centro. Otras comunidades no lo sacan (porque no tienen portero o no quieren/pueden pagar a alguien para esta tarea). Además, es terriblemente ineficiente para el servicio de recogida. Un contenedor por cada edificio hace que los camiones de la basura tarden muchisimo en volcar todos estos contenedores, haciendo un ruido insoportable a altas horas de la noche. </p>

<p>La ausensia de estos contenedores comunales, hace que mucha gente tire su basura en lso contenedores comunales de reciclaje, o la deje al lado. Esa basura acaba inpepinablemente esparcida por toda la calle)</p>

<p>Por otro lado, si hubiene contenedores comunales, los vecinos reciclarían más, ya que tienen que desplazarse con la basura hasta el contenedor, serían mas proclives a separar papel y envases y depositarlos en sus contenedores respectivos. </p>

<p>En fin, no veo ninguna ventaja a este sistema de basura por comunidad de vecinos. He vivido en muchas ciudades antes de venir a Madrid, (todas con sistema de recogida de contenedores compartidos), y esta cuidad es la más sucia y la que menos recicla de todas. Creo que deberíamos copiar el sistema a otras ciudades grandes. No hay más secreto. </p>
";"15/09/2015 14";"52";"38";"14";"3";"936142200";"1753"
"3858";"Dejar de ser cliente de Bankia";"<p>El Ayuntamiento de Madrid debería dejar de ser cliente de Bankia, así como de cualquier otra entidad que esté envuelta en procesos judiciales por delitos financieros, debe buscar una entidad bancaria que no solo esté limpia de corrupción si no que también no haya sido rescatada y, por tanto, financiada con dinero público. En caso de no haber ninguna entidad con estas características (que lo veo bastante complicado), por lo menos deberá de colaborar con la más ""limpia"".</p>

<p>La propuesta la lanzo porque tengo la convicción de que el Ayuntamiento debe ser el primero en mostrar una actitud beligerante contra la corrupción (sea de facto o presunta con muchos indicios) en cualquier escala, a cualquier nivel y dar a entender y dar ejemplo de que desde dicha institución se va a luchar siempre contra los delitos financieros, que no va a participar en ellos ni con cualquier entidad, empresa o persona que esté envuelta en procesos judiciales o que haya sido sentenciada por ello.</p>

<p>A día de hoy aún no se puede afirmar que Bankia sea una empresa limpia; aún sigue debiendo dinero público, no ha resarcido a las personas afectadas por las preferentes, sigue habiendo personas en sus filas de los tiempos de Rato y sigue pendiente de resolución judicial.</p>

<p>No con mi dinero. No con mi Ayuntamiento.</p>
";"15/09/2015 14";"261";"228";"33";"6";"945984737";"17034"
"3859";"Educación";"<p>Que el horario en Madrid capital y comunidad,para los colegios públicos y concertados sea continuó de ( 9 o 8;30 a 13:30 o 14:00),seria mucho mas beneficioso para los alumnos, como en el resto de los países europeos y en casi todas las comunidades autónomas de España,y empezase ya este año por decreto ley</p>
";"15/09/2015 14";"58";"32";"26";"2";"930519510";"331"
"3860";"Carril bici y patines en Madrid Río";"<p>Una medida necesaria en Madrid Río. Debería estar claro por donde deben circular las bicicletas y los patines y por donde los peatones, puesto que es peligroso en algunos momentos para los peatones el pasear por Madri Río</p>
";"15/09/2015 14";"134";"123";"11";"3";"944936366";"10280"
"3861";"Peatonalizar la Calle Fuencarral desde Calle Colón hasta la Glorieta de Bilbao";"<p>Asi de terminar de peatonalizar toda la calle Fuencarral.La aceras son bastantes estrechas y mucha gente caminando que te obligan ir caminando por la calzada.Y es bastante peligroso por la cantidad de vehículos y riesgo de atropello.</p>

<p>También en la entrada del Museo de Historia de Madrid.Trasladar hasta allí la fuente histórica que hay en la Calle Barceló.Que está totalmente escondida y ponerla en la la Calle Fuencarral.Para disfrute de los madrileños y turistas.</p>
";"15/09/2015 14";"79";"56";"23";"1";"936927100";"2339"
"3862";"POR LEY PODER EN LOS GARAJES APARCAR 1 COCHE+ 1 MOTO SI NO SE MOLESTA AL VECINO ";"<p>En varias comunidades no está aprobado la posibilidad de poder aparcar habiendo espacio suficiente un coche + una moto. Ahora mismo por no incurrir en ninguna batalla vecinal, y por el miedo de que el seguro NO cubre en caso de incendio a los propietarios de los vehiculos si hay más vehiculos en el garaje que plazas algunas personas como soy yo, no dan el paso de poder comprar una motocicleta pudiendo dejar el coche en casa. La idea es que por ley se establezca ( sin que la Comunidad de Vecinos decidan) en algunas comunidades ya está establecido y por tanto no hay nada que hacer, o las promotoras se cubren en salud y construyen solo 2 plazas para moto en una comunidad con la idea de sacar dinero, la posibilidad de aparcar siempre respetando los límites de tu parcela y sin molestar al vecino de la plaza de al lado una motocicleta y vehículo o en su defecto hasta máximo 3 motociletas si no hubiera coche. </p>

<p>gracias </p>

<p> </p>

<p>saludos</p>
";"15/09/2015 14";"70";"39";"31";"5";"931535849";"445"
"3863";"Peatonalizar las Calles Hortaleza y Barquillo";"<p>Hacerlas igual que las Calles Fuencarral y Montera.Muchos peatones.Aceras bastantes estrechas.Peatones que tienen que ir por la calzada con riesgo de atropello.Por no poder caminar con tanta gente.</p>
";"15/09/2015 14";"108";"88";"20";"0";"941093185";"5540"
"3864";"Peatonalizar la cuesta de la Vega y la calle Mayor a la altura de la Almudena";"<p>Asi unirlos con Madrid Rio,El Campo del Moro y el futuro Museo de las Colecciones Reales.Ir caminando tranquilamente andando y o en bicicleta,sin coches aparcados invadiendo las aceras ni gorillas.</p>
";"15/09/2015 15";"60";"42";"18";"1";"935954991";"1679"
"3865";"Punto limpio de comida";"<p>Apertura de espacios con una politica de responsabilidad e inmediatez hacia el medio ambiente, la comunidad, los derechos sociales y la igualgad estan en juego cuando una alimentación no adecuada crea mas enfermedades y dotan a los pueblos de mas miseria. Mediante este debate queremos generar un espacio en donde propongamos mas que -ideas soluciones a todos y cada uno de los elementos que en materia comida se toman como ""desperdicios"" y que por fecha de caducidad o calidad visual se tiran a un contenedor.</p>
";"15/09/2015 15";"65";"59";"6";"1";"942042493";"4810"
"3866";"Autobuses Express , o Lineas Express EMT";"<p>Creo que estaria bien que hubiese mas lineas express de la EMT, o que hubiese autobuses en cada linea que fueran express, que no parasen en todas las paradas, solo en aquellas que baja y sube mucha gente. Tendria que ser en lineas en las que el express aportase una ventaja de tiempo claro para una mayoria de usuarios. Los autobuses de por ejemplo, la linea 27 tendrian autobuses  ""normales"" que  pararian en todas las paradas, y los ""express"" solo en algunas.</p>

<p>A muchos nos gusta el autobus, pero nos desanima el tiempo que se pierde al hacer tantas paradas. Hay lineas en el que el 70% de la gente sube y baja en unas pocas paradas. Esas lineas son las que propongo que tengan autobuses Express, o que se haga una linea Express aparte.</p>

<p>Por ejemplo que no tiene por que ser real: un autobus de la linea 27 que fuese express, pararia unicamente en plaza castilla, , nuevos ministerios, colon, cibeles, atocha.</p>

<p>O por ejemplo, un autobus 135 Express que fuese directo de plaza castilla al hospital la paz y al hospital Ramon y Cajal.</p>

<p>Creo que esto disminuiria el tiempo de viaje en autobus</p>
";"15/09/2015 15";"77";"74";"3";"1";"944179372";"6823"
"3867";"Que Metro de Madrid vuelva a ser el Transporte Público que Madrid demanda";"¿Considera que el servicio que presta hoy en día, Metro de Madrid, es el que que teníamos años atrás y el que nos merecemos los madrileños?

<p>La falta de personal actual está suponiendo:</p>

<ul>
	<li>La reducción del número de trenes que provoca largas esperas en los andenes.</li>
	<li>Estaciones sin personal hacen imposible la atención al viajero.</li>
	<li>Escaleras mecánicas y ascensores fuera de servicio.</li>
	<li>Máquinas expendedoras de billetes y torniquetes averiados.</li>
	<li>Incremento de averías de trenes.</li>
	<li>Acumulación de suciedad en las instalaciones</li>
</ul>

<p>Por todo esto, reclamamos la incorporación inmediata de nuev@s trabajador@s para dar solución a este problema, manteniendo la plantilla necesaria para prestar un servicio con la calidad, seguridad y rapidez que debe prestar.</p>
";"15/09/2015 15";"473";"462";"11";"34";"952565385";"44051"
"3868";"Todas las estaciones de Metro funcionando hasta finalización del servicio";"<p>No sé en cuántas estaciones sucede algo similar (supongo que en todas), pero me he encontrado desde hace ya más de dos años que a partir de las 1:30h, en las estaciones de Línea 7 de la periferia, las escaleras mecánicas dejan de funcionar. Teniendo en cuenta que el último tren de ambas cabeceras sale a esa hora, y que el recorrido de la línea extremo a extremo es aproximadamente 1 hora, existe gente en el interior del Metro con posibilidad de necesitar salir del suburbano hasta aprox. las 2:30h, quizá más en otras líneas. Hora en la que entiendo alguien debe cerrar las puertas del Metro, y por tanto debería haber al menos un miembro de personal de Metro en cada estación.</p>

<p>Interpuse reclamación y la contestación fue que ""la parada de las instalaciones se produce a las 1h 30m aproximadamente, coincidiendo con el horario de finalización del servicio -(completamente falso)- y de la jornada de nuestros agentes"".</p>

<p>¿Cómo es posible que el servicio del personal termine cuando aún prestan servicio?</p>

<p>El número de escaleras que hay que subir en mi estación para llegar a la calle (estación sin ascensor) es el equivalente a subir un sexto piso, esfuerzo que una persona mayor puede que no sea capaz de realizar.</p>

<p>Súmese este debate a uno más de los interminables problemas que tiene Metro de Madrid en los últimos cuatro años, todos asociados a los recortes de personal que no se corresponden con las subidas de precio que hemos visto en los últimos años y que han supuesto una merma tras otra del servicio.</p>

<p>Hablo de estaciones del interior de Zona A, por lo que entiendo que, aunque el Consorcio depende de la Comunidad de Madrid y de la señora Cifuentes, el Ayuntamiento de Madrid podrá decir bastante al respecto.</p>
";"15/09/2015 15";"98";"89";"9";"4";"943992262";"7265"
"3869";"Se hace";" 

<p>Si la propuesta es aceptada mayoritariamente, el Ayuntamiento la asume como propia y se hace. (este fragmento lo he sacado de la web)</p>

<p>Pero la pregunta es: ¿cuantos vostos son necesairos para que la propuesta se lleve a cabo?</p>

<p>o en su defecto, que mecanismo se activara para aprobar una propuesta ?????</p>
";"15/09/2015 16";"14";"9";"5";"1";"930804437";"257"
"3870";"DGT y multas de tráfico: ¿ conducción segura o abuso recaudatorio ?";"<p>Inicio este debate porque creo que es un tema muy importante, que nos afecta a todos y está muy mal organizado. Personalmente creo que por las medidas que se toman es un claro abuso recaudatorio.</p>

<p>- 1: Los límites de velocidad: ¿quién no ha ido alguna vez a más de 120 Km/h (no mucho más pero sí algo más) por una autovía, o a más velocidad de la permitida por una vía de servicio o cosas similares? Creo que estos límites son poco adecuados en muchas ocasiones. Me planteo en primer lugar que si realmente se buscara una conducción segura, los coches podrían salir de fábrica limitados (que yo sepa en todos los coches, en el panel de velocidad marca mucho más de 120 km/h), pero es más fácil ir a por el débil que a por grandes compañías, y sobretodo da mucho más dinero. En segundo lugar, a alguien con mucho dinero, 120  o el pago de un curso de recuperación de puntos no le supone prácticamente ningún esfuerzo, de modo que puede infringir cuando le venga en gana. Esto no es seguridad. Sin embargo en el caso contrario, (y esto lo extiendo a otro tipo de infracciones como las de aparcamiento) ¿qué pasa con alguien que cobre 600  (muchos hoy en día y algunos ni eso) que tenga que pagar su casa, que tenga hijos? Una multa de 120  le puede arruinar por completo.</p>

<p>Aquí ya dejo dos propuestas: La primera es que con la tecnología que poseemos los coches pueden ser mucho más seguros, y no que esta seguridad dependa del conductor. La segunda, es que las multas vayan en función de la renta de cada uno.</p>

<p>Aquí dejo otra reflexión: No entiendo que me puedan multar aludiendo a mi seguridad por no llevar casco en bici, y sin embargo ahora que son fiestas en muchos municipios, me coloquen un toro en mitad de la calle, por donde corretean por ejemplo muchos niños  y algún que otro adulto con una tasa de alcoholemia digamos alta. Eso lo permiten alegando el festejo y la tradición. Tampoco entiendo como para ser cualquier profesional cualificado exigen estudios superiores, y para ser el encargado de sancionar a la gente, de llevar pistola, porra y usarla en caso necesariono se exigen estudios muy superiores, pero este es otro debate que animo a abrir.</p>

<p>- 2 : Los controles de alcoholemia y drogas: Con el sistema que se ha impuesto recientemente, alguien que le haya dado una calada a un porro dos días atrás, es sancionado y tachado como delincuente inconsciente asesino. Sin embargo en este tipo de controles podría ir al volante perfectamente una persona que tenga por ejemplo problemas de visión serios, o movilidad reducida, o que consuma algún medicamento (que no droga), que tenga serios efectos. Si se buscan las condiciones óptimas para circular, hay muchos más factores que las drogas o el alcohol que las pueden alterar. Creo que es una invasión a la intimidad tremenda, una caza de brujas, y que en este sentido era mucho más eficaz aquello de : camine usted en línea recta. Es decir, si lo que se busca es que el conductor esté en condiciones de conducir, seguro que se pueden realizar psicotécnicos mucho más eficaces, y que realmente excluyan de la circulación a aquellos que por ejemplo no tienen los reflejos necesarios, ya sea por haberse fumado un porro, o porque llevan sín dormir 24 horas, o por que desgraciadamente tienen una enfermedad que les afecta a la visión. Nuevamente asistimos a que es más fácil y beneficioso económicamente ir a por el tachado socialmente (canalla drogadicto) que mejorar realmente la seguridad en la circulación.</p>

<p>Son temas serios puesto que hay muchas víctimas, y la frivolización viene por parte de la DGT con sus campañas. Solo hay que ver los psicotécnicos que nos realizan para sacarnos el carnet, y las veces que los repiten a lo largo de nuestras vidas. O como las aseguradoras no nos piden ninguna referencia a si somos consumidores de algo, o tenemos alguna enfermedad, a la hora de cobrar, pero ponen todo tipo de pegas e investigaciones a la hora de cubrir daños.</p>

<p>Creo que hay que mejorar todo esto, de un modo real, y que los conductores dejemos de ser meros pagadores para que más de uno se forre, mientras por ejemplo el estado de las carreteras sigue siendo penoso en muchos tramos.</p>
";"15/09/2015 16";"40";"27";"13";"3";"934805151";"945"
"3871";"Urinarios públicos gratuitos en las calles más concurridas por el ocio nocturno";"<p>Considero que sería muy interesante la instalación de urinarios públicos y gratuitos, para evitar que la gente usara cualquier hueco o lugar (estilo a los que se encuentran en muchas ciudades europeas).</p>

<p>No es nada agradable pasear por una calle que apesta, al igual que no lo es buscar un local abierto en el que no se cobre entrada para poder utilizar el baño.</p>

<p>Creo que sería una buena forma de atajar ambos problemas.</p>
";"15/09/2015 16";"294";"261";"33";"8";"947964225";"20240"
"3872";"Wifi en barrios desfavorecidos de Madrid";"<p>Crear una red de puntos Wifi Hot Spot del ayuntamiento gratuitos para acceso a Internet, con cobertura en los barrios más desfavorecidos, para favorecer la educación digital de esas zonas.</p>

<p> </p>
";"15/09/2015 16";"108";"72";"36";"2";"937487275";"2400"
"3873";"Arreglar el suelo del paseo de Madrid Río ";"<p>Desde el Puente de Toledo hasta el Puente de Segovia el suelo está muy deteriorado, con baches en todo su recorrido que son peligrosos para la práctica de deportes como correr o patinar. También la iluminación nocturna en algunos puntos habría que revisarla, porque los árboles tapan las farolas</p>
";"15/09/2015 17";"63";"59";"4";"3";"943620405";"5150"
"3874";"Canal Isabel II";"<p>La empresa de distribución y abastecimiento de agua de Madrid, también se encarga del alcantarillado. Todos somo testigos que las alcantarillas están obstruidas con basura, hojas, papeles y algunas han sido cubiertas con asfalto. He trabajado en la central telefónica de atención al cliente y resulta que las alcantarillas son limpiadas solo por llamadas telefónicas de los vecinos. Esto no es ni justo ni eficiente. El Ayuntamiento debe obligar a que Canal Isabel II las mantenga limpias y si no lo hace MULTA, señores que necesitamos fondos para pagar la deuda de Gallardón.</p>
";"15/09/2015 17";"184";"181";"3";"3";"949513583";"17509"
"3875";"Uso de nuevas tecnologías para agilizar denuncias ciudadanas.";"<p>Sería una buenisima iniciativa que un ciudadano corriente pudiera grabar o fotografiar una situación ilegal y tuviera un medio rápido (¿una web o dirección de correo?) para aportar dicha prueba y que la policía decida posteriormente si el hecho merece ser denunciado y sancionado.</p>

<p>A diario me encuentro con situaciones que están prohibidas por ley, situaciones que generan riesgo y entorpecen el día a día del ciudadano normal. Calles enteras con coches en doble fila donde el dueño tiene un aparcamiento a escasos metros, pero prefiere entorpecer un carril que en algunos casos es el único obligando al resto de coches a invadir la calzada contraria. Gente que te hace ""la pirula"" por ir hablando con el móvil. O los que no respetan la velocidad ni la distancia de seguridad. Todos ellos dificiles de denunciar por la falta de rapidez del agente municipal requerido para tal efecto, además en estos casos normalmente el infractor se suele encarar con quien haga falta si les recriminas. Del mismo modo otras acciones prohibidas y molestas, aunque no sean tan peligrosas, como la publicidad en los parabrisas, que contribuye a que el suelo se llene de papeles. Gente abandonando la caca de sus perros. El trapicheo con drogas en la calle. Conductas violentas. Etc.</p>

<p>Todo esto en pleno siglo XXI en el que todo el mundo lleva un móvil con cámara de fotos y vídeo puede ser solucionado en gran medida si se trabaja para que esta tecnología esté a favor de la seguridad.</p>

<p>Actualmente prima por encima de la seguridad la ley de protección de datos. Es muy complicado, salvo que seas policía, utilizar una imagen para denunciar un comportamiento delictivo o peligroso. En mi caso llevo una cámara en el casco de la moto y todos los días grabo dos o tres momentos de peligro en mi trayecto de 15 minutos al trabajo. Esos momentos de peligro ocurren en su mayoría por conductas como las que he descrito mas arriba, dificiles de denunciar y por tanto casi imposibles de erradicar. Sé que no puedo publicar esas imágenes por mostrar caras y matrículas de personas que no han dado su autorización para ser grabadas, pero en algunos casos el peligro es tan grande y la reacción de quien lo provoca tan agresiva que me dan ganas de ir con la cámara a una comisaría.</p>
";"15/09/2015 18";"135";"126";"9";"12";"946912794";"10920"
"3876";"Conceder el abono tercera edad de transportes en función de la renta";"<p>El abono de la tercera edad, del cual estoy a favor, creo que no debería ser para todo el mundo, sino para aquellos mayores que tengan baja renta. ¿Por qué deberíamos financiar entre todos a un pensionista que cobre 2.500 euros? </p>

<p>No estoy seguro si esto sea compentencia de la Comunidad de Madrid, pero tal vez el Ayuntamiento tambien forme parte del consorcio de transportes y tenga voz.</p>
";"15/09/2015 18";"146";"117";"29";"16";"943419724";"7052"
"3877";"Plazas de aparcamiento de Embajadas y Consulados";"<p>En Madrid hay restricciones al tráfico y al aparcamiento para la mayoría de los ciudadanos pero hay algún que otro colectivo libre no sólo de impuestos sino también de limitaciones. En concreto las Embajadas y Consulados. Pagan al precio de mercado por las plazas que tienen reservadas en las calles de Madrid? Mi petición es que si no lo hacen, que lo hagan. Suman muchas plazas y no veo la necesidad de ese supuesto privilegio.</p>
";"15/09/2015 18";"46";"43";"3";"0";"942730365";"3739"
"3878";"Transporte público para desempleados";"<p>El Consorcio de Transportes de Madrid tiene múltiples acuerdos con empresas, entidades, colectivos de mayores, jóvenes...etc. pero creo que han olvidado uno muy importante: los desempleados. No sería razonable establecer una tarifa especial para este colectivo?</p>

<p>Este colectivo requiere movilidad para una búsqueda activa, mantenimiento de contactos (llamado ahora networking) y tiene las limitaciones económicas que son propias de su estado.</p>

<p>Me parece más que razonable que tenga las mismas condiciones que un joven o un mayor.</p>
";"15/09/2015 18";"143";"129";"14";"5";"946445694";"10374"
"3879";"Madrid sin ruidos";"<p>Tomar medidas para que se respeten los límites de contaminación acústica de cualquier medio emisor (bares de copas, restaurantes, terrazas, etc., incidiendo especialmente en vehículos a motor (no eléctricos) y MOTOS).</p>

<p>Hay zonas (Sinesio Delgado en paralelo con calle Ribadavia) donde, sobre todo las motos, rugen como si estuvieran compitiendo en el Jarama. Los vecinos de toda la calle lo sufrimos.Y supongo que es habitual en muchas calles de Madrid.</p>

<p>Las medidas deben ser ejemplares con los reincidentes.</p>
";"15/09/2015 18";"234";"221";"13";"7";"949750786";"19644"
"3880";"¿Queremos soplahojas?";"<p>Los soplahojas son maquinas muy agresivas pra el operario. Son ruidosas, usan combustible contaminante, son pesadas, vibran... Los soplahojas son my molestos para los vecinos, hacen ruido, huelen mal... Los soplahojas remueven la suciedad de un sitio para otro y sólo una parte es finalmente recogida... ¿Queremos soplahojas?</p>
";"15/09/2015 18";"88";"68";"20";"8";"941006581";"3709"
"3881";"HAGAN ALGO POR LOS INVERSORES DE NUEVA RUMASA ";"<p>Hola, soy inversor de nueva rumasa y la verdad estoy totalmente enfadado tanto con la justicia que con ustedes, como es posible que permitan que pasados ya casi 5 años la justicia, el gobierno no haga nada respecto a los afectados , ¿ por que no tocais a los hijos de los ruiz mateos?, ¿ por que siguen viviendo en sus casas de lujo y van sus hijos a colegios privados?, ¿ por que permite el gobierno de madrid que esten dados de alta como autonomos para asesorar empresas sabiendo que tienen todo embargado?, ¿ de que sirve que tengan todo embargado si pueden trabajar, ir en yate, irse de vacaciones y con que dinero? con el de los inversores? on lo que ellos ganan? por que no le meteis mano de una vez y que cobremos algo? , no hemos cobrado ni un centimo despues de 5 años , ? como es posible que se permitan que desahucien a personas por no poder pagar una hipoteca y a esta familia nadie le desahucia teniendo todo embargado ? ellos no creo que coman del espiritu santo , tienen dinero, por que permitis que la justicia de la audiencia nacional lleve este caso paralizado?, el banco santander, el banco etchebarria, el banco de españa, hacienda, sabia que los ruiz mateos no pagaban impuestos, que se les cerro el grifo  a los creditos  y por eso fureron a los pagares, ? por que se quedaron callados y no avisaron nadie de que estaban emitiendo pagares por que el banco santander o banesto les habia cerrado los creditos?, esto se a sabido despues de la estafa no antes, no sirve que la cnmv avisabe que es arriesgado invertir , ya se que es arriesgado invertir como lo es con la bolsa u otras cosas pero no dijeron el por que, por ejemplo la emisora de pocoyo antes de entrar en concurso de acreedores emitieron unos pagares similares a los de nueva rumasa , cual ue el aviso de la cnmv?, que no iban a poder pagar os intereses, por que deben a corto plazo mas de 6 millones de euros etc...y sabeis cuantas personas invirtieron? NINGUNA, por eso solicitaron el preconcurso y luego el concurso, ¿ por que con los pagares de nueva rumasa no se explico de la igual manera ademas sabiendolo con mas de 2 años que no pagaban...?, ustedes ayuntamiento de madrid, ustedes los que mandais en madrid, hagan algo, no permitais que la justicia indirectamente este dando favor a los ruiz mateos , ya al padre no por que a fallecido, pero los hijos, echarles de sus casas, fuera coches de lujo, viajes etc..., que estamos hablando de personas afectadas , mas de 10 personas en estos años se han suicidado por que no ve esperanza en esto, la audiencia nacional, los hijos de ruiz mateos, los negocios de los ruiz mateos, todo esto esta en la ciudad de madrid,. VASTA YA DE PROTEGER A LOS LADRONES Y AYUDEN A LOS PERJUDICADOS DE NUEVA RUMASA QUE EN 5 AÑOS NO HEMOS COBRADO NADIE NI 1 CENTIMO SABEN LO QUE ES, NI 1 CENTIMO DE LOS MAS DE 350 MILLONES DE LOS INVERSORES Y DE CASI 5.000 AFECTADOS, EN MI CASO 60.000, Y SIENDO EL MAS JOVEN INVERSOR CON 23 AÑOS HACE 5 AÑOS AHORA 28, MUCHOS ERAN MAYORES Y ESTAN MURIENDO Y OTROS HAN ENTRADO EN UNA DEPRESION PROFUNDA Y NO HAN PODIDO CON ESE DOLOR POR QUE SOMOS INVERORES PARTICULARES NO GRANDES FORTUNAS COMO LOS BANCOS CITADOS. HANAN ALGO YA POR DIOS.</p>
";"15/09/2015 19";"50";"7";"43";"10";"925318307";"-504"
"3882";"Plan contra la publicidad en los limpiaparabrisas ";"<p>Que se realiza un plan para aplicar la ley qque prohibe dejar folletos de publicidad en los parabrisas de los coches. Al cabo de un par de días dejan los parabrisas llenos de folletos, y eso ya es ilegal. Nadie hace nada. Entre los compro oro, la prostitución y los compro tu coche cada semana hay que sacar cerca de una veintena de folletos del coche. ¿Y los residuos que generan?</p>

<p>Que se cree una norma municipal que considere esta actividad un delito contra el medio ambiente. Que equivalga a tirar residuos incontroladamente</p>

<p>Que se investigue la publicidad de prostitución que tanto se deja en los parabrisas para localizar mafias y actividades de tráfico de personas.</p>
";"15/09/2015 19";"205";"191";"14";"7";"949018359";"16491"
"3883";"Qué opináis vosotros sobre los Autobuses de donación de sangre de la Cruz Roja?";"<p>Según tengo entendido, Comunidad de Madrid y la Cruz Roja firmaron un convenio para dividirse las tareas en materia de donación de sangre. Cruz Roja  se queda, con todos los vehículos de donación de la Comunidad de Madrid y por cada bolsa de sangre que coge Cruz Roja y va al Centro de Transfusión, la Comunidad le paga 67 euros.</p>

<p>¿Qué os parece la medida?</p>

<p>¿Tiene el Ayuntamiento alguna competencia o poder para realizar una contramedida?</p>

<p>Información obtenida de: http://www.elmundo.es/madrid/2014/02/07/52f546e7268e3ece408b4585.html</p>
";"15/09/2015 19";"36";"24";"12";"12";"936145851";"800"
"3884";"Descentralización de Madrid, reorganización de distritos por actividades";"<p>Quizá sea algo novedosa esta idea, y no sé si actualmente hay ejemplos de grandes ciudades que la apliquen, ni siquiera sé si sería viable. Pero consistiría en repartir las actividades entre todos los distritos de Madrid, de manera que no se concentre casi todo en el centro de Madrid. Cada distrito podria estar especializado en un ambito, bien economico, bien cultural. Por ejemplo se podría proponer Carabanchel como distrito destinado al arte o pintura, promoviendo actividades y cursos relacionados con ello, y creando centros de información acerca de ello, lo mismo se podría hacer con otros ambitos como el deporte, la musica, e incluso ciertos sectores economicos, como pudieran ser la artesania o antiguos oficios, por sugerir algo. Esto tambien puede favorecer (entre otras cosas) que el turismo se extienda más allá de la  almendra central y tambien la generación de nuevos empleos o empresas. ¿Qué os parece la idea? ¿Viable? ¿Sugerencias? Un saludo.</p>
";"15/09/2015 19";"26";"13";"13";"0";"928204610";"0"
"3885";"Trabajo para los parados madrileños ";"<p>Se puede crear empleo que genere derechos a los vecinos para poder vivir, el ayutamiento puede hacer mucho apoya esta propuesta    https://decide.madrid.es/Proposals/240 estoy dispuesto a defenderla y desarrollarlas en donde quiera la alcaldesa JHV</p>
";"15/09/2015 20";"88";"82";"6";"1";"946122423";"7081"
"3886";"Desprivatización de las Residencias de la Tercera Edad en Madrid";"<p>Las Residencias de Gestión privada de la Comunidad de Madrid son caras y tienen una atención muy poco eficiente por tener poco personal, lo que perjudica a los residentes. Mi experiencia con una Residencia de día gestionada por el Ayuntamiento de Madrid fue maravillosa. Creo que todos tenemos derecho a tener una atención digna cuando ya no podemos valernos por nosotros mismos y mi experiencia me ha demostrado que eso lo da una atención pública. </p>

<p>Pido al Ayuntamiento que presione a la Comunidad de Madrid para desprivatizar este servicio que TIENE que ser público.</p>
";"15/09/2015 21";"256";"231";"25";"3";"949735463";"18588"
"3887";"Ascensores en el Viaducto";"<p>Instalación de ascensores en el Viaducto adosados a los pilares, que comuniquen la calle Bailén con la calle Segovia y proporcionen un acceso desde el centro histórico a la zona del río. Así se contemplaba en los proyectos de los años 30. Además de ser un elemento de cohesión urbana podrían convertirse en un nuevo atractivo para la ciudad.</p>
";"15/09/2015 21";"38";"24";"14";"2";"935306022";"631"
"3888";"Residencia para enfermos de Alzheimer temprano ";"<p>El Ayuntamiento ya tiene una Residencia de día de Alzheimer temprano (Dr. Salgado Alba) que es excepcional, pero Madrid no cuenta con una Residencia de Alzheimer temprano en las que  enfermos puedan vivir, ya que muchas familias no puede ocuparse de estas personas. Ahora estos enfermos tienen que ingresar en una Residencia de la tercera edad que les produce un estado depresivo.  </p>

<p>Solicito que el Ayuntamiento de Madrid abra una Residencia para enfermos de Alzheimer temprano.</p>
";"15/09/2015 21";"114";"111";"3";"1";"948759526";"10515"
"3889";"Contenedores para reciclar ropa en el centro de Madrid";"<p>Creo que faltan contenedores de reciclaje de ropa (por supuesto: contenedores ""oficiales"") en el centro de Madrid. Sé que se pueden reciclar zapatos y ropa en los puntos limpios fijos y móviles pero parece que mucha gente o bien no lo sabe o bien no se puede acercar a dejar la ropa y los zapatos allí (por horario o distancia). A diario veo ropa tirada en la calle, encima de los contenedores de reciclaje de papel y eso en el ""mejor"" de los casos. Con frecuencia es ropa a la que se le podría dar un segundo uso o al menos aprovechar el material.</p>
";"15/09/2015 21";"97";"87";"10";"4";"945928790";"6906"
"3890";"Acceso a servicio y tratamiento psicológico eficaz";"<p>Queda abierta la propuesta para proponer un servicio y tratamiento psicológico eficaz.</p>

<p>https://decide.madrid.es/proposals/178</p>

<p>El tratamiento psicológico es muy importante y se ha dejado de lado en ésta época, queda más que registrado que con el aumento de paro, la mala situación económica, sumados a casos que podrían tratarse antes de que deriven en trastornos más graves, los cuales pueden derivar en enfermedades más costosas; ante el aumento de los trastornos de ansiedad, depresión y otros trastornos relacionados con el tema de la salud mental, cabe decir que hay que reforzar los servicios de psicología y psiquiatría, los cuales debieran ser eficaces y esperanzadores.</p>

<p>Las familias y personas con pocos recursos tienen que acudir a entidades como psicólogos sin fronteras u otros. Los jóvenes que están sometidos al paro, tienen que hacer cara a una situación muy dura al verse en la situación de llegar a la vida adulta en un ambiente que es poco favorecedor y poco esperanzador. El aumento del miedo a perder el trabajo y las condiciones precarias a generar estrés y la correspondiente hormona cortisol, que lleva a los trastornos de ansiedad crónicos, los cuales llevan a otros trastornos a su vez.</p>

<p> </p>

<p>Para un buen tratamiento y una buena terapia, se necesita un seguimiento bastante continuado con no sólo un día al mes o cada dos meses como ocurre en los centros de salud de la seguridad social, la cual se reduce a un drástico trato superficial de corta duración.</p>

<p>Existe un estigma relacionado con la salud mental que hay que dejar atrás y que no se trata en nuestro país, el cual como podemos poner ejemplo la página estadounidense UROK, en la que se conciencia a la población de recibir y atreverse a pedir un tratamiento relacionado con las conexiones neuronales relacionadas con la serotonina, la cual puede ser un factor genético o fisiológico. No sólo hay un estigma, sino que procesos en los que la ansiedad y gestión de las emociones son clave, prevalecen los pensamientos o la forma de pensar tradicional en la que se piensa que los psicólogos o psiquiatras no ayudan y es muy común que en la población se piense que una depresión se cura con voluntad o actitud, cuando la realidad es que se cura con tratamiento.</p>
";"15/09/2015 21";"81";"73";"8";"1";"945366539";"5858"
"3891";"Recuperar la acera para los peatones";"<p>Proliferación de terrazas en lugares inverosímiles que hacen incómodo el paso. Y sobre todo la circulación de bicicletas por la acera han hecho insegura el transitar por las mismas.</p>
";"15/09/2015 21";"155";"138";"17";"9";"947673463";"10772"
"3892";"Ascensor en metro de Manuel Becerra";"<p>En la zona de Manuel Becerra viven muchas personas ancianas y familias con niños pequeños que les cuesta mucho coger el metro en la parada de Manuel Becerra por los tramos de escaleras que existen.</p>

<p>Es necesario que una parada como esta, que tiene un transbordo entre la línea 6 (con gran afluencia de pasajeros) y la línea 2 (que lleva al centro) se instale un ascensor desde la calle hasta los andenes de ambas lineas.</p>

<p>Mejoraría  mucho el acceso con carritos de bebe y personas con dificultades de movilidad ya que existen varios tramos de escaleras para acceder a los tornos de las estación y varios mas para acceder a los andenes.</p>

<p>Un saludo.</p>
";"15/09/2015 21";"47";"45";"2";"1";"944753686";"4117"
"3893";"Cerrar al tráfico la castellana los domingos";"<p>Cerrar la castellana a los coches nos permitiría descubrir la ciudad, transportarnos y promocionar el uso de la bicicleta.</p>

<p>Esto se realiza en arias ciudades, como México Df donde se cierra todo el centro y el último domingo de cada mes el equivalente a la m/30 lo que permite realizar un paseo de 40 km por la ciudad.</p>
";"15/09/2015 22";"123";"69";"54";"1";"935825007";"841"
"3894";"Formación en Habilidades Sociales,es necesario para la ciudadanía participativa?";"<p>Mi experiencia como Educadora Social y Formadora es, que son imprescindibles para cuaquier interacción humana y depende de ellas la calidad de los resultados y de la satisfacción con el proceso.                                                                                                               La comunicación verbal y no verbal, la escucha, la empatía y la asertividad, son vitales para que una persona se pueda desarrollar y en consecuencia los sistemas en los que está: familia, colegio, trabajo, colectivos, barrio, localidad, ciudad, pais...</p>

<p>He pasado por muchas aulas de diferentes edades y distritos, he trabajado con adultos, con personas mayores y he podido observar que nos queda bastante que mejorar en cuanto a comunicación, trabajo en equipo, solución de conflictos, toma de decisiones... También he podido observar que éstas habilidades se pueden practicar y que las personas disfrutan mientras que las aprenden.</p>

<p>Creo que en los dispositivos municipales (centros cívicos, culturales, de mayores, jóvenes, deportivos, empresariales y en la medida en que se pueda en CEIP e IES) pueden dedicar parte del poco presupuesto en formación, a contenidos de Habilidades Sociales.</p>

<p>www.youtube.com/watch?v=vY_ijggQssE</p>

<p>www.youtube.com/watch?v=Z9kg71McATg</p>
";"15/09/2015 22";"21";"13";"8";"0";"933612185";"309"
"3895";"Ascensores metro";"<p>La gente que va en silla de ruedas o con cochecitos de bebes no lo tienen nada facil para acceder al metro,deberia de haber al menos un ascensor en cada estacion.El acceso en practicamente imposible en muchos casos.</p>
";"15/09/2015 22";"146";"145";"1";"1";"950860657";"14301"
"3896";"SER = Servicio de aparacamiento regulado";"<p><strong>El servicio del SER que sea GRATUITO para las empresas activas empadronadas en madrid, ya que perdemos mucho tiempo de nuestro trabajo y dinero    </strong>                                                                                                                                                                                                                                  </p>
";"16/09/2015 00";"35";"9";"26";"3";"926886297";"-437"
"3897";"Recuperación de solares abandonados.";"<p>Nuestra ciudad, especialmente fuera de la almendra central, esta llena de solares completamente abandonados y que en numerosas ocasiones se convierten en auténticos vertederos.</p>

<p>En muchas ocasiones el suelo de estos espacios es de titularidad municipal, por lo que una implicación tanto del Ayuntamiento como de los vecinos de la zona, podria convertir estos solares en lugares de convivencia y disfrute ciudadano. Algunos ideas podrian ser la plantación de arbolado, creación de huertos urbanos, pequeños parques, fuentes de agua potable, etc.</p>

<p>Estas medidas no suponen un gran desembolso económico y harían de estos espacios lugares mas amables y atractivos.</p>
";"16/09/2015 00";"319";"304";"15";"10";"953721880";"27541"
"3898";"Dejaderias de objetos (reciclaje urbano)";"<p>Propongo que los puntos de recogida selectiva se amplíen un modulo, además de papel y vidrio, otro para dejar pequeños objetos que ya no nos son útiles, pero están en perfecto uso.</p>

<p>Da rabia tirar libros, pequeños electrodomésticos o útiles que funcionan, pero por no saber que hacer con ellos acaban en el cubo de basura. </p>
";"16/09/2015 00";"88";"84";"4";"9";"948655301";"7636"
"3899";"Controlar el nivel de iluminación de los escaparates";"<p>Cada vez proliferan más en los escaparates de distintos comercios las pantallas (especialmente de tecnología LED) para mostrar continuamente publicidad.</p>

<p>Dichas pantallas que durante el día pueden no ser molestas por la noches de vuelven un auténtico para transeúntes, vecinos e incluso vehículos. El nivel de brillo de susodichas es el mismo que durante el día, llegando a iluminar fachadas y viviendas próximas, además de causar dolor en los ojos de todos los que paseemos por la acera o nos las encontremos.</p>

<p>Por ello el Ayuntamiento debe tomar medidas y, mediante el articulamiento legal necesario, obligar a las empresas a ajustar el brillo según la iluminación exterior (¿uso de fotosensores? ¿hacerlo según hora de salida y puesta del sol en las distintas épocas del año?).</p>
";"16/09/2015 01";"59";"47";"12";"3";"942983810";"2788"
"3900";"Cruzar la castellana sin peligro... y en menos tiempo.";"<p>A todos nos ha pasado. Intentar cruzar el paseo de la castellana es muy pekligroso. No se puede hacer de una vez, sino de dos o tres, y, con todo, los conductores son agresivos y se tiran a la carretera aunque el color ámbar favorezca al peatón. Les da igual, además, en la castellana rara vez se respeta el lçimite de velocidad.</p>

<p>No podría hacerse algo para facilitar cruzar La Castellana? pasarelas elevadas, mejorar el tiempo de los semáforos (yo estoy en buena forma y aún así lo hago deprisa... y la gente de movilidad reducida?)</p>

<p> </p>

<p>me gustaría no poerde media mañana ni pasar susto por lña agresividad de los conductores cuando tengo que cruzar el Paseo. qué opináis los demás? </p>

<p>gracias :)</p>
";"16/09/2015 01";"74";"67";"7";"4";"946893104";"5432"
"3901";"Que los edificios públicos paguen impuestos";"<p>Ya está bien de que con eso de ser la capital haya cientos de edificios gubernativos que no pagan IBI ni paso de carruajes ni nada de nada, perjudicando a todos los que hacemos vida en Madrid.</p>
";"16/09/2015 02";"74";"62";"12";"4";"945275204";"4189"
"3902";"Soterrar los cubos de basura en todos los distritos";"<p>Que os parece que el ayuntamiento de madrid empieze a soterrar los contenedores de basura? Por una de las mejores capitales del mundo limpias , sin olores y ordenada.</p>
";"16/09/2015 02";"374";"324";"50";"11";"952162864";"23736"
"3903";"Vuelta a la Plaza de la Villa";"<p>Que la sede del Ayuntamiento salga. De Cibeles y vuelva a la Plaza de la Villa.</p>
";"16/09/2015 02";"81";"46";"35";"5";"937401633";"624"
"3904";"Eliminación del ayuntamiento y todos los puestos políticos";"<p>En lugar de tener políticos inamovibles (si, siguen todos, en otros puestos, pero siguen), propongo eliminar el ayuntamiento y contratar un administrador de fincas para que lo lleve, seguro que hace mejor las cuentas y además, al no tener poder político en cuanto cometa la más mínima tropelía, a la carcel sin plañideras reclamando que es persecucuón política,

Además se puede cambiar en cuanto los ciudadanos quieran en lugar de tener que esperar obligatoriamente 4 años.

¿Puede alguién imaginarse la paz social que tiene que haber al no haber políticos?</p>
";"16/09/2015 04";"58";"15";"43";"4";"927945373";"-724"
"3905";"Lineas de RENFE circulares";"<p>Es necesario la creación de líneas circulares de RENFE o Metro con el recorrido de la M-30 y la M-40 para que no sea necesario llegar hasta el centro de Madrid cuando el recorrido es entre barrios del extrarradio.</p>
";"16/09/2015 05";"156";"144";"12";"12";"951927605";"12184"
"3906";"La colaboración ciudada en la limpieza de nuestras calles";"me he planteado muchas veces que nos es más limpio quien más limpia, sino quien menos ensucia.Pagamos nuestros impuestos, por cierto incrementados por el anterior gobierno municipal, sin haber visto una contrapartida.No obstante aunque soy una fiel defensora de los servicios publicos, opino que toda la ciudadania deberia de implicarse de moda voluntaria en este cometido de la limpieza y su mantenimiento. Para ello quiero proponer comisiones por barrios , de supervisión directa bajao la supervisión de los funcionarios a quien competa.Y que se hagan incentivaciones a todas aquellas personas que participen activamente, puedo desarrollar más esta popropuesta incluso se podria hacer reconocimientos mediante premios a los barios, calles, más limpias. O a las acciones puntuales de limpieza más efectivas además de proponer nichos de trabajo y de mini empresas/ cooperativas,también se podrian hacer desgravaciones municipales en las tasas a quien estuviera implicado en esta participación activa.";"16/09/2015 08";"63";"49";"14";"3";"945570488";"2722"
"3907";"La colaboración ciudada en la limpieza de nuestras calles";"Me he planteado muchas veces que nos es más limpio quien más limpia, sino quien menos ensucia.Pagamos nuestros impuestos, por cierto incrementados por el anterior gobierno municipal, sin haber visto una contrapartida.No obstante aunque soy una fiel defensora de los servicios publicos, opino que toda la ciudadania deberia de implicarse de moda voluntaria en este cometido de la limpieza y su mantenimiento. Para ello quiero proponer comisiones por barrios , de supervisión directa bajo la supervisión de los funcionarios a quien competa.Y que se hagan incentivaciones a todas aquellas personas que participen activamente, puedo desarrollar más esta popropuesta incluso se podria hacer reconocimientos mediante premios a los barios, calles, más limpias, plazas etec. O a las acciones puntuales de limpieza más efectivas además de proponer nichos de trabajo y de mini empresas/ cooperativas,que conlleven una incentivacion al autoempleo.También se podrian hacer desgravaciones municipales en las tasas a quien estuviera implicado en esta participación activa.";"16/09/2015 08";"130";"109";"21";"18";"950028590";"7378"
"3908";"Eliminar la religión como asignatura";"<p>La enseñanza de las religionesn en sus templos. </p>
";"16/09/2015 09";"322";"235";"87";"12";"949987707";"10801"
"3910";"Volver a colocar la estatua de Felipe II en la Plaza de la Armeria";"<p>Cuando finalizen las obras del Museo de las Colecciones Reales.Sería buena idea de volver la estatua de Felipe II.En el lugar donde estuvo antes.</p>

<p>Era un buen lugar.Donde madrileños y turistas.Se reunian para ver el atardecer.Con las maravillosas vistas a la Casa de Campo y la Sierra de Guadarrama.</p>

<p>Y no la idea de ponerla en la Plaza de la Villa.Como querían el anterior gobierno.Alvaro de Bazán,está muy bién alli.</p>

<p>Felipe II se merece su estatua.Por el.Madrid es capital de España.</p>
";"16/09/2015 09";"113";"90";"23";"2";"948697225";"5336"
"3911";"TRANSPORTE AL HOSPITAL RAMON Y CAJAL";"<p>Aunque la decisión debe ser compartida por el Ayuntamiento y la Comunidad de Madrid en el Consorcio Regional de Transportes, creo que el Ayuntamiento puedo hacer la propuesta y la misma salir adelante. Aquí va mi propuesta:</p>

<p>Los vecinos de Ciudad Lineal y San Blas tenemos asignado como Hospital de zona el Ramón y Cajal, sin embargo, acudir en transporte público a ese centro es una excursión de una hora o más, es decir, que si me voy a Valladolid en ave llego en una hora, si me voy de Ciudad Lineal al Ramón y Cajal tardo una hora y media, ¿es normal?</p>

<p>El autobús 135 tiene una frecuencia de 15 minutos entre cada autobús de media, y el metro te deja en Begoña y luego tienes 15 minutos o mas andando desde la estación del metro, eso sin contar que las personas con problemas de movilidad cuando no funcionan las escaleras del metro, cosa muy habitual por cierto, tienen que darse la vuelta e irse a otra estación.</p>

<p>Y Cercanías? a los vecinos de esta zona eso es como pedirnos que demos la vuelta al mundo.</p>

<p>Mi petición es un transporte público directo (bus)  que una sin transbordos los barrios de San Blas y Ciudad Lineal con el hospital Ramón y Cajal con una frecuencia decente.</p>

<p>Gracias</p>

<p> </p>
";"16/09/2015 09";"87";"82";"5";"5";"951993539";"7257"
"3912";"AMPLIAR HORARIO CERCANÍAS DURANTE LOS VIERNES Y SABADO";"<p>Con el fin de mejorar el uso del transporte público en la capital sería recomendable que el horario de los trenes de cercanías fuera,al menos,  igual que el del metro los viernes y sábado, ya que hay zonas, icluso dentro del Municipio de Madrid, en las que la cobertura  de transporte público nocturna es muy escasa ya que el horario de trenes finaliza antes de las 12 de la noche y los autobuses son escasos</p>
";"16/09/2015 10";"289";"271";"18";"8";"956841408";"23724"
"3913";" estacionamiento regulado";"<p>Un robo el precio,y tenía que ser zona azul sólo el centro de Madrid,mendez alvaro,pacífico,ciudad lineal,no merecen ese robo de precios, al menos los sábados que vuelva a ser hasta las 3  dr la tarde el pago.fuera parquímetros de zonas que no son el centro.</p>
";"16/09/2015 10";"75";"56";"19";"5";"946256163";"2762"
"3914";"Horarios zona SER";"<p>Creo que el horario de las zonas SER debería como mínimo ser como antes, de 9 a 20 horas. En mi opinión ya tendria ese efecto disuasorio por el que se instaló y  recaudaria bastante con un horario comercial: de 10 a 19 horas.</p>
";"16/09/2015 10";"179";"150";"29";"12";"952091916";"10139"
"3915";"Tasas más justas y progresivas";"<p>Entre las propuestas económicas y sociales de la mayoría de partidos, suelen aparecer la bajada del IBI o la del Impuesto de Sucesiones como promesa electoral. Pero rara vez habla nadie del Impuesto sobre el Incremento de Valor de los Terrenos de Naturaleza Urbana o <strong>Plusvalía Municipal por Mortis Causa. </strong>Calculado sobre unas ""tablas"" que difieren de municipio en municipio, el impuesto aplicado por el Ayto. de Madrid es uno de los más altos de España, con una valor catastral absolutamente inflado, propio de la burbuja inmobiliaria, y de años anteriores a la crisis. La tasa carece de progresividad alguna, ya que en estas tablas de cálculo no se considera la situación del pagador, ni sus ingresos o rentas. Tanto da estar en paro o ser pensionista que gran propietario: la cuantía del impuesto será la misma. La injusticia flagrante que esto conlleva para los ciudadanos menos favorecidos supone que, en muchos casos tengan que solicitar un préstamo bancario para hacer frente a la deuda, con los intereses correspondientes, claro está. El que muchos de esos deudores no puedan acceder a ningún préstamo por carecer de nómina o ser autónomo, o pensionista o parado de larga duración, no resulta relevante a los ojos de la administración municipal. No hay bonificación alguna ni demostrando que el deudor utliza la vivienda heredada como domicilio habitual, ni cuando es el ÚNICO bien legado. Tampoco da el consistorio facilidades de pago  y a partir de una moratoria de 6 meses, se castiga con un 7% anual de interés sobre la deuda acumulada. Un gasto extra que -después de un fallecimiento, con lo que todo ello conlleva- muchas familias no pueden asumir. Recordemos que las renuncias a herencias se han triplicado con la crisis. (El Mundo, 23 de Julio de 2015) ¿Es necesario ser rico para poder heredar? ¿Qué opción aporta el ayuntamiento de Madrid a aquellos que no pueden hacer frente a estas deudas? </p>

<p>Esperamos que este nuevo gobierno municipal responda lealmente a las demandas de los ciudadanos y que convierta la ley (esa ley hecha para favorecer a quienes más tienen) en justicia.</p>

<p>Enhorabuena por la iniciativa de los debates públicos.    </p>
";"16/09/2015 10";"106";"99";"7";"7";"952966569";"8592"
"3916";"Acera Lopez de Hoyos-Cartagena";"<p>Tras la fatídica remodelación de la calle Lopez de Hoyos, se ha creado un embudo en la esquina con la calle Cartagena, en grán parte por la ""valla"" de protección de la acera y la farola colocada.

En un cruce en donde pasan muchisimos peatones entre dos calles muy transitadas, solamente podemos pasar de uno en uno por esta barrera arquitectónica creada con la remodelación, que se podria abrir otro debate sobre como se han cargado una arteria principal del barrio de Prosperidad, pero creo que este es su punto más acuciante.</p>
";"16/09/2015 10";"62";"55";"7";"6";"949608189";"4258"
"3917";"Semana barroca o del siglo de oro y el mercado de época más grande de europa";"<p>Durante una semana.Madrid podría ser acoger una semana una feria con actividades,mercado,conferencias.Sobre el siglo de oro o el barroco.Como hace Alcalá de Henares con la semana cervantina.Sería una perfecta para la economía y el turismo.</p>

<p>Podría acoger el mercado de época más grande de Europa.Estaría bién ponerlo en la Plaza Mayor,Plaza de la Villa y el Madrid de los Austrias.Sería el entorno perfecto.O sino por Madrid Rio,por la zona del Puente del Rey y la Casa de los Vargas.</p>
";"16/09/2015 10";"106";"90";"16";"4";"950509721";"6283"
"3918";"Autobuses/transporte nocturno a la zona de Abrantes";"<p>Hay una zona de Abrantes, concretamente la situada entre la Carretera de Toledo A-42 y Pan Bendito que carece de transportes nocturnos ya que ningún autobús nocturno atraviesa dicha zona y carece de metro. Los búhos más cercanos pasan por La Peseta u Orcasitas, pero a gran distancia de esta zona.</p>

<p>Cada vez hay más familias en dicha zona y gente más joven que necesita un modo de volver por la noche, aparte de servicios como tanatorios a los que puede ser necesaqrio acudir en transporte público.</p>

<p>Paradójicamente, hay unas cocheras inmensas de la EMT pero ningún autobús nocturno hasta ellas.</p>

<p> </p>
";"16/09/2015 11";"31";"24";"7";"1";"944435720";"1316"
"3919";"Mayor iluminación en Parque Emperatriz María de Austria";"<p>Este parque, situada en Plaza Elíptica, es un gran pulmón verde intransitable por la noche por la falta de iluminación e inseguridad; estando más y mejor iluminado serviría para poder salir a correr por la noche, pasear o poder ir andando desde Plaza Elíptica a las viviendas situadas en la Avenida de los Poblados, reduciendo la contaminación y tránsitod e coches de gente que no tiene más remedio que ir en coche por no poder atravesar el Parque por la noche</p>
";"16/09/2015 11";"49";"44";"5";"2";"949229931";"3502"
"3922";"Solución para aparcar para Residentes en zona centro";"<p>Hola, </p>

<p>Como antiguo usuario de coche (ya no tengo) en el centro de Madrid quiero exponer el siguiente problema.</p>

<p>Si no tienes recursos económicos para alquilar o comprar un garaje en la zona centro te toca buscar aparcamiento en la calle.</p>

<p>Encima cada vez van quitando más lugares para aparcar, lo que hace que esta labor de dejar el coche aparcado en la zona donde vives se vuelva un auténtico infierno.</p>

<p>Deberíamos pensar en la gente trabajadora con pocos recursos para que puedan tener una opción de poder aparcar con dignidad.</p>

<p>Se me ocurren medidas dispares y un poco locas. Ahi van:</p>

<p>- cerrar el barrio a solo residentes</p>

<p>- asignar un espacio de aparcamiento fijo a cada vecino</p>

<p>- habilitar zonas que ahora son prohibidas por razones de seguridad absurda u otras razones.</p>

<p>*Ejemplos de zonas prohibidas absurdas:</p>

<p>- calle Manzana (por estar junto al Ministerio de Justicia de San Bernado) de verdad se necesita prohibir aparcar en toda la calle?</p>

<p>- calle san hermenegildo. Hay un tramo de 100 metros que no se puede aparacar. ¿por que?</p>

<p>- zonas de minusvalidos sin matricula. deberian tener la matricula del coche, porque si no pueden aparcar todos los que tengan el distintivo, y eso permite alguna que otra trampa. Lo he visto con mis propios ojos.</p>
";"16/09/2015 12";"40";"29";"11";"8";"944827581";"1305"
"3923";"Quitar la señal de prohibido que hay donde la Policia Local de San blas";"<p>Frente al estadio de la Peineta hay un acceso para el resto del barrio de uno 2 metros de largo, con señal de prohibido, excepto Policia , creo que si se permitiese acceder esos minusculos 2 metros, se verian bastante oxigenadas el resto de accesos al barrios de las rosas, sobre todo el de la Avd. Niza, que llega a obstruir la Gta. de Grecia en el cruce con la avenida de Arcentales, tanto para los vehículos que proceden de la avd. vicalvaro, como de los que acceden de la M-40 y Luis Aragones.</p>

<p>Toda la Gente que veve por esa zona del barrio no tendria necesidad de obstaculizar su paso por la Avd. de Niza y podrian acceder por ese trozito de calle, sin que ello fuese a perjudicar en sus labores a la Policia.</p>
";"16/09/2015 12";"20";"14";"6";"1";"941747892";"560"
"3924";"ASCENSORES EN BARRIO DIRIGIDO DE FUENCARRAL";"<p>En el Barrio dirigido de Fuencarral, se hicieron edificios de 4 y 5 pisos hace 40 años o más, ahora a pesar de que se pueden poner ascensores facilmente por fuera, las subvenciones son muy pequeñas, y los vecinos muchos no quieren. Mis padres viven en un cuarto, 81 y 86 años, y les supone no poder bajar en casi todo el año a la calle. Por favor podrían ayudarnos con subvenciones o algo? Concretamente yo hablo de calle Sabadell 148, donde ya investigamos en su día, y los vecinos no quisieron por el costo. A lo sumo poder poner ascensor 4 y 3º si es que los de abajo no quieren y que no sea ilegal. Gracias</p>
";"16/09/2015 12";"24";"17";"7";"2";"942596287";"708"
"3925";"No creeis que es el momento de apuntarnos otra vez en los juegos olimpicos?.. ";"<p>Ya no está el PP para llevarse las comisiones. Y no se presenta casi ningun pais. Tendriamos apoyo de sudamerica y mucho andado.. </p>

<p>El coste es alto, pero ya está casi todo hecho y desaprovechado..</p>

<p> </p>
";"16/09/2015 13";"176";"16";"160";"2";"933460115";"-1309"
"3926";"Mas espejos convexos en los cruces de calles estrechas";"<p>Es indispensable facilitar a los conductores la correcta maniobrabilidad a la hora de circular por zonas de dificil visibilidad como ocurre en una gran parte de las calles de la zona oeste de Madrid. En el barrio de Tetuan, en la zona de Almenra por ejemplo, existen numerosos cruces que para poder ceder el paso hay que invadir practicamente el carril prioritario y que con la ayuda de espejos convexos, no solo facilitarían la visibilidad, sino que facilitarían el correcta circulación por dichas vias y evitarian numerosas colisiones.</p>
";"16/09/2015 13";"121";"115";"6";"0";"954974567";"10359"
"3927";"Contratación del personal de empresas externas en entidades publicas.";"<p>Somos muchos los que trabajamos en organismos públicos y empresas adscritas, como personal externo cubrimos un puesto de trabajo en nombre de una ETT o consultora que nos paga sueldos por debajo de nuestras cualificaciones y contratos basura. porque no podemos estar contratados directamente y cubrir ese puesto de trabajo? Pido que todo el personal externo que estamos cubriendo esas plazas seamos contratados por la entidad correspondiente y reducir los contratos basura que hacen las ETT´s y consultoras.</p>
";"16/09/2015 13";"60";"30";"30";"5";"935710711";"0"
"3928";"Bicicleta en Cercanías - Metro";"<p>Llevo meses utilizando la combinación <em>bicicleta+cercanías</em> para desplazarme cada día a mi puesto de trabajo.</p>

<p>Es lamentable la cantidad de viajeros que utilizan el vagón del cercanías destinado a <strong>sillas de ruedas - carritos - bicicletas</strong> (el que tiene baño), sin poseer ninguno de estos elementos.</p>

<p>Es más, especialmente, existe menos ""amabilidad"" para aquellos que nos subimos con las dos ruedas, sufriendo gestos despectivos, comentarios fuera de lugar y teniendo que <strong>recordar</strong> que el que está de más en ese espacio, es el viajero que sí puede subirse y ocupar el resto de vagones habilitados.</p>

<p>Por ello, abogo por informar de manera <strong>CLARA</strong> y <strong>LLAMATIVA</strong> (carteles, pegatinas, o incluso, como en otros países, poner en otro color el interior del vagón) para qué está destinado el uso de ese vagón, como medida a corto plazo; siendo necesario un diseño interior de espacio más confortable y accesible para el futuro.</p>

<p>También, recalcar la necesidad de <strong>NO LIMITAR</strong> el horario de uso de la bicicleta en el <strong>Metro</strong>: como viajero entiendo el caos de meter una bicicleta, por ejemplo, en hora punta, ahora, tal y como ocurre con el cercanías, sería una solución viable y agraciada, destinar uno de los vagones como espacio prioritario para sillas de ruedas - carritos - bicicletas.</p>

<p>Gracias de antemano por vuestro tiempo y atención.</p>

<p>Un fuerte abrazo,</p>

<p>Sergio Maroto</p>
";"16/09/2015 13";"222";"209";"13";"14";"957473298";"18452"
"3929";"BICICLETAS";"<p>JUNTAR TODOS LOS DEBATES QUE HAY A CERCA DE LA MOBILIDAD DE LAS BICICLETAS PARA ASI JUNTANDO TODOS LOS VOTOS PODER ABRIR UNA PROPUESTA CIUDADANA.HAY UN MONTON DE DEBATES ABIERTOS QUE SERIA MAS FACIL DIALOGAR Y PROPONER SOLUCIONES SI SOLO HUBIERA UNO.</p>
";"16/09/2015 14";"96";"92";"4";"0";"954558989";"8433"
"3930";"Hospital púplico en los terrenos de la antigua carcel de Carabanchel";"<p>Es una demanda histórica que llevan los vecinos de la zona pidiendo.Ya que no disponen de un hospital de referencia cercano.Y no a la especulación inmobilaria en los terrenos.Por un hospital Publico.</p>
";"16/09/2015 14";"136";"123";"13";"4";"954496565";"9948"
"3931";"Placa o monumento de homenaje a las víctimas del Madrid Arena y de Alcalá 20";"<p>Estaría bién poner una placa o algún monumento de homenaje a la víctimas de ambos sucesos.Al igual que lo tienen los bomberos,que murieron en la calle Montera,en los antiguos Almacenes Arias.</p>

<p>Justo al lado o en el mismo lugar donde sucedieron los hechos.Así no caer en el olvído y de homenaje para las víctimas.</p>
";"16/09/2015 14";"76";"54";"22";"1";"946839267";"2273"
"3932";"Baños Públicos en la Casa de Campo";"<p>Un espacio como la Casa de Campo debe de contar con Aseos Publicos por motivos ambientales y de higiene. </p>

<p>Somos muchos los que acudimos frecuentemente para pasar el día, hacer deporte y resulta complicado encontrar un sitio adecuado. </p>

<p>Hay que facilitar este tipo de instalaciones para evirtar en la medida de los posible que la gente salga al campo y vaya dejando su huella...</p>

<p>Otros espacios como el Retiro o el Parque de Rey Juan Carlos tienes servicios... la Casa de Campo tambien los necesita!</p>

<p>Gracias por generar este espacio! ;)</p>

<p> </p>
";"16/09/2015 14";"165";"157";"8";"1";"956856565";"14177"
"3933";"Solución excrementos caninos - prueba ADN - multa";"<p>Puede que parezca ficción pero no lo es, ya se aplica en otros sitios y se basa en que todo dueño de perro tenga que registrar su ADN en una base de datos canina (al principio puede estar subvencionado) lo que haría que cualquier excremento en la calle, con una simple muestra de heces que se envíe a laboratorio nos daría el dueño del can, pudiendo aplicar una sanción. </p>

<p>La prueba tiene un coste de 15, precio no muy elevado que se repercutiría en la sanción.</p>

<p>Es una medida eficaz que no necesita coger al infractor infraganti, por un Madrid sin excrementos.</p>

<p>La recaudación de las sanciones las reinvertiria en zonas habilitadas para canes y subvenciones que permitan que el registro del can en la base de datos no tenga coste para el dueño.</p>

<p> </p>

<p>gracias.</p>
";"16/09/2015 14";"155";"111";"44";"12";"949453212";"4798"
"3934";"Sacar los autobúses históricos a la calle ";"<p>La propuesta sería sacar los autobuses históricos que estén guardados en las cocheras de la EMT o en algún museo para 'pasearlos' por las calles de Madrid. La semana de la movilidad sería una buena oportunidad para hacerlo, aunque se puede hacer en cualquier otro momento. Se podrían organizar las rutas por distritos en las que hiciesen un recorrido por las calles más principales para el disfrute de los madrileños. Podrían ir organizados de más antiguos a más modernos.</p>

<p> </p>

<p>No es una idea muy elaborada, pero aquí la dejo.</p>
";"16/09/2015 14";"81";"63";"18";"1";"949124146";"3500"
"3935";"LIMPIEZA DE LAS CALLES DE MADRID, YAAAA!!";"<p>.La primera impresion de un cambio inmediato en Madrid,  es ""verlo""-  Las calles, sucias y abandonadas por Ana Botella, están peor que nunca. Que se note ya que Madrid tiene a Manuela al frente!!!!. NECESITAMOS que el cambio sea palpable y se perciba de forma inmediata, por favorrrrrrrrrrrrrrrrrrrr, <strong>que limpien TODO MADRID,  YAAA!!!!!.</strong></p>
";"16/09/2015 15";"513";"504";"9";"35";"962967324";"48631"
"3936";"Revisar el suledo de los trabajadores de la EMT y del METRO como prioridad";"<p>Informense de lo que cobra un trabajador en esos sitios y luego entiendan en donde se va parte del dinero que cuesta viajar en transporte público. Porque es carísimo. Debería incentivarse bajando los precios y están a un nivel casi como de ir en coche, normal que no funcionen las campañas y haya tantos atascos y poluciones. Y gran parte se va en sus exagerados sueldos, de los que solo para ellos se destianan cientos de millones de euros, cuando se podría rebajar el billete en gran parte si cobraran algo normalito. Me parece de verdad una verguenza de verdad, y todo imagino porque no vayan a la huelga con sus sindicatos. No sé porque me da que manejan ellos mismos sus propios sueldos... Ahora mismo sé que para esos trabajadores no existe la crisis, con sus sueldos no pueden notarla.</p>
";"16/09/2015 15";"52";"23";"29";"16";"934354740";"-265"
"3937";"Cerrar la Gran Vía del Este para conectar Vicálvaro con el H.Infanta Leonor";"<p>Actualmente la Gran Vía del Este (que comienza cerca de la Renfe de Vicálvaro) se corta cerca de la A-3 y del pinar del Cerro Almódovar, para luego proseguir desde el Hospital Infanta Leonor y acabar junto a la estación de Vallecas. La única conexión directa entre Vicálvaro y Vallecas Villa es la Avenida de la Democracia, que aunque cuenta con aceras es toda una odisea para los peatones.</p>

<p>Pienso que cerrando la Gran Vía del Este (bien por encima o bien por debajo de la A-3) de forma paralela a las vías del tren, además de mejorar las conexiones entre ambos barrios se crea un importantísimo acceso al hospital. ¿Qué os parece?</p>
";"16/09/2015 15";"47";"46";"1";"2";"952757487";"4404"
"3938";"AMNISTIA MULTAS ORA ANTES DE APP,s";"<p>Hasta que las APP,s para pagar las zonas azul y verde de la ORA no se crearon, los ciudadanos, no podíamos en muchos casos, volver al parquímetro a alargar la estancia, por varias razones... Consultas médicas, reuniones, servicios de reparaciones, gremios de construcción, etc...</p>

<p>Yo y muchos madrileños que acumulamos muchas sanciones de la ORA por ese motivo, sugiero en este foro que para q la ciudad pueda recaudar, nos de a estos ciudadanos una amnistía parcial del 60%/70%  y nos deje pagar un porcentaje de estas sanciones ya en periodo ejecutivo.</p>

<p>Tan sólo las sanciones de la ORA, no así las de tráfico o aparcar en zonas prohibidas.</p>
";"16/09/2015 16";"31";"8";"23";"0";"933736364";"-387"
"3939";"Eliminar transbordo de Tres Olivos en L10 de Metro";"<p>Me parece totalmente innecesario y absurdo que para ir al barrio de Montecarmelo (que es parte del municipio de Madrid) haya que hacer un transbordo en la parada anterior para cambiar de tren dentro de la misma línea. En horarios nocturnos muchas veces incrementas 10-15 min mas el viaje y a veces a la vuelta el metro que comes a la 1 en el centro al llegar a tres olivos ya no hay conexión y no puedes continuar viaje. Es totalmente injusto pues no estamos en otra zona de transporte y pagamos lo mismo la gente que estamos en la zona A. No entiendo por que el servicio es peor después de Tres Olivos.</p>
";"16/09/2015 16";"174";"163";"11";"10";"957390922";"14239"
"3940";"Si las concesionarias de limpieza no limpian.";"<p>Si las concesionarias de limpieza no limpian, proceder a sancionarles y con dichas sanciones crear grupos de trabajo para la limpieza de los distritos con personal desempleado, seria una forma con la que las concesionarias se dieran cuenta que tienen que cumplir sus obligaciones.</p>
";"16/09/2015 16";"266";"258";"8";"10";"960308969";"24248"
"3941";"Operación Campamento Vs parque forestal y dotaciones";"<ul>
	<li>Algunas estimaciones hablan de que en España podría haber más de 6 millones de pisos vacios y en Madrid se concentra un alto porcentaje de estos.</li>
	<li>No hay justificación demográfica para ocupar más suelo en la ciudad (España tiene unos índices de natalidad de los mas bajos del mundo).</li>
	<li>La especulación inmobiliaria, nos ha costado muy cara. No crea riqueza o la que crea se va a unas pocas manos. Por no hablar del coste medioambiental o en términos de corrupción.</li>
</ul>

<p><strong>REFLEXIONEMOS</strong> si queremos una ciudad congestionada y colapsada con un número elevadísimo de viviendas vacías o si por el contrario queremos una ciudad amable con un entorno más cuidado, más natural y más humano.</p>

<p>Hay una propuesta en este sentido que se puede votar...</p>

<p>https://decide.madrid.es/proposals/193</p>
";"16/09/2015 17";"88";"78";"10";"2";"953359479";"6027"
"3942";"Policia de tráfico en la Rotonda de conexión (Canillejas-NII). ¡Todos los días!";"<p>Un día sólo he visto la policia en la rotonda que pasa por encima de la NII a la altura de Canillejas. ¡Es horrible!. </p>

<p>Debería haber todos los días (mañana y tarde) policias de tráfico y movilidad, ya que es un punto muy conflictivo de coches que vienen de un sentido y otro de la NII.</p>
";"16/09/2015 17";"25";"18";"7";"0";"944622037";"792"
"3943";"Retirar el nombre Margaret Thatcher del nuevo colegio del ensanche de Barajas";"<p>Retirar el nombre de Margaret Thatcher del nuevo colegio abierto este curso en el ensanche de Barajas.</p>

<p>Tenemos grandes personalidades madrileñas de la cultura y la educación. </p>

<p>http://www.ampamargaretthatcher.com/</p>
";"16/09/2015 17";"332";"278";"54";"11";"956929113";"18756"
"3944";"Polideportivos municipales. Reducción general de tarifas.";"<p>En tiempos del alcalde Alberto Ruiz Gallardón se produjo una enorme subida de tarifas en los polideportivos en un solo año (p.ej., casi un 40% en el abono de 10 usos -para piscina, salas polivalentes, etc.-). Posteriormente se han conservado así, incluso con leves incrementos. Es fundamental volver a aquellos precios para reducir la desigualdad en las posibilidades de acceso a la práctica deportiva. Gracias a tod@s por apoyar este debate. Saludos.</p>
";"16/09/2015 17";"345";"330";"15";"8";"961147013";"30130"
"3945";"Señalizar los hidrantes en las calles";"<p>Un hidrante es un toma de agua para los bomberos. Estas tomas están en el suelo de muchas calles, en un incendio los bomberos tienen agua pero esta se acba y  tienen que repostar. Para ello uno de los bomberos tiene que ir mirando por la calle al suelo hasta que encuentra un hidrante. En muchos paises se ponen pequeñas marcas para que los bomberos lo detecten con facilidad, amén de las señales en la puertad e hoteles que indican la ubicación, pero son las menos. </p>
";"16/09/2015 17";"54";"52";"2";"7";"953725990";"4814"
"3946";"Señalizar los hidrantes en las calles";"<p>Un hidrante es un toma de agua para los bomberos. Estas tomas están en el suelo de muchas calles, en un incendio los bomberos tienen agua pero esta se acba y  tienen que repostar. Para ello uno de los bomberos tiene que ir mirando por la calle al suelo hasta que encuentra un hidrante. En muchos paises se ponen pequeñas marcas en las fachadas a modo de plaquitas para que los bomberos lo detecten con facilidad, amén de las señales en la puertad e hoteles que indican la ubicación, pero son las menos. </p>
";"16/09/2015 17";"31";"30";"1";"9";"951685268";"2806"
"3947";"¿Necesitamos los 'mupis'? ( 'mueble urbano para la presentación de información')";"<p>Estos carteles, ubicados en las aceras sólo empeoran el fluir de los viandantes afeando el aspecto de la ciudad.</p>

<p>ejemplo: http://www.digitalavmagazine.com/wp-content/uploads/2012/05/JCDecaux-Danone.jpg</p>

<p>Y la pregunta es:  ¿realmente nos renta o podríamos vivir sin ellos?. No  me sé las cuentas pero dudo que los ingresos por esta engorrosa forma de publicidad que hace uso de dominio público  la justifiquen.   Estoy seguro que la patronal de publicistas en vallas (los privados) estarían encantados de ver incrementado liberamente sus canones como compensación por la retirada de esta competencia municipal que sufrimos los madrileños. </p>

<p>Este intesante articulo del mundo cuestiona los aspectos económicos del actual contrato: http://www.elmundo.es/madrid/2015/03/16/55074327268e3e60218b456c.html</p>
";"16/09/2015 19";"45";"31";"14";"1";"946465331";"1171"
"3948";"Entrada para minusválidos a la Casa de Campo desde Aravaca";"<p>La entrada actual a la Casa de Campo desde Aravaca, desde la calle Cuesta del Galván, consiste en dos tramos de escaleras bastante pronunciadas, una de ellas de madera y tierra que se llena de barro cuando llueve. De esta manera es imposible entrar a la Casa de Campo con una persona en silla de ruedas o un carrito de bebé. Las soluciones podrían ser o poner una rampa o poner una pasarela peatonal por encima de la Vía de las Dos Castillas.</p>
";"16/09/2015 19";"103";"100";"3";"4";"957308859";"9417"
"3949";"VADOS con identificación anual";"<p>Las placas de los vados, se encuentran registrados por un número de identificación, pero no indican si se encuentran vigentes o no; así como la identificación de la itv en las lunas de los coches donde se identifica la la fecha vigente, está se debiera utilizar en los vados y en el caso de incumplir el pago anual no fuera reemplazada para el año siguiente. Pues es muy normal que no se pague en una sola ocasion y luego permanezca como uso y disfrute sin pagar por ellas.</p>

<p> </p>

<p> </p>
";"16/09/2015 19";"71";"68";"3";"5";"955542153";"6225"
"3950";"BICICLETAS DE ALQUILER BICIMADRID EN BOCA DE METRO TIRSO DE MOLINA";"<p>POR FAVOR PONGAN UNA PARADA DE BICICLETAS DE ALQUILER BICI MADRID EN LA PARADA DE METRO DE TIRSO DE MOLINA. EN LA PLAZA HAY ESPACIO SUFICIENTE Y ES NECESARIO QUE LAS BICICLETAS ESTEN JUNTO A LAS BOCAS DE METRO. </p>
";"16/09/2015 20";"72";"63";"9";"1";"953710976";"4725"
"3951";"OBLIGAR A PONER LAS ""PLACAS DE CALLE"" EN TODOS LOS EDIFICIOS DE MADRID";"<p>Una placa de calle es un tipo de señal urbana, en algún sentido similar a las señales de trafico, y cuya función principal es la de indicar el nombre de una calle o avenida o lugar.</p>

<p>Generalmente, este tipo de carteles o placas son colocados a cada extremo de una vía, y a ambos lados de la calzada, especialmente en los cruces, y orientan a los usuarios de las vias a saber donde estan o a orientarse.</p>

<p>En el boom inmobiliario nadie ha obligado a las constructoras a poner las citadas ""placas de calle"", ni a las fincas, a reponerlas cuando se caen o se deterioran.</p>

<p>Es por ello por lo que hago esta sugerencia al Ayto de Madrid. No entro en debate de nombres ni historias raras, simplemente a su uso como herramienta util para el ciudadano.</p>

<p>Antes cada vez que se construia un edificio se ponia por que el ayuntamiento lo obligaba. Desde hace años no se hace.</p>

<p> </p>

<p> </p>
";"16/09/2015 20";"152";"135";"17";"2";"957023483";"10480"
"3952";"Abolición de todas las practicas taurinas";"<p>cada vez estamos más en el punto de mira por la vergüenza de esta ""gran fiesta nacional"", ¿se podría abolir la tauromaquia en Madrid?, y cualquier tipo de festejo que impliquen animales, en general, los cuales puedan sufrir algún daño??

Aparte de avanzar hacia una ciudad más acorde al medio ambiente, lo mismo hasta nos ahorramos miles de euros en comprar animales que van a ser sacrificados...</p>
";"16/09/2015 22";"355";"277";"78";"14";"957258221";"15527"
"3953";"Coches en segunda fila al lado de restaurantes";"<p>En Madrid hay muchos restaurantes en donde los aparcacoches dejan los coches en segunda fila y parece que la policía no pueda hacer nada porque los están vigilando. El problema es que en algunas zonas se forman cuellos de botella con el tráfico. Debería buscarse alguna solución para que pudieran ser sancionados.</p>
";"16/09/2015 22";"277";"270";"7";"13";"962880878";"25635"
"3954";"Unión de debates similares";"<p>He estado mirando los debates y las propuestas que hay en esta web.Muchas de ellas son similares. Por ejemplo, he leído varias sobre la necesidad de fuentes públicas.</p>

<p>Creo que tal como está organizado este sistema en el que, si no me equivoco, se debe llegar a 50000 apoyos para que una propuesta salga adelante, debería darse la posibilidad de unificar las propuestas (siempre que los que iniciaron la propuesta consideren que estas pueden unirse). </p>

<p>Los votos de ambas propuestas deberían unirse sin repetición, si no sería hacer trampas.</p>

<p>De esta forma se verían los apoyos reales a una propuesta y sería más facil llevarla a cabo.</p>
";"16/09/2015 23";"307";"305";"2";"5";"964256264";"30102"
"3955";"legalizar prostitución";"<p>Legalizar prostitución</p>
";"16/09/2015 23";"125";"94";"31";"4";"953199535";"4737"
"3956";"Adelantar horarios de recogida de basuras centro";"<p>Hola, vivo en Camberi,en un 5º con ventanas nuevas, todos los dias entre las 3 y las 4 de la mañana pasa el camion de la basura haciendo un escándalo terrible y despertandonos a todos.</p>

<p>¿Pasa en otros barrios? ¿No es posible adelantar los horarios de recogida de basuras? ¿Sistemas más silenciosos? ¿Como lo veis?</p>

<p>Gracias</p>
";"16/09/2015 23";"66";"57";"9";"6";"954329067";"4145"
"3957";"Reducir el impacto acústico en las zonas residenciales";"
Revisar las ordenanzas municipales que regulan el máximo de decibelios permitido, los horarios de recogida de basuras y de apertura de bares y terrazas para garantizar el descanso nocturno.


<p>Hagamos de Madrid una ciudad para sus vecinos, donde quien venga de fuera se sienta acogido, sostenible, sin ruidos y desarrollada económicamente, premiando a los emprendedores pero garantizando el descanso nocturno a partir de las doce de la noche.</p>

<p>Acabemos con las practicas in cívicas como aparcar en doble fila a la puerta de los restaurantes, con los consiguientes bocinazos de quien había logrado encontrar un hueco..</p>

<p> </p>


";"16/09/2015 23";"174";"161";"13";"1";"959943862";"13694"
"3958";"Por una tauromaquia sin sufrimiento en Madrid";"<p>Comenzaré diciendo que yo he vivido desde niño muy cerquita de la plaza de toros de Ventas. Por inercia, en una época en que las corridas no se cuestionaban nunca (estábamos ciegos) he asistido a muchas tardes de toros y he visto sacrificar a muchísimos. Ya hace bastantes años no puedo soportar la visión de la corrida. Ese trance de las picas, las banderillas, las terribles estocadas, los descabellos, la puntilla, los caballos destripados...Es demasiado, es insoportable. Nadie se acuerda del pobre toro. Lo malo es que actualmente no se pueden prohibir porque de hacerlo, el toro desaparecería. Habría que reformar los espectáculos taurinos para que no se produzca mas el sufrimiento del toro.</p>

<p>Me duelen profundamente las cosas que se están diciendo sobre nuestro bellísimo animal totémico y simbólico nacional, el toro de lidia. Yo comprendo muy bien que las asociaciones defensoras de los derechos animales le quieran proteger asimilándolo al resto de los animales. Comprendo que haya gente que en el campo vaya a abrazarlos y darles cariño e incluso últimamente en las propias plazas de toros, durante la lidia, como ha hecho una señora creo que en Marbella. Todo eso me parece muy bien, pero lo malo es que están falseando la realidad y tratando de «desnaturalizar» las cosas. Ahora dicen que el toro de lidia no es una especie propiamente dicha, sino un bovino más. Vamos a ver, todos los perros del mundo descienden del lobo. Eso está claro. ¿Que tiene que ver en su comportamiento y en su aspecto un caniche con un lobo? Se han establecido unas diferencias bien claras. Todos los bovinos descienden del antiguo Uro. El Uro se extinguió en Lituania en el siglo XVII. En España quedaron las vacas y toros mansos y quedó un género especial, en estado semisalvaje, que es lo que hoy es la ganadería de lidia. Los romanos conocían bien al toro de lidia. No llevaban a sus circos a pelear contra leones y gladiadores a vacas pastueñas. Llevaban toros bravos. Estos toros en algún tiempo estuvieron por toda Europa, pero al final, solo se conservaron en España y Portugal. Como se usaban en las justas y torneos no se les extinguió por eso. El toro de lidia es un animal que solo debe su existencia a la participación en este tipo de festejos. Es verdad que, mediante la selección (fundamentalmente mediante la eliminación de las madres menos bravas) las diferentes castas de toros se han conservado bastante íntegras. El toro es un animal formidable, sin duda el mas valiente que existe. Aunque nunca ataca a traición, sus ataques son formidables y se pueden producir ante cualquier pequeña excitación. Sus defensas son todo para un toro. Si el toro pierde o se lastima un cuerno se queda retraído y es la mitad de toro que era antes. Aunque machos y hembras se crían separadamente, las peleas entre los toros son muy frecuentes. Son peleas a muerte e las que uno de los contendientes casi siempre termina muy mal parado. El toro derrotado en la pelea se denomina «abochornado» y se retira un tiempo de la manada. Durante ese tiempo el toro se vuelve peligrosísimo. Suele ser cuando matan a sus ganaderos y criadores. El toro bravo es toro ante todo y si se le pone por delante una vaca de leche también la deja preñada sin ningun problema. Es la misma raza, pero con muy diferentes connotaciones. Esta especie no es productiva ni como productora de carne ni leche. Todo su valor económico reside en las corridas de toros. Siendo uno de los animales mas bellos y hermosos de la  Creación, con ese bellísimo componente de la bravura, posiblemente sin las corridas lo perderíamos y España perdería su totem nacional numero uno. No queremos que el toro sufra, odiamos su espantosa muerte a estoque pero no queremos perder al toro tampoco. Habría que conciliar mediante una nueva especie de espectáculos taurinos en las que el animal no sufra ningún daño para que pueda continuar criándose y se productivo. Propongo las corridas de recortes, forcados, Don Tancredos, dominguillos o cualquier innovación de las muchísimas que se pueden hacer, pero por favor, no perdamos a nuestro toro de lidia , lo debemos conservar a todo trance.</p>

<p> </p>
";"17/09/2015 01";"79";"54";"25";"11";"950895344";"1982"
"3959";"Que te informen si te censuran";"<p>Ya que tienen nuestro correo, porque para registrarse hay que darlo, que cuando eliminan un tema que has propuesto que al menos te envíen un correo diciendo que se ha eliminado.

Lo de esperar que te digan el motivo ya es casi ciencia ficción. 

 </p>
";"17/09/2015 05";"59";"55";"4";"2";"958361406";"4754"
"3960";"Primeros 30 minutos de BICIMAD gratuitos y MEJOR FUNCIONAMIENTO!!!";"<p>Como en Barcelona. Pagas 40 al año y el servicio es gratuito la primera media hora. Ahora mismo es muy caro para el servicio que da. Aparte de que deben sancionar a la empresa: algunas estaciones siempre vacias, siempre bicis en rojo, no se arregla el problema de los anclajes....</p>

<p>un gobierno de iniciativa popular debe apostar por un servicio de bici accesible y bueno y acabar con el imperio de las cuatro ruedas en el centro. Medidas YA!!!!</p>
";"17/09/2015 08";"304";"268";"36";"10";"964356067";"20452"
"3961";"Unificar imagen Centro Madrid";"<p>El centro de Madrid tiene que guardar una estética y se está convirtiendo en una feria. Propongo que todos los distritos de centro guarden una imagen uniforme. Me refiero a rótulos de locales, toldos, banderolas, etc. Pues los locutorios, tiendas de alimentación, electrónica, etc llenas sus fachadas de horribles carteles de todos los colores. Esto perjudica la imagen de nuestra ciudad que debemos de mejorar.</p>
";"17/09/2015 08";"94";"79";"15";"6";"958741260";"5378"
"3962";"Alcorques ecológicos";"<p>Alcorques ecológicos en todo el centro de Madrid. Los actuales parecen vertederos.</p>
";"17/09/2015 08";"113";"104";"9";"2";"961823938";"8743"
"3963";"Recogida neumática de basuras Centro Madrid";"<p>Propongo la instalación de un sistema de recogida de basuras neumático. Esto evitaría olores. Las calles estarían más limpias, podriamos tirar la basura a cualquier hora del día. Y en consecuencia al necesitar menos empleados para su recogida estos podrían pasar a la limpieza de calles y tendríamos una ciudad mucho más limpia.</p>
";"17/09/2015 08";"79";"61";"18";"9";"956529290";"3320"
"3964";"Zona SER gratis un número determinado de horas anuales por vehiculo";"<p>Estimados Srs,</p>

<p>Dado que ya pagamos el IVTM creó que seria interesante que el mismo nos diese derecho a disfrutar de la zona SER un número determinado de horas anuales de forma que quedara cubierto el uso esporádico y racional de la misma por los contribuyentes.</p>

<p>Muchas gracias.</p>
";"17/09/2015 09";"75";"53";"22";"4";"954563047";"2190"
"3965";"Paradas de transporte publico libres de humo";"<p>Es habitual ver gente fumando esperando el bus o el tren mientras fuma, bien bajo una marquesina o bien en un anden pero con el detalle de con gente alrededor fumafores o no.</p>

<p>¿Debe ese no fumador aguantar los humos del tabaco? Una ordenanza municipal regulando la prohibicion de fumar en lugares de espera de transporte publico es posible creo yo.</p>
";"17/09/2015 09";"88";"69";"19";"12";"957530604";"3920"
"3966";"Igualar los permisos de maternidad y paternidad";"<p>Iguales e intransferibles.</p>
";"17/09/2015 09";"139";"131";"8";"5";"963830044";"11592"
"3967";"Permiso paternidad y maternidad, de 16 semanas";"<p>Iguales e intransferibles</p>
";"17/09/2015 10";"74";"67";"7";"4";"960346794";"5432"
"3968";"Cambio ubicación taxis estación Atocha";"<p>Debido al cambio que se produjo con respecto a la ubicación de la entrada de taxis en la estación de Atocha, la calidad de vida de los vecinos se ha visto afectada notablemente. Debajo de nuestras casas, a lo largo de toda la calle Mendez Álvaro y aledañas, se hacen durante las 24 horas unas colas (de más de 100 vehículos) inmensas que ocupan un carril de circulación, impidiendo aparcar o sacar el coche del carril que tapan. Esto provoca continuos altercados. Como también los provoca que los taxis de las bocacalles intenten colarse en la infinita fila. Pitidos, taxistas que orinan en plena calle, gritos, motores continuamente arrancados... nos han llevado a poner múltiples denuncias ante las cuales se presenta un patrulla que soluciona la cosa, pero solo momentáneamente. En una zona que debería ser protegida medioambientalmente, el ambiente se hace irrespirable, los niños no duermen, tenemos un vía crucis para aparcar o sacar nuestros coches... Creemos que la anterior ubicación no era tan molesta, pues no había viviendas tan cercanas. Y pedimos que se regule esto de alguna manera, pues está afectando a nuestra salud física y anímica.</p>
";"17/09/2015 10";"45";"39";"6";"3";"957633943";"2860"
"3969";"Auditoría de seguridad vial en los entornos escolares  ";"<p>Mala señalización, escasez de pasos peatonales, coches en doble o triple fila, y los niños entrando y saliendo apresuradamente del colegio. ¿Podemos presumir de apostar por la movilidad mientras mantenemos estos niveles de inseguridad en las puertas de los colegios? El objetivo de esta propuesta es obtener un mapa real del espacio público en el que se ubican los centros escolares para poder elaborar una batería de soluciones realistas que puedan eliminar, o al menos paliar, los problemas detectados aumentando la seguridad de nuestros niños y la confianza de sus padres.</p>
";"17/09/2015 10";"81";"76";"5";"1";"961935144";"6661"
"3970";"Cercanías red troncal y metro red de acceso";"<p>En los últimos años la red de metro ha crecido muchísimo, en relación a red de cercanías que crece muy despacio.</p>

<p>Lamentablemente tenemos, en mi opinión, un red de cercanías escasa y un metro que para largas distancias no es práctico (p.e. L10 con el transbordo en Tres Olivos para ir de sur a norte o viceversa).</p>

<p>Hay zonas donde se concentran muchos trabajadores, p.e. en la carretera de Fuencarral a Albobendas empresas como Telecinco, Huawei, Alcatel-Lucent, BT y Telefónica y el trasporte público disponible (que lo hay) es francamente mejorable, pues habiendo metro en la zona, tendría que haber sido un Cercanías o haberlo enlzado con Cercanías a la altura de Telecinco moviendo al norte la actual estación de Cercanías (llamada Fuencarral, que no tiene nada que ver ni está cerca de la homónima de metro ---&gt; esto es otro debate).</p>

<p>Es decir, se está usando el metro como red troncal, pero con las características de un metro: muchas más paradas que un Cercanías, y nada de ir directo... va dando vueltas para servir a los barrios colindantes.</p>

<ul>
	<li>P.e. ir desde Telefónica a Chamartín en metro cuesta media hora (metro lento).</li>
	<li>P.e Ir desde Telefónica a Chamartín en bus (T61) y Cercanías cuesta media hora (atasco del T61, transbordo muchas veces no coordinado). Además si no tienes abono, son dos billetes!!!</li>
</ul>

<p>All final... la gente que tiene coche, va en coche...</p>

<p>Luego están las nuevas oficinas del BBVA y alrededores (también en las Tablas), ¿cuánta gente va ahí a trabajar todos los días? ¿qué opciones de transporte público rápido hay? --&gt; ¿ninguna? --&gt; pues la gente coge el coche...</p>

<p>En definitiva, creo que hay que acercar el Cercanías a los grandes núcleos de trabajo o bien conectar esos núcleos de manera rápida con la red de Cercanías... si se opta por el autobús para este acercamiento, estos deberían circular por carriles no atascados y tener preferencia sobre el transporte privado.</p>

<p>El autobús T61 (Estación de Fuencarral -- Las Tablas) en estos momentos es un suplicio en hora punta... esto hay que mejorarlo... hasta tiene que hacer un <strong>stop </strong>en la salida de la estación cediendo paso a los vehículos que giran...</p>

<p>¿No se puede llevar un tranvía desde la estación de Cercanías hasta los núcleos de trabajo mencionados por una plataforma preferente? (el tranvía puede ir cerrando semáforos para los coches a su paso, como pasa en la ciudad de Vitoria y permite la carga paralela de pasajeros)</p>

<p>¿Alguien ha pensado que un tren descarga por múltiples puertas y que en un autobús normal de la EMT (no gusano) los pasajeros tienen que subir todos por una sola puerta? ¿saben las colas que se montan?</p>

<p>Debatamos...</p>

<p> </p>
";"17/09/2015 10";"71";"66";"5";"1";"961164219";"5670"
"3971";"Eliminar ""trampas"" en la zona de la ORA";"<p>Existen zonas de ""reserva compartida"", es decir sitios donde está señalizado con líneas verdes de aparcamiento y además es zona de carga y descarga según horario, por ejemplo en la plaza de Tirso de Molina. Esto es una auténtica trampa recaudatoria, pues estás buscando aparcamiento, ves las líneas verdes, aparcas y sacas el tiquet en la máquina. Cuando regresas te encuentras una multa además de haber pagado el tiquet. Al no comprender (al menos la primera vez que aparcas allí) miras y ves que existe una placa vertical que te cuenta lo de reserva compartida y además está tapada por un camión. Por favor pinten rayas amarillas de zig zag en el suelo para advertir, esta señalización está contemplada en el código de circulación.</p>

<p> </p>
";"17/09/2015 10";"111";"104";"7";"2";"963200794";"9088"
"3972";"Tasa a los bancos con cajeros en la vía pública que cobren comisiones abusivas";"<p>Propongo que el Ayuntamiento de Madrid cobre una tasa a todos aquellos bancos con cajeros en la vía pública y que cobren comisiones abusivas a sus clientes. </p>
";"17/09/2015 11";"272";"242";"30";"6";"965560278";"18861"
"3973";"Mas control para hacer respetar las zonas de prohibiciones";"<p>Como vecino de la Av de Gudalajara 65,  28032 Madrid, y en otras calles del distro de San Blas, pido que la autoridadad competente ? haga cuymplir  las normas,  las prohibiciones de estacionamiento ,   las de circulacion... salvo a vehiculos autorizados, como son ambulancias, bomberos policia, ect... ya que en dichas zonas que exiten estas prohibiciones podemos ver,  como ocurre en mi callle ...que hasta para tomar una caña en el bar aparcan en dicha zona, se realizan desacargas, vecinos se toman dichas zonas como propias  teniendo su vehiculo  ante la puerta de su casa ? cuando esta totalmente prohibido, por eso una de dos o retiramos dichas prohibiciones o que la autoridad competente haga valer  su poder para el cumplimento de dichas normas, con lo que sera un beneficioso para todos.</p>
";"17/09/2015 11";"51";"43";"8";"2";"958002468";"2950"
"3974";"ACCESIBILIDAD ESTACION DE CERCANIAS RAMON Y CAJAL.(HOSPITAL)";"<p>Soy trabajadora de este hospital desde hace mas de 20 años, y usuaria de renfe habitualmente. A pesar de que ha pasado todo este tiempo, sigue siendo una estación inaccesible para personas con movilidad reducida, y no me refiero a personas que precisan silla de ruedas para trasladarse.</p>

<p>Prácticamente, cualquier persona con pequeñas limitaciones es incapaz de subir o bajar a estos trenes, por la altura y separación desde el andén, y además no existe ni escaleras automaticas , ni rampa, ni ascensores .... HABLAMOS DE UN HOSPITAL¡¡¡¡</p>
";"17/09/2015 12";"112";"109";"3";"2";"964753708";"10316"
"3975";"Evacuación masiva";"<p>Estamos en días de preparación de las fiesta navideñas y nos encontramos sacando el coche del aparcamiento subterráneo del Centro Comercial, pero, a poco, hemos de parar en uno de sus pasillos mientras otros coches se nos agolpan por detrás:   Claro, a todos nos ha dado por venir de compras y las calles circundantes, siempre saturadas de vehículos, no permiten acceder a los que intentamos salir.     </p>

<p>Pasa el tiempo, que se hace eterno, y la mayoría de los conductores hacemos sonar insistentemente el claxon, con lo que los nervios se disparan.   Tampoco podemos respirar, ya que el monóxido de carbono inunda los pulmones, ya que mantenemos  todos los coches encendidos.     Mientras, pasa el tiempo y nadie puede avanzar.  </p>

<p>¿Pero es que no hay nadie del Centro Comercial que diga por telefonía que se apaguen los motores y los que puedan que aparquen en las plazas libres, despejando pasillos, y se marchen a casa a pié, que llegarán antes?   Claro que podría ser peor:   Si fuese por un accidente o atentado, y por ello se apagasen las luces, alumbrándonos únicamente con las débiles lámparas de emergencia, al tiempo que las alcachofas antiincendios nos lanzasen agua </p>

<p>¿Es que no hay Planes de Emergencia?  ¿Por qué no estamos los ciudadanos preparados por falta de información?  ¿Nadie coordina nada en los primeros momentos?  ¿Es que nunca ha pasado nada anteriormente?  ¿Por qué somos eficaces organizando el minuto de después y no dedicamos ninguno antes para conocer el evitar o paliar las consecuencias?</p>
";"17/09/2015 12";"13";"10";"3";"1";"951666640";"538"
"3976";"Mayor protección de edificios con valor arquitectónico/artístico";"<p>Ante los numerosos casos de desprotección y derribo de edificios antiguos en los últimos años en Madrid, solicitamos una mayor protección y rigor en la conservación de los mismos y de todos sus elementos. Basta de destrozar Madrid!!!</p>
";"17/09/2015 13";"375";"364";"11";"5";"970261234";"34264"
"3977";"Pago de tasas con tarjeta en las oficinas, además de en los bancos";"<p>Me parece increible que haya aun muchas tasas, e impuestos que solo se puede abonar personandose en unas entidades bancarias determinadas. No entiendo que porque  no se puede pagar directamente en las oficinas de atención al ciudadano o en mi casa con una tarjeta bancaria. En la Comunidad de Madrid se puede pero el Ayuntamiento de Madrid en este aspecto es menos accesible y facilitador.</p>

<p>El debate es que si hay alguna razón por la que se hace asÍ.</p>

<p>Se ahorraría tiempo, papel y se ganaria en comodidad para el ciudadano.</p>

<p>Comienzo este debate.</p>

<p>Para que se pueda pagar todas las tasas e impuestos municipales desde casa o directamente en ventanilla</p>
";"17/09/2015 13";"76";"73";"3";"1";"963559871";"6723"
"3978";"PLANTAS DONADAS PARA LOS ALCORQUES DE LAS CALLES CENBTRICAS";"<p>La mayoria de los alcorques son utilizados para dejar basuras, botellas, cajas y un sin fin de objetos,  ademas de ser urinarios para perros y alguno que no son perros.</p>

<p>En el parque de El Retiro hay un invernadero que,  de vez en cuando regalan plantas. Seria buena idea y practica que a los vecinos y comerciantes se les donara plantas resitentes para cubir dichos alcorques, de esa manera   se evitaria que fuera vertederos  y al mismo tiempo  ayudariamos al medio ambiente ademas de  adornar las calles de Madrid que son preciosas por cierto.</p>
";"17/09/2015 14";"29";"27";"2";"3";"959264636";"2327"
"3979";"Reciclaje aceite usado y producción de jabón en cooperativas";"<p>Ha habido ya varias propuestas sobre la necesidad de poner contenedores para que se pueda reciclar el aceite usado y no acabe, entre otros sitios, en el desagüe de nuestras casas. Yo creo, que en combinación con esta propuesta se podría aprovechar para impulsar la creación de cooperativas en los barrios que utilizasen parte de este aceite para hacer jabón como lo hacían nuestras abuelas, de manera artesanal. Esto podría ayudar a crear empleo en los barrios, a reciclar el aceite sin añadir mucha carga de trabajo a la recogida de basuras y a hacer que se quedase en los barrios de Madrid un dinero que de otra manera iría a las grandes superficies y a las grandes multinacionales. El ayuntamiento podría ayudar formando a los interesados en crear estas cooperativas en cómo se hace el jabón, dejando que utilizasen de manera gratuita el aceite reciclado, dando ayudas directas para la formación de estas cooperativas, ayudándoles a hacer planes de viabilidad y dando publicidad a las que se vayan creando, ya sea con un mapa de cooperativas en alguna página del ayuntamiento o con espacio en tablones de las juntas municipales y los demás edificios municipales para que se publiciten.</p>
";"17/09/2015 14";"388";"373";"15";"10";"970759664";"34415"
"3980";"Impuesto de vehículos. Baja y pago prorrateado.";"<p>Cuando se da de baja temporal un vehículo del impuesto te hacen pagar todo el año aunque sólo esté de alta un mes en ese año. </p>

<p>Pienso que lo lógico es pagar por el tiempo efectivo de alta durante el año.</p>
";"17/09/2015 15";"111";"106";"5";"4";"965439713";"9645"
"3982";"Limpieza: servicio, concienciación, educación...";"<p>Estimado equipo de gobierno,</p>

<p>Tras sus primero 100 días de gobierno, algo muy importante, que afecta  a la ciudad, a sus ciudadanos y sus visitantes, sigue igual incluso peor. Me refiero a la limpieza de las calles, de los parques, la recogida de enseres y los excrementos de mascotas en vías publicas.</p>

<p>En días pasados he leído una carta de Ines Sabanes achacando la suciedad a los contratos firmados por el anterior equipo de gobierno y las contratas. En mi opinión, esa no puede ser excusa, como tampoco lo era la justificación que daba Rajoy a las subidas de impuestos por la nefasta herencia de Zapatero.</p>

<p>Pienso que hay que abordar el problema ya, con acciones urgentes, denunciando contratos si están mal, subcontratando nuevos servicios o pasando la gestión de los mismos al consistorio.</p>

<p>Pero también hay que hacer campañas que conciencien al ciudadano, que le ayude a reflexionar y colaborar no dejando desperdicios en vía publicas, enseres viejos, ni escupiendo o fumando en la puerta de edificios y dejando colillas. </p>

<p>Madrid no es una papelera como piensan una gran mayoría de sus ciudadanos.</p>

<p>Obviamente, esa educación de base no se cambia en un día, pero algún día hay que empezar y para ello que mejor que campañas educativas en colegios públicos, privados y concertados.  Campañas publicitarias en metro, redes sociales y medios afines  con el fin de no incurrir en gastos en medios.</p>

<p>Una mayor vigilancia policial en contenedores de reciclaje, basta ya de furgonetas extrayendo papel de los contenedores y dejando lo que no les sirve en medio de la calle ante la impasibilidad de la policía.</p>

<p>Acabemos con los chatarreros con los carritos de supermercado desguazando motores, cañerías o frigoríficos en medio de la vía publica o volcando contenedores para ver que pueden sacar.</p>

<p>Imponiendo sanciones a las empresas que dejen sus residuos apilados en los contenedores de reciclaje.</p>

<p>Una menor permisibidad con los botellones, no ya por el daño que se hacen a ellos mismos, si no como queda la ciudad al día siguiente.</p>

<p>Sancionando a los dueños de perros que dejan sus excrementos en la vía publica o parques, por no ser muy duros una primera de apercibimiento y en caso de reincidencia una multa con alto importe económico.</p>

<p>Creo que hay muchas medidas que se pueden tomar, tanto en los servicios municipales como en la concienciación del ciudadano y, aunque no me gusten las sanciones, creo que por una buena e higiénica convivencia, en determinados casos de reincidencia, serían una solución.</p>

<p>Cualquier ciudad de Europa, con servicios de limpieza menores  a los que ""disfrutamos"", está más limpia que Madrid.</p>

<p> </p>
";"17/09/2015 17";"158";"150";"8";"24";"967693742";"13481"
"3983";"Fuentes públicas";"<p>Desde hace unos años, sin explicación alguna, se han ido reduciendo las fuentes de las calles. Sin ir más lejos, recuerdo una, quizás centenaria, que había en la esquina de la Avda. Daroca con la calle Apóstol Santiago y que desapareció sin pena ni gloria. A lo mejor se colocó decorativamente en el jardín de algún consejero...</p>

<p>El caso es que en la actualidad, no se puede salir de casa sin la botella de agua o, en su defecto, comprarla por la calle a precios desorbitados. </p>

<p>Por favor, devuélvannos nuestras fuentes.</p>

<p>Gracias.</p>
";"17/09/2015 17";"317";"305";"12";"4";"970840893";"28190"
"3986";"División del distrito Latina en dos...";"<p>Está incluido en el programa electoral de ""Ahora Madrid""... El actual distrito de Latina es el más poblado de la ciudad, lo cual implica que sea más difícil de gestionar, por lo que se hace necesario dividirlo en dos de tamaño y población ""manejables"". Esta reestructuración podría afectar, incluso, a otros distritos colindantes, como pudiera ser Moncloa, que engloba a la Casa de Campo, que podría pasar a uno de los nuevos distritos en que se dividiera Latina.</p>
";"17/09/2015 17";"42";"35";"7";"4";"959580140";"2333"
"3987";"Papelotes en los organismos públicos";"<p>Por lo general, en cuanto accedes a las oficinas o centro perteneciente a un organismos público, antes de preguntar dónde está la ventanilla que te corresponde, intentas ser autosuficiente y te fijas en la estancia. </p>

<p>Al lado de cada ventanilla te encuentras numerosos papelotes pegados al cristal o a la pared con papel celo: a veces hay folios, otras veces cuartillas, casi siempre escritos en mayúsculas, pegados de cualquier manera, o incluso escritos a mano con bolígrafo. Los mejores son los que, además, están subrayados, y por si acaso, también marcados en amarillo con el stabilo boss. Por supuesto cada papel dice algo diferente, por lo que después de un buen rato leyendo, al final tienes que preguntar a alguien cual es la ventanilla que te corresponde.  Evidentemente, la siguiente vez que tienes que ir al mismo centro, ya no te fijas en los papelotes porque vas directamente a tu ventanilla. </p>

<p>Estamos rodeados de papepoles en los centros oficiales de organismos públicos que nadie hace caso porque no están ordenados, explicados ni con un orden coherente: la dispersión en tal, que supone una auténtica agresión a la vista. No es necesario que subrayen ""es imprescindible el DNI"" o ""sonría,  es gratis"" porque ya nadie lo lee,  ya forma parte de la pared o el cristal. </p>

<p>Por favor, ¿sería posible centralizar todas las normas a cumplir, bien explicadas, en un lugar visible en los accesos a los centros, y aquellas otras obligaciones que deba conocer el contribuyente, situarlas de una forma ordenada con carteles bien construidos, tal que, evite ver ese despliegue masivo de papelotes pegados con papel celo?</p>

<p>Opino que la imagen es importante, sobre todo en los organismos públicos. No cuesta mucho más dinero y queda más correcto.</p>

<p>Qué os parece?</p>

<p>Saludos a todos</p>
";"17/09/2015 18";"34";"32";"2";"1";"961445786";"2823"
"3988";"Cambio de los nombres de las calles de Madrid";"<p>Propongo que el Ayuntamiento y su alcaldesa dejen de perder el tiempo en una ....... llamarla como queraís y se preocupe más en incentivar el turismo a nuestra ciudad, en la limpieza de ella, en crear más centros de dia y comedores sociales, en la limpieza, poda y mantenimiento de las zonas verdes de la capital, en potenciar la económia de la ciudad y crear más puestos de trabajo atrayendo a empresas, ya sean nacionales o extranjeras, y otras muchas más iniciativas que de verdad son prioritarias para l@s madrileñ@s. Un saludo</p>
";"17/09/2015 18";"88";"40";"48";"11";"944103363";"-363"
"3989";"Carril Bici entre el Parque Emperatriz María de Austria y Madrid Río.";"<p>La conexión entre el carril bici del Parque Emperatriz Maria de Austria con el de Madrid Rio (les separan poco más de 2km de recorrido) es inexistente y muy peligrosa. Desde Plaza Eliptica hasta Madrid Rio hay espacio suficiente para poder habilitar un carril en el que se pueda transitar con seguridad y unir así dos puntos verdes de gran transito en Madrid Sur.</p>
";"17/09/2015 18";"162";"148";"14";"1";"967116430";"12241"
"3990";"Mismos libros de texto en todo Madrid";"<p>No entiendo como puede ser que cada colegio tenga unos libros diferentes, que además cambian cada año. Unificar libros de texto y hacer que el mismo libro dure un periodo de tiempo prudencial, haría que los ciudadanos ahorremos cientos de euros al año.</p>

<p>Otra cosa que habría que perseguir es que se usen libros en los que haya  que resolver ejercicios escribiendo en los mismos. Es otra práctica que usan las editoriales para garantizar que un libro muy caro solo dure un año.</p>

<p>Una vez puesta esta medida, con coste 0 y que sin embargo ahorra mucho, sobre todo a familias con varios hijos, el siguiente paso sería que los libros fuesen públicos y gratuitos, devolvíendose al finalizar el curso. Pero esto último es imposible si al año siguiente ya no sirve el mismo libro.</p>
";"17/09/2015 18";"373";"341";"32";"9";"970549392";"28249"
"3991";"REFERENDUM SUBVENCIÓN TOROS";"<p>Quizás prohibirlos es una medida demasiado radical pero sí nos podrían preguntar a los madrileños si queremos subvencionar este tipo de ""fiestas"" con nuestro dinero, si queremos utilizar parte de nuestro presupuesto para ayduar a este tipo de espectáculos o si preferimos que ese dinero se dedique a espectáculos donde no sufra ningún ser vivo. El maltrato animal en general y en particular las corridas de toros es algo que debería estar abierto a debate por la confrontación que genera. ¿Solución? REFERENDUM YA! </p>
";"17/09/2015 18";"402";"346";"56";"31";"969086333";"24960"
"3992";"Zonas de acceso restringido";"<p>La regulación de acceso para residentes en estas zonas son muy complicadas y restrictivas, especialmente para personas mayores. Deberian ponerse otro sistema de autorización de matriculas más flexible.</p>

<p> </p>

<p>¿ Por qué quien paga el impuesto de vehiculos en Madrid, no tienen ningún beneficio respecto del resto de ciudadanos, en relación al tráfico, aparcamiento, zonas SER, etc?</p>
";"17/09/2015 18";"20";"15";"5";"0";"955267461";"750"
"3993";"APR unico";"<p>Madrid es una ciudad radial, sin embargo, los que vivimos en un APR tenemos prohibido circular por los otros.</p>

<p>Ello provoca que se aumente el trafico innecesariamente, por tanto mas congestion y contaminacion y se nos produce una perdida de tiempo innecesaria.</p>

<p>PROPONGO QUE EL APR SEA UNICO, tecnicamente el cambio es inmediato y por ello sus beneficios se pueden ver enseguida.</p>

<p> </p>

<p>Gracias</p>

<p> </p>
";"17/09/2015 18";"19";"10";"9";"4";"949273032";"52"
"3994";"impuestos segun renta de manera proporcinal";"<p>Que todos paguemos impuestos según la renta y de una menra exclusivamente proporcianal donde el que solo tenga para vivir, en un mismo impuesto paque como mínimo un euro y así proporcinalemtne hasta un máximo lógico y superior al establecido como común a día de hoy. No digo unos todo y el resto nada, todo de manera proporcional y que paguemos todos, los que no tengan para comer que paguen un euro simbolico y así avanzando proporcinalmente hasta los más ricos que paguen un máximo por encima de lo que está establecido para todos, con un tope máximo claro. El reparto es primordial. Si uno no puede no puede, si otro puede un poco más pues un poco más, si otro puede incluso un poco más, pues más que el anteiror y si otro si puede mucho, pues el máximo en su tope, no es deavariado ni inapropiado, es de sentido común. Si el rico se arruina verá como le gusta la norma de no tener que pagar apenas impuestos cuando no tenga dinero. Y muchos ricos han acabado arruinados. Que la vida es la vida y no es un juego.</p>
";"17/09/2015 18";"131";"112";"19";"16";"964906467";"7951"
"3995";"hipodromo de la.zarzuela";"Quitar todo tipo de subvención al hipódromo de la zarzuela.Un ""deporte"" sin.seguimiento ninguno social,pagado en parte muy grande por los ciudadanos,a los cuales no  interesa ni tiene seguimiento ninguno y dejar de pagar grandes sumas de dinero a la dirección de dicho espacio ,la cual ha demostrado en los últimos años una más que pésima gestión ,dejando una deuda bárbara ,con incluso denuncias a su cúpula.investigar el pago de servicios en los últimos años a empresas de servicios en dicho recinto y comparar gastos con servicios realizados.";"17/09/2015 20";"188";"160";"28";"0";"966674580";"11234"
"3996";"¿ crear una tarjeta de aparcamiento para residentes temporales?";"<p>No hablo de ir  al centro a tomar algo, compritas , turismo...ocio en general. Hablo de residencia temporal justificada.</p>

<p> </p>

Tengo casa en madrid pero no puedo ir porque no es posible aparcar ni pagando, soy residente temporal <strong>sin derechos.</strong>

<p>En mi caso vivo en otra ciudad y ni siquiera puedo votar propuestas de esta página. Comprendo que estoy empadronada en otro lugar y que Madrid no es mi  1ªresidencia , pero si es mi 2ª residencia, aunque no puedo hacer un  uso  normal de ella por este tema.</p>

<p>Otro caso podría ser:  que uno tenga un familiar enfermo en Madrid centro y no pueda ir a cuidarle unos días porque no puede aparcar más de 4 horas..en transporte público ? con maletas , carros infantiles, o combinaciones imposibles, no siempre es posible.Parking privado? a veces no esta cerca o esta lleno además del coste elevado</p>

<p>Por favor ayuda!!</p>
";"17/09/2015 21";"83";"71";"12";"2";"964259201";"5046"
"3997";"limpieza";"<p>no es  soportar las  nominas  cantidad  excesiva  de  limpiadores.   mejor facilitar otros empleos.</p>

<p>es  precisar  a quien ensucie, basurice con tanta facilidad y tantas cacas  en lugares  publicos. eso no es cultura  y</p>

<p>debe pagar los costes de mantenimiento de limpieza  y falta de respeto  a quien actua civicamente.</p>

<p>de igual manera los actos vandalicos  --- quien  rompe paga</p>

<p>gracias</p>

<p>jose</p>
";"17/09/2015 22";"24";"9";"15";"4";"946523182";"-225"
"3998";"Vecinos temen que su edificio sea el próximo en derrumbarse";"<p><strong>¿Puede el ayuntamiento garantizar la seguridad de los edificios de la capital?</strong></p>

<p> </p>

<p><strong>Los servicios municipales del área de urbanismo se encuentran sobrepasado</strong>s. Así lo ha asegurado un técnico municipal con impotencia a los vecinos de José Calvo N9. Estos temen que su edificio se derrumbe debido a unas filtraciones que están <strong>afectando a la estructura.</strong> Esperan desesperadamente una solución tras saber que su edificio podría venirse abajo si no se actúa con celeridad. </p>

<p> </p>

<p>Nos encontramos ante un ejemplo más en el que los técnicos necesitan más recursos para poder garantizar la seguridad del patrimonio inmobiliario de la capital. Quizás deberíamos replantearnos modificar la normativa que regula las ITEs. No resulta razonable que un edificio de más de 100 años este obligado a tener menos revisiones que un vehículo con 4.</p>

<p>¿Qué opináis? </p>

<p> </p>
";"17/09/2015 22";"64";"61";"3";"3";"966298780";"5528"
"3999";"Música en el METRO todos los días ";"Los lunes Jazz, los martes clásica, los miércoles caountry, los jueves rock, los viernes flamenco y los domingos running

<p>Estaremos esperando cada día cuando entremos en los vagones del metro¿ que tema escucharemos?  En lugar de tener cara de aburridos, cara de funeral nos cambiará el gesto cada vez que a través de los altavoces de los vagones o del pasillo de los andenes oigamos jazz o rock según sea lunes o jueves. El domingo con la camiseta de running o las mallas estaremos a tope con ganas de empezar la carrera</p>

<p>No cuesta nada, es original y te cambia el humor. ¿ por qué no?</p>
";"17/09/2015 23";"83";"45";"38";"2";"954563184";"379"
"4000";"Integrar Decide Madrid con Twitter y Facebook ";"<p>Decide Madrid debe aprovechar el potencial para compartir y desarrollar conocimiento que tienen las redes sociales. La idea de esta herramienta es maravillosa, pero las propuestas y debates se pierden en seguida fuera de la primera página y dejan de tener votos. </p>

<p>Añadiendo la opción de compartir en Twitter o Facebook se daría visibilidad a las propuestas y debates y además se fomentaría el uso de la misma y el alta de nuevos usuarios.</p>
";"18/09/2015 00";"63";"54";"9";"0";"964218280";"3857"
"4001";"facilitar el acceso a mercados";"<p>Tras la ola de cerramientos de urbanizaciones ha habido mercados de pequeños comerciantes que antes eran fácilmente accesibles que ahora están mucho más distantes debidos a estos cerramientos. Creo que el ayuntamiento debería ayudar a los mercados correspondientes a encontrar soluciones con los propietarios y habitantes de esas urbanizaciones para que se pueda encontrar una manera de que la gente las cruce (o las bordee por un pasillo creado para conectar la urbanización con la calle aislada correspondiente). Un ejemplo de esto podría ser el mercado situado en la calle camarena, que debido al cerramiento de una urbanización contigua quedó sin fácil acceso desde la calle ocaña, haciendo que haya personas que hayan dejado de ir por su lejanía como pueden ser personas mayores a las que les cueste andar distancias medias o grandes.</p>
";"18/09/2015 01";"51";"50";"1";"0";"967159776";"4803"
"4002";"referendum inmigrantes en madrid";"<p>Queremos referendum sobre si se quiere ,o se quiere inmigrantes musulmanes en madrid.</p>
";"18/09/2015 01";"134";"36";"98";"6";"945851262";"-1665"
"4004";"Carril bici Barajas pueblo-Campo de las naciones-Canillejas";"<p>El barrrio de Barajas esta aislado salvo por el Metro. Tenemos un estupendo parque en el distrito, el parque Juan Carlos I.</p>

<p>Solicito que hagan un carril bici en la avenida de logroño para poder ir con los niños en bici de manera segura</p>
";"18/09/2015 07";"142";"126";"16";"5";"971270479";"9760"
"4005";"Barrido y recogida de hojas y otros residuos deberían ir unidos en el mismo acto";"<p>Existen zonas en las que los barrenderos únicamente amontonan hojas y residuos, pero no lo recogen, por lo que con el aire se vuelve a esparcir toda la basura y su trabajo no ha servido de nada; es decir han realizado un trabajo inútil que supone un gasto innecesario (ya que la zona termina quedando como al principio: sucia). Para optimizar la limpieza viaria se debe realizar la recogida de las hojas inmediatamente a continuación del barrido.</p>
";"18/09/2015 07";"253";"244";"9";"7";"976158386";"22664"
"4006";"Brigada civica municipal";"<p>Propongo la creación de una Brigada civica municipal que ayude, controle, conciencie e incluso multe a los ciudadanos que incumplan las normas de civismo. Estas brigadas también podrían ayudar a los ciudadanos en cuestiones informativas, informar al ayuntamiento sobre deficiencias en la vía pública, etc. Estos puestos de trabajo serian para Madrileños parados de larga duración mayores de 45 años que sufren una gran exclusión laboral. Que mejor que ellos para esta tarea? Experiencia, conocimiento de la ciudad.</p>
";"18/09/2015 08";"123";"83";"40";"11";"964770481";"2901"
"4007";"Dispersión de la información municipal en internet con tantas nuevas webs";"<p>No solo era complicado antes encontrar la información, es que además ahora están creciendo las webs como setas y por ejemplo en esta ni siquiera se puede encontrar un vínculo a la web oficial. Y ya ni hablo de las redes sociales... Están muy bien todas las iniciativas que se van planteando, pero nos estamos volviendo locos. Hay que construir con un poco más de cabeza y pensar que estas herramientas hay que hacerlas más fáciles para la gente que no somos nativos digitales porque al final abandonamos...</p>
";"18/09/2015 09";"110";"106";"4";"1";"973345657";"9829"
"4009";"Peaje a los usuares M30 y mejorar la frecuencia del trans pub.";"<p>Ya que la mayor deuda de Madrid es debido a la melomania del Sr Gallardon, y con un costo muy superior al presupuestado, esa parte de deuda deberia ser pagada por los usuarios de estas infraestructuras, a cambio se debe disminuir la frecuencia del metro y cercania y ampliar el horario de cierre. Y ya si fuera posible una linea circular de metro que una el sur con el noreste, por eje para ir de vallecas villa a canillas hay que ir al centro y volver. Se han hecho estaciones de gran lujo e infrautilizadas en ciertas zonas como Pitis, Mirasierra, Paco de Lucia....</p>
";"18/09/2015 12";"91";"14";"77";"5";"952384215";"-969"
"4010";"Peaje a los usuarios tunel  M30 y mejorar la frecuencia del trans pub.";"<p>Ya que la mayor deuda de Madrid es debido a la melomania del Sr Gallardon, y con un costo muy superior al presupuestado, esa parte de deuda deberia ser pagada por los usuarios de estas infraestructuras, a cambio se debe disminuir la frecuencia del metro y cercania y ampliar el horario de cierre. Y ya si fuera posible una linea circular de metro que una el sur con el noreste, por eje para ir de vallecas villa a canillas hay que ir al centro y volver. Se han hecho estaciones de gran lujo e infrautilizadas en ciertas zonas como Pitis, Mirasierra, Paco de Lucia....</p>
";"18/09/2015 12";"108";"16";"92";"5";"952417589";"-1125"
"4011";"Canon a los organizadores de las carreras populares";"Corremos y no somos ""yonkis del dinero"", solo queremos correr, y que 1/3 del presupuesto de lo mucho que se paga por una carrera popular se destine a reparar las pistas de atletismo de cada barrio. 

<p>Es una vergüenza el deterioro de las pistas de atletismo de los barrios de Madrid, a diferencia de las pistas de la periferia. salvo la reciente reparada de Moratalaz, es lamentable el estado en el que están las pistas de Aluche, Orcasitas, Parla, Arganda, Tres Olivos, etc </p>

<p>Mientras cada fin de semana existen 5 o 6 carreras sin que ninguna destine en el presupuesto un porcentaje para reparar esas pistas. Se podría imponer una medida de canon para que una minima parte fuera destinada a la reparación de los atletas que además de correr en carretera también corren entre semana en las pistas de atletismo de Madrid.</p>

<p> Es atletismo, tanto las carreras populares como la preparación en las pistas de atletsimo para correr esas carreras. Si son 2000 o 5000 corredores, una parte puede revertir en el propio barrio o en la propia ciudad.</p>

<p>  Corres para mejorar tu marca y corres para contribuir a mejorar el tartán de la pista de atletismo de tu barrio.</p>

<p> Es original la propuesta, es posible, y no cuesta casi nada una contribución en el precio de cada carrera que corremos a lo largo del año. </p>

¿ quieres que una parte de lo que se paga por una carrera polar se destine a reparar la pista de atletismo de tu barrio?
";"18/09/2015 13";"87";"82";"5";"2";"973240177";"7257"
"4012";"Ampliar el tiempo de validez del Bonotren de cercanías (10 viajes sencillos)";"<p>En la actualidad el periodo de validez del título del Bonotren de cercanías (10 viajes sencillos) es de<strong> un mes</strong>, desde el día n (fecha de inicio de validez) hasta el día n-1 del mes siguiente.</p>

<p>Al ser un título que en ocasiones es utilizado por personas que no frecuentan de forma diaria el cercanías, el periodo de un mes es muy escaso, provocando que se <em>pierdan </em>viajes al llegar el plazo de validez.</p>

<p>En la provincia de Barcelona el periodo de validez del mismo título es de 90 días.</p>

<p>Con el fin de normalizar los títulos entre los diferentes transportes <strong>el periodo de validez debería ser el que actualmente tiene el Metrobus</strong>.</p>
";"18/09/2015 14";"208";"201";"7";"2";"978071924";"18747"
"4013";"Prohibir a los niños jugar al balón en los parques";"<p>Estoy harto de recibir balonazos procedentes de los críos que juegan en mi parque. Mi padre perdió la vista de un ojo a consecuencia de un balonazo que recibió. No lo parece, pero esos golpes tan fuertes pueden suponer un riesgo para la gente. ¿Porqué no se van a jugar al balón a los centros habilitados para ello y nos dejan en paz a los ciudadanos pacíficos que paseamos por el parque o simplemente estamos sentados? Yo siempre les amenazo con que me voy a quedar con la pelota y así consigo que a veces me escuchen, pero no siempre.</p>
";"18/09/2015 18";"185";"20";"165";"3";"955263450";"-1567"
"4014";"Corridas de toros sin sangre";"<p>Yo soy taurino porque amo al toro y me emociona su belleza y su bravura. Los verdaderos antitaurinos son los que los matan y los hacen sufrir Las corridas actuales tienen que ser abolidas porque son criminales. El día que eso suceda, es muy probable que la especie del toro bravo se extinga. Eso tambien hay gente a la que no importaría que sucediera. A mí me importaría mucho. Por eso propongo que alguien se plantee la idea de celebrar corridas sin herir al toro. Sin banderillas, picas ni espadas. Solo verlo correr y atacar a los engaños. Terminado el espectáculo los toros serían recogidos, llevados a su ganadería de vuelta y en paz. Conseguiríamos dos cosas: evitar el sufrimiento animal, si es posible totalmente, y lograríamos que el toro se siguiese criando, con sus razas y castas como hasta ahora en las ganaderías de bravo. El toro es un animal muy hermoso y el espectáculo está en su sola presencia. Verlo correr y atacar es un espectáculo espléndido siempre. No es necesario pincharlo ni hacerlo sufrir.</p>
";"18/09/2015 18";"140";"94";"46";"13";"969338051";"3222"
"4015";"Propuestas ciudadanas organizadas";"<p>Hay muchas propuestas ciudadanas iguales, lo que hace que la navegacion por la pagina se complique. Deberia haber un equipo que las agrupe junto con sus votos (sin que se puedan duplicar). Las propuestas que se apoyan deberian de dejar de estar visibles, para poder visualizar las nuevas propuestas y asi hacer que la gente no abandone esta iniciativa y siga participando. Asi mismo deberia ser posible dejar de ver las propuestas que no se comparten para poder ver nuevas (dejar de verlas en la cuenta privada de cada uno, no para el resto). Tambien deberia crearse una app para que la gente se descargue en el movil y poder usar el tiempo que se pasa en el trasporte publico para aportar ideas y participar.</p>
";"18/09/2015 20";"107";"102";"5";"5";"977378983";"9246"
"4016";"Nunca un teatro publico medio vacio";"<p>Muchas veces los teatros públicos están medio vacíos. Se puede prever perfectamente complementar el aforo con colectivos que no tienen acceso normalmente a la cultura teatral. No debe ser gratuito, aunque sólo sea un precio simbólico, pues siempre debe de haber un mínimo interés por asistir y tener acceso, en este caso , a la cultura teatral. Pero es inconcebible que los teatros públicos estén medio vacíos. Es muy triste ver un teatro así, cuando hay fórmulas para llenarlos por el interés sociocultural teatral y general.</p>
";"18/09/2015 20";"171";"155";"16";"12";"978077854";"12599"
"4017";"1 entrada teatro privado=1 con descuento teatro publico";"<p>Después de utilizar una entrada de un teatro privado, con esa entrada se le haría un descuento muy considerable para cualquier teatro público de Madrid. </p>

<p>Es necesario promover el teatro en Madrid. Plantear nuevas formas y sugerencias atractivas para el público en general. Iniciativas que hagan que el consumo teatral cultural sea más interesante para el espectador. La cultura teatral, el espectador, el empleo, la pluralidad en la programación,la creacion, la economía, y el turismo; en definitiva el movimiento cultural con los beneficios que se supone con resultados por el mayor acceso de espectadores a los teatros que serían muy beneficiosos, en genera, para una ciudad referente e importante como Madrid.</p>

<p>Hay fórmulas y formas para racionalizar el teatro Público, en beneficio del espectador, sin hacer competencia al Privado, siendo este último quien más empleó promueve en la ciudad, entre los diferentes colectivos ,y por supuesto a nivel nacional.</p>

<p>El teatro de Madrid público y privado deben de ir de la mano en muchas cosas , por el interés sociocultural, económico y turístico de la Capital.</p>

<p>El teatro publico tiene como fin atraer espectadores y ofrecer programacion de interes sociocultural, diversa, plural y de calidad. El teatro privado tiene como fin atraer espectadores y ofrecer una programacion segun los criterios del empresario, cuyo resultado sea la calidad  de la programacion, y los resultados economicos para seguir creando empleo con nuevas producciones.</p>

<p>Ambos les une el interes comun de atraer espectadores. Ambos deben de ir de la mano por el interes comun de Madrid.</p>
";"18/09/2015 20";"48";"37";"11";"1";"969660391";"2004"
"4018";"PROFUNDA DECEPCION  CON ""DECIDE""";"<p>Con mucha pena tengo que comentar que a una propuesta de incentivación para el comercio barrial que podría generar muchos puestos de trabajo, he ejemplificado la tecnología empleada con dos links ilustrativos, dado que lo mejor es mostrar lo que existe y puede ser, mas que lo que..podría ser.Cuando hago la prueba de entrar a los links que por ejemplo ilustran Madrid en realidad virtual y visión en 3D y guía inteligente, me encuentro que le han puesto en código,NOFOLLOW que significa<em><strong> El atributo ""nofollow"" ofrece a los webmasters un modo de indicar a los motores de búsqueda ""No seguir los enlaces de esta página"" o ""No seguir este enlace ...</strong></em></p>

<p>He enviado en su oportunidad mails con la explicación de proyecto, destacando que antes de someter la propuesta a empresas privadas pretendía exponer el proyecto al Nuevo Ayto de Madrid, dado que en cuando lo presentamos a la anterior administración, sin que fuera visto, se lo consideró de no interés...vaya casualidad en el mismo mes obtuvimos un premio internacional en Monterrey ,Mejico por la misma tecnología.Tampoco pretendíamos éxito de gestión sin tener ningún contacto, pero al menos, por cortesía se nos contestó que NO interesaba lo que no se había visto.Los mails enviados a Urbanismo y Cultura de la actual administración, ni siquiera tuvimos respuesta por cortesía y aprovechando esta posibilidad de exponer propuestas, expuse en nombre de mi equipo, lo expuesto mas 2 links ilustrativos, vedados con el NOFOLLOW..Su pongamos el caso que se pensara que se trata de una publicidad de nuestra parte...Por un lado, podrían exponer las limitaciones, pero no...dicen que es un espacio de pensamiento..aham...manda eggs...Mis pensamientos han sido volcados en docencia, entre alumnos, la propia gerencia de urbanismo,Consejo superior de Deporte, Ministerio de Interior, Ministerio de Hacienda, mas de 42 artículos publicados en revistas técnicas y publicación del primer libro en habla hispana sobre la arquitectura a Través del Cad, presentado en TVE por Eduard Punset (puedo aportar documentación), siento que suene a fardeo, pero siento una profunda decepción por un equipo que creí realmente abierto y con intención de acercamiento.Vetar información ilustrativa de Madrid bajo Realidad Virtual sin publicidad alguna es ese ""tratamiento de TU""? Lamento Manuela Carmena que tu apoyo personal, tu ética y estética parezcan secuestrados por alguna impotencia..no se cual..si cargos gallardonistas que siguen por ahi.Quiero agregar que cuando el ""pensamiento "" de Zapata derramó el chiste sobre cenizas, salí a defenderlo, siendo mi étnia de origen judio y ni las gracias...EGO SUM amigos ...No se trata de jugar a lo despiadado tal la voluntad expuesta de vuestra parte, pero..un AYUNTAMIENTO...no es un video juego.</p>



&lt;p&gt;&lt;a href=""http://www.virtualaction.net/madrid3604d "" target=""_blank"" rel=""nofollow""&gt;http://www.virtualaction.net/madrid3604d 
";"18/09/2015 21";"32";"11";"21";"0";"955543086";"-343"
"4019";"Promover que los bares del centro permitan a los clientes entrar a mear";"<p>Partimos de un <u><strong>problema </strong></u>existente: Las calles del centro están llenas de orines en el centro de Madrid.</p>

<p>La solución propuesta: Por una <u><strong>mínima</strong></u> parte de lo que cuesta instalar y mantener baños públicos en la calle, se podría destinar ese dineroa a que los bares nocturnos permitan a los clientes entrar al servicio, y evitar las riadas en las calles?</p>

<p>Se podría pagar una cuota (pequeña!) a los bares que permitan entrar al baño a los no-clientes. Y poner un indicativo en la entrada del bar (ESTE BAR ES MADRID FRIENDLY)</p>

<p>Se puede <u><strong>controlar </strong></u>si un bar cobra del ayuntamiento pero impide a los no clientes entrar, ya que estos lo notificarían (llamando al 010)
Además el ""bonus"" a abonar a estos bares sería muy pequeño, ya que realmente estos bares se benefician de que los clientes entren y vean el local. En muchos casos tal vez consuman algo al salir. (bares de entrada gratuita para evitar conflictos).

Si no, la solución más popular sería instalar urinarios públicos (mayor coste?, peor aspecto?, peor olor?)
Otra opcíon son las multas, que requieren trabajo de la policía. Pero no es más caro esto? No serán más necesarios en otras tareas?
Y la última vía es no hacer nada y decir...que los jóvenes vayan a otro lado o no salgan.. lo cual es esquivar el problema.</p>
";"18/09/2015 22";"115";"70";"45";"15";"968218996";"1521"
"4020";"Rebautizar la calle Bolívar.";"<p>Es la calle que conecta desde la Plaza Legazpi hasta el parque planetario. El nombre de esta calle proviene de Simón Bolívar, el cual estuvo a la cabeza de la independencia de las colonias españolas a principios del siglo diecinueve. Tener esta calle es antipatriótico.</p>

<p>Propongo reubatizar la calle con el nombre de un héroe español; Blas de Lezo quien luchó y ganó a los ingleses en Cartagena de Indias.</p>

<p>VIVA ESPAÑA!</p>
";"18/09/2015 22";"103";"31";"72";"9";"954446624";"-1233"
"4021";"Biblioteca en barrio barajas pueblo";"<p>Antes de la crisis, había una sala de lectura-biblioteca de caja Madrid en el pueblo. Llegó bankia y la crisis y la sala se cerró. El local abandonado y lleno de libros.</p>

<p>Solicito una biblioteca para el barrio. No importa que sea modesta, pero necesitamos recuperar la biblioteca que habia</p>
";"18/09/2015 23";"52";"46";"6";"6";"974284024";"3538"
"4022";"Incremento del número de Taxis ";"En relación a la población actual, el número de licencias de taxi se ha visto reducido. Para ser justos, deberían otorgarse a no propietarios con cartilla de taxista.

<p>La exasperante carestía de taxis que soportan los madrileños, sobre todo por las noches y días festivos, tiene una explicación estadística: hay un 25% menos de los que había hace 10 años en relación con la población. Los 15.487 coches que atendían a 3,69 millones de personas en 1996 se han convertido en 4,97 millones de usuarios (un 35% de aumento) con sólo 159 licencias más (un 1%). El incremento de población y la incorporación de 19 municipios al servicio regional han hecho descender la ratio de 4,2 taxis por 1.000 habitantes a 3,15 en una década.</p>

<p>Decenas de miles de personas -cada día se hacen 600.000 trayectos en taxi en la región- han protagonizado en fechas como las navideñas, escenas que se están convirtiendo en habituales: mover los brazos como un espantapájaros intentando en vano <em>cazar</em> un vehículo libre.</p>

<p>Actualmente, según el padrón municipal y regional, es necesario incrementar el nº de licencias de autotaxi, por supuesto con coches no contaminantes, y según la ordenanza municipal, mediante concurso público.</p>

<p>Para ser justos, de avanzar ésta propuesta, deberían otorgarse únicamente a taxistas con cartilla y que nunca hayan sido propietarios/as ni familiar de propietario/a. Para evitar testaferros, una actividad constante mediante vida laboral, y la no titularidad de una licencia sería lo idóneo.</p>

<p>El descenso de taxis por habitante se acentuó con el crecimiento de población que han vivido todos los municipios del APC sin excepción.</p>

<p>Fuente: http://elpais.com/diario/2007/01/04/madrid/1167913455_850215.html</p>

<p>Apoyo a la Propuesta ciudadana:  https://decide.madrid.es/proposals/1602</p>

<p> </p>
";"19/09/2015 07";"81";"14";"67";"9";"959940501";"-916"
"4023";"Servicios de aseo gratuitos o a mínimo importe para gente sin techo";"<p>Dignamente los sin techo deberían de tener espacios gratuitos para asearse a diario o bajo un mínimo importe. Los que existen tienen un precio muy alto que pretenden sacar beneficios cuando deben de ser un servicio y no un negocio.</p>
";"19/09/2015 07";"208";"199";"9";"9";"985052625";"18177"
"4024";"Celebración de Fin de Año en Espacios Públicos Municipales";"<p>-Matadero Madrid</p>

<p>-Caja Mágica-</p>

<p>Madrid Arena</p>

<p> </p>

<p>Existen multitud de espacios municipales que podrían ser utilizados para crear un festival internacional de música, en cualquier fecha, con horarios diurnos y nocturnos, sin afectar al descanso de ni un solo vecino, ni a la seguridad de las personas.ni de los bienes municipales. Podría ser de hecho, una actividad para potenciar la imagen de Madrid, ingresando un rédito económico directo e indirecto.</p>
";"19/09/2015 07";"86";"57";"29";"7";"973095282";"1855"
"4025";"Se pueden poner puntos específicos de recogida para viajes en coche compartido?";"<p>Durante los últimos años han proliferado los servicios que ponen en contacto conductores y pasajeros para hacer viajes en coche compartido en recorridos de larga distancia (Blablacar, Amovens...). Muchos de estos viajes tienen como origen y destino Madrid, habiendo puntos habituales e informales de recogida. Ejemplos son las paradas de autobús de Moncloa (lateral Ministerio del Aire) o la gasolinera frente a la estación de Atocha. ¿Se debería hacer un estudio de puntos habituales de carga o descarga de viajeros y habilitar una franja específica para ello en ciertos puntos? Por un lado, compartir coche es una práctica que puede ayudar a retirar coches de las carreteras, pero destinar un lugar específico en el espacio público puede ahondar la primacía del coche en la ciudad.</p>
";"19/09/2015 10";"77";"59";"18";"3";"976965871";"3141"
"4026";"Linea 11 de metro: ampliación hasta Atocha";"<p>Antes del comienzo de la crisis, se hablaba de una línea del este semicircular que sirviera para intercomunicar todas las líneas de metro de un modo similar a la línea 10 de metro por el oeste de la ciudad. El proyecto original se puede ver en la wikipedia.</p>

<p>Ha sido apoyado por la oposición regional en varias campañas electorales. Desde la Consejería de Transportes se filtró a la prensa las intenciones de hacer esta ampliación, sin una fecha determinada, lo que convertiría a la 11 en una de las líneas más largas de la Red de Metro, con un total de 28 estaciones.</p>

<p>https://es.wikipedia.org/wiki/L%C3%ADnea_11_(Metro_de_Madrid)#/media/File:Futura_l%C3%ADnea_11.png</p>

<p>Con la crisis en el año 2010, esa nueva línea 11 ha quedado parada y ahora mismo sólo es un apéndice de la línea 6, lo que dificulta la movilidad de muchos ciudadanos de la zona sur de madrid.</p>

<p>Ahora mismo no existe dinero suficiente para realizar esta nueva línea que permitiera el enlace hasta el aeropuerto, pero creo que sí se podría plantear a la Comunidad de Madrid el inicio de las obras de ampliación de esta línea para empezar a enlazar con la línea 3 y la línea 1</p>

<p> </p>
";"19/09/2015 11";"113";"98";"15";"4";"981305747";"7198"
"4027";"Jardines en Valdebebas ";"<p>Algo que si que podría hacer el ayuntamiento de Madrid es preocuparse por el mantenimiento de los jardines de Valdebebas. Me parece increíble la altura de la vegetación en algunas zonas. No creo que sea una medida muy cara de efectuar.</p>

<p> </p>

<p>Gracias.</p>
";"19/09/2015 11";"77";"66";"11";"1";"979719747";"4714"
"4028";"PipiCan";"<p>Propongo la instalación de PipiCanes en las calles de nuestra ciudad. Consistiría en crear unas franjas de grava/tierra/material permeable entre alcorques, en medio de este espacio habría unos palos donde los perros levantarían su patita, este palo tendría un sistema de agua que el dueño pulsaria para limpiar la zona, y de ahí al alcantarillado. Por una ciudad más limpia y moderna! </p>

<p>P.D: Tengo un diseño que podría interesarle Manuela ;-)</p>
";"19/09/2015 12";"120";"102";"18";"5";"981829969";"7139"
"4029";"¿Prevenir la violencia de genero O Esperar a que mas mujeres mueran?";"<p>Actualmente el sistemas de seguridad brinda mil y una alternativa para las mujeres que suelen ser victimas de violencia machista, las alternativas se podrian traducir en que estamos preparados para atender a las victimas, Pero¡ ¿Acaso no es mejor que en una sociadead no exista dicho mal? es decir, No deberiamos PREVENIR Y REEDUCAR para que no LAMENTAR y que desaparezcan lasvictimas de estos delitos? o no son en realidad IMPORTANTE nuestras MADRES, HIJAS, HERMANAS O ESPOSAS?</p>
";"19/09/2015 14";"112";"89";"23";"21";"980836690";"5244"
"4030";"Pista Atletismo Polideportivo Santa Ana";"<p>Estas instalaciones, aunque municipales, no permiten el acceso a cualquiera ya que parece estar gestionado por una asociacion deportiva que si imparte clases de atletismo por las tardes. El resto del tiempo, por desgracia, ningun madrileño puede disfrutar de las instalaciones...</p>

<p>Pistas de Santa Ana, Paseo de las Alamedillas, sn. </p>

<p> </p>
";"19/09/2015 15";"29";"18";"11";"5";"972347062";"434"
"4031";"¿Qué pasó o qué fué de.......?";"<p>A veces sucede que en el Ayuntamiento se inician gestiones de asuntos públicos de interés general que por razones desconocidas se interrumpen o se abortan. Surgen entonces dudas sobre la naturaleza de las razones, su legalidad, su ética y sus responsables. Este título de debate completado con el ""asunto concreto"" puede ser una forma de sacar a la luz esos temas oscuros que requieren transparencia.</p>

<p>*  A partir de aquí, espero que se abran debates por causas concretas de interés general.</p>

<p>* Como muestra mi pregunta concreta es: </p>

<p><strong>¿Què fué de del enlace peatonal entre la urbanización Rosa Luxemburgo y la Casa de Campo?</strong></p>

<p>* BOAM nº 5807  (18/04/2008) Área de Gobierno de Obras y Espacios Públicos</p>

<p>http://www.madrid.es/portales/munimadrid/es/Inicio/El-Ayuntamiento/Boletin-Oficial-del-Ayuntamiento/Buscador-Boletines/1294-132-2008-01131-LICITACION?vgnextfmt=default&amp;vgnextoid=e4d02fb810159110VgnVCM1000000b205a0aRCRD&amp;vgnextchannel=7a698db0ae967010VgnVCM1000009b25680aRCRD</p>

<p><em>Resolución de 11 de abril de 2008 de la S.G.Técnica del Área de Gobierno de Obras y Espacios Públicos por la que se hace pública la convocatoria para la adjudicación por procedimiento abierto mediante concurso del contrato de consultoría y asistencia nº 132/08/01131, denominado <strong>Redacción del proyecto de construcción del enlace...</strong></em></p>
";"19/09/2015 19";"25";"20";"5";"6";"977946334";"1200"
"4032";"Aseo en los intercambiadores ---->  papel higiénico ""racionado"" para usuarios.";"<p>¡Valiente astracanada!  ...es verdaderamente grotesco, que a estas alturas del siglo xxi y en la ""joya"" del urbanismo -muestra internacional de la funcionalidad y la eficiencia- erigido como moderno exponente de la <strong>colaboración público/privada</strong> más avanzado hoy en día, tengamos aún que distanciar los SERVICIOS PUBLICOS de los <em>Servicios al público</em> en su conjunto (ya sean usuarios, contribuyentes, pasajeros, ciudadanos ó transeuntes) mediante <u>sutiles gestos</u> con que dejar a cada cual en el ""sitio que les corresponde"" bien claro y de modo inequívoco.</p>

<p>¿Quién sabe?  quizás convendría Propuesta formal para llegar a estrecharles efusivamente la mano a todos estos inteligentísimos político/administradores/contratistas tras nuestro sobrevenido ""apretón"" de manera que se llevaran cada uno de ellos un RECUERDO INDELEBLE de cómo hemos tenido que <s>quitarnos la mierda del culo</s> al descubrir con espanto que la cabina utilizada carecía de porta-rollos.  Disculpen la indignación transmitida al texto, por favor: si no lo cuento reviento... ya no podía más (literalmente).</p>

<p> </p>
";"19/09/2015 20";"65";"59";"6";"4";"984230345";"4810"
"4033";"¿Cree usted que la mejor obra de caridad es donar preservativos a gente humilde?";"<p>Bajo mi opinión, las clases de bajo poder adquisitivo, son las que mayor número de hijos tienen, cuando debería ser al contrario. Pienso que un buen modo de prosperar, para la gente necesitada, es planificar de un modo adecuado la descendencia realmente deseada y proporcional a la capacidad económica de la familia.</p>
";"19/09/2015 20";"53";"16";"37";"4";"964566546";"-633"
"4034";"Transparencia Total";"<p>Sugiero una página o una pestaña de l apágina del Ayuntameinto, donde se muestre claramente el presupuesto del Ayuntamiento y se desgloce todos los rubros de ingresos y egresos. Como una página de balance contable. Yo quiero saber en que se gasta el dinero de Madrid, íntegramente, sueldos, edificios, servicios, etc</p>
";"19/09/2015 20";"232";"229";"3";"2";"991974010";"22307"
"4035";"el negocio de la muerte";"<p>Nacemos .y luchamos por nuestros derechos humanos durante toda nuestra vida .pero cuando dejamos de existir nos roban nuestros derechos de descansar en paz .para que unos pocos se hagan millonarios con el sufrimiento el dolor de nuestros seres queridos.cuando las celebridades tienen sus panteones a cargo del pueblo.como se puede seguir consintiendo tal atropello .</p>
";"19/09/2015 22";"60";"51";"9";"6";"983300025";"3569"
"4036";"Las aceras para los peatones";"<p>Ir por Gran Via o preciados es una carrera de obstaculos, sorteando motos mal aparcadas,   quioscos de prensa que invaden la zona de peatones de forma desmesurada, terrazas y manteros que se ponen donde pueden y que cada vez que ven a la policia salen corriendo con el co siguiente peligro para todos.</p>
";"19/09/2015 23";"175";"158";"17";"7";"989056098";"12730"
"4037";"Rehabilitación sostenible de edificios con ayudas reales a los vecinos.";"<p>Por una rehabilitación sostenible del parque de viviendas de Madrid. Mediante materiales que ahorren energía y gasto en energia.</p>

<p>  Lo malo ,es que estas obras ,muchas veces exceden el presupuesto que puede asumir una comunidad de propietarios sin una ayuda.</p>

<p> Por una ayuda del ayuntamiento ,tanto económica o de financiación, a las comunidades que hagan un estudio de ahorro energético y decidan por mayoría acometer las obras.</p>
";"20/09/2015 09";"106";"96";"10";"4";"991727638";"7788"
"4038";"Mismos derechos de los inmigrantes sirios para las familias madrileñas";"<p>Visto que, en esta -llamada- ""crisis económica"" que padecemos y pagamos todos los madrileños, me sorprende saber que había 10 millones de euros de los que podíamos disponer todos y todas las ciudadanas, por lo que entiendo que, todo aquello que se dé a las familias sirias, también se dé a las familias madrileñas que también pasan penurias económicas, sociales y laborales (falta de casa -viviendo varias generaciones en el mismo hogar-, falta de alimentos, falta de trabajo, etc.).</p>

<p>Aprovecho para proponer a las familias madrileñas solidarias que también abran sus casas a los chicos marroquíes que andan por nuestras calles, o los manteros que han venido desde Africa buscando también huir de una situación inhumana...</p>

<p> </p>
";"20/09/2015 11";"150";"100";"50";"8";"986374844";"3333"
"4039";"Realizar una auditoría ciudadana de la deuda";"<p>Exigimos el derecho a saber, que se ha hecho con el dinero público, del que se han beneficiado unos pocos mientras la mayoría sufría las consecuencias de la crisis.</p>

<p>La <strong>auditoría ciudadana es un instrumento,</strong> para analizar de manera crítica el endeudamiento llevada a cabo por las autoridades así como el <strong>impacto de esta política sobre la población. </strong>No sólo aplica el análisis de datos financieros si no un análisis más amplio que abarca desde los recortes en los derechos fundamentales de los ciudadanos, en el medio ambiente y la falta de transparencia, hasta el <strong>derecho de control que tienen los ciudadanos sobre aquellos que gobiernan</strong> y por tanto en participar activamente en los asuntos públicos.</p>

<p>Llevar a cabo una auditoría ciudadana de la deuda es <strong>examinar y evaluar los procesos que han originado dicha deuda</strong>, no sólo con la finalidad de determinar la razonabilidad y fiabilidad de los datos contables sino también si han sido legales, legítimos y transparentes, así como si han originado perjuicios para la población en base a las normas legales, contables, financieras, ambientales y sociales establecidas en el Estado.</p>

<p>La auditora debe ser Ciudadana ya que son las <strong>madrileñas y madrileños los únicos soberanos</strong> para decidir de manera participativa si un gasto o una deuda son legítimos o no.</p>

<p>El Ayuntamiento de Madrid es el más endeudado del Estado español (2000 por habitante aprox.), fundamentalmente desde el gobierno de Gallardón cuando la deuda pasa de 1455 millones de 2003 a 7757 en 2011 según el Banco de España. El despilfarro en el soterramiento de la M-30, las inversiones para las olimpiadas y otros gastos de dudoso beneficio para los ciudadanos, sin hablar de la Gurtel y la Púnica.</p>

<p> </p>

<p>http://auditoriaciudadana.net/</p>

<p> </p>
";"20/09/2015 11";"288";"262";"26";"1";"996489086";"21469"
"4040";"Prohibir los coches los viernes y sábados por la noche en el Centro de Madrid";"<p>Ayer estuve por el centro de Madrid a la 1 de la madrugada y las calles están REPLETAS de gente, todas las carreteras están invadidas por peatones, algún día acabará pasando algo. </p>

<p>Soy muy defensor de peatonalizar casi todo el centro, como se hizo ya con Callao, Preciados y Funecarral en su momento, Madrid ganaría mucho, el peatón podría ir tranquilo y sería todo mucho más cómodo, por no mencionar el beneficio para los comercios. Sin embargo, con una deuda de más de 6.000 millones de euros puedo entender que sea muy caro, por tanto, propongo prohibir el paso de coches a partir de ciertas horas de los viernes y sábados.</p>

<p>A partir de las 21:00 h la Puerta del Sol está imposible, hacer que pasen coches por ahí es una locura, y como digo, antes o después pasará alguna desgracia entre los borrachos que van sin enterarse de nada y los coches que pasan por el centro. Prohibir el paso de coches desde las 21:00 hasta las 6 de la mañana mejoraría mucho la zona. </p>
";"20/09/2015 12";"180";"116";"64";"8";"986198875";"3351"
"4041";"Madrid necesita una semana cultural ";"<p>Al contrario que Barcelona o Valencia, Madrid no tiene playa, es algo que personalmente siempre he agradecido porque así nos evitamos mucho turismo clásico del turista que va a emborracharse. </p>

<p>Madrid tiene una MUY BUENA OFERTA CULTURAL, eso es un fuerte importante de Madrid, tenemos el Museo del Prado, el Palacio Real, el Reina Sofía, el Teatro Lope de Vega y se va a acabar la construcción del Museo de Colecciones Reales, pero me parece que no puede competir con ciudades como París ni Londres ni Roma (con ellos es casi imposible competir, todo sea dicho). </p>

<p>Creo que Madrid necesita iniciativas que mejoren la oferta cultural. Por aquí he leído festivales de cine o ferias barrocas... creo que algo del estilo, que ponga a Madrid en el punto de mira de la cultura en Europa durante una semana, como lo hace el Festival de Cannes en la ciudad del mismo nombre, estaría bastante bien para potenciar el turismo y la oferta cultural. </p>

<p>Os invito en este debate a que pongáis iniciativas culturales que se puedan llevar adelante, a ver si alguien ""de arriba"" lo lee y dice ""oye, esto se puede hacer"". </p>

<p> </p>
";"20/09/2015 12";"129";"117";"12";"2";"993476845";"9523"
"4042";"Sustituir/eliminar/nueva ubicación el árbol de Navidad en la Puerta del Sol";"<p>El árbol de Navidad que se instala los últimos años en la Puerta del Sol debería ser objeto de un nuevo planteamiento.</p>

<p>El árbol que se está instalando los últimos años está situado en en centro de la plaza lo que dificulta la movilidad en la época de Navidad. Además, dicho arbol tiene una base muy amplia lo que hace que ocupe una gran parte de la plaza.</p>

<p>Abro un debate para sustituir el árbol actual por otro con menos ocupación de la vía pública o bien para buscar otra ubicación más correcta.</p>

<p>En cuanto al diseño no lo valoro pero es manifiestamente mejorable.</p>
";"20/09/2015 12";"86";"25";"61";"2";"970753011";"-1046"
"4043";"¡¡Que el Metro de Madrid contrate personal!!";"<p>Estoy <strong>HARTO</strong> de tener que esperar hasta 20 minutos en el andén (esperas que NO se contemplan en los horarios oficiales) por la evidente falta de personal y desinterés general. El Consorcio está causando desastres uno detrás de otro, <strong>¡¡fuera esa gente corrupta!!</strong></p>
";"20/09/2015 13";"325";"310";"15";"10";"999256620";"28138"
"4044";"Dimisión en bloque del equipo de gobierno";"<p>Si el gobierno municipal se dedica a gastar el dinero en webs varias para ver que dice tal o cual vecino y luego ver si le parece bien o no, que pongan al presidente de una comunidad de vecinos y hará lo mismo. Y nos ahorramos elecciones, con lo que cuestan. Si jugamos a la democracia y hemos decidido que es representativa, esto no puede ser.</p>

<p>Pidamos al Aytº que matenga los cauces de comunicación con los ciudadanos, pero que no se escude en lo que dicen. 3 millones de madrileños son muchas opiniones. Hay que gestionar, que para eso les pagamos.</p>

<p>.</p>
";"20/09/2015 13";"215";"31";"184";"9";"972432600";"-2206"
"4045";"La desfachatez de las funcionarias del Servicio de Vivienda Municipal";"<p>Estimados ciudadanos:</p>

<p>Abro este debate para quejarme públicamente -y pedir al Ayuntamiento que lo solucione- sobre la <strong>absoluta desfachatez de las funcionarias</strong> del <strong>Servicio de Inspección de Vivienda Municipal de la calle Palos de la Frontera, 13</strong>. </p>

<p>He tenido que acudir a esta dependencia municipal en algunas ocasiones para formalizar el contrato de mi piso alquilado, así como para hacer cambios en la titularidad (compartido) o para pedir copias del acuerdo con mi casera, necesarias para solicitar las ayudas de la Comunidad de Madrid.</p>

<p>Pues bien, puedo decir que en ninguna de las ocasiones me han atendido como es debido y en todas ellas he observado inconcebibles negligencias por parte de estas funcionarias. Ya no sólo es que haya tenido que esperar una hora y media para que me atendiera la encargada de facilitarme una fotocopia del contrato, sino que he tenido que ver cómo la responsable de la recepción, ante mis quejas por la falta de diligencia de los trabajadores de esta oficina, me respondía: ""es que las cosas de palacio van despacio"". Todo ello, mientras cuatro de las funcionarias charlaban y reían frente a la fotocopiadora.</p>

<p>El último problema, al respecto, lo tengo con una de las responsables de esa oficina (obvio decir el nombre por respeto hacia ella), a quien envié un correo electrónico hace 3 semanas con la documentación necesaria para renovar mi contrato de alquiler. Al igual que hizo el año pasado, ni se ha dignado a contestarme. No está pendiente. No le apetece cumplir su trabajo. Nadie le vigila, nadie le juzga y nadie le evalúa. Entonces, lo seguirá haciendo. Y, entonces, tendré que invertir otra hora y media de mi tiempo en acudir a esa dependencia municipal para hacer algo que, si esta persona tuviera un mínimo de respeto por el ciudadano, podría resolver en un minuto.</p>

<p>Señora alcaldesa, señores concejales, ¿de veras tenemos que aguantar los ciudadanos estos abusos de poder por parte de los empleados del sector público? ¿Por qué he de salir perjudicado por el mero hecho de querer hacer las cosas bien, siempre dentro de la legalidad? ¿No creen que sería más fácil firmar un contrato ilegal con mi casero y darle el dinero en mano para ponerle en bandeja la comisión de un fraude fiscal? ¿Por qué siempre tenemos que salir perjudicados quienes pagamos religiosamente nuestros impuestos y nos atenemos a la legislación en cada acción que realizamos?</p>

<p>¿No les parece que a estas funcionarias se les debería exigir que cumplan con su trabajo y presten al ciudadano el servicio que reclama? ¿A qué viene esta indefensión?</p>

<p>Les agradezco la atención. Reciban un cordial saludo.</p>
";"20/09/2015 14";"65";"56";"9";"9";"990651916";"4049"
"4046";"Ampliar zona ORA hasta la M-40";"<p>Al ampliar la ORA hasta la M-40, impediriamos faltas de aparcamiento en las zonas proximas a la almendra de ma M-30</p>
";"20/09/2015 17";"128";"20";"108";"3";"974027036";"-1375"
"4047";"Propuestas de mejora Decide.Madrid";"<p>Creo que deberíamos ir incluyendo propuestas de mejora a la herramienta que estamos utilizando, de forma que sea más eficiente y más eficaz. Por ejemplo:</p>

<p>- Unificar propuestas similares (sin duplicar votos), y cuando se vaya a condensar en una propuesta consultar a las personas implicadas si están de acuerdo con la modificación. Es básicamente aplicar criterios de optimización. He visto algún debate y alguna propuestas diciendo esto mismo </p>

<p>- Diferenciar más entre propuestas y debates. He visto debates con más apoyo que propuestas que dicen exactamente lo mismo, y no sé si esos votos positivos se están teniendo en cuenta como apoyo a las propuestas. Deberían de darse a los debates un único voto de ""interesante"" para que lo de el que quiera y poner enlaces a las propuestas relacionadas.</p>

<p>- Sé que esto requeriría más recursos...pero creo que sería bueno fomentar desde el Ayuntamiento el uso de esta herramienta de forma presencial, con algún acto breve en lugares concurridos o aprovechando eventos para que aumente la participación pública. He encontrado varias propuestas que firmaría seguramente la mayoría de la población, ya sean de un partido político o de otro.</p>

<p>Por último quiero felicitar al Ayuntamiento de Madrid por el desarrollo de esta herramienta y a todos los inscritos en esta web. Creo que entre todos podemos mejorar Madrid y fomentar la participación. Espero que esto triunfe y poder ver resultados efectivos</p>

<p>Un saludo cordial</p>
";"20/09/2015 17";"109";"104";"5";"14";"996469079";"9445"
"4048";"En los edificios antiguos ahora quieren poner ascensores.";"<p>La nueva Ley de propiedad horizontal obliga a todos los vecinos a pagar los ascensores, es una Ley injusta, protege a las personas  con discapacidad, pero no a las personas que cobran una pensión de 350 euros o menos ¿en este Pais nos hemos vuelto locos o que?</p>
";"20/09/2015 18";"58";"35";"23";"36";"985881882";"724"
"4049";"Puntos limpios de comida";"<p>¿Cuál es la mejor organización para que la comida en buen estado no acabe en la basura? ¿Implicamos a los establecimientos/supermercados/restaurantes/pequeñas tiendas? ¿Establecemos un grupo de voluntarios para recoger y repartir toda esta comida?</p>

<p>Hoy en día pequeños y grandes distribuidores de comida tiran una parte de su producción a la basura, por no considerarla de rentablidad económica. El mismo producto que compras lo encontras de igual calidad en el contenedor, pero más ""feo"", ¿Que hacemos? ¿Nos estan maleducando los escaparates?</p>

<p>https://www.youtube.com/watch?v=Rm3hA65Drk0</p>
";"20/09/2015 18";"198";"189";"9";"5";"999167534";"17181"
"4050";"Apoyo al atletismo municipal degradado";"Hay muchas carreras populares cada fin de semana, pero las pistas de atletismo municipal y su entorno están destrozadas, al estar decenas de años sin repararlas. Fomentas salud y deporte

<p>Los menores son el futuro, si les metemos en una pista con baches o inundadas cuando caen tres gotas, les cerramos la puerta a ese mundo. </p>

<p>Sería más atractivo para los menores y para los mayores que cuando usen una pista de atletismo no haya baches en el tartán. Que cuando llueva no estén inundadas las calles de la pista, o que se corra sin cuerda en los límites de la pista.</p>

<p>Las pistas municipales de Aluche, Orcasitas, Tres Olivos, y otras se hayan olvidadas desde hace decenas de años.</p>

<p>No es mucho que en Madrid, además de la pista de atletismo de Moratalaz, hubiera 3 o 4 pistas sin baches. </p>

¿Se puede mejorar el atletismo municipal de tu barrio.?
";"20/09/2015 20";"70";"63";"7";"2";"994110627";"5040"
"4051";"Reforma del Monumento del 11 M";"<p>Es un monumento poco digno para las víctimas, muy feo, pues parece una papelera gigante, en una horrible y excesiva peana negra, que además dificulta el flujo en una plaza con un tráfico elevado.</p>
";"20/09/2015 20";"83";"56";"27";"6";"988685739";"1956"
"4052";"Atardeceres de verano con música en El Retiro";"<p>Llevo años pasando los agostos en Madrid y la verdad es que mucho ha cambiado desde que no quedaba nadie en Madrid y era un desierto completo. </p>

<p>Y echo de menos algo que nos haga mas agradable los atardeceres en el Retiro , después de un dia de calor increible como hace ne Madrid. Propongo algo que no es costoso y puede atraer a muchas personas al Retiro y hacer un momento maravilloso. </p>

<p>Madrid tiene unos atardeceres maravillosos pues no tiene montañas por donde trasncurre el sol con lo que los atadeceres son muy largos y los colores son increibles. </p>

<p>Desde el monumento a Alfonso XII en el lago de El Retiro se ven unos atardeceres que son lo mas parecido que podemos ver como si fuesesn en el mar. Propongo poner banda sonora al atardecer como hacen en Ibiza en el famoso Café del Mar, cada día la última hora de  sol se le puede poner música y hacerlo mas maravilloso si cabe.Nos da un respiro a los que nos quedamos en Madrid y nos relaja, todo en uno , convirtiéndose en un atractivo para el turismo. </p>
";"21/09/2015 10";"120";"105";"15";"6";"1001385507";"7875"
"4053";"Áreas caninas";"<p>Limpieza de las áreas caninas que actualmente están muy sucias. Cierre completo de las mismas para que no se pueda salir el perro, algo tan fácil como una sencilla puerta de madera. Bolsas en las entradas de estas áreas para poder recoger los excrementos. Pequeñas piedras para evitar pisar la arena o el barro cuando llueve y poder recoger los excrementos.</p>

<p>Con unas áreas caninas (pipicanes) limpias y cuidadas nos ahorramos suciedad en las aceras y facilitamos la convivencia entre todos.</p>

<p>Muchas gracias.</p>
";"21/09/2015 11";"121";"112";"9";"8";"1003492290";"9533"
"4054";"Limitar el uso de los coches más contaminantes";"<p>Propuesta ciudadana: https://decide.madrid.es/proposals/1826</p>

<p> </p>

<p>Está claro que Madrid está contaminado, lo dicen todos los medidores: https://www.google.com/maps/d/u/0/viewer?mid=zhXEP0UvjVXc.kmMof6g-_u5E&amp;hl=es, y el problema es que nos afecta directamente:</p>

<p>1. Más <strong>alergias</strong>, ¿no te has preguntado por qué ahora muchísima gente tiene alergia a algo?</p>

<p>http://www.quo.es/salud/la-contaminacion-dispara-las-alergias</p>

<p>http://www.muyinteresante.es/salud/articulo/la-contaminacion-aumenta-las-alergias</p>

<p>2. <strong>Problemas respiratorios</strong>, cardiopatías, etc.</p>

<p>http://www.ecodes.org/salud-calidad-aire/201302176117/Impactos-sobre-la-salud-de-la-contaminacion-atmosferica</p>

<p> </p>

<p>Pero si analizamos que provoca toda esta contaminación la respuesta es muy llamativa:</p>

<p>http://www.europapress.es/sociedad/noticia-contamina-mas-gasolina-diesel-20150604172336.html</p>

<p>https://es.wikipedia.org/wiki/Humo_Di%C3%A9sel</p>

<p>Con esto no pretendo estigmatizar a todos los coches diesel, no es lo mismo un Euro 3 que un Euro 6, pero es cierto que muchos coches diesel son los principales responsables de la contaminación en Madrid, concretamente de Dioxido de Nitrógeno y partículas PM10 y PM2,5.</p>

<p>Actualmente también parece que los coches gasolina de inyección directa son muy contaminantes en comparación con los tradicionales de inyección indirecta.</p>

<p> </p>

<p>En definitiva, escucho propuestas como limitar la velocidad o el uso de TODOS los vehículos pares o impares según la necesidad y me pregunto <strong>¿por qué nos prohíben a todos si no todos contaminamos lo mismo?</strong></p>

<p>No es lo mismo un coche diesel muy contaminante que un gasolina o un híbrido o un eléctrico, ¿por qué entonces deben tener todos las mismas rectricciones? Existen tecnologías alternativas a parte de la gasolina como: Glp, Gnc, híbridos, híbridos enchufables, eléctricos. Y por supuesto aun usando el mismo combustible no todos los coches contaminan lo mismo.</p>

<p> </p>

<p>Por tanto, la propuesta sería: <strong>Categorizar a todos los vehículos por su nivel contaminante (A, B, C, D, E, F, G)</strong> igual que el modelo de eficiencia energética y en función del grado de contaminación empezar limitando el uso de los coches más contaminates (G) y así sucesivamente. </p>
";"21/09/2015 12";"139";"109";"30";"21";"1000466156";"6194"
"4055";"Realizar un seguimiento de solares sin edificar en Madrid";"<p> Vivo en Tetuán, concretamente en Valdeacederas y además de los grandes problemas como la limpieza, asfaltado de las calles (llega a ser peligroso), o aceras intransitables, nos encontramos con gran cantidad de solares sin edificar de titularidad privada abandonados, sin desbrozar y donde se va acumulando basura, con los peligros que ello conlleva, no sólo de salud sino de incendio, (amén del daño estético al barrio). Evidentemente esa obligación es del propietario y el Ayuntamiento sólo puede realizar la ejecución subsidiaria con cargo al propietario, (algo que parece tampoco hace). Si el propietario no tiene dinero ni para edificar ni para conservar, creo que tampoco estará pagando su contribución, por lo que entiendo sería conveniente realizar actuaciones como la cesión (que no expropiación) al ayuntamiento o asociaciones vecinales para la creación de espacios públicos, huertos urbanos...., con las corresponidentes ventajas para el propietario, (exención del IBI, por ejemplo) y garantías de recuperación  en caso de inminente edificación. Creo que hay muchos estudios al respecto pero no se hace nada y seguimos con aunténticos vertederos en los barrios.</p>
";"21/09/2015 13";"131";"120";"11";"10";"1004222968";"9984"
"4056";"Ayudar a refugiados";"<p>Buenos días. Quería saber si alguien podría informarme de cómo se puede ofrecer asilo a los refugiados, qué procedimiento hay que seguir, dónde se realiza el ofrecimiento o si hay algún requisito. Somos siete personas y un perro en un piso pequeño, pero nos las podemos apañar para cubrir las necesidades de un niño o un padre/madre con un hijo, hasta que puedan vivir en su propia casa. Tenemos tres niños pequeños. Si alguien puede asesorarme se lo agradecería.</p>
";"21/09/2015 14";"93";"54";"39";"4";"993088549";"870"
"4057";"POR EL MEDIO AMBIENTE EN MADRID ";"<p>Muchos edificios de Madrid,  en sus tejados tienen terrazas y muchas de ellas sin ningun tipo de utilidad, como es la que tenemos en el edificio donde resido, mas de 300 m2 sin utilizacion alguna.</p>

<p>Se podria utilizar estas terrazas para plantar arboles y plantas duraderas y hacer pequeños jardines. De esta  manera se podria contribuir y mucho al medio ambiente mantniendo una atmosfera mas limpia.</p>
";"21/09/2015 14";"80";"70";"10";"4";"1001783500";"5250"
"4058";"¿Tenemos suficiente información para hacer propuestas viables?";"<p>Hola,
A veces si tenemos suficiente información para proponer, pero otras se nos escapan aspectos técnicos o nos falta información importante. En el último punto del proceso de propuestas, el 4 (https://decide.madrid.es/proposals_info), se contemplan hacer informes técnicos sobre la viabilidad de las propuestas, una vez ya se ha decidido y apoyado en la votación. Me parece un poco tarde para esto y quizás convendría tener un feedback sobre la propuesta algo antes. Se podría poner en marcha mecanismos para mejorar las propuestas. Por ejemplo que técnicos del ayuntamiento aporten información en los debates o propuestas que alcancen tantos votos o apoyos, que se facilite información concreta o que se abran talleres sobre ""cómo realizar tu propuesta"".

Saludossssssssss
 </p>
";"21/09/2015 15";"28";"25";"3";"4";"998824727";"1964"
"4059";"Por la accesibilidad en los edificios sea una prioridad.";"<p>Por una accesibilidad en el parque de viviendas sea una prioridad , frente a las normas urbanísticas.</p>

<p> En nuestra comunidad con dos personas mayores de 75 años y un minusválido nos han denegado la licencia para el ascensor por reducir la escalera 5 cm frente a lo exigido en las nuevas normativas urbanísticas para obra nueva. Y eso que aportamos un informe favorable de bomberos.</p>

<p>  Igualmente los ascensores que se puedan poner en zonas comunes o patios aunque aumenten la edifica olvidad. Ya que debería ser una prioridad.</p>

<p> Se debería dar ayudas para mejorar la accesibilidad en los edificios, rampas ,salva escaleras,ascensores,etc.</p>

<p> </p>
";"21/09/2015 21";"67";"58";"9";"7";"1003801377";"4241"
"4060";"Aceras de cemento o asfalto en lugar de losas.";"<p>Cuando uno viaja por el extranjero, lo primero que le llama la atención es que las aceras son de hormigón o de asfalto, me gustaría que se hiciera un estudio del coste que tiene esta costumbre española de que las aceras sean de losas.  Ademas que se estudien el número de accidentes que se producen por estar deteriorada la acera,  por ejemplo una loseta que se mueve y que produce tropezones y caídas.</p>

<p>Si uno se acerca a la calle Precisados, ve lo deteriorada que esta la acera y no tendrá más de 4 años, para estar en ese estado, mejor que sea de cemento, aunque lo mejor seria que en las calles principales, sean aceras bonitas, pero que las hagan empresas que sepan hacerlas, aún se pueden ver vías romanas de hace 2000 años que se encuentran en mejor estado que la calle Preciados.</p>
";"21/09/2015 21";"122";"93";"29";"13";"1003026493";"4878"
"4062";"Homologación de las ""madres de día""";"<p>Regular y homologar los modelos de cuidado de bebés con ""madres de día"" (para quien no lo conozca, www.redmadresdedia.com) muy extendidos en muchos otros países europeos e incluirlos en las subvenciones del ""cheque guardería"".</p>

<p> </p>
";"21/09/2015 23";"51";"36";"15";"3";"999297976";"1482"
"4063";"Controlar los perros peligrosos";"<p>Cada vez es más habitual ver personas por el centro con perros de razas peligrosas, sin bozal y a veces sin correa, por zonas en las que juegan niños y caminan ancianos. En muchos casos los pasean personas que por su complexión física y peso serían incapaces de controlarlos. Habiendo una normativa al respecto, la policía municipal debería controlarlos y multar a quienes la infrinjan.</p>
";"21/09/2015 23";"212";"192";"20";"16";"1010204225";"15577"
"4064";"Baños públicos de uso gratuito";"<p>En Madrid hay una falta clamorosa de baños públicos. Esto lleva a que la única opción para mucha gente sea pagar en un bar o hacer sus necesidades en la calle. Aparte de la conveniencia para todos los ciudadanos, hay algunos colectivos (niños, personas que viven en la calle o que pasan el día bebiendo en ella, borrachos en zonas de bares e incluso algunos abuelos con temas de próstata) que si no hay baños públicos van a hacerlo en la calle, se quiera o no.</p>

<p>Es urgente instalar más baños públicos y que su uso sea gratuito, al menos para aquellos que no puedan pagarlo.</p>
";"21/09/2015 23";"224";"206";"18";"2";"1010857969";"17289"
"4065";"Bolardos retráctiles en vados privados";"<p>Con la incapacidad que algunos tienen en esta ciudad para respetar las normas, es habitual que los vados de entrada a los garajes privados sean aprovechados continuamente para aparcar coches para recados de ""cinco minutos"".</p>

<p>La consecuencia típica es que el dueño del garaje que quiere salir se pone a tocar la bocina como un/a energúmeno/a molestando a todos los vecinos a cualquier hora. El que deja el coche obstruyendo confía en que ""le tocarán la bocina"" si quieren salir, el que toca la bocina se queda tan pancho porque ""es culpa del otro"" y al final la pagan los vecinos y su calidad de vida y sueño.</p>

<p>Todo esto se solucionaría fácilmente dando licencias a los propietarios de vados para que instalen bolardos retráctiles como los que hay en las calles peatonales, con su propio mando a distancia. De este modo nadie puede aparcar en su vado y todos contentos.</p>
";"22/09/2015 00";"41";"28";"13";"0";"998073275";"1024"
"4066";"Miedo por la apertura de un centro ultraderechista en C/ Azcona";"<p>Los vecinos de la zona estamos asustados. Resulta que una organización ultraderechista llamada ""Alianza Nacional"" cuyos dirigentes afirman sin escrúpulos ser ""neonazis"" ha inaugurado un amplio local en la Calle Azcona, en el barrio de la Guindalera de Madrid, justo enfrente de la gran biblioteca Manuel Alvar.Los vecinos del barrio estamos aterrados.Siempre ha sido un barrio superpacífico en que nunca ha sucedido nada malo y en el que vivimos españoles e inmigrantes integrados perfectamente. Sólo faltaría que ahora comenzasen agresiones y axtos incívicos en un lugar en que nunca ha ocurrido nada de eso. Ruego a las autoridades que por favor mantengan vigilancia sobre estos individuos y sus actividades.Los numerosos estudiantes que acuden a la biblioteca, los jovenes del barrio y todas las personas que en él vivimos tenemos derecho a la paz y tranquilidad que hasta ahora hemos disfrutado.</p>

<p> </p>
";"22/09/2015 01";"94";"59";"35";"7";"999425623";"1506"
"4067";"Puerta del Sol limpia a cualquier hora";"<p>Es denigrante ver como queda el fin de semana la puerta del Sol y calles como, Montera, Gran Vía, Fuencarral (zona peatonal), si no cuidamos el centro histórico que imagen vamos a dar a quienes nos visitan? </p>
";"22/09/2015 01";"55";"49";"6";"1";"1005211928";"3830"
"4068";"Puerta del Sol limpia a cualquier hora";"<p>Es denigrante ver como queda el fin de semana la puerta del Sol y calles como, Montera, Gran Vía, Fuencarral (zona peatonal), si no cuidamos el centro histórico que imagen vamos a dar a quienes nos visitan? </p>
";"22/09/2015 01";"112";"107";"5";"2";"1009857296";"9744"
"4069";"No a la venta nocturna de bebidas alcohólicas ni comida en plena calle";"<p>Aquí no se vigila nada, ni siquiera a los que a partir de ciertas horas de la noche se ponen en las esquinas, creando un punto de venta improvisado de bebidas alcoholicad , sobretodo cerveza e incluso comida. Me parece tercermundista.</p>
";"22/09/2015 01";"162";"128";"34";"7";"1006374024";"7427"
"4070";"No a las pintadas ni graffitis en el centro";"<p>Es que nos hemos habituado a ver esta imagen de Madrid llena de pintadas? Es una guerra de a ver quien puede mas, si el vándalo que pinta  fachadas, puertas, cierres, papeleras, farolas, kioscosY el ayuntamiento o los mismos propietarios o vecinos por mantener la limpieza y buena imagen de casas y negocios.  Basta ya, !! La pintura no desaparece del todo en las fachadas de granito o ladrillo , se desconchando las paredes de tantas capas de pintura. Cuando cierran todas las tiendas o negocios de cualquier tipo, la visión aun es peor, porque no hay un cierre que no este pintado.</p>

<p> </p>
";"22/09/2015 01";"142";"114";"28";"7";"1006413771";"6904"
"4071";"No nas colillas ni chicles en la calle";"<p>Los fumadores se creen los reyes del mambo cuando con esa soltura tiran las colillas al suelo dándolas un toque con el dedo y lanzándolas lo mas lejos posible, ya no se pisan al menos con el pie para asegurarse de que están apagadas. Y ni que decir las colillas que tiran en los parques para que cualquier niño se la lleve a la boca. Mas ceniceros a la salida de bares y restaurantes y mas conciencia ciudadana.</p>
";"22/09/2015 02";"225";"212";"13";"10";"1012571971";"18750"
"4072";"Apoyo el Atletismo municipal en la clase de educación física ";"Es chulo el atletismo; pero en clase no se les enseña cómo correr, cómo saltar. Si es bueno para los padres, el Ayuntamiento deberia de fomentarlo en clase de educación física. Salud y estilo de vida

<p>Se les puede enseñar, cómo correr como un gamo y cómo saltar como un león sobre la arena, cómo volar como un pájaro. </p>

<p>El atletismo es salud y es también un modo de vida. Los menores pueden estar en el futuro en un sitio donde no están otros ahora. Donde solo piensen en un estilo de vida basado en el esfuerzo, en la constancia, en el sacrificio de cuidar tu cuerpo. Esos beneficios se pueden introducir a los menores desde que tengan 4 años. El Ayuntamiento puede estar más presente en ese modo de ver las cosas. Es barato y es posible</p>

¿ peso, longitud, Carreras, salto de altura se puede impartir en la clase de educación física.?
";"22/09/2015 13";"68";"54";"14";"2";"1008388229";"3176"
"4073";"Que deje de haber propuestas en está pagina que piden lo que ya está hecho";"<p>Si te pones a repasar las peticiones de los usuarios, hay una gran parte de ellas que piden que se regule algo que ya esta regulado, que se prohiba algo que ya está prohibido o que se multe a la gente por algo por lo que ya se les multa. ¡Basta de peticiones inútiles!</p>
";"22/09/2015 14";"95";"83";"12";"6";"1012483872";"6203"
"4074";"Estacionamiento SER tambien para los que regenten un local comercial en la zona";"<p>Propongo ampliar el SER a cualquier persona que acredite tener un negocio en la zona regulada por parquimetros. Por necesidades del trabajo se exponen a multas constantemente.</p>
";"22/09/2015 15";"76";"55";"21";"4";"1007662721";"2460"
"4075";"Unir con un 'pasillo verde' varias zonas verdes de la ciudad";"<p>La idea es que se pueda ir de un parque a otro de forma directa y sin tener que coger el coche, simplemente paseando o en bicicleta y sin tener que cruzar calles o mezclarse con el tráfico. Se podría hacer un carril bici y un carril para peatones con algo de vegetación en los lados. De esta forma, personas que por cuestiones de tiempo y comodidad suelan ir únicamente a una zona verde tienen más posibilidades de disfrutar de otras, disfrutando más de la ciudad y ganando calidad de vida.</p>

<p> </p>

<p>Por ejemplo, podría ser factible unir todos estos parques: Parque Lineal del Manzanares - Madrid Río - Casa de Campo - El Pardo - Valdelatas - Parque de Valdebebas - Parque Juan Carlos I</p>

<p> </p>

<p>Algunos ya están unidos, pero se podrían mejorar. Por ejemplo, el Parque de Valdebebas está ""unido"" al Parque Juan Carlos I por el carril-bici, pero se podría mejorar esta conexión para hacerla más directa a través del barrio de Valdebebas, por la ciudad deportiva del Real Madrid e Ifema, a través de un pasillo verde. En principio, con las avenidas tan anchas que hay por la zona de Valdebebas no habría mucho pobrema de espacio.</p>

<p> </p>

<p> </p>
";"22/09/2015 17";"255";"244";"11";"8";"1019942770";"22294"
"4076";"el cambio de nombres de las calles la decisión de los vecinos";"<p>No me parece justo que venga uno que no viva en mi barrio ni en mi calle para decir que el nombre no le gusta por que es franquista o pertenece a alguien que no fue comunista,  en los barrios existen asociaciones de vecinos que pueden decidir libremente si quieren cambiar el nombre de la calle o no, o llamarla pepito y jaimito si ellos lo deciden asi, a eso se le llama democracia, no que venga uno que ni vive ni nada en un barrio y diga que ese nombre se quite por que asi le sale de los cojon..., y eso es lo que pienso,  que decidan los vecinos que para esos son sus calles no los demas</p>
";"22/09/2015 20";"58";"27";"31";"1";"995877279";"-186"
"4077";"Remunicipalización servicios publicos";"<p>Debe recuperarse la gestión directa de los servicios municipales, superando las nefastas, caras e ineficientes externalizaciones y privatizaciones. Me gustaría, en este sentido, que alguien me aclarara si es cierto que el ayuntamiento ha cedido el polideportivo municipal de Barceló a gestión de una empresa privada que está implicada en la gurtel. Lo he leído en un artículo en el diario digital rebelión. Por favor, espero que no sea cierto. En este artículo se alerta de que las grandes empresas están presionando al ayuntamiento para que renueven las contratas que están venciendo. Se puede pecar de ser demasiado prudente o moderado por temor a la guerra mediática de la oligarquía.</p>
";"22/09/2015 22";"186";"168";"18";"5";"1019011015";"13548"
"4078";"Más pequeño comercio, y menos locales de ocio en la zona Centro";"<p>Cada vez que se cierra un <strong>pequeño comercio de proximidad </strong>en la zona Centro de Madrid, se abre un local de ocio, pese a la saturación existente, lo que -además de molestias para los vecinos- provoca la desaparición del tejido social del barrio. Debería prohibirse la apertura de nuevos locales de ocio (bares, restaurantes, discotecas, etc.) a la vez que se implanta una política de apoyo al pequeño comercio de proximidad, mediante la subvención a los negocios existentes o a aquéllos que quieran abrir uno nuevo. Parte de estas subvenciones podrían obtenerse destinando para ello el importe recaudado mediante las sanciones impoestas por el incumplimiento de la ""ley antibotellón"" o de las sanciones impuestas a los locales por el incumplimiento de la normativa vigente (licencias, ruidos, sanidad....)</p>

<p>Igualmente, debería revisarse la concesión de licencias para la instalación de terrazas en la vía pública, así como el incumplimiento de la normativa vigente sobre el tema o los términos de las licencias concedidas. El Centro de Madrid se convierte en intransitable completamente -sobre todo los fines de semana- ante la instalación de más mesas de las permitidas o terrazas ilegales, o la instalación de mobiliario accesorio (sombrillas, carros, etc.) ocupando plazas, aceras y espacios que deberían ser de todos, al tratarse de espacio público. Debería incrementarse el importe de las sanciones por estas irregularidades, de manera que el perjuicio por el incumplimiento de la notmativa/términos de la licencia concedida sea mayor que el beneficio obtenido por su incumplimiento. Estas sanciones podrían, también, dedicarse a las subvenciones anteriormente mencionadas para el fomento del comercio de proximidad.</p>
";"23/09/2015 07";"134";"122";"12";"6";"1021567148";"10014"
"4079";"Me han borrado una propuesta (Multar bancos)";"<p>Me han borrado una propuesta y no entiendo el motivo. Era una de las más apoyadas, había recabado más de 1000 apoyos y no pedía nada ilegal, ni era troll ni nada.</p>

<p>El caché de google permite ver una imagen de hace unos días de la misma.</p>

<p> </p>

<p>¿Alguien me puede explicar qué ha pasado? ¿No les gustaba la propuesta y la han borrado? </p>

<p> </p>

<p>El link dónde estaba la propuesta (No funciona)</p>

<p>https://decide.madrid.es/proposals/900</p>

<p>y una imagen del caché de google con la propuesta (Cuando creé la propuesta tenía otro nombre de usuario):</p>

<p>http://imgur.com/bzlz9OW</p>

<p> </p>

<p> </p>
";"23/09/2015 11";"60";"50";"10";"13";"1018486703";"3333"
"4080";"Voluntariado de los estudiantes en el Ayuntamiento de Madrid";"<p>El Ayuntamiento de Madrid podría canalizar el voluntariado de muchos estudiantes de las Universidades y Colegios de Madrid.</p>

<p>Mediante acuedo con ellos los seleccionados por las Universidades y Colegios pasarían a ser voluntarios del Ayuntamiento en los diferentes proyectos y esto se contemplaría en el curriculo academico de cada uno de los alumnos. </p>

<p>Esto contribuiría de forma decisiva no solo a la educación civica entre los estudiantes y a la propia imagen de las Universidades y Colegios participantes sino también a aprovechar mucho talento y a la vez proporcionar una actividad social, humanitaria y enriquecedora a muchos alumnos que no disponen del tiempo, el dinero o la capacidad para conectar con otras organizaciones existentes. </p>

<p>El reconocimiento por los colegios y las universidades de esta actividad en el curriculo del alumno sería un aliciente y la canalización a través del ayuntamiento una garantía para los participantes. </p>
";"23/09/2015 11";"65";"45";"20";"6";"1014725347";"1730"
"4081";"Ceder Terrenos Gratis para las Empresas Catalanas que se quieran deslocalizar ";"<p>¿Está usted de acuerdo en Ceder Terrenos Gratis para las Empresas Catalanas que se quieran deslocalizar a Madrid?
Va a haber una carrera por quedarse con las empresas Catalanas que se vayan de Cat.</p>

<p>En esta carrera, Madrid deberia tener una actitud mas proactiva, llamando a las companias, cediendo espacios, mostrando las virtudes de la ciudad y lo Business Friendly que somos.</p>

<p>Se podria crean un slogan , algo como,   Vente a Madrid!</p>

<p>Ganariamos puestos de trabajo y riqueza.</p>
";"23/09/2015 13";"161";"38";"123";"2";"1000884909";"-2006"
"4082";"Soterramiento contenedores de basura";"<p>Las quejas por la falta de limpieza en las calles Madrid son unánimes. Hay muchos frentes que atacar, pero uno de ellos son las <strong>bolsas de basura tiradas en la calle</strong>. La costumbre madrileña de que los contenedores no estén en la calle hasta pasadas las 19 horas hace que la gente que por lo que sea tenga que salir de casa antes y sacar la basura la deje donde pueda, si es que en su comunidad el contenedor no está accesible. A mí me ha pasado más de una vez, por irme de vacaciones o similar, y he tenido cuidado de tirarla el día anterior y usar na bolsa pequeña hasta salir, que pudiera tirar en una papelera, pero nadie o casi nadie lo hace.</p>

<p>He vivido en otras ciudades y en todas ellas están implantando progresivamente el <strong>sistema de contenedores enterrados</strong>: no son para un solo portal, sino para varios, y obviamente se <strong>puede tirar la basura todo el día</strong>, de modo que no encuentras bolsas tiradas junto a los árboles o en la acera. Además, la recogida es más rápida, porque el camión no tiene que hacer tantas paradas. Es limpio, estético, y evitaría el problema de meter y sacar los contenedores todos los días. </p>

<p><strong>También están disponibles para residuos reciclables, como vidrio, papel y cartón. </strong></p>

<p>Creo que sería una propuesta a ir implementando poco a poco, barrio a barrio. </p>
";"23/09/2015 13";"186";"163";"23";"14";"1024504922";"12268"
"4083";"Crematorio M40 licencia";"<p>  Por que no ha parece la propuesta q ayer estábamos apoyando los vecinos de Villaverde en contra de la concesión de la licencia para el tanatorio de Parcesa situado en la Avd de los Rosales para la ampliación a crematorio </p>
";"23/09/2015 15";"39";"30";"9";"11";"1017289560";"1615"
"4084";"ENHORABUENA";"<p>Simplemente quería felicitar al ayuntamiento por ser capaz de convertir la pocilga que es Comillas, en una pocilga limpia. Es la 1ª vez en 50 años, que veo el barrio limpio ""estuvieron casi un mes seguido a destajo"", las aceras y las calles limpias incluso debajo de los coches, los jardines regados, los árboles podados, las papeleras y contenedores vacios... vamos que si no vas con cuidado te pierdes, parece otro. </p>

<p><strong>MUCHAS FELICIDADES POR EL EMPEÑO Y LOS LOGROS.</strong></p>

<p>La pena es que continúa lleno de cerd@s, no se lo que va durar.</p>

<p>Mi más sincera y ferviente enhorabuena.</p>
";"23/09/2015 20";"47";"37";"10";"7";"1019868583";"2125"
"4085";"Descuentos a familias numerosas por el ayuntamiento";"<p>La sociedad está cambiando y ahora hay familias creadas por dos anteriores unidades familiares que aportan nuevos miembros a la unidad familiar y que la Comunidad de Madrid reconoce como familias numerosas, dándoles el título. </p>

<p>Y piensas ostras en el IBI el Ayuntamiento hace descuento, pero llega la burocracia y te dicen que no. Si, tienes reconocido el título de familia numerosa pero como hay miembros que no están empadronados en la vivienda, aunque el sujeto pasivo obligado si lo este, aunque sea la única vivienda que tienes y en la que se reside de forma habitual por todos los miembros de la familia, no tienes derecho al descuento. </p>

<p>Así que el título de familia numerosa para las familias reconstituidas solo sirve para el descuento en el McDonald </p>

<p>Por favor actualicemos las necesidades a la vez, no es posible que la Comunidad avance con los cambios de la sociedad y el Ayuntamiento se quede obsoleto, retrasado y en la prehistoria.</p>

<p> </p>
";"23/09/2015 20";"53";"36";"17";"9";"1017767787";"1290"
"4086";"Muy bien Manuela Carmena quitando la subvención a la Escuela de Tauromaquia";"<p>En esa escuela, unos críos se dedicaban a martirizar becerrillos y pobres animalitos con la excusa de aprender a torear. Eso de ser torero no es algo que se pueda aprender en una escuela pública y subvencionada. Los antiguos toreros se hacían robando pases en las ganaderías a escondidas y a la luz de la luna. El toreo, como muy bien dijo el famoso torero Mondeño debería de ser ante un toro cansado, pero nunca herido. Los tiempos deben evolucionar y ha llegado el momento en que muchas cosas malas deben desaparecer porque ya tocan a su fin.</p>
";"24/09/2015 01";"260";"196";"64";"6";"1026864153";"9950"
"4087";"¿Cómo darse de baja de Madrid Decide?";"<p>¿Qué hay que hacer para darse de baja de la plataforma?</p>
";"24/09/2015 08";"30";"22";"8";"12";"1022624808";"1026"
"4088";"En contra del crematorio de la M-40 Avda los Rosales ";"<p>Estamos totalmente encontra del crematorio que quieren poner en la avda de los Rosales al sur de Madrid. </p>
";"24/09/2015 09";"66";"57";"9";"10";"1028686640";"4145"
"4089";"Regular tráfico M-30 en horas puntas a vehículos con 2 o más ocupantes";"<p>Cualquiera que necesite llegar a su trabajo o centro de estudios, a través de la M-30 (o principales vías de acceso) a primera hora de la mañana, y regrese por la tarde, comprobará que es un auténtico infierno de atascos, pérdidas de tiempo innecesarias, y un aumento brutal de la contaminación.</p>

<p>La base del problema se encuentra en que la mayoría de automóviles llevan a un único ocupante, por lo que la M-30 (así como grandes carreteras de acceso y avenidas), colapsan, porque no pueden hacer frente a tal cantidad de tráfico.</p>

<p><strong>Si se limitara el uso de la M-30 en las horas puntas, para que sólo se pudiera circular por ella en caso de que el automóvil lleve a 2 o más ocupantes, estaríamos reduciendo el tráfico a la mitad.</strong></p>

<p>Esta medida debería ir seguida de algún tipo de plataforma para poner en contacto a personas que se trasladen en la misma dirección y puedan compartir vehículo, y por supuesto, de un aumento de la frecuencia de Metro y autobuses.</p>

<p>Por favor, hagamos entre todos que Madrid sea una ciudad más verde y feliz, y no un mar de atascos y humo, en el que todas las mañanas empezamos el día de mal humor.</p>

<p>¿Se os ocurren otras medidas que se puedan llevar a cabo?</p>
";"24/09/2015 10";"65";"36";"29";"4";"1019385037";"387"
"4090";"Biblioteca municipal en barrio de Legazpi (Arganzuela)";"<p>Hay un magnifico solar municipal vacio entre las calles Hierro y Rodio. Se podria aprovechar para abrir una biblioteca municipal para un barrio en expansion. El resto de bibliotecas nos pillan muy lejos. Gracias y enhorabuena por esta magnifica iniciativa de participacion</p>
";"24/09/2015 11";"94";"91";"3";"0";"1033462978";"8519"
"4091";"Hay gente que son discapacitados y con poca pensión,  y necesitan un ascensor ";"<p>La nueva  ley de propiedad  horizoltal obliga a pagar el ascensor, a personas discapacitadas que no pueden bajar de sus pisos, ni pueden pagarlo por que sus pensiones son de miseria, tienen dos problemas no pueden salir de casa ni pagarlo ¿habría que ayudar a estas personas no? </p>
";"24/09/2015 12";"75";"68";"7";"7";"1031338491";"5530"
"4092";"FAROLAS NUEVAS CALLE ANTONIO ACUÑA";"<p>En el tramo de la calle Antonio Acuña, entre O´Donnel y Dr. Castelo, numeracion entre el numero 19 y 25, no se cambiaron las farolas altas por las clasicas como  toda la zona. Todo el barrio de Salamanca y Retiro, ademas de otros barrios tienen cambiadas las farolas desde hace mas de 7 años, pero este tramo, no se sabe porque no se cambiaron en su dia y sigue hasta la fecha y hablamos de un tramo que no llega a 100 metro de longitud. Se solicito en su momento hace mas de 5 años informacion a este respecto y la contestacion fue que no habia presupuesto. Estamos hablando de entre 8 o 10 farolas. </p>
";"24/09/2015 13";"16";"11";"5";"0";"1020959600";"412"
"4093";"¿Esta recibiendo la página de propuestas ciudadanas la promoción que se merece?";"<p>Creo que el portal de propuestas ciudadanas no está recibiendo toda la afluencia de gente que debiera tener. Por poner un ejemplo: la propuesta de eliminar los festejos taurinos apenas ha recolectado unos 2300 apoyos, cuando en Madrid han votado unas 9600 personas a PACMA(aunque no me cabe duda de que hay muchísimas personas más dispuestas a acabar con esta práctica). </p>

<p>Por lo tanto es conveniente hacerse las siguientes preguntas:</p>

<p>¿Se esta promocionando debidamente una plataforma con tanto potencial como lo tiene decide Madrid? </p>

<p>¿La población madrileña se tomará en serio este proyecto si no lo conoce?</p>
";"24/09/2015 14";"104";"84";"20";"10";"1030931739";"5169"
"4094";"Situación desastrosa en el PAU del Ensanche de Vallecas";"<p>Ahora Madrid un autentico desastre en la gestión municipal del PAU del Ensanche de Vallecas. El barrio continúa siendo una cloaca infecta, el riego gota a gota esta de atrezo, los parques sin regar y la suciedad sigue siendo el paisaje habitual. Es evidente que quieren que NO les votemos en la generales...</p>
";"24/09/2015 16";"73";"72";"1";"8";"1035214241";"7002"
"4095";"Servicio Estacionamiento Regulado  ""SER""";"<p>Vigila nuestro Ayuntamiento lo que se cobra por el estacionamiento?</p>

<p>Sabe nuestro Ayuntamiento cuándo suben los importes las empresas que tienen la concesión?</p>

<p>He comprobado que del día 14 al 15 de Septiembre lo han subido un 30%.</p>
";"24/09/2015 18";"45";"44";"1";"2";"1033669451";"4204"
"4096";"Aceras bien arregladas para evitar tropiezos y caídas";"<p>Buenas tardes, abro este debate porque me parece muy necesario y urgente que se revise el estado de los adoquinados de las aceras de, por lo menos mi zona, concretamente la calle General Orgaz, General Cabrera y colindantes.</p>

<p>Ya van dos veces que mi madre, de 78 años, se cae por tropezarse con adoquines sueltos, rotos o inexistente...y eso que pone mucho cuidado y va con bastón. El otro dia voy con ella y me lleva por ""la ruta""...tiene su camimo hecho por donde no hay roturas, pero nunca esta libre de tropiezos.</p>

<p>Es una pena que una persona con bastante agilidad a pesar de su edad y con muchas ganas de hacer su vida de una forma autosuficiente tuviera que verse encamada por una mala caida que podria evitarse haciendo lo que se supone que pagan nuestros impuestos.</p>

<p>La pena es que no es pueden poner fotos en estos debates.</p>

<p>gracias</p>

<p> </p>
";"24/09/2015 18";"164";"161";"3";"4";"1039492263";"15510"
"4097";"Si al THC, que es vulgarmente conocido como marihuana";"<p>La marihuna es THC, un compuesto químico como es el de la aspirina o el paracetamol. Lo que pasa es que está estipulada como droga ilegal y la falta de información es algo muy dañino en las sociedades. La marihuana se considera un tema muchas veces tabú y que por como se tiene vista, no hay ni que dabatirse que no se legalice. La marihuana además se relaciona con fumar y lo nocivo que es el tragar humo para el organismo. No, la marihuna, como he dicho, es un compuesto químico como la aspirina, el paracetamol y de echo mucho más blando que otros fármacos como el orfidal e incluso la morfina, que se usa y es legal bajo receta. Debemos de abrir la mente y aceptar que debe legalizarse, y vamos a llamarlo THC, no marihuana, para que entendamos que hay mucha hipocresía respecto al tema y hay que abordarlo dándole una solución pragmática. Sí al THC como medicina, que sea una medicina más. No se debe demostrar sus beneficios en pacientes como puedan ser los de glaucoma o terminales de muchas ramas pues está ya científicamente demostrado. Sí al THC, es un avance, debemos de quitarnos estereotipos que hay inculcados por ignorancia y desconocimiento y apoyar lo que es un avance al igual que se apoyan otros avances médicos, siendo este de la misma envergadura o incluso mayor que muchos de ellos. El THC se puede tomar de muchas maneras que no sea fumado. Legalización del THC como medicina, es lo que prima. Mejorará la calidad de vida de muchos pacientes en sus dolores y patologías, está ya cientificamente demostrado y hay que librarse de estereotipos, hipocresias e ignorancias sobre el tema que no tienen sentido alguno.</p>
";"24/09/2015 20";"78";"34";"44";"11";"1014427685";"-435"
"4098";"Eliminar publicidad institucional innecesaria. Es financiación camuflada";"<p>Últimamente no sé, porque no escucho mucho la radio, pero hasta hace poco era descarada la saturación de anuncios del tipo: Metro de Madrid vuela, Canal de Isabel II, Ecoembes, etc. etc. etc
¿Es necesario anunciar el metro? ¿El agua del grifo? Vamos, que pienso que era una forma utilizada por el Antiguo Régimen de subvencionar a los medios.</p>

<p>Sé que no todas esas empresas corresponden al Ayuntamiento de Madrid, pero al menos en las que son de su competencia, se debería acabar con esa práctica.</p>

<p>El dinero que se ahorre se podría utilizar en mejorar el servicio que dan esas empresas o bajar el precio, por ejemplo. Que falta hace.</p>

<p>Salud</p>
";"24/09/2015 22";"129";"126";"3";"9";"1040015177";"12013"
"4099";"Prohibir correr  por  la periferia  del retiro por haber mucha  contaminación";"<p>Actualmente hay unos circuitos  para  correr por la periferia del retiro, se trataría de cambiarlo al interior del mismo.</p>

<p>El motivo es debido a que por la periferia van paralelos a  las calles por donde circulan los coches ,donde hay más contaminación, y como  corriendo se respiira  5 veces más que andando ,el corredor respira  toda la contaminación especialmente las particulas menores de 2,5 micrometros que van directas a los pulmones,con lo que se perjudican la salud sin necesidad. Al  final la mayor parte de  los gastos de salud los pagamos todos los ciudadanos..</p>

<p>,</p>
";"25/09/2015 02";"62";"4";"58";"7";"1019592003";"-348"
"4100";"Paneles informativos de METRO y EMT útiles, déjense de información inútil";"<p>Los paneles electrónicos del Metro y de la EMT deben tener como fin primordial informar del tiempo que falta para la llegada del siguiente tren o bus, Y NADA MAS. Es decir; si entro al vestíbulo del metro y hay un cartel que me dice que tal o cual línea está de obras, YA LO SE, no necesito que me lo repitan en los paneles electrónicos mientras me desespero ""esperando"" que me diga cuánto falta para que llegue mi tren, o viendo una pantalla que dice ""próximos trenes"" durante varios segundos sin que salgan esos trenes...QUE YA SABEMOS QUE LA INFO ES DE LOS PROXIMOS TRENES NO NOS TOMEN POR MEMOS. Si en los andenes se introduce información adicional, QUE NO ESTORBE BAJO NINGUN PRETEXTO la información verdaderamente útil que es el tiempo que falta para que llegue mi tren. Lo otro es desesperarnos a todos. Dudo que algún usuario de metro o EMT arda en deseos de que le repitan hasta la saciedad lo que ya sabe; si es que hay algo más importante, si desde el vestíbulo tomo la opción de salir corriendo al andén porque llega mi tren, o tomármelo con calma. Háganos más agradable los trayectos</p>
";"25/09/2015 12";"89";"80";"9";"3";"1042050648";"6382"
"4101";"Creación de una línea de tranvías en el centro de Madrid.";"<p>Madrid debería tener tranvías como muchas ciudades españolas y del resto de Europa. Es un transporte limpio, seguro y rápido ya demás daría a nuestra ciudad un aspecto más europeo y bohemio como ocurre por ejemplo en Lisboa. Para ello propongo una línea por el centro de Madrid con modificaciones y extensiones, así como otras dos Desde Carlos V a Pte. de los Franceses, y Paseo de la Castellana. Para más información, la propuesta está en la página 18 más o menos, en el apartado ""Movilidad""  </p>
";"26/09/2015 11";"104";"55";"49";"42";"1041483879";"317"
"4102";"Controlar la velocidad de los ciclistas en el Paseo del Retiro y control perros ";"<p>He observado en más de una ocasión la <strong>velocidad que alcanzan algunos usuarios en bicicleta</strong> en el <strong>Parque del Retiro</strong>, especialmente en la cuesta de la <strong>Avenida de Cuba, </strong>bajan de noche y de día a gran velocidad, muchas veces en las bicicletas del ayuntamiento que tienen ayuda con un  motor eléctrico y alcanzan irresponsablemente y sin tener en cuenta la integridad del prójimo ante cualquier imprevisto, velocidades peligrosas. <strong>En el Retiro debemos tener preferencia los peatones y queremos caminar tranquilamente</strong>, es una locura lo de las bicis o lo de los patinadores, lo mismo en el <strong>paseo de coches. </strong>Se cruza un niño y un anciano y ouede ocurrir cualquier desgracia, como no se ponga coto a esto solamente es cuestión de tiempo. Sugiero se haga algo al respecto.</p>

<p>Igualmente sería deseable que los perros fueran atados y se cumpla la normativa pues en más de una ocasión cuando voy a correr han venido tras de mi ladrando lo cual no es plato de gusto, máxime cuando el que viene es un mastín o un pit-bull. La ley está para cumplirla.</p>

<p>Gracias y un saludo.</p>
";"26/09/2015 17";"78";"53";"25";"14";"1047715706";"1902"
"4103";"Instalación de un carillón en la Pza Mayor.";"<p>Propongo que se instale un carillón o artilugio musical a base de campanitas afinadas, en el reloj de La Casa de la Panadería de la Pza Mayor de Madrid, así como un mecanismo con figuras móviles para darle más vistosidad. El mecanismo musical debería poderse silenciar a partir de la hora que interese, para no molestar el descanso nocturno de los vecinos. Las melodías musicales a programar pueden ser muchas y propongo algún movimiento de la obra ""Música Nocturna de Madrid"" de Boccherini.</p>
";"26/09/2015 18";"53";"22";"31";"6";"1033846349";"-373"
"4104";"Mejorar carretera barrio de la Fortuna";"<p>Tanto la calzada, como la iluminación y planificar aceras.</p>
";"26/09/2015 19";"23";"20";"3";"3";"1048992740";"1478"
"4105";"Colonia Pedro Vives";"<p>Realizar limpieza de.la colonia, lleva meses sin limpiar. </p>
";"26/09/2015 19";"11";"9";"2";"2";"1045333960";"572"
"4106";"Policia municipal  ---->  conducta poco ejemplar.";"<p>El pasado Jueves día veintisiete de agosto, en la plaza del Callao alrededor de las diez de la noche se retiraban tras su intervención una ambulancia y un transporte policial.  Ambos vehículos retrocedieron entre la nutrida concurrencia iniciando su maniobra de <strong>marcha atrás</strong> con indiferente parsimonia, ajenos  -primero uno y luego el otro-  al patente riesgo que obviamente constituyen tales movimientos en esas circunstancias.  Pero mientras los desplazamientos del primero se anunciaron con notoria SECUENCIA SONORA de toques intermitentes (más su iluminación de retroceso reglamentaria) el segundo hizo caso omiso a los palmetazos sobre su chapa del público circundante, a punto de ser arrollados sin tiempo material de escape:  el furgón MercedesBenz modelo ""Sprinter"" con matricula 8589-HYJ no activó (a pesar de su iluminación de retroceso) absolutamente <u>ninguna señal sonora</u> por lo que se hubo de apercibir enérgicamente al Conductor de la dotación, quien sin ocultar su divertida sorpresa no dejó por menos de sorprender con la expresión jocosa de ""Allá ellos... que <em>se retiren</em> -ante la Policia municipal- <em>cuando nos vean</em>. Así aprenderán (la proxima vez) que se acerquen"".  La persona impedida que apenas consiguió cojeando evadirse del arrollamiento, al comprobar que el tono oscuro se correspondía con la ""librea"" de la Autoridad prefirió no formular cargos.  Por lo que ninguno de los presentes pudo (a nuestro pesar) contar con su testimonio determinante: sabiendo las facilidades DE SERIE que permiten visualización en tiempo real, detección en proximidad y señalización sonora -a la palanca en Caja de Cambios- sobre dicho Modelo, exigimos sean inmediatamente determinadas las correspondientes <strong>Responsabilidades <em>individuales</em></strong> así como se proceda de inmediato con la extensiva <strong>revisión <em>de toda</em> la Flota</strong> de vehículos a este particular respecto en la policia municipal de Madrid.  Y al propio tiempo se solicita amablemente cuantos otros testimonios sobre el tema sean pertinentes recoger de los lectores también afectados en cualquier otra ocasión por el desdén y la prepotencia de quienes no parecen ""estar a la altura"" de la confianza otorgada, sin importar su graduación ni destino. </p>
";"26/09/2015 21";"73";"69";"4";"3";"1056277805";"6143"
"4107";"mejorar el control y cuidado de zonas verdes";"<p>Numerosas zonas verdes de madrid se ven aquejadas de problemas con el arbolado, en varias ocasiones se han sufrido accidentes incluso muerte de un ciudadano. la riqueza arbórea de madrid está sufriendo serios castigos y cada vez se encuentran mas tocones de arboles con decenas de años. Estos ""cadaveres vejetales"" son indicios de algo profundo y peligroso que está dañando severamente a los pulmones de la ciudad.</p>

<p>Propongo un debate serio y técnico, para identificar las causas reales de este daño incontrolado que solo se ve resuelto con las talas de árboles mientras que la ciudadanía ve impotente como desaparecen especies de gran valor. Me gustaría incluir en este debate también la invasión de especies de pájaros exóticos que están desplazando a gorriones y palomas, y que se apoderan por decenas de las praderas de nuestras zonas verdes.</p>
";"27/09/2015 13";"73";"71";"2";"1";"1063355245";"6710"
"4108";"Cambiar el adoquinado de la Plaza Mayor ";"<p>Y poner en su lugar otro parecido,quue han puesto en la Aveida de Portugal o losas como la de Salamanca.Las que hay están bastantes desgastadas.Puede producir caidas,incómodas para caminar y como estár un buen rato de pié.</p>
";"27/09/2015 15";"42";"14";"28";"1";"1042624552";"-466"
"4109";"Revisar tiempos para el cruce de semáforos por los peatones.";"<p>Muchos de los semáforos de nuestra ciudad tienen establecido un tiempo insuficiente para el cruce de peatones, especialmente para personas mayores o con problemas de movilidad.</p>

<p>Con el envejecimiento de la población, debería replantearse la velocidad media de paso y en base a eso, actualizar los tiempos de los semáforos.</p>

<p> </p>

<p> </p>

<p> </p>

<p> </p>

<p> </p>

<p> </p>

<p> </p>

<p> </p>

<p> </p>
";"27/09/2015 20";"67";"65";"2";"3";"1066246596";"6111"
"4110";"limpieza de la ciudad";"<p>Es una verguenza como está la ciudad desde el cambio del ayuntamiento. No hay operarios para la limpieza, es vergonzoso, donde había 16 personas ahora hay 4, no pueden limpiar todo lo que tienen que hacer, las calles y plazas se mediolimpian una vez por semana. Penoso cuando nos están cobrando cada día más.</p>

<p> </p>
";"28/09/2015 03";"110";"103";"7";"17";"1070246425";"8989"
"4111";"Nos mean y los medios dicen que llueve";"<p>  Hola , ¿Cómo podemos democratizar los medios audiovisuales y dar acceso y medios a colectivos sociales para que participen en la construcción de la sociedad en lugar de fanatizarlos con la discriminación y así enriquecer la crítica constructiva? ¿No parece peligroso que las grandes empresas de comunicación se finacien con dinero de empresas de armamento o bancos? y que los ciudadanos tengamos  participación y podamos expresar nuestras opiniones o manifestaciones artísticas.</p>

<p>Una ley de medios que garantizara medios económicos y licencias a colectivos sin acceso a los media por falta de recursos , como radios sociales, espacio televisivo, promover una televisión pública europea, derecho a réplica obligatorio, promover el desarrollo social , cultural y científico como pago por utilizar las licencias públicas, un órgano defensor del periodista y el consumidor, multas por manipulación de noticias o por falta de verificación, apoyar a los medios alternativos con impuestos a las plataformas más ricas, obligación de proporcionar educación crítica y de entendimiento consciente de la información audiovisual, prohibir la publicidad dirigida a menores o que discrimine y ridiculice colectivos .</p>

<p>¿Cómo se podría llevar a la práctica?</p>
";"28/09/2015 04";"26";"14";"12";"1";"1053610392";"107"
"4112";"¿Que hacer con las glorietas?";"<p> Accidentes a dirario y enfrentamientos entre conductores cada segundo. Por desconocimiento, por interés personal y egoísmo, por rebeldía o incomprensión de su funcionamiento, el caso es que 1 de cada 2 conductores se enfrenta con el otro por que cada uno circula de distinta forma en las glorietas.</p>

<p> Su existencia y funcionamiento pueden estar justificadas o no, pero si existen y debemos circular por ellas debemos hacerlo todos con las mismas reglas para no chocar (literalmente). Asi que la situación actual debe cambiar.</p>

<p> </p>

<p> Se pueden hacer campañas de información y concienciación, pero creo que lo mas efectivo es que el responsable de haberlas colocado en este caso el ayuntamiento se preocupe, al menos de cuando en cuando y más viendo la conflictividad actual, de vigilar el funcionamiento y correcta circulación en ellas. Y si en alguna es imposible solucionarlo y evitar los accidentes, pues que se quite y establezca un cruce o raquetas de giro.</p>
";"28/09/2015 09";"18";"14";"4";"7";"1062322476";"777"
"4113";"Utilización de equipamientos construidos en Madrid y abandonados.";"<p>¿Qué ocurre con cosas que se hicieron, se utilizaron y se abandonaron?, me refiero, por ejemplo, al auditorio del Parque Juan Carlos I, es una pena verlo abandonado, hace años que no se utiliza y no entiendo porqué, estando en un sitio en el que no se molesta a nadie por el ruido y cosas así. Recuerdo cuando se usaba para los espectáculos de fuentes cibernéticas, había un ambiente familiar estupendo.</p>

<p>Hablo de éste porque vivo al lado, y señora alcaldesa, creo que usted también es de Hortaleza, aunque da igual donde se viva, seguro que otros distritos de Madrid hay más sitios parecidos.</p>

<p> </p>

<p>Muchas gracias. Marisa González</p>
";"28/09/2015 11";"78";"74";"4";"5";"1072181992";"6641"
"4114";"Limpieza carabancel";"<p>Limpieza de calles</p>

<p> </p>
";"28/09/2015 11";"58";"53";"5";"4";"1070215992";"4386"
"4115";"Carril bici en la carretera en toda la zona de Madrid";"<p>Como ya muchas ciudades utilizan (ej. Dublin, Amsterdam, etc), un carrill bici en la carreera junto con los buses y taxis sería de buen uso, en lugar de utilizar un mismo carril para coches y bicis ya que ningún coche sigue los limites de 30 km/h.</p>
";"28/09/2015 15";"106";"83";"23";"6";"1070363346";"4698"
"4116";"Perseguir la publicidad en los parabrisas y ventanillas de los coches";"<p>Cuando vives en una zona céntrica, se da el caso de que te levantas para ir a trabajar y te encuentras en el coche papeles publicitarios y te tienes que pasear alrededor del coche quitando: la publicidad del local de comida rapida, de un concierto, de una optica, de un prostíbulo etc. Y por supuesto, si quieres ser un ciudadano cívico acercarte con todos los papelitos a la papelera mas cercana, que puede estar cerca o no. Estas molestias se multiplican cuando está lloviendo. Los papelitos al mojarse se quedan pegados al cristal y al intentar quitarlos se rompen. No es agradable estar bajo la lluvia a las 6:30 de la mañana, rascando los cristales con las uñas para que no se forme una pasta de papel al poner en funcionamiento los limpiaparabrisas, y por supuesto viajecito a la papelera mas cercana con la mano llena de agua y trozitos de papel que no te puedes quitar bien porque en la otra mano llevas el paraguas.</p>

<p>No tengo ningún problema en aceptar la publicidad que me ofrecen por la calle; no tengo ningún problema en que me llenen el buzón con publicidad; pero en el coche basta ya por favor.</p>
";"28/09/2015 15";"135";"125";"10";"14";"1075750432";"10648"
"4117";"¿Medidas para reducir el numero de captadores de socios de O.N.G.s en la calle?";"<p>Quiero abrir un debate sobre posibles medidas para reducir, o minorar, las posibles molestias de tantos captadores de socios de ONGs hoy en día en las calles. Por ejemplo, solo pueden trabajar ciertos días y/o ciertos zonas, o solo puede haber un numero limitado de captadores por `metro cuadrado´. Quizás otro opción es que tengan permiso para montar un pequeño quiosco temporal con el nombre de su ONG visible, pero no tienen permiso para aproximarse a la gente andando.</p>

<p> </p>
";"28/09/2015 16";"73";"60";"13";"11";"1070664217";"3863"
"4118";"Utilizar el buscador";"<p>Propongo que antes de realizar una propuesta , utilicemos el buscador para no repetir, por ejemplo ; si queremos proponer algo sobre limpieza , buscamos la palabra limpieza para ver si alguien ya lo propuso antes y apoyarle, o con el carril bici , etc.</p>

<p>Muchas y gracias un abrazo</p>
";"28/09/2015 16";"70";"66";"4";"3";"1073643417";"5845"
"4119";"Las aceras para los viandantes";"<p>Estoy a favor de las bicicletas y de hecho las uso, pero considero un grave riesgo que por las aceras, independientemente de su anchura o velocidad a que se circula (no se respeta ninguno de los dos condicionantes), circulen bicicletas al mismo tiempo que adultos. niños o personas mayores que, desgraciadamente no pueden tener la linea recta como su preferencia de movilidad, siendo habituales sus detenciones o cambios de dirección,que son dificiltmnente evitables cuando se circula sobre dos ruedas, incluso aunque se vaya practicamente parado, sin olvidar los árboles, semáforos, papeleras, parquímetros, postes de distintos controles viarios o las denominadas ""catalinas""</p>

<p>Se que es un riesgo para los ciclistas circular entre los coches, pero he comprobado en numerosas ocasiones, que no lo es menos para los viandantes compartir las aceras con los ciclistas y para colmo con las motos que parece tienen permiso para aparcar en ellas donde no parece que lleguen en brazos de sus pilotos.</p>

<p>Creo que por las aceras sólo se debería circular a pie o, si no es posible, acondicionar carriles para viandantes donde no corran el riesgo de atropeyos.</p>
";"28/09/2015 18";"121";"107";"14";"9";"1075262204";"8223"
"4120";"Intermediación Empresa Municipal del Alquiler (EMA) ";"<p>Estoy viendo como necesario que la EMA del Ayto de Madrid se dote de más herramientas tanto a nivel de normativas, como de tramitación, para servir de referencia y apoyo verdadero tanto al inquilino como al propietario. </p>

<p>Como inquilina, lamento la inexistencia de un código escrito de las obligaciones y responsabilidades que nos incumben, detalladas y explícitas (si se pueden pintar o no las paredes, si se pueden clavar clavos, etc). En caso de dudas con respecto a las obligaciones a cumplir, la EMA no tiene nada que decir e invoca la libertad de decisión del propietario. </p>

<p>Por ejemplo, propongo como solución sencilla y satisfactoria para ambas partes arrendatarias que, al abandonar el piso alquilado, el inquilino y el propietario pongan en partes iguales una suma de dinero para la limpieza del piso, evitando así posibles retenciones del fondo de la fianza y desacuerdos.</p>

<p>Otra cosa necesaria sería que se le imponga al propietario la contratación de un seguro de hogar que cubra el continente y la responsabilidad civil.</p>

<p> </p>
";"28/09/2015 22";"17";"14";"3";"0";"1067988152";"905"
"4121";"Bicis en aceras de más de 3 metros y al ritmo del peatón";"<p>Hasta 2011 la normativa municipal pemitía algo muy razonable: se podía circular por aceras de más de 3 metros de ancho, y si había peatones se debía mantener una velocidad similar a los mismos.</p>

<p>En la actualidad la policía municipal amenaza con poner, y a veces pone, multas a los ciclistas que vayan por aceras, aunque sean poco concurridas y las calles sean muy inseguras de transitar, como es el caso de la Cuesta de San Vicente, donde hay mucha pendiente y mucho tráfico.</p>

<p>Creo que habría que volver a la normativa anterior a 2011, y sólo multar a los ciclistas que no la cumplan por exceso de velocidad que sea temeraria.</p>

<p> </p>
";"28/09/2015 22";"71";"49";"22";"16";"1069957179";"1863"
"4122";"Cerrar la M30 en el nudo norte";"<p>La inacabada M30 en su parte norte provoca atascos en la carretera de Colmenar M607, tanto de entrada como de salida de Madrid, en el Paseo de la Castellana (lo mismo, tanto de entrada como de salida), en el acceso de la carretera de Burgos y, obviamente a ambos lados del nudo norte de la M30.</p>

<p>Si se cerrase completamente la parte norte de la M30 vecinos de todo Madrid que venimos a esta zona a trabajar (vecinos de Vallecas, Aluche, Carabanchel, Moratalaz, Chamberí, Centro, Ciudad Lineal, Usera, Arganzuela, Salamanca, Chueca...) ganaríamos mucho en calidad de vida si tuviéramos la M30 como discurre en todo su recorrido, con una zona central con 3 o 4 carriles en cada sentido y entradas y salidas para cada una de las carreteras que a ella acceden, en lugar de confluir todas las nombradas anteriormente en un espacio de poco más de 2 kilómetros. Además bajaría mucho la contaminación tanto en esa zona como en el resto de Madrid por el hecho de que habría menos aglomeración de coches contaminando todos juntos y mucho más tiempo del necesario.</p>

<p>Por eso considero que debe ponerse en estudio la conclusión de la M30 para que sea un verdadero anillo que circunde Madrid.</p>

<p>Votad SI con el dedo hacia arriba!</p>
";"29/09/2015 00";"86";"62";"24";"10";"1071701754";"2739"
"4123";"Metro por el Paseo del Prado y Recoletos";"<p>No es una propuesta nueva, pero a día de hoy sigo echando en falta que exista una línea de metro que vertebre la ciudad. A finales de los 80 se redactó un proyecto que no se llevó a cabo, de prolongación de la línea 8 (hoy línea 10) hacia Rubén Darío, Colón-Recoletos, Banco de España, Prado y una bifurcación a Plaza Elíptica y por otro lado a Martínez de la Riba por Méndez Álvaro.</p>
";"29/09/2015 00";"41";"31";"10";"4";"1070550420";"1587"
"4124";"Incorporación al carril-bici de Sol desde la curva de la calle Alcalá = suicidio";"<p>La incorporación desde la curva de Alcalá de sol (sí, donde el Apple Store) hacia el carril-bici contrario al sentido de la circulación es peligrosa. No hay espacio para girar a la derecha desde una curva hacia la izquierda, además de los peatones que inundan esta calzada despistados, que también son un peligro. Habría que solucionar esta zona peligrosa haciendo una bifurcación a la derecha desde dicha curva, para incorporarse al carril-bici.</p>
";"29/09/2015 01";"37";"27";"10";"1";"1069573341";"1240"
"4125";"Prohibir fumar en zonas al aire libre (terrazas, restaurantes, cafeterías, acera";"<p>Prohibir fumar en zonas al aire libre (terrazas, restaurantes, cafeterías, aceras...No es viable ni tolerable que los fumadores sigan contaminando con humo tóxico y dañino para la salud a todo aquel que se cruce con ellos por las calles, aceras, cafeterías terrazas al aire libre,etc. De forma que una persona SANA no fumadora, no puede hacer uso de ningún espacio abierto de al ciudad sin ser invadido con el humo de TODOS los fumadores que se le cruzan por la calle.  COn frecuencia me veo limitada a no poder disfrutar de una terraza en verano, charlando con amgios al aire libre proque SIEMRPE hay varias mesas de al lado con gente fumando que te lega el humo, de no solo uno sino de dos o más fumadores. También cuando camino tranquilamente por la ciudad de Madrid, te vas cruzando con gente, o a veces tienes que estar andando a la par con una persona que te va ahumando , enfermandote y eso es no solo una falta de respeto TOTAL y absoluta que ya se ha perdido ese concepto de respeto a los demás (no hagas al otro lo que no te gustaria que te hicieran) sino que invade gravemente tu intimidad física haciendote , forzandote a respirar humo directo en tu nariz , directo en tus pulmones, afectando gravemente a tu salud de una forma no autorizada evidentemente. Vamos que es una  una agresión que no está penada y debe estarlo.es una adicción que no afecta al adicto sino a los demás y eso debe estar penalizado, ya que agrede a otros, no solo a uno mismo.,</p>

<p> Si por ejemplo en otro tipod e adicciones como un drogodependiente, vieramos que alguien sale con su jeringuilla a inyectar heroina a otros, nos horrorizaríamos, entonces proque la cultura sigue tergiversando la visión de la realidad sobre los fumadores como adictos agresivos? estan dañando a otros, y eso no ocurre con nada, no estña tolerado con nada. Nadie tolera ningun tipo de agresión de unos a otros, salvo la del tabaco. Tienen que legislar que no esté permitido dañar a los demás con el humo del tabaco en ningun tipo de espacio publico ni cerrado ni al aire libre, Hacen algo a muchas personas que NO desean que se les haga, y además algo que nos perjudica gravemente, ademas de molestar a muchas personas gravemente y no permitirles ejercer su libertad de estar en espacios publicos respirando aire limpio.</p>

<p>¿porque una persona que no contamina ni agrede con su humo no puede disfrutar de los espacios abiertos en cambio alguien qeu si agrede contamina y molesta a muchos tiene potestad de utilizar el espacio publico ?? es el mundo al reves y una agresión y limitación de libertades de los no fumadores que debe terminar.</p>
";"29/09/2015 03";"137";"55";"82";"35";"1055741609";"-1083"
"4126";"Prohibir los parámetros en Madrid, que vuelva a ser una ciudad de libre aparcami";"<p>Prohibir los parámetros en Madrid, que vuelva a ser una ciudad de libre aparcamiento totalmente, dado que ya se paga el impuesto de circulación, y el de matriculación, que debe incluir el tránsito por la ciduad y el establecimiento de los coches por la ciudad. Evidentemente al compra de un coche y el impuesto anual de circulación ya llevan implícitos la obligatoriedad de estacionar el vehículo que está circulando, por tanto no debe cobrarse adicionalemnte por ese establecimiento.</p>

<p> </p>

<p>Para más inri ahora los parkímetros los han puesto hasta las 21h¡¡ un abuso¡¡ cuando debería ser libre aparcamiento y gratuito no se puede tolerar que el horario sea tan largo, ni tampoco que los sábados por la mañana exista la obligatoriedad de poner el parkímetro en el coche. Esto debe desaparecer.</p>

<p> </p>

<p>Encima el sistema actual que tienen de tener que estar máximo dos horas en cada sitio que aparques y cuando termina el plazo tener que cambiarlo de barrio es una exigencia que no se puede permitir. El otro día tuve que aparcar de 10a 15horas un sábado que fui a unas charlas. tuve que cambiar el coche de lugar 3 veces¡¡¡ de 10 a 12h en un sitio, luego el parkimetro no me permitía poner más dienro en esa zona, así que a las 12 cambié el sitio hasta las 13:30h, el máximo que me permitía en esa nueva zona y para cambiar hasta las 15h, tuve que volver a cambiar de zona¡¡¡¡ es delirante¡¡¡ 3 cambios de sitio y de barrio para solo 5 horas¡¡¡  prohiban esta locura y hagan libre aparcamiento y gratuito (que en realidd no sería gratis porque ya se paga en los impuestos del coche y el seguro ¡¡¡</p>

<p> </p>

<p> </p>
";"29/09/2015 03";"67";"25";"42";"73";"1059566732";"-634"
"4127";"Prohibir que los taxistas cambien de tipo de tarifa a partir de ciertas zonas";"<p>Prohibir que los taxistas cambien de tipo de tarifa a partir de ciertas zonas, como por ejemplo saliendo de la castellana hacia adelante cambian de tarifa y cobran una barbaridad,  en realidad he tenido que usar taxis esta semana y es una barbaridad qeu 10 minutos subida en el taxi que en madrid no es nada de tiempo, supone al menos 10 euros, vamos a euro por minuto, teniendo en cuenta los atascos y eternos semáforos de madrid que dar la vuelta a una manzana supone al menos 3 minutos-5 ¡no puede ser que se cobre 1 euro por minuto¡ para ir a dos o tres calles mas alla ya tienes que pagar 8 euros¡¡¡ precios más cercanos a la realidad adquisistiva de la media, que da la sensación de que van trucados los taxímetros proqeu van mas rapido imposible¡¡ mas coherentes gracias</p>
";"29/09/2015 03";"61";"44";"17";"68";"1073885096";"1947"
"4128";"Videntes, tarotistas, 806, 807, 118xx  y demás números de tarificación adicional";"<p>Prohiban ese tipo de teléfonos y servicios.</p>

<p>Primero los números de tarificaicón adicional deben desaparecer porque las operadoras telefónicas las cobran adicionales a los contratos que tienes con ellos, de cuotas mensuaels incluyendo todos los servicios de telefonía, por lo que elc obro de esos números no pueden ser cobrados.Y para evitar problemas eliminen esos teléfonos.</p>

<p>Segundo proque son servicios estafan en su propia esencia, nadie puede leer el futuro por tanto se ofrece algo que no es real que no se puede ofrecer lo que lo convierte en un timo una estafa un engaño. ""te digo que te doy algo que es mentira y te cobro una fortuna a través de teléfono sin saber realemtne lo que supone cada llamada"" es decir, la ley de ocnsumo obliga a decir el precio TOTAL de todo producto o servicio, de forma que si voy al teatro se que cuesta por ejemplo 30 , y que eso es lo que voy a pagar , en estos telefonos solo te dicen el precio por minuto , una muestra mas de la mala intención de apoderarse de un dinero engañando al consumidor sin saber cuanto pagará pro el servicio ficticio.</p>

<p>Tercero, prohubirlo de aparecer en programas de tv, no solo aparecen a diario todas las ncohes sino que en mas de 10 canales televisivos, y todos los medios de comunciaicón prensa internet etc...igual que prohiben otros delitos prohiban este proque es totalmente delictivo vender algo que es humo qu ees mentira a gente adicta y necesitada de ayuda psicologica . Debe ser prohibido terminantemente su aparcición en medios de comunciación, ni tv, ni radio, ni revistas, ni prensa, ni internet, no facilitarles la publicidad ni los medios para figurar, que desaparezcan los telñefonos de tarificación adicional TODOS deben ser declarados completamente ilegales por lo descrito previamente.</p>

<p> </p>

<p>y ayuden a los afectados adictos </p>

<p>Cuarto.la mayoria de los que llaman son adictos con necesidad de apoyo psicologico y emocional, por tanto estan embaucando enfermos y perosns necesitadas de compañía, apoyo, ayuda, que se enganchan a esa adicción como lo hacen los ludopatas en el casino. Por lo que deben, ruego encarecidamente que protejan a esas personas adictas que llaman arruinando sus ahorros y sus vidas completas por esta estafa, engaño y falta de regulación y de protección a los adictos a la videncia que la sanidad y la sociedad en su conjunto debe conocer esta problematica y ayuda en esta adicción de muchos.</p>
";"29/09/2015 03";"73";"64";"9";"13";"1077054452";"4821"
"4129";"Precio abusivo parking público de los hospitales la Paz, Ramón y Cajal, etc.";"<p>concretamente el parking del hospital la Paz es un autentico abuso.. estoy seguro que es con diferencia el parking publico más caro de Madrid. Y no me parece de recibo que un parking que no se suele visitar por placer o por ocio. Y que casi todos los Madrileños nos vemos en la obligación de usar en algún momento.. tenga precisamente los precios más caros y abusibos de la capital.. No se de que manera se peude meter mano a esa concesión..,. pero es importante racionalizar este punto...</p>
";"29/09/2015 09";"184";"181";"3";"12";"1086228698";"17509"
"4130";"Recuperar escaleras Méndez Álvaro-Estación Atocha RENFE";"<p>Buenas ciudadanos,</p>

<p>en resumen me gustaría solicitar <strong>realizar una limpieza exhaustiva y un mantenimiento constante</strong> de esas escaleras, e <strong>instalar unos urinarios</strong> cercanos al acceso superior (estación de Atocha) dado que mucho me temo que los taxistas que hacen cola durante horas los están reclamando indirectamente. Una vez existiesen éstos, debería sancionarse el orinar en esas escaleras.</p>

<p>Llevo a mis hijos pequeños a una escuela infantil cercana a la estación de Atocha Renfe, del lado de Méndez Álvaro, barrio en el que residiré próximamente... A la salida de la escuela, nos gusta ir a este fantástico parque/jardín de nuestra ciudad, El Retiro. El camino que yo elegiría normalmente, y que hace que estos lugares se encuentren muy próximos, son las escaleras que suben a la parte superior de la estación desde C/ Méndez Álvaro, a la altura del Colegio Menéndez Pelayo, pero desgraciadamente siempre se encuentran en un estado lamentable de limpieza (orina a raudales). Es necesario recuperar esas escaleras para su uso ya que en su estado actual el hedor insoportable hace este camino inviable, y creo que facilitan una conexión a esa parte de la ciudad y el noreste de Arganzuela.</p>

<p>GRACIAS!</p>
";"29/09/2015 11";"42";"40";"2";"6";"1080117893";"3619"
"4131";"Limpieza urbana  ---->  paralizando ERE a los Contratistas.";"<p>Al hilo de la cuestión, aunque no directamente relacionado, alguien sin duda se preguntará qué impide además ir facilitando progresivamente la incorporación -por ejemplo, en turnos rotativos- de <strong>parados capaces</strong> (tal y como se decía antiguamente <em>Fit and Able seamen</em> para las flotas del sVIII)  mediante cupos reservados -repuntes inabordables de trabajo excesivo ó imprevisto, nevadas, encierros, desfiles- a voluntarios disponibles en  CUADRILLAS AUXILIARES  que les permitan dignamente aliviar tantas angustias familiares y dramáticas necesidades individuales <u>todavía enmascaradas</u>... ya saben, como las del anuncio en TV que crudamente nos describe ""la abuelita no tiene hambre"" mientras cede su alimento a los nietos.  Sin distinción de sexo, discriminación por edad ni cortapisas accesorias  (como nuestra propia Alcaldesa, por cierto)  ¡ánimo!  ¡demuestren coraje!</p>
";"29/09/2015 15";"54";"51";"3";"2";"1082421640";"4533"
"4132";"Remunicipalización del servicio de Linea Madrid";"<p>Escucho con bastante asombro que hay intención por parte del Ayuntamiento de Madrid de remunicipalización del servicio de Linea Madrid a aquellos trabajadores y trabajadoras que pertenecen a la empresa privada. No estoy ni mucho menos en contra de la mejora salarial y de condiciones sociales de unos trabajadores que prestan servicio al Ayuntamiento de Madrid y, por consiguiente, a todos los madrileños y madrileñas, pero ¿qué se va a hacer en este caso? </p>

<p>Hay ciertas informaciones que salen del Ayuntamiento que son preocupantes, como por ejemplo, el paso directamente (y sin pasar por una oposición como el resto de funcionarios y funcionarias que trabajan en Linea Madrid) a la categoría de funcionarios públicos de estos trabajadores. Si la intención fuera esa, sería un gran agravio comparativo con respecto a aquellos funcionarios que han tenido que pasar por una oposición para trabajar donde están trabajando. De hecho, sería un escándalo que trabajadores que pertenecen a la empresa privada pasaran ""automáticamente"" a ser funcionarios sin haber pasado por las mismas condiciones que el resto de trabajadores públicos. </p>

<p>Espero que esta no sea la solución que se de a este problema porque no saldría de mi asombro que un ayuntamiento regido por Ahora Madrid consintiera algo así. Y, repito, sería más que escandaloso que así fuera.</p>

<p>No sé qué solución se les puede dar a estos trabajadores, pero cualquiera que no sea a costa del trabajo ingente por el que han tenido que pasar los trabajadores públicos que han tenido que prepararse y aprobar unas opociones durísimas en su momento.</p>
";"29/09/2015 18";"62";"44";"18";"13";"1078355941";"1845"
"4133";"Que en esta web decide, se puedan  borrar debates y propuestas";"<p>Que en esta web ""decide"", se puedan borrar debates y propuestas si uno lo cree conveniente. Que el desarrollo de la web se mejore para que se permita editar errores en el planteamiento de la propuesta, o borrar mensajes , propuestas, debates, usuarios si uno lo ve oportuno.</p>

<p>Y también que en la partte de MI CUENTA se pueden encontrar facilmente todos los debates y propuestas realizadas, proque sino te vuelves loco buscandolas.</p>
";"29/09/2015 20";"38";"25";"13";"11";"1076459544";"789"
"4134";"¿Por qué sigue cerrado los aparcamiento público Daoiz y Velarde?";"<p>El aparcamiento público Daoiz y Velarde, frente a la Junta Municipal de Retiro, lleva casi 10 años si abrir.</p>

<p>¿Por qué no se abre?</p>
";"29/09/2015 21";"24";"21";"3";"2";"1080002383";"1575"
"4135";"Subvenciones de ccoo, ugt y patronal. aquí enlace de la propuesta";"<p>https://decide.madrid.es/proposals/2291</p>
";"29/09/2015 23";"22";"12";"10";"1";"1071785264";"109"
"4136";"¿Las ONG son  privatización de los servicios públicos camuflada de solidaridad?";"<p>https://decide.madrid.es/proposals/2262</p>

<p>Es incoherente defender la sanidad , la educación, las pensiones, la información o el derecho a un abogado contra la privatización y luego apoyar a una empresa privada con ánimo de lucro que maltrata a sus trabajadores  para que cumpla estas funciones. Esto tiene que ser un derecho , no estar sujeto a  la caridad de una ONG, que no se con qué criterios decide a quién ayudar y a quién no.</p>
";"30/09/2015 00";"25";"21";"4";"0";"1080343353";"1428"
"4137";"Pintadas en las calles y plazas";"<p>Pintadas en las calles</p>
";"30/09/2015 08";"37";"31";"6";"9";"1085493698";"2094"
"4138";"Convertir el antiguo ayuntamiento de Madrid en Parador de turismo";"<p>AsI se daria un uso y daria un poco de vida a la Plaza de la Villa.Daría trabajo y dinero para la ciudad.Es junto a la casa de la carnicería de la Plaza Mayor y el Palacio de Santa Cruz.Los 3 mejores lugares para acoger un parador de turismo en Madrid.</p>
";"30/09/2015 14";"94";"57";"37";"7";"1084393778";"1212"
"4139";"Talleres distrito de USERA";"<p>No sé si este es el mejor medio para mostrar mi indignación, más que debate, quiero presentar mi QUEJA, por el trato recibido por parte de este ayuntamiento. Supongo que compartida por todos los vecinos del barrio de USERA que esperábamos comenzar nuestros talleres mañana día 1 de octubre.</p>

<p>El pasado mes de junio (dentro de los plazos propuestos por este ayuntamiento), solicité plaza para el taller de Baile Moderno que se ofrecen (mejor dicho ofrecían) en el centro cultural mas cercano a mi domicilio, para mi hija de 9 años. En julio (tres semanas después de lo previsto), nos confirmaron que se le había concedido la plaza. En septiembre, tras varios días de paseos hasta el centro cultural, porque no funcionaba la web..., porque no imprimía los pagarés... y no se cuantos impedimentos más, conseguí el abonare para poder REALIZAR EL PAGO DEL IMPORTE DE LA MATRÍCULA Y DEL PRIMER TRIMESTRE DEL TALLER. Hoy 30 de septiembre, a las 6 de la tarde, recibo una llamada en la que me comunican que el taller se ha suspendido y que por tanto no es necesario que lleve a mi hija. TODO ESTO JUSTAMENTE EL DÍA ANTERIOR AL COMIENZO DEL CURSO, SIN PLAZO PARA PODER BUSCAR OTRO ACORDE YA QUE, EN LAS FECHAS QUE ESTAMOS, YA ESTÁ TODO CUBIERTO.</p>

<p>Esto no pasa solo con el taller de mi hija, se HAN SUSPENDIDO TODOS LOS TALLERES DEL DISTRITO DE USERA, DESPUÉS DE QUE LOS USUARIOS HEMOS ABONADO TANTO LA MATRÍCULA COMO EL PRIMER TRIMESTRE DE LOS MISMOS. Vivimos en un barrio muy humilde y con grandes carencias, (dicho por la que hoy es alcaldesa de Madrid), y creo que hablo, no solo por mi boca sino también por la de mis vecinos diciendo que aquí no sobra nada, pero hemos pagado religiosamente para acceder a los pocos servicios que se ponen a nuestra disposición. Por supuesto, nos comentan que se nos devolverá el dinero (faltaría más), pero eso ya no se sabe cómo se va a hacer.</p>

<p>Simplemente LAMENTABLE, al final siempre ""pagamos"" los mismos.</p>
";"30/09/2015 20";"16";"9";"7";"1";"1080444749";"112"
"4140";"autobus 140";"<p>aumentar frecuencia del autobus 140  porque tarda 20 minutos o mas en llegary es eso lo que se tarda desde avda. guadalajara a hcda. de pavones.</p>
";"30/09/2015 20";"47";"43";"4";"1";"1093084993";"3568"
"4141";"Estelas en el cielo";"<p>Prácticamente todos los días que miro al cielo veo una cantidad de estelas que no me parecen normal, además que ahí se quedan durante horas, y no hablo de una o dos, es que he llegado a ver decenas ¿qué son? ¿el Ayuntamiento puede informar a la ciudadanía aunque no sea un asunto de su competencia?</p>
";"30/09/2015 21";"43";"19";"24";"26";"1078757966";"-220"
"4142";"Posibilidad de las corridas de toros sin sangre";"<p>En Cuba se celebraron durante muchísimos años corridas sin sangre. El pueblo cubano, que es dulce y cariñoso como muy pocos, no podía soportar el sufrimiento y muerte del toro. Se suprimieron las puyas de picar, las banderillas y los estoques. El toro salía, corría, los lidiadores se enfrentaban a él con capas y muletas, pero al terminar al toro se le recogía y sin ningun sufrimiento se le devolvía a su ganadería. En una corrida así, habría bellos pasodobles, habría buenos cigarros puros como ahora, se conservaría todo el color y sabor de la fiesta  y habría posiblemente mas emoción que ahora, pues el toro acabaría cansado, pero no herido y tendria incluso mas peligro para los lidiadores.Recientemente se han celebrado en el estado norteamericano de las Vegas unas corridas así con un gran éxito de público, pero esto no es algo novedoso porque ya existía en Cuba y otras partes hace mucho más de un siglo. Con un poco de imaginación y unas medidas políticas adecuadas se podría conseguir. Como anécdota se puede recordar que un banderillero español en Cuba, al ocurrírsele poner un único par de banderillas de verdad a un toro, fué encarcelado por violar la ley de protección animal. Esto sucedió cuando Cuba aún pertenecía a España. Tenemos que comenzar a avanzar y esto puede ser un signo claro de avance.</p>
";"01/10/2015 02";"78";"46";"32";"6";"1087916249";"825"
"4143";"Plenos y Comisiones  ---->   registro de la ""filmación"" completa para visualizar";"<p>Francamente, la idea de ""transparencia"" que se tiene por la ciudadanía no es la de unos <em>Despachos acristalados</em>, elegantemente ceñidos con sus persianitas y mullido recubrimiento de extenso enmoquetado: se trata más bien de <u>comprobar fehacientemente</u> cómo las intervenciones y su correspondiente réplica estan realmente atendiendo las expectativas que cada facción despertó durante su Campaña en periodo electoral.  Por ello me permito sugerir (a tenor de las facilidades digitales hoy en día disponibles) sean exigidas junto al resto de  <strong>Minutas</strong> y <strong>Agendas</strong>  para toda reunión, se almacene asímismo un meticuloso archivo  -en formato universalmente accesible-  de la GRABACIÓN EN COLOR con alta definición para la posteridad en cualquiera de las ""páginas Web"" oficiales actualmente establecidas.</p>

<p>Por descontado, las tribunas del Publico y los micrófonos tanto de presidencia como oradores habrán igualmente de estar incorporados a través de <strong>canales paralelos</strong>, pudiendose sincronizar  -a elección del espectador- variadas combinaciones simultáneamente de diversos ""focos de sonido"" y ""puntos de vista"" diferenciados... no necesariamente idénticos a la COORDINACION básica ofrecida desde Realización/Post-producción por el secretario de turno ó moderador.</p>

<p>No estaría de más  (por cierto)  conocer quiénes rellenan crucigramas ó dormitan placidamente en sus <em>bien pagadas</em> asistencias: el Consistorio no puede seguir por más tiempo ""encubriendo"" bajo artificiosas restricciones de <em>reserva</em> ó <em>sigilo</em> frecuentes casos de <u>conducta bochornosa</u> totalmente inadmisibles.  Queremos verlos, y queremos conocerlos.  Porque tenemos derecho a exijirlo, deseariamos el respaldo entusiasta de cuantos lectores se identifiquen con esta idea perfectamente factible: confiamos con vuestra ayuda despertar un amplio apoyo.  MchGrcs.</p>
";"01/10/2015 03";"28";"25";"3";"0";"1093650853";"1964"
"4144";"Transgénicos";"<p>Mi sugerencia se refiere al tema de los transgénicos. Espero que antes de tomar decisiones recaben toda la información científica posible. Se puede empezar con una web como esta, con artículos y datos que reflejan la complejidad del asunto, actualmente muy contaminado por simplificaciones y mitos: http://www.siquierotransgenicos.cl/2015/01/02/que-dice-la-evidencia-cientifica-sobre-la-seguridad-de-los-cultivos-y-alimentos-transgenicos/ http://www.siquierotransgenicos.cl/recursos-recomendados/</p>

<p>Por favor, no tomen decisiones basadas en titulares y opiniones sin rigor científico. Gracias por su atención</p>
";"01/10/2015 12";"32";"20";"12";"4";"1091380054";"500"
"4145";"BARRIOS POBLACIÓN GENTE MAYOR INFERIORIDAD CONDICIONES PROPUESTAS CIUDADANAS";"<p>Los barrios con población de gente mayor, tienen mucho más difícil que sus propuestas ciudadanas lleguen a buen puerto. Este sistema (que no digo yo que esté mal); no ha tenido en cuenta que la gente mayor no está muy puesta en nuevas tecnologías y carecen muchos de ellos de ordenadores...Pero muchos de los barrios donde viven, deberían ser objeto de mejoras.</p>
";"01/10/2015 13";"44";"43";"1";"2";"1101458589";"4104"
"4146";"Sistema de muerte de las propuestas sin apoyos";"<p>Como usuario de la web de decide.madrid, pasé de la euforia inicial a un estado de decepción. La multiplicación de propuestas es abrumadora, e incluso la poca seriedad con la que se plantean algunas propuestas es indignante. </p>

<p>Me gustaría plantear a debate si se debería incluir un mecanismo automático para que las propuestas poco apoyadas sean eliminadas por el sistema. Los motivos pueden ser distintos: la propuesta está repetida, es absurda, es irrelevante, o no está correctamente desarrollada. El usuario de la web castiga la propuesta sin votarla, y así al cabo del mes (por ejemplo) se cae.</p>

<p>Creo que sería una forma de concentrar a los usuarios en las propuestas que prosperan, y limpiar de ""pequeñas propuestas que no van a ninguna parte la web"" </p>
";"01/10/2015 14";"163";"149";"14";"9";"1105618948";"12340"
"4147";"Contra la ""becerrada"" del domingo 4 en las Ventas";"<p>El domingo día 4 en la plaza de toros de Venta se va a celebrar una ""becerrada"" en la que se va a torturar y asesinar a seis becerrillos indefensos. Son crías de toro que no llegan a los dos años y que no tienen fuerza ni defensas y van a ser banderilleados y cruelmente estoqueados. Es un tema que nos indigna a muchísimas personas y daríamos cualquier cosa por impledirlo. Apelo a la sensibilidad demostrada de nuestra alcaldesa Manuela Carmena para que ponga todos los medios a su alcance para que este crímen no pueda celebrarse o al menos, si no hay otro remedio, que sea la última vez que un acontecimiento así tenga lugar en nuestra ciudad. Ya está bien!!! Estos taurinos se están mofando y befando de la sensibilidad de muchas personas y siguen cometiendo sus acciones execrables pero esto tienen que tener un fin, pacífico o no pacífico. No podemos soportar crímenes como este mucha gente que somos madrileños y vivimos en Madrid. Ya es bastante.</p>
";"01/10/2015 15";"97";"60";"37";"7";"1095124142";"1422"
"4148";"Talleres y Cursos de los Centro Culturales";"<p>Cuento  una experiencia personal, creo que ilustrativa de cómo están las cosas en el Ayuntamiento de Madrid.</p>

<p><strong>En pocas ocasiones en mi vida (ya larga) me he sentido víctima de una situación tan caótica, originada por una deficiente concepción, planificación y toma de decisiones de una instancia administrativa.</strong></p>

<p>Las normas de inscripción a los Cursos y Talleres de los Centros Culturales del Ayuntamiento de Madrid han cambiado, por iniciativa, no corregida, del equipo municipal de Botella, introduciendo, al menos dos nuevas peoras:</p>

<p>1 )  Todos los madrileños, cualquiera que sea el distrito municipal de pertenencia, podrán inscribirse en cualquier centro cultural  de Madrid, sin que se precise mayor arraigo.</p>

<p>Lo que prima a los que tienen más posibilidades de renunciar por el engorro de un largo desplazamiento para asistir al curso o taller,  frente a los que no tienen esa rémora, y pueden asistir con más facilidad a los cursos y talleres.</p>

<p>2 )  El orden de adjudicación de plazas, en vez de hacerse por orden cronológico de inscripción, se hace por sorteo.</p>

<p>Creo que no sería descabellado asignar un porcentaje de plazas (15% o 20%) a los que, según informe del monitor que imparta el curso, hayan acreditado aprovechamiento en el curso pasado.</p>

<p>No fui afortunado por el sorteo veraniego del Taller que había elegido, pero tuve opción a una nueva inscripción en setiembre si quedaban plazas vacantes por impago de la matrícula en las fechas determinadas para ello.</p>

<p>El primer día hábil para inscribirme me personé en el centro, pero la inscripción se había aplazado una semana sin que se me hubiese notificado.</p>

<p>A la semana siguiente la cosa fue mucho peor. Estuvimos más de cien personas toda una mañana desde las 10 h. a las 14 h., esperando poder inscribirnos, ya que la famosa Plataforma no funcionaba . A pesar de la demanda generalizada de que se nos diese una nueva fecha, nos tuvieron en vilo, sin que nadie se definiese acerca de si íbamos a poder inscribirnos o no esa mañana<strong>. La gente estaba que bramaba</strong>. Sobre las 13,20 h. se restableció el funcionamiento de la terrorífica Plataforma.  Dado lo avanzado de la hora se nos dijo que sólo podrían inscribirse los quince primeros por orden de llegada. <strong>Al final lograron inscribirse únicamente tres. Al primero que lo consiguió le tributamos todos los presentes un caluroso aplauso</strong>. Se nos indicó que fuésemos por la tarde. Por la tarde no se pudo hacer ni una sola inscripción porque la Plataforma se había caído nuevamente.</p>

<p>Hoy tuvimos una nueva oportunidad, y a la tercera fue la vencida.</p>

<p><strong>Y pensar que nada de esto hubiese sido necesario si se hubiesen sorteado, también, el orden de preferencia de los puestos en la lista de espera, y se hubiera llamado por teléfono, por ese orden, a los candidatos a ocupar las plazas vacantes.</strong></p>

<p>Un saludo.</p>
";"01/10/2015 18";"33";"30";"3";"13";"1101359124";"2454"
"4149";"Sustituir paulatinamente árboles que provocan alérgias por otros que no";"<p>En la primavera proliferan los pólenes y las alergias. Esto se podría reducir evitando plantar árboles de especies que provoquen alergias o que ensucien la calle con ""pelusas"" de pólen e irlos sustituyendo poco a poco. Se que el polen que provoca las alergias puede venir de muy lejos y por tanto de fuera del municipio pero para el tema de la limpieza de la calle en las epocas de polinización si puede ser importante.</p>
";"02/10/2015 01";"100";"74";"26";"5";"1103170113";"3551"
"4150";"Buses nocturnos  ----->  gran intercambiador central.";"<p>Como bien saben los publicistas (y asesores de Campaña electoral) el usuario ó consumidor  -en definitiva, el votante-  no suele <em>acordarse de Santa Bárbara</em> hasta que empieza a tronar: mientras pasa el verano, nadie parece acordarse de aquellos otros pasajeros que durante las <u>frías madrugadas de invierno</u> quedan a la intemperie aguardando (para su regreso al hogar) los trayectos del ""búho"" a <strong>temperaturas bajo cero</strong>, depié para no perder su puesto en la fila y no siempre guarecidos en caso de tormenta.</p>

<p>Las personas de extracción modesta (camareros, limpiadoras, vigilantes, panificadores, etc) a quienes tan frecuentemente se les viene perdiendo el DEBIDO RESPETO socio/profesional aspiran de sus Autoridades obtener el mismo amparo y tutela que sin embargo tanto prodigan éstas a distinguidos usuarios del Avión, del Taxi ó del AVE.  Y no entienden que además de calles despejadas -en esas horas de especial confluencia- no exista todavía <u>proyecto ninguno para solucionar</u> su merecida Sala de Espera climatizada, batería de Asientos (con enchufe próximo y wi-fi inalámbrica) abundantes, Botiquín, dispensadores de café o refresco, amplios Aseos ventilados (incluyendo gabinete para lactantes y cabina de discapacitados), área de reposo para Conductores... en fin, los mismos derechos al <strong>confort</strong> y <strong>seguridad</strong> ya disponibles durante el día a los ""visibles"" miembros de las clases medias.</p>

<p>No faltan propuestas para el reaprovechamiento del <em>complejo subterráneo</em> (Plaza de Colón) tantos años infrautilizado de la calle Goya: su indiscutible localización idónea, cómodas rampas entre cocheras, accesos despejados y -lo más importante- facilidades obvias a la distribución y encaminamiento de multitudes, hacen lógicamente sopesar sus acusados beneficios frente a diversos ""usos terciarios"" hasta ahora INFRUCTUOSOS. Arengas, homenajes, exposiciones, desfiles, liturgias, degustaciones y un sinfín de ""afirmaciones"" colectivas no ocultan el auténtico fracaso -paisajístico incluido- bajo el que nos han arrebatado los últimos años la <em>Joya</em> de nuestras infraestructuras colectivas.</p>

<p>Lúzcase por fin el Consistorio con lo último en <em>obra civil</em> moderna  -no por silenciada menos reclamada-  que completaría así brillantemente nuestro actual parque de <strong>estaciones intermodales</strong>, al proveer tanto con servicios directos como indirectos a sus más modestos convecinos... es justo. Y necesario.</p>

<p> </p>
";"02/10/2015 03";"49";"40";"9";"3";"1103565056";"2530"
"4151";"Agrupen las propuestas que piden lo mismo con diferentes palabras!";"<p>Buenos días. hay decenas de debates que piden lo mismo pero con diferentes palabras. por ejemplo que bajen el precio del abono deportivo, que suban frecuencia del metro, que hagan más carriles bici, o que pongan aparcamientos para bici en los parkings municipales. Sin embargo estas propuestas nunca se hacen visibles ya que estan en los últimos puestos de popularidad al haber muchas propuestas, todas ellas con unos pocos votos, que sumandolos darían una gran cantidad. que alguien gestione estos debates para unificarlos (sin censura).</p>

<p> </p>

<p>gracias.</p>
";"02/10/2015 09";"371";"364";"7";"11";"1119203938";"35026"
"4152";"Poder añadir párrafos en los comentarios en la web";"<p>Antes de nada, perdón si está repetido, he buscado y no he visto nada al respecto.</p>

<p>En los comentarios en esta web, los textos aparecen en un único párrafo, lo que los hace más difícil e incómodo de leer.</p>

<p>¿Pueden los informáticos poner solución a esto? Dudo que sea muy difícil y no creo que tenga ninguna funcinalidad el evitarnos diferenciar los párrafos con un espacio.</p>

<p>Por si alguien no ha entendido bien de lo que hablo, lo ejemplifico, si alguien escribiera este mismo texto en un comentario aparecería así:</p>

<p> </p>

<p><em>Antes de nada, perdón si está repetido, he buscado y no he visto nada al respecto. En los comentarios en esta web, los textos aparecen en un único párrafo, lo que los hace más difícil e incómodo de leer. ¿Pueden los informáticos poner solución a esto? Dudo que sea muy difícil y no creo que tenga ninguna funcinalidad el evitarnos diferenciar los párrafos con un espacio. Por si alguien no ha entendido bien de lo que hablo, lo ejemplifico, si alguien escribiera este mismo texto en un comentario aparecería así:</em></p>
";"02/10/2015 13";"20";"19";"1";"4";"1107584958";"1709"
"4153";"Limpieza por unoversitarios";"<p>primero fue las amas de casa en los colegios y ahora son los universitarios....la última propuesta de nuestra alcaldesa es que los universitarios dediquen sus horas en limpiar las calles para darse cuenta lo que supone para los trabajadores  y se conciencien.es España hay a día de hoy 4.090.000 parados.no será mejor que cada uno que ocupe de lo suyo?</p>

<p>en los próximos días sabremos las bases del nuevo concurso de ahora Madrid para elegir el mejor cuidadano....que nervios!!!</p>
";"02/10/2015 14";"44";"27";"17";"15";"1103317645";"613"
"4154";"Recuperación de las farolas históricas";"<p>En Gran Vía, Cibeles, Recoletos... había farolas clásicas de una gran belleza. En Nueva York, París, Londres... se conservan las farolas clásicas, en Madrid se sustituyeron por las autopisteras en los años 60. En las calles estrechas del centro, Salamanca... se han recuperado los faroles villa y fernandinos pero en las avenidas seguimos con las farolas sesenteras. ¿Os parecería bien recuperar las farolas clásicas? </p>
";"03/10/2015 02";"120";"114";"6";"7";"1120502349";"10260"
"4155";"Prohibición de hacer fotos en el Palacio Linares";"<p>El Palacio Linares, en Cibeles, es uno de los más valiosos de Madrid y es propiedad municipal. Los madrileños lo tenemos cedido a la Casa de América, que permite visitas cobrando por ello pero que prohibe que los madrileños y turistas le hagamos fotos a nuestro palacio. Además, alquila las salas del palacio para empresas, fiestas...</p>

<p>Creo que el Ayuntamiento, propietario del edificio, debería obligar a la Casa de América a que no nos prohiba a los madrileños hacer fotos en un edificio que es nuestro.</p>

<p> </p>

<p>¿Os parecería bien que se permitiera hacer fotos en el Palacio Linares?</p>
";"03/10/2015 02";"39";"21";"18";"0";"1103712712";"161"
"4156";"motor de búsqueda en la web para evitar propuestas repetidas";"<p>Sería interesante que aquella persona interesada en apoyar o crear una propuesta, tuviese la oportunidad de ver si alguien la ha subido ya a la web de modo que se evitases duplicidades. </p>

<p>Además, cada cierto tiempo debería hacerse limpieza unificando propuestas similares.</p>

<p>Por último, creo que se debería plantear qué hacer con aquellas propuestas que caduquen o que no tengan seguidores.</p>

<p> </p>
";"03/10/2015 04";"95";"93";"2";"1";"1120858640";"8908"
"4157";"Voluntarios del distrito.";"<p>Crear un equipo formado por los vecinos de los distritos, los vecinos que vivimos en el distrito sabemos de los problemas que tenemos en nuestro distrito, en nuestro barrio, creando un equipo con competencia delegada del ayuntamiento podríamos solucionar los problemas que vemos a diario. La gente que vive en el barrio conoce los problemas del barrio, organizarnos para dar solución a dichos problemas.</p>

<p> </p>

<p> </p>
";"03/10/2015 22";"63";"52";"11";"6";"1122937327";"3384"
"4158";"Madrid ciudad ruidosa";"<p>España es el segundo país más ruidoso por detrás de Japón, y Madrid contribuye ampliamente a dicho título.</p>

<p>Madrid es una ciudad muy ruidosa, todas las máquinas que se utilizan en limpieza y jardinería contribuyen a ello, ya que  son ruidosísimas. Hay unos cacharros que ""soplan"" hojas, sólo para cambiarlas de sitio, que meten un ruido infernal, así como los  corta -setos de gasóleo que emiten una barbaridad d dcibelios, cualquier máquina o vehículo del ayuntamiento hace un ruido espantoso, los camiones de la basura, los que riegan etc. Habría que irlos sustituyendo por otros más silenciosos.</p>

<p> </p>
";"04/10/2015 12";"99";"94";"5";"8";"1133848139";"8450"
"4159";"Madrid ""version original""  ----->   su abandonada actualización nos duele.";"<p>La refrescante y gallarda defensa de la ""propia"" identidad  (frente al Colonialismo de intermediarios, auto-denominados LOS MEDIOS como únicos pontífices entre <em>la realidad</em> y su sacerdocio de<em> la verdad</em> revelada)  aparece día tras día progresivamente <u>anquilosada</u> en su vibrante actualidad, lo que nos hace <strong>sospechar sobre la merma</strong> cierta de aquél impulso inicial... tan admirable iniciativa no debería fenecer, y por ello suplico  -si falta quizá materia prima-  lleguen a ser recogidas cualesquiera de las más notables iniciativas en ""MadridDecide"" para la divulgación del curso otorgado a las mismas a través (precisamente) también de ""MadridVO"".</p>

<p>Al menos, sabremos que siguen vivos.</p>

<p> </p>
";"04/10/2015 15";"33";"24";"9";"2";"1125208397";"1090"
"4160";"¿Sirve para algo llamar al 010? ¿o es una pérdida de tiempo?";"<p>Hoy he llamado al 010 para avisar del abandono de una de esas bicicletas públicas que tanto nos dinero nos han costado a los madrileños. Probablemente, esa bici habría sido robada porque estaba tirada sin sillín en una plaza de Carabanchel. Tras media hora sin personarse nadie, he llamado a la Policía Local, tras una hora sin que nadie apareciera, he llamado al 112, pero me han dicho que urgencias no está para eso, que llamara al 010.</p>

<p>Ya no hace falta que vengan, se la acaban de llevar unos chungetes que paseaban por el barrio. Lástima, ¡con el dinero que nos cuestan las bicis, el 010 y la Policía Local! y, por lo menos hoy, parece que no sirven para NADA.</p>

<p>¡¡¡Gracias (irónicas) Ayuntamiento!!!</p>
";"04/10/2015 17";"65";"57";"8";"15";"1132266090";"4296"
"4161";"Bicicletas eléctricas";"<p><strong>Soy partidario de que las bicicletas tengan un lugar en la ciudad.</strong></p>

<p><strong>Soy partidario de que la gente pueda andar en bicicleta por la ciudad sin jugarse la vida.</strong></p>

<p><strong>Soy partidario de la bicicleta como medio de locomoción no contaminante y que te permite hacer deporte o, al menos, ejercicio</strong>.</p>

<p>Y dicho esto, me paso a la ormitología para hablarles de las palomas. La paloma es un animal inofensivo. La paloma con su ramo de olivo es el símbolo de la paz. La paloma ha tenido representaciones ilustres como la de Picasso. ¿Hay una escena más entrañable que la de un anciano o una anciana dándole de comer miguitas de pan a las palomas en un parque público?</p>

<p>Pues bien Señores, en ocasiones, las palomas son una plaga, y lo digo con conocimiento de causa. En mi casa de Gijón empezaron a anidar en uno de los muros que daba al patio interior. Al principio nos hicieron gracia y nos consideramos afortunados, pero con el tiempo, se reprodujeron a una gran velocidad, su gorjeo resultó insoportable y sus deposiciones eran cuantiosas y abrasivas de cualquier superficie. Nos dimos cuenta, entonces que teníamos una plaga. Hoy lo más que hemos podido hacer es poner un sistema de pinchos, que nos costó un ojo de la cara, para que no se posen en las ventanas.</p>

<p>Hace ya casi cincuenta años visité Amsterdam. Allí la mayoría circulaba en bicicleta. Los holandeses, que tienen a gala plantearse cualquier problema cívico, y resolverlo, de una forma a veces original, acertaron con su planteamiento de sustituir coches por bicicletas. La ciudad tiene mucho menor tráfico de coches, mucha menor contaminación y los habitantes que han optado por ese medio de locomoción tienen asegurado un ejercicio físico diario sin tener que ir al gimnasio.</p>

<p>No es el caso de Barcelona, en la que paso temporadas.</p>

<p>¿Qué es lo que ocurre allí?</p>

<p>Que las bicicletas son más un problema que una solución.</p>

<p>¿Por qué?</p>

<p>Porque una legislación muy laxa ha permitido que circulen por donde no deben. En teoría pueden circular por las aceras, si éstas tienen una anchura superior a seis metros. En la práctica, circulan por cualquier acera. El que esto escribe ha sido atropellado ya dos veces cuando andaba por la acera, sin consecuencias graves, eso sí. La primer, por una japonesa que le hizo gracia eso de andar en bicicleta por la ciudad visitada, sin que se acordase mucho de cómo se andaba en bicicleta. La segunda por un catalán que se empeñó en que podía pasar por donde no podía.</p>

<p>Por otro lado el servicio municipal de alquiler de bicicletas funciona fatal allí. No es infrecuente que todas las bicicletas de un punto de recogida estén averiadas. Y tampoco es raro que uno coja una bicicleta y cuando la vaya a dejar no funcione el parquímetro correspondiente, por lo que sigue contabilizando el alquiler.</p>

<p>Hasta ahí mi experiencia: Si la promoción de la bicicleta en Madrid se hace sin la debida planificación, surgirán problemas que pueden llegar a ser importantes.</p>

<p>Pero hay una cuestión mucho más grave que quiero poner en conocimiento de todos. Acabo de coger un taxi, y lo que me ha dicho el taxista respecto a las bicicletas eléctricas me ha sobrecogido. No tengo motivos para dudar de su palabra. Por curiosidad he cogido sus datos, pero no los voy a hacer públicos para no comprometerle.  </p>

<p>Resumo lo que me ha contado:</p>

<p>1 )  Ha sido testigo o ha presenciado las consecuencias de dos accidentes mortales de personas que iban en bicicleta eléctrica.</p>

<p>1.1)  La primera víctima mortal era una chica joven. El accidente ocurrió en la Avenida Menéndez Pelayo, casi enfrente de una de las entradas del Parque del Retiro.</p>

<p>1.2 )  Aunque no presenció el accidente, pudo contemplar a la segunda víctima mortal en la calle Gran Vía.</p>

<p>2 )  Vio las consecuencias de otro accidente, sin que pudiera saber el alcance de los daños. Había una bicicleta eléctrica hecha polvo y un taxi con la ventanilla posterior destrozada y abundante sangre, por lo que dedujo que el ciclista, por razones desconocidas, había salido despedido y había chocado con la ventanilla del taxi. El accidente ocurrió en la calle Atocha.</p>

<p>3 )  Me informó que al parecer hay carriles-bici negros, como hay puntos negros, para el uso de la bicicleta eléctrica. Me hizo hincapié en el de la calle Alcalá. Al parecer la bajada de Sol a Cibeles por el carril-bici de la calle Alcalá es peligrosísimo. Se han producido ya unos cuantos accidentes, y él fue testigo presencial de un ciclista con bicicleta eléctrica que bajó toda la calle sin frenar, sin que le pasase nada, seguramente gracias a la intercesión de una cooperativa de santos milagrosos.</p>

<p>Como me lo contó, lo cuento. Añadan Uds., les ruego que si lo desean sus experiencias personales sobre bicicletas eléctricas a este comentario mío.</p>

<p>Un saludo a todos.  </p>
";"04/10/2015 17";"63";"42";"21";"28";"1127020264";"1400"
"4162";"ILUMINACION EN ALGUNA ZONA DEL PARQUE DEL RETIRO";"<p>Buenas tardes, aunque ya hice llegar este mismo comentario a anteriores moradores del Ayuntamiento de Madrid, espero sinceramente tener mayor fortuna con el actual Equipo de Gobierno.</p>

<p>Somos muchos los ciudadanos que utilizamos el parque del Retiro cada tarde para hacer deporte, y concretamente los que corremos por el circuito de tierra que recorre el parque junto a su valla. Al llegar el Otoño y acortarse considerablemente las horas de luz, hay parte de este circuito que carece de iluminacion. Me refiro a la recta que discurre paralela a la calle Alfonso XIII, entre la entrada situada junto al inicio de la Cuesta de Moyano y la Puerta de Alcala.</p>

<p>Transitar por esta parte del recorido a oscuras entraña cierto riesgo por la afluencia de corredores y bicicletas en ambos sentidos. Ademas, despues de dias de lluvia, es imposible ver charcos y agujeros. Una pocas farolas que nos permitiesen ser vistos seeia suficiente.</p>

<p>Muchisimas gracias.</p>

<p>Saludos</p>

<p> </p>
";"04/10/2015 19";"60";"55";"5";"7";"1133713490";"4583"
"4163";"Erradicar las infraviviendas de los terrenos contiguos al museo del ferrocarril.";"<p>Desde hace tiempo han empezado a ubicarse chabolas pobladas por individuos rumanos gitanos en los terrenos que están al lado del Museo del Ferrocarril, cada vez hay más cantidad de infraviviendas  y la zona se está convirtiendo en un foco de insalubridad por la acumulación de basura, además de las penosas costumbres de estos individuos. Durante el verano se han producido varios incendios en la zona (parece que provocados por ellos mismos para quemar parte de la porquería que generan), estos incendios son susceptibles de extenderse porque la zona esta rodeada de edificio de viviendas. </p>

<p>Cuando se va actuar para eliminar ese foco de insalubridad? Cuanto más tiempo se espere mayor número de chabolas habrá y más difícil de solucionar el problem</p>

<p>Se propone solicitar al ayuntamiento la eliminación del citado poblado con el fin de asegurar la salubridad de la zona.</p>

<p> </p>
";"04/10/2015 22";"65";"61";"4";"3";"1135697614";"5349"
"4164";"Acogimiento de refugiados  ---->   inscripción de ""hogares"" desinteresada.";"<p>Lamentando posible reiteración, permítasenos aprovechar la presente oportunidad para rogar muy encarecidamente una más AMPLIA DIFUSION del posible <strong>registro para acogimientos</strong> en la que se nos ofreciese la ""pre-selección"" desde cualquiera de las localizaciones Web oficialmente establecidas acceso VOLUNTARIO a una primera descripción de nuestros hogares  (capacidad, idiomas, con/sin juguetes, dietas kosher ó especiales, TV satelite, aptitud a minusválidos, etc)  bajo la que proceder luego  -con las ""claves"" recibidas para su posterior Codificado localizador-  a una detallada personalización en la que nuestras Familias finalmente subscriban su <u>ofrecimiento confidencial</u> ante el Ayuntamiento (y/ó demás entidades asociadas) con su hospitalidad de EMERGENCIA sobrevenida:  sólo una noche, para varios días, exclusivamente mujeres y niños, ó personas individualmente, con vestimenta/calzado para cederles, con vehículo para trasladarles.</p>

<p>Las declaraciones ""responsables"" recogidas igualmente por período sostenido como por ofrecimiento ocasional, deben ser <u>siempre cordialmente</u> sometidas a consideraciones <em>muy cuidadosas</em> al segmentar la empatía espontánea de un sentimiento momentáneo entre otros muchos motivos (naturalmente todos loables) de altruismo contra el ESFUERZO solidario fruto quizá de una más profunda y meditada <strong>Reflexión de convivencia</strong> ampliamente consolidada con experiencias previas.  En fin, también los ""donantes de órganos"" revisan su posible <em>compatibilidad</em> hacia los posibles beneficiarios.  Y es mejor prevenir todo conflicto, más en esas circunstancias.</p>

<p>Si tras esta lectura se va animando un colectivo progresivamente más nutrido de Vecinos en nuestra capital, ya sólo faltaría constituir la correspondiente Propuesta debidamente articulada con la cual ""elevar"" un sólido <strong>germen</strong> que conectase con el resto de municipios como la hipotética <em>Red de Hogares</em> para recurrir en caso de catástrofes e incidentes súbitos siempre en contacto.</p>

<p>A todos, muchas gracias por su tiempo y  -esperamos-  desinteresado apoyo. </p>
";"05/10/2015 20";"45";"17";"28";"1";"1124413562";"-415"
"4166";"Atascos";"<p>Desde hace varios días,se dice que hay atascos kilometricos en Madrid y una de las causas es la falta de agentes para la regulación del mismo.por todos es sabido que el mal tiempo,accidentes,manifestaciones,cortes de calles también influye en la carretera pero el debato lo abro con la pregunta:alguien sabe cómo funciona la gestión de tráfico?</p>
";"06/10/2015 16";"24";"20";"4";"9";"1147480088";"1333"
"4167";"no a la tala indicriminada de arboles";"<p>cada dia en mi propio barrio un nuevo arbol grande, de bastantes años y a juzgar por los aros en la madera talada sin signo de putrefaccion,es talado porque algun vecino se haya quejado o no se sabe cual es la razon. a esto se le añade que desde la euforia desatada ante la gran cantidad de arboles que se rompian con el vendabal, otros muchos se talaron, en un momento en que el cambio climatico provocado por nuestra cada vez mayor contaminacion y indiferencia, los arboles son cada vez mas necesarios por que dan oxigeno, son el hogar de miles de especies de aves que se ven inmersas en ciudades cada vez mas hostiles, y en lugar de plantar,,se destruyen mas??? ademas recuerdo de pequeña el olor a abono, que podia no gustarte, pero son nutrientes para el suelo.hace años no he vuelto a oler nada, porque no se abona- y ¿ahora nos extrañamos de q esten podridos todos los arboles de madrid? ¿que cuidado se les da aparte de agua reciclada que habria que anallizar su estado?nuestros arboles estan pidiendo socorro y ademas nuestra supervivencia va ligada a ellos. exijo que se tome en serio este problema de las zonas verdes en todo madrid y se deje de ir a empresas subcontratadas baratas que ademas no tienen idea de talar ni podar, provocando heridas y terciados en los arboles que esnormal que se pudran con la humedad.</p>
";"07/10/2015 10";"139";"132";"7";"6";"1164362561";"11870"
"4168";"Gobierno abierto?";"<p>No creo que esta plataforma sea útil, solo para quedarnos tranquilos de haber propuesto algo!</p>
";"07/10/2015 20";"27";"18";"9";"5";"1155385471";"600"
"4169";"No a que los autobuses vuelvan a Sol.";"<p>¡increíble! Leo que el ayuntamiento quiere que los autobuses que ahora tienen su cabecera en la Calle Sevilla la tengan proximamente en la calle Alcalá, frente al número 10, y que entren en Sol y salgan por la Carrera de San Jerónimo. ¡No me lo puedo creer!. Es algo que me horroriza. Otra vez a soportar los autobuses en Sol.</p>

<p>Varias líneas tendrán allí su cabecera, se tirarán 5 minutos soltandote el humo en la cara y metiendo ruido, además de afear una de las calles más majestuosas de Madrid. </p>

<p>También me apena que se abandone la idea de ensanchar las aceras de la Carrera de San Jerónimo, como estaba previsto, y que se le reste espacio al peatón en Alcalá para que los autobuses paren en ella.</p>

<p>Estaba previsto que los autobuses tuvieran su cabecera en un nuevo intercambiador de transportes bajo la calle Sevilla, ahora hay un aparcamiento que se convertiría en intercambiador, pero el Ayuntamiento se opone y prefiere que estén en superficie. El mótivo es ahorrarse una cantidad de dinero que debería de pagar a los actuales concesionarios del parking por convertirlo en intercambiador de transportes. Quién piense que así nos ahorramos las rampas de entrada y salida se equivoca. Harán unas nuevas y mayores que las actuales. Me duele mucho que se haga daño a uno de los espacios más bellos de Madrid por ahorrar una pequeña cantidad de dinero.</p>

<p> </p>
";"08/10/2015 03";"76";"62";"14";"7";"1165216410";"3915"
"4170";"Denuncia: peligrosos nidos de cotorra en el parque de San Isidro.";"<p>Los arboles del parque de San Isidro están llenos de ""Mega construcciones"" de nidos de cotorra, que no solo los dañan (muchos están despuntados y sobrecargados de peso) sino que son un peligro real para los que pasean en sus inmediaciones, o para los niños que juegan a su sombra, y todo esto sin tener en cuenta que hablamos de una especie invasiva y muy territorial.</p>

<p>Esto es una denuncia de que no se esta llevando el mantenimiento del parque como se debiera, pero no disponeis de pestaña de denuncias, solo de propuestas y debates...</p>

<p>De verdad que los nidos suponen un peligro tremendo, mas que arboles torcidos o tronchados...  venir a daros un paseo y os lo enseño.</p>

<p>El día que ocurra una desgracia, nos llevaremos las manos a la cabeza y todos iréis, bien a haceros la foto bien a dar apoyo a las familias, cuando lo que hay que hacer es el trabajo diario: quitar esos nidos antes de que ocurra nada.</p>
";"08/10/2015 09";"49";"46";"3";"3";"1169403152";"4036"
"4171";"Nueva pestaña web para las denuncias";"<p>En debates se están incluyendo denuncias de cosas que deben hacerse sin necesidad de debatirlas, porque es trabajo del ayuntamiento. Por ejemplo (ficticio): reparar alcantarillas rotas en tal sitio no tiene nada que debatir, es algo que hay que hacer. </p>

<p>Que limpien en una calle por la que no pasan, o un parque, no es una petición, porque es un servicio por el que los madrileños pagamos y que el ayuntamiento tiene que realizar.</p>

<p>Que los dueños de los perros no los lleven sueltos, o que recojan las heces, está regulado, se denuncia y que el ayuntamiento envíe efectivos para que se cumpla la regulación...</p>

<p>Si las denuncias se separan de los debates, será una plataforma mucho mas efectiva.</p>
";"08/10/2015 09";"55";"53";"2";"3";"1170604130";"4914"
"4172";"¿Error informático?";"<p>Buenos días , un compañero de mi nuevo trabajo me comentó que en este foro había unas propuestas que me interesaba apoyar relacionadas con quitar la financiación pública de los partidos políticos y de los ""sindicatos"" UGT y CCOO que me dejaron en paro y encima cobraron por ello, pero no encontramos las propuestas que ya tenían más de 100 votos según mi compañero, ¿Saben si pudo haber algún error informático o un ataque que pueda borrar propuestas? ¿O cómo pueden reclamar quienes votaron ?</p>

<p>Muchas gracias y un abrazo.</p>
";"08/10/2015 15";"25";"23";"2";"12";"1169213756";"1932"
"4173";"Crear un botón para fusionar propuestas y agruparlas según los votos";"<p>Crear en esta web un botón mas, junto al de ""votar a favor"" y ""votar en contra"" que fuese ""fusionar propuestas o debates"" por ejemplo: si pinchas te salen las demás propuestas para que elijas con cual fusionarla o incluso que puedas elegir varias</p>
";"09/10/2015 00";"121";"117";"4";"10";"1180111953";"10926"
"4174";"Transparencia de la RPT y de las retribuciones de cargos públicos.";"<p>En la página web del Ayuntamiento de Madrid, desde 2011, siempre han constado las retribuciones que los madrileños pagamos a los asesores de los grupos políticos, al personal eventual de las Áreas de Gobierno y a los directivos municipales. Durante el mandato de Ana Botella, dicha información se actualizó hasta en seis ocasiones, a medida que se iban reduciendo dichos puestos y sus atribuciones. La última actualización es del pasado mes de enero de 2015.</p>

<p>http://www.madrid.es/UnidadesDescentralizadas/Presupuestos/NavegacionCanales/04_Retribuciones/eventuales_pleno_grupos_20150128.pdf</p>

<p>http://www.madrid.es/UnidadesDescentralizadas/Presupuestos/NavegacionCanales/04_Retribuciones/retribuciones_directivos_20150128.pdf</p>

<p>Como puede comprobarse, en los links de arriba, la última actualización es de enero de 2015. Han pasado más de 120 días desde la formación del nuevo gobierno y los madrileños desconocemos el número de altos cargos, directivos, asesores del gobierno y asesores de grupos políticos que existen actualmente. También desconocemos sus retribuciones, pese a que las abonamos de nuestros impuestos.</p>

<p>¿Es más transparente el gobierno de Ana Botella que este? No es tolerable que cuatro meses después de constituirse el gobierno no sepamos nada sobre su estructura y sobre todo, cuanto nos cuesta.</p>

<p>Actualícense estos documentos cuanto antes.</p>

<p> </p>
";"09/10/2015 16";"44";"44";"0";"0";"1183285747";"4400"
"4176";"acabar con el estigma y rechazo hacia los seropositivos";"<p>esto es un ""copia y pega"" de la Swiss Federal Commission for HIV / AIDS</p>

<p>""Una persona infectada por VIH que reciben terapia antirretroviral con viremia suprimida por completo ("" efectiva ART "") no es sexual infecciosa, es decir, no puede transmitir el VIH por contacto sexual."" El artículo comienza por afirmar que la Comisión ""es consciente de que los datos médicos y biológicos disponibles en la actualidad no permiten la prueba de que la infección por VIH durante la terapia antirretroviral eficaz es imposible, porque la no ocurrencia de un evento improbable, no puede ser probada. La situación es análoga a la de 1986, cuando el VIH la declaración ""no puede ser transmitido por besos"" fue hecho público. Esta declaración no ha sido probado, pero después de 20 años de experiencia de su exactitud, parece muy plausible. ""
 
No quiero decir con esto que no haya que usar siempre preservativo, pero que quizàs tendrìamos que planteanos que es probable que estemos màs seguros con un seropositivo en tratamiento que con una persona que no està bajo control.</p>

<p>
PUEDES ENCONTRAR MAS INFORMACION AQUI:</p>

<p>
http://www.poz.com/articles/hiv_condoms_virus_761_14010.shtml (VIDEO INTERVIEW WITH AN HIV SPECIALIST)</p>

<p>http://www.aidsmap.com/No-one-with-an-undetectable-viral-load-gay-or-heterosexual-transmits-HIV-in-first-two-years-of-PARTNER-study/page/2832748/</p>

<p>http://www.aidsmap.com/Swiss-experts-say-individuals-with-undetectable-viral-load-and-no-STI-cannot-transmit-HIV-during-sex/page/1429357/</p>

<p>http://www.poz.com/articles/hiv_meds_not_sexually_infectious_1_13922.shtml</p>

<p>http://www.aidsmap.com/March-2014/page/2842945/</p>

<p>http://www.aidsmap.com/No-one-with-an-undetectable-viral-load-gay-or-heterosexual-transmits-HIV-in-first-two-years-of-PARTNER-study/page/2832748/</p>

<p>EN ESPAÑOL:</p>

<p>http://elblogdegabrieljmartin.blogspot.it/2014/03/indetectable-vih-intransmisible-y-punto.html</p>

<p>http://superandoelsida.ning.com/forum/topics/expertos-suizos-dicen-que-las</p>
";"10/10/2015 11";"40";"29";"11";"1";"1184006040";"1305"
"4177";"Mejora en la comunicación y promoción de la WEB";"<p>Creo que está web está poco publicitada y aunque se ha comentado algo de ella ha sido todo poca información y muy poco seguida. Creo que para unos temas tan importatnes como decisiones sobre nuestra ciudad esto se merece una mayor difusión en toda la ciudad con carteles, anuncios en autobuses y marquesinas, cartas a los ciudadanos y anuncios en la televisión publica. También dar a conocer la importancia de las decisiones y el funcionamiento para que la gente se anime a seguirla y participar en ella.</p>

<p> </p>

<p>Por otro lado, veo necesario un sistema de mejoras como se ha comentado en otros debates. Lo primero y fundamental es que a pesar de tener los tags habría que crear categorías e intentar sugerir propuestas que ya existen para evitar su repetición. De otra manera sería contratando moderadores que pudieran pasar el contenido de las propuestas a unas globales. Como mucha gente para obtener más de 50.000 votos es necesario eliminar muchas que tratan del mismo tema. Otra opción es asociar propuestas relacionadas dentro de ellas mismas para que un usuario pueda ir navegando entre ellas.</p>

<p> </p>

<p> </p>
";"10/10/2015 15";"59";"55";"4";"7";"1192605296";"4754"
"4178";"Cuota de apoyo para las propuestas de índole local (distrito).";"<p>Tras algunas visitas al portal, me llama la atención lo mucho que supone llegar a ese 2% del censo establecido como cuota para que la propuesta pase a estudio... En el caso de propuestas que son de ámbito restringido a los vecinos de un distrito, o de un barrio, pienso que ese 2% no tendría que remitir al censo de toda la ciudad sino al del distrito o del barrio. Mucho me temo de que lleguemos al plazo de 12 meses con poquísimas propuestas que hayan alcanzado los 53.726 apoyos... Si así fuera, el intento de abrir decisión ciudadana se podría convertir en una impotencia más para quienes van aportando sus iniciativas. O sea que lo que en su espíritu es alentador se convertiría en un factor más de desilusión. Ya iremos viendo el impacto que pueda suponer esta herramienta. Pero si no adquiere mayor dinámica, propongo que se actúe a nivel de estas cuotas. Por ahora, me parece que el listón anda demasiado alto para unos inicios (y éso que, en lo asoluto, un 2% parecía razonable al principio... pero tal vez aun así no lo sea).</p>
";"10/10/2015 23";"44";"42";"2";"7";"1195371718";"3818"
"4179";"¿que funciones debería de tener una nueva ""Oficina de Pobreza Energética""?";"<p>Crear la ""Oficina de Pobreza Energética y Fomento de las Energías Renovables""</p>

<p>¿que funciones debería tener?</p>

<p> </p>

<p>por ejemplo:</p>

<p>*hacer censos de familias en situación de pobreza energética ¿?</p>

<p>*hacer de intermediario entre las familias y las compañías eléctricas ¿?</p>

<p>*crear conjunto de soluciones para esta situación ¿?</p>

<p>*fomentar las energías renovables para toda la población ¿?</p>

<p>*favorecer que las personas desconectadas de la red puedan instalar paneles solares en sus casas ayudándoles económicamente, o técnicamente con respecto a la instalación eléctrica  ¿?</p>

<p>*encargar a técnicos del Ayuntamiento de verificar la seguridad y el buen funcionamiento de la instalación ¿?</p>

<p> </p>
";"11/10/2015 05";"24";"17";"7";"5";"1189828921";"708"
"4180";"gestión de las quejas por el ayuntamiento";"<p>Si la gestión de las quejas que se realizan a este Ayuntamiento a traves de este canal o los demás disponibles se reduce a enviar un ""amable"" correo diciendo que en realidad todo esta correcto y que se ""lamentan mucho"" las molestias todo el trabajo que hacemos aqui los ciudadanos no sirve para nada. Señores algo mas de gobierno, poder ejecutivo y medidas concretas, por favor!</p>
";"11/10/2015 21";"48";"44";"4";"4";"1203887764";"3666"
"4181";"Peineta";"<p>La obra de la Peineta los madrileños sabemos que fue el timo de la aventura olímpica. Pues bien, desde hace años, muchos años, existe un puente que hace continuar el carril bici y llega a la Peineta. Pero este puente, construido está cerrado, ¿por qué? Pues supongo que a los políticos que gastaron nuestro dinero esta inaguración se les ha olvidado y nos obligan a los ciudadanos a dar una vuelta para volver a encontrarnos con la continuación del carril bici. </p>
";"11/10/2015 22";"36";"35";"1";"6";"1204464757";"3305"
"4182";"Recogida de basura cubo amarillo";"<p>¿Cuando se recogen en madrid los cubos amarillos de basura? He oido por ahi que 3 días a la semana pero no sé cuando tengo que sacarlo y no lo encuentro en internet...</p>
";"13/10/2015 15";"13";"11";"2";"7";"1215330927";"761"
"4183";"POR EL SACRIFICIO CERO EN EL CENTRO DE PROTECCION ANIMAL DE LA FORTUNA";"<p>En el Centro de Protección Animal de La Fortuna , en Leganes, se sacrifican cientos de animales cada año. ¿De qué ha servido la Iniciativa Legislativa Popular presentada por la Asociación El Refugio y que en la Asamblea de Madrid todos los grupos parlamentarios , sin excepción, votaron a favor del SACRIFICIO CERO ?. Pero incoherentemente en la perrera del barrio de La Fortuna se sigue sacrificando si los animales no son adoptados en un tiempo. PEDIMOS APLICACION INMEDIATA DEL SACRIFICIO CERO DE ANIMALES en el Centro de protección Animal de la Fortuna y de todos los Centros de Protección Animal pertenecientes al Ayuntamiento de Madrid.  Madrid debe sumarse al resto de países y ciudades de la Unión Europea dónde no existen sacrificios y si derechos garantistas de protección a los animales. </p>
";"13/10/2015 19";"103";"83";"20";"8";"1222591443";"5076"
"4184";"parroquias e iglesias en los barrios";"<p>no mas suelo público para mas parroquias o iglesias. en cualquier barrio de madrid. hay mas parroquias que guarderias. residencias de ancianos. colegios y  mucho menos hospitales me refiero de titularidad pública. si quieren una parroquia que hagan lo mismo que cualquier religion que hay en madrid. que alquilen o compren un edificio terreno o lo que quieran y lo avalen sus fieles.</p>
";"13/10/2015 23";"133";"66";"67";"5";"1209774591";"-49"
"4185";"La organización y distribución del espacio como herramienta de propaganda.";"<p>Water para chicos y chicas, alumn@s enfrentados al profesor ,separados y compitiendo entre sí , trabajando por un objetivo individual , carreteras en la puerta de casa , dictadura económica del espacio audiovisual , cárceles ""masculinas"" y ""femeninas""...</p>

<p>La infiltración ideológica en la educación oficial es incompatible con la democracia y la capacidad crítica, necesaria esta para el avance científico , la creación artística y la adaptación social a un mundo siempre cambiante.</p>

<p>Quienes hablan en nombre de Dios , de la Justicia , la Libertad, o cualquier otro royo metafísico-espiritual-místico, que se vayan a dar misa o mitines políticos y dejen a las maestras y maestros trabajar libre y dignamente.</p>
";"14/10/2015 00";"12";"4";"8";"0";"1208227275";"-133"
"4186";"¿Por qué tratar a un enfermo de cáncer con dinero público es democracia...?";"<p>Y subvencionar la luz o la comida a nuestros mayores es dictadura?</p>
";"14/10/2015 00";"46";"8";"38";"17";"1206986754";"-521"
"4187";"Correccion de medidas antipolucion en motocicletas";"<p>La concejal Ines Sabanes ""rectifica"" las medidas antipolución añadiendo a las motocicletas de 125cc y superior cilindrada en iguales condiciones a los automoviles.</p>

<p>Los datos que en los que se basa su decisión y aporta son falsos por cuanto compara datos de  motocicletas del 2007/2008 con datos de automoviles del 2014/2015. La patronal de 2 ruedas le intenta sacar de su error pero........ </p>

<p>La decisión se ha tomado con datos de mediciones erroneos (supongo que es responsabilidad de su equipo de asesores en este campo)  las mas importantes son que el indice de NOX con homologacion  EURO 3 con el que han calculado las motocicletas está anticuado en 7/8 años y que las motocilcetas actuales tiene un indice hasta 10 veces inferior (con lo que con sus calculos 10 motos=1 coche, hasta que el calculo no lleva  un factor corrector por la diferencia de tiempo que tarda una moto con respecto a un coche para el mismo trayecto con lo cual  con menos tiempo circulando las emisiones bajan.</p>

<p>Aqui os pongo para que podais analizar los datos del estudio publicado por su misma area del Ayuntamiento de Madrid en 2014 y denominado ANÁLISIS DE LAS EMISIONES CONTAMINANTES DEL PARQUE CIRCULANTE ciudad de Madrid 2013 donde se dice</p>

<p>Que en el interior de la M30 del 100% NOX emitido las motos son 1.9%, si señora concejal 1.9% y el transporte publico de Madrid 25.1% ,el resto transporte privado , página 4 del informe</p>

<p>http://www.madrid.es/UnidadesDescentralizadas/Sostenibilidad/EspeInf/EnergiayCC/06Divulgaci%C3%B3n/6eEventos/JornParqueCircula2014/Ficheros/04AnalEmis2013UNIFPOLITECNICA.pdf</p>

<p> </p>

<p>Asimismo el parque de motocicletas en todo el territorio nacional  es de menos de 3 millones contra 22 millones de automoviles y 5 milones de furgonetas/camiones segun fuentes de la DGT con respecto al estudio del PIVE 8</p>

<p> </p>

<p>Solicito un debate</p>
";"14/10/2015 09";"65";"54";"11";"21";"1228084182";"3572"
"4188";"CARTA ABIERTA A LA SRA ALCALDESA";"<p><strong>CARTA ABIERTA A LA SRA. ALCALDESA DE MADRID Dª. MANUELA CARMENA</strong></p>

<p>LA ASOCIACIÓN DE ESCUELAS TAURINAS ANDALUZAS</p>

<p>EN</p>

<p>APOYO DE LA ESCUELA TAURINA DE MADRID</p>

<p> </p>

<p>            Una Vez reunidas las escuelas taurinas andaluzas en la Villa de El Bosque (Cádiz), con motivo del XVI Encuentro de las Escuelas Taurinas de Andalucía, se acordó por unanimidad dar cumplida respuesta a la acción llevada a cabo por la Sra. Alcaldesa de Madrid, Dª. Manuela Carmena, de suspender las actividades de la Escuela Municipal de Tauromaquia de Madrid que depende directamente de usted, - faro y guía de la tauromaquia y de donde han salido un gran número de figuras del toreo que han llevado y llevan su arte por todos los ruedos del mundo-, en un alarde de desprecio, no a la Fiesta o a la Escuela Taurina que eso al fin y al cabo sería lo de menos, sino a esa legión de chavales cuyo único delito ha sido el querer ser toreros.</p>

<p>            Pues si estimada alcaldesa, estos chicos como diría un castizo, tienen perfecto derecho a ser toreros o lo que les dé la gana, solo que la exquisita sensibilidad que atesoran les ha llevado a escoger un camino cuyo final grandioso solo está al alcance de muy pocos. Por lo tanto le ruego no ponga más obstáculos en sus vidas, que algunos ya tienen más de los que pueden soportar.</p>

<p>            De otro modo, la tauromaquia es según la apreciación de personajes tan poco dudosos para Vd. ¡me imagino!, como son García Lorca y Picasso, de que los toros es la profesión más culta y demócrata de todas cuantas existen. Y no es solo porque ellos lo digan, sino porque en ningún lugar del mundo el pueblo ejerce de verdad y de forma total su soberanía como en una plaza de toros, allí, autoridades, intervinientes, protagonistas, obedecen ciegamente sus decisiones, y estos (el público) las ejercen con justicia y generosidad.</p>

<p>            Puede sentirse orgullosa señora por ser la Regidora de una Villa como Madrid, pero no por su historia, ni por sus monumentos, ni por ser la capital de España, sino por tener en ella a la más importante plaza de toros del mundo, ¡Las Ventas!, donde se cambia el destino, se alcanza la gloria y hasta la inmortalidad.</p>

<p> </p>

<p> </p>

<p> </p>
";"15/10/2015 10";"149";"40";"109";"16";"1219203427";"-1852"
"4189";"Madrid: La ciudad inteligente";"<p>¡Hola!</p>

<p>Madrid se encuentra a la cola de las grandes ciudades de Europa en el desarrollo de servicios inteligentes, que permitan lograr una ciudad más sostenible y amigable con el ciudadano. Pensad, por ejemplo, en sistemas de riego inteligentes que regulen el riego en función de la humedad o lluvia del ambiente, o que las calles principales tuvieran sistemas de sensores que te informen del tráfico, los servicios en tu zona o incluso las ofertas de tiendas con productos que te interesan.</p>

<p>O también edificios realmente sostenibles que no consuman energía, o incluso que aprovechen las azoteas para generar energía y alimentos.</p>

<p>Todo esto puede parecer ciencia ficción, pero ya se está haciendo en otras ciudades europeas, aquí os dejo unos ejemplos (lo siento, están en ingles)</p>

<p>http://amsterdamsmartcity.com/visitus</p>

<p>http://international.kk.dk/sites/international.kk.dk/files/uploaded-files/Solutions%20for%20sustainable%20sities%202012.pdf</p>

<p>http://www.fastcoexist.com/3024721/the-10-smartest-cities-in-europe</p>

<p>¿Qué proyectos os gustaría ver en Madrid? ¿No os parece que el Ayuntamiento debería dedicar esfuerzos a esto?</p>

<p> </p>
";"15/10/2015 10";"42";"40";"2";"0";"1239422649";"3619"
"4190";"Obligar a modificar el proyecto de Canalejas para hacer vivienda social";"<p>¿Obligarías a los promotores a modificar el proyecto tras la demolición de este conjunto de edificios declarados BIC, para construir vivienda protegida?</p>
";"16/10/2015 11";"39";"9";"30";"5";"1231456782";"-484"
"4191";"SOLO ..................7% ";"<p>La Propuesta mas apoyada en esta web es del 7%, Sirve para algo este portal ?</p>

<p>Entenderme bien, no critico la idea.........y si los resultados....</p>

<p> </p>
";"16/10/2015 12";"60";"52";"8";"11";"1249871172";"3813"
"4192";"Esta página web es un cachondeo";"<p>Lo siento mucho, desconozco si los moderadores pueden ver mis mensajes, intento aportar criticas constructivas, pero esto es un cachondeo, nos encontramos con el problema principal, la web no es conocida, es casi imposible conseguir que algo salga adelante. Muchísima gente vive ajena a internet, sobretodo miles de ancianos y clase media que usa internet para leer el periódico, pornografía y facebook si acaso.. .ya sabéis. </p>

<p>He visto multitud de MEDIDAS BUENAS, completamente apolíticas, medidas que no solo son necesarias implementar YA, si no que además le puedes preguntar a un ""facha del pp"" o a un ""rojo de podemos"" y te dirán que si, que la apoyan completamente. ¿y se ha hecho algo? Nada, esta web me parece que esta por estar, para decir ""ey, os escuchamos"". No señores, si una medida es buena, coherente, razonable y no va a perjudicar las arcas del estado ¿por que hay que someterla a la aprobación de 50.000 personas o las que sean? Que se haga y punto. 

Así a ojo me viene a la cabeza: 
  - Prohibir la venta ambulante, ya sabéis, ""el meloneeero, el tapizador, el afilador"", todos esos que vienen con megáfonos a despertarte a las 11 de la mañana del domingo. 
 - Baños públicos, he visto multitud de opciones, por ejemplo baños en el metro (esto lo veo algo caro), otros son urinarios como los de Ámsterdam, que se limpian a manguerazo. 
 - Que Bici Madrid se incluya en el bono transporte, para esto no hay que cambiar más que cuatro cosas, y llegar a un acuerdo con la Comunidad de Madrid y ale. 
 - Que los autónomos (instalador de aire acondicionado, gente dedicada a reformas, etc...) no tengan zonas azules o verdes, o que tengan que pagar cada 4 horas, yo que sé. </p>

<p>¿cuanto puede costar todo eso? Poco comparado con lo que infresa el Ayto. de Madrid cada año, y podríamos tener una ciudad un poquito (al menos), mejor. 

Que tampoco es que estemos pidiendo que peatonalicen el centro para mañana (ojalá), pero muchas cosas buenas que se dicen por aquí pasan de largo y nadie las tiene en cuenta. </p>
";"16/10/2015 17";"84";"74";"10";"21";"1253522181";"5638"
"4193";"¿Es legal que que tengas que pagar para echar un curriculum?";"<p>Hola a todos:</p>

<p>Mi duda viene a ser que si es legal que al ir a entregar un currículum a una empresa madrileña te deriven a un  telefono 902..., donde te cobran la llamada.</p>

<p>Si no es así, què debería hacer?</p>
";"17/10/2015 13";"23";"10";"13";"3";"1243886454";"-130"
"4194";"FRUSTRACION CON ESTA PROPUESTA DE DECIDE";"<p>Resulta obvio que los resultados de la intención de esta propuesta, mas...menos son lamentables...Lo malo es que para quienes hemos votado a Ahora Madrid, teníamos ilusión en cada paso porque necesitamos contrastes pragmáticos en cuestiones básicas, tal tantas propuestas expuestas y que estadísticamente muestran un real fracaso...porque llegar a 53.000 y tantos apoyos, lamentablemente no me va a aguantar la edad a los 285 años y ni tan siquiera.Creo que hay que tener muchísimo cuidado cuando se habla de transparencia y de agilidad de gestión porque huele nuevamente a que los grandes beneficiados son los que estan dentro de la orquesta y no de los que ni siquiera podemos escuchar la música.Queda claro que la izquierda necesita de otra vitalidad y no dudo de la ética de D.Manuela Carmena, pero cuando se juega con el personal, el daño va hacia afuera.No hubiera sido mejor..decir...las propuestas que tengan mas esencia y apoyo, se trasladarán a la Junta de Gobierno Municipal, mas que jugar al 53.000 y tanto...No se a quien se le ocurrió esta idea...o es que aún siguen manejando el cotarro los intocables del faraón???</p>

<p> </p>
";"18/10/2015 19";"63";"57";"6";"18";"1273777384";"4614"
"4195";"Mejora de la movilidad en Madrid";"<p>Existe desde finales de verano, una cantidad de tráfico que no ha existido en años anteriores, y que no sólo afecta a los automovilistas, sino que también afecta a los usuarios de transporte público, como el autobús. Por este motivo, lo que solicito al Ayuntamiento es que realice las actuaciones necesarias para poder mejorar la movilidad por la ciudad de Madrid, y que no suponga que el desplazamiento por la ciudad en transporte público, suponga un tiempo de desplazamiento superior a las personas que puedan desplazarse desde otras ciudades próximas, hasta aquí.</p>
";"19/10/2015 09";"69";"64";"5";"9";"1280529497";"5472"
"4196";"ZONAS VERDES DE SANCHINARRO";"<p>El mantenimiento de las areas verdes de Sanchinarro, es pésimo... entre arboles secos (final de la Calle Principe Carlos), las áreas que deberían ser de cesped, están secas o mal cuidadas, las malas hierbas (Principe Carlos, María Tudor, Conde de Mayalde, Niceto Alcalá Zamora, Francisco Pi y Margall) en algunos puntos son mas altas que una persona. Hay papeles y escrementos de perros, los barrenderos brillan por su ausencia y parque y jardines, estubieron hace un més y dejaron todo a medio hacer. Le he tuiteado a la Alcaldesa y al ayuntamiento y no he tenido respuesta. Para ser un gobierno que presume de estar cerca de la gente me parece lamentable que respondieran ni siquiera con un ""lo tendremos en cuenta"". La nefasta administración anterior, de la señora Botella, tenía al menos la cortesía de responder. </p>

<p>- PROPUESTA: Aumentar la presencia de barrenderos municipales y del servicio de Parque y Jardines.</p>

<p>- PROPUESTA: Mejorar la presencia en la Redes Sociales de la Alcaldesa... que no sea solo propaganda de autobombo.</p>

<p> </p>

<p> </p>
";"19/10/2015 13";"54";"49";"5";"8";"1280919061";"3992"
"4197";"Regulación licencias de obra en edificios con vecinos.";"<p>¿A quién no le ha tocado soportar una obra durante meses? Al igual que en las obras públicas se anuncia el presupuesto y duración en las obras de locales y pisos donde el ruido y suciedad afecte a los vecinos debería de estar prevista y anunciada la duración. El horario ""legal"" de ruidos hace que sea imposible descansar o trabajar en casa cuando hay una obra.
Actualmente la licencia de obra es solo necesaria a nivel informativo y no es obligatoria. Propongo que siga siendo así durante las dos primeras semanas de obra y a partir de ahí que sea necesaria una licencia ""de pago"" mas complicada de obtener.</p>
";"19/10/2015 14";"46";"36";"10";"5";"1277359451";"2034"
"4198";"Añadir bebederos para mascotas en las fuentes públicas";"<p>Con el fin de evitar que tengan que lamen del grifo, se puede añadir un cuenco en la base de la fuente, para que las mascotas puedan beber, y así evitamos el contacto con el grifo, de está manera las mascotas podrán beber de una manera más natural para ellos y será beneficioso también para los usuarios de 2 patas.  :))</p>
";"19/10/2015 17";"120";"80";"40";"8";"1278102145";"2666"
"4199";"¿EQUO existe?";"<p>El partido ecologista EQUO ha sido la razón principal por la que muchos votamos a la coalición Ahora Madrid. Unos pocos meses después podemos constatar su total invisibilidad, jamás había visto los barrios tan sucios, se siguen cortando árboles y no se reponen, es raro no pasear por una calle y encontrarte varios huecos vacios donde debería haber un árbol. ¡No he visto reponer ni uno sólo, pero si cortar varios! ¡Qué decepción! A mi juicio, o bien EQUO no tiene peso alguno en Ahora Madrid o también comparten la poca preparación a la hora de asumir las responsabilidades para las que les elegimos. Su gestión ecológica no es mala, es inexistente.</p>

<p>En este tiempo he creado propuestas y debates en este ""Facebook"" de la pataleta institucional que parece no servir para más que desahogarse, ¡¡¡50.000 apoyos!!!, está claro que esto es predicar en el desierto. He escrito correos a Ahora Madrid, EQUO, Podemos, Inés Sabanés, Ramón Linaza..., les he hecho llegar listados de árboles cortados detallándoles su ubicación, nada, no me han hecho ni caso. </p>

<p>Quedan 2 meses para las próximas elecciones y, en vista de lo poco que valoran las iniciativas ciudadanas, mi voto va a cambiar radicalmente. No merece la pena apoyar lo que parece no existir, y EQUO no parece existir. </p>
";"19/10/2015 21";"46";"33";"13";"34";"1279777711";"1434"
"4200";"Desafío a los taurinos";"<p>Respondan a esto si pueden.</p>

<p>https://blogsostenible.wordpress.com/2015/09/14/cuento-toro-de-la-vega-argumentos-favor-contra-toros-noaltorodelavega/</p>
";"21/10/2015 08";"63";"30";"33";"17";"1283424949";"-142"
"4201";"PARQUE FORESTAL ZONA SUR MADRID";"<p>Me gustaría estar rodeado de zonas forestales, parques como el de VALDEBEBAS, 500 hectareas de parque, donde poder ir a pasear, montar en bici, correr, respirar un poco de aire puro...</p>

<p>En la zona sur, en concreto en el ENSANCHE DE VALLECAS, se quedo en un intento de parque, contando solo con 5 hectareas, algo ridiculo.</p>

<p> </p>

<p>Por ello desde aqui hago un llamamiento a las autoridades competentes a que hagan las intervenciones ccorrespondientes y nos hagan un PARQUE.</p>

<p> </p>
";"21/10/2015 09";"76";"68";"8";"5";"1300039699";"5368"
"4202";"BiciMad pierde 300.000 al mes";"<p>http://www.elmundo.es/madrid/2015/10/21/56277e1446163fac218b4639.html</p>

<p>¿De verdad es viable un servicio que sí, ayuda a eliminar la contaminación, o no ya que provoca buenos atascos a la ciudad, pero que hace que mes a mes sea deficitario en 300.000?</p>

<p>He visto cantidad de propuestas por municipalizar este servicio y extenderlo a más sitios de Madrid. ¿No deberiamos buscar otras alternativas? ya que pagamos todos este servicio.</p>

<p>Quizás deberiamos fomentar la bicicleta privada en vez de un servicio público que no sufre más que vandalismo.

 </p>
";"22/10/2015 12";"70";"46";"24";"26";"1304818351";"1445"
"4203";"¿Hay manera de saber cuanta gente está inscrita en Madrid Decide?";"<p>Hola,</p>

<p>Esta claro que la mayoria de gente que se ha inscrito ha sido porque desea algo mejor.</p>

<p>Es frustante pensar que es imposible llegar a 53.000 votos, sobre todo si no sabemos ni cuantos inscritos hay con derecho a voto.</p>

<p>Asi que lo que os propongo es que dejemos de quejarnos al webmaster y movamos el culo. Hagamos toda la publicidad posible de esta página, que se inscriba toda nuestra familia, nos vecinos, ... todo el mundo, una vez dentro veran el potencial.</p>

<p>Hasta que no haya inscritas almenos 100.000 personas con derecho a voto, esta pagina solo tiene el sentido de experimento.</p>

<p>Somos 4 gatos gritando en un estadio vacio, si queremos hacer la ola, hay que llamar a mas gente.</p>

<p>Buenas noches</p>

<p><em>Jaime</em></p>

<p> </p>

<p> </p>

<p> </p>
";"23/10/2015 01";"73";"68";"5";"8";"1317351652";"5868"
"4204";"Autodefensa ecológica";"<p>Compartir información ( a poder ser indicando la fuente) , denunciar empresas ( con pruebas y argumentos ), crítica honesta en la construcción de un mundo sostenible, poner en contacto a cooperativas o empresas de productos ecológicos en Madrid, informar sobre recogidas de firmas , manifestaciones o boicots,</p>

<p>Esto también es participación política y podemos utilizar la página de forma práctica y complementaria al objetivo de los 53000.</p>
";"23/10/2015 09";"37";"26";"11";"10";"1312990480";"1054"
"4205";"Participación ciudadana de otros lugares de España";"<p>Propongo que todo ciudadano español tenga acceso a las votaciones de las propuestas del Ayuntamiento de Madrid, no solamente los empadronados en el mismo. Me ocurre que quiero apoyar alguna propuesta y no puedo.</p>
";"24/10/2015 10";"64";"19";"45";"12";"1310088516";"-771"
"4206";"Crear un mensaje para enviar por grupos de whassap y redes sociales.";"<p>Yo no sabia de la existencia de esto hasta hoy.</p>

<p>Propongo que creemos un mensaje para enviar a nuestros grupos de whassap, etc, y dar a conocer esto.</p>

<p>Tipo:</p>

<p>Ahora puedes participar: https://decide.madrid.es/ Si eres madrileño y quieres mejorar madrid, seas del signo que seas, participa. Tu opinión cuenta.</p>
";"24/10/2015 15";"43";"28";"15";"2";"1323755725";"846"
"4207";"Metro 24 horas en Madrid";"<p>Estas a favor de que el metro de Madrid funcione las 24 horas del dia al menos los fines de semana como sucede en Barcelona0</p>
";"24/10/2015 15";"206";"177";"29";"3";"1335281660";"12716"
"4208";"Reducir la velocidad y el volumen del tráfico en Cea Bermúdez y José Abascal.";"<p>Hay que tomar medidas disuasorias para reducir el uso de esta via y la velocidad de los vehículos. Desde radares para que la velocidad no exceda los 50 Km/h o los coches no se salten los semáforos hasta que se pongan badenes, lomos, bandas para evitar los que van a toda pastilla generando riesgo, ruido y contaminación. Esta autovía urbana es la que inyecta vehículos a toda pastilla a la almendra central y que además es utilizada para atravesar el núcleo de la ciudad evitando así circunvalar la ciudad.</p>
";"24/10/2015 19";"66";"42";"24";"12";"1326486965";"1145"
"4209";"trafico - investigacion - auditoria";"¿ESTARIA DE ACUERDO EN QUE SE INVESTIGUE EL FUNCIONAMIENTO DE LAS EMPRESAS CONCESIONARIAS DE LOS PANELES Y SISTEMAS DE CONTROL DE TRAFICO?

<p>Me gustaria que el Ayto de Madrid investigara a las empresas concesionarias de los paneles informativos (no se usan para la finalidad para que se pusieron, ayudar al trafico) asi como se analizaran ""los sistemas informaticos"" que hay detrás del manejo de los mismos.</p>

<p>Se por algunas personas relacionadas con los mismos, que se manipulan en determinados momentos para provocar el ""efecto mariposa"" que da lugar a los ingentes atascos que venimos padediendo en Madrid, M30 y M40. Se provocan determinados ""actos"" que dan lugar a determinados Accidentes, en zonas muy concretaas y sensibles, lo que unido a un lunes o/y a un dia lluvioso, provoca atascos kilometricos.</p>

<p>Desde que entró Gallardon en el Ayto hasta el dia de hoy, etapa de Carmena, se siguen produciendo ""exactamenter"" los mismos atascos, solo que antes no salian en las noticias y ahora si. ¿por que?... entiendo que por ""intereses creados"".</p>

<p>Asi mismo, los paneles que estan sobre las calzadas, en las calles, la M30 y M40 no se usan para la finalidad para la que estan diseñados... """"""ayudar a los conductores"""""". ! de cada 4 funcionan en horas punta (¿será por que los que NUNCA funcionan no estan ni conectados al sistema y se pusieron para facturar a los distintos ayuntamientos y cobrar por un servicio que no dan?)</p>

<p>Creo que estas empresas desde Gallardon a Carmena estan usando ""el trafico"" para tener cautivos a los Ayuntamientos (me da igual de que ideologia sean) y hacerse cada vez mas imprescindibles en lo que ellos llaman ""la solucion"", creando realmente EL PROBLEMA.</p>

<p>Ciero es que la M40 no depende del ayuntamiento de Madrid, Pero muchos guardias civiles de trafico han observado esto mismo que comento, pero no pueden decirlo, por su estructura de mando, que es la que es.</p>

<p>Por favor, no seamos cautivos de alguien que nos manipula y nos ocasiona llegar tarde al trabajo, a clase, a un hospital.... con las consecuencias que para todos los ciudadanos en general tienen estas actuaciones.</p>

<p>No nos dejemos influenciar sobre comentarios tales como """"cogemos mucho el coche"""", """"los lunes hay mas coches"""" """"los dias de lluvia cogemos mas el coche"""".... mentira. Dada la situación actual, los ciudadanos no cogen tanto el coche, suelen compartir viajes, se ha incrementado el uso de la bicicleta y de las motos... se suele usar mas el transporte publico, se ve mas gente andando que antes.... (ver cualquier estadistica seria al respacto, tales como litros de combustible consumidos en la serie de los ultimos 15 años; ver estadisticas de ventas de bicicletas y motocicletas en las series de los ultimos 15 años, etc.... NOS ENGAÑAN A LOS CIUDADANOS POR QUE ENGAÑAN A LOS AYUNTAMIENTOS</p>
";"24/10/2015 19";"43";"36";"7";"2";"1330334239";"2427"
"4211";"Creación nuevo/s parques Retiros en Madrid";"<p>Madrid necesita para limpiar esa nube tóxica que la envuelve, además de otras medidas, la creación de uno o varios parques del tamaño del Retiro, lo cual servirá también para disfrute de los madrileños y de los turistas, convirtiéndose en una de las ciudades más verdes del mundo. Fomentar en estos parques actividades públicas deportivas al aire libre. Creación de grandes lagos dentro, donde se pueda entrenar remo, piragüismo y paseos en barcas. Una pista de patinaje de hielo sólo para el invierno. Terrazas, restaurantes, parque para niños... Que la gente disfrute de ese aire limpio y de ese ocio o deporte.</p>

<p>No queremos solo centros comerciales y terrazas donde nos tragamos el humo de los coches que pasan al lado.</p>
";"26/10/2015 00";"86";"74";"12";"2";"1346235873";"5334"
"4212";"Comprar suelo vivienda plan 18000";"<p>Hola a todos,</p>

<p>por favor, alguien más está a la espera de escriturar la comprar del suelo de una vívienda del plan 18000, después de haber entregado ya el 5% del dinero y estar todo aprobado, solo a la espera de que el ayuntamiento de fechas para firmas ?</p>

<p>yo llevo esperando la fecha desde julio.</p>

<p>alguien sabe algo y pondría ayúdame?</p>

<p>gracias?</p>
";"26/10/2015 11";"9";"8";"1";"3";"1343086193";"622"
"4213";"Unificación de propuestas";"<p>Llevo viendo desde que empezó a funcionar este portal, muchas propuestas similares si no practicamente iguales, que suman votos por separado. ¿no se podria idear un sistema poniendose en contacto con los impulsores de las ideas para poder UNIFICAR y que sea eficaz la recogida de votos de las propuestas similares?</p>
";"26/10/2015 11";"148";"145";"3";"10";"1356527538";"13912"
"4214";"WEB Gobierno Abierto";"<p>Me gustaria saber si se puede hacer publico, o donde encontrar los gastos que generan al ayuntamiento de Madrid este portal, y si, como he leido la maxima aceptacion de una propuesta es el 7%, si realmente sirve para algo ese dinero destinado.</p>

<p>Gracias</p>
";"26/10/2015 15";"37";"27";"10";"4";"1346101478";"1240"
"4215";"IBI abusivo";"<p>Acabo de recibir el recibo del IBI 2015 y por un piso con dos habitaciones en Herrera Oria; <strong>306,73</strong>, me parece muy fuerte cuando nos prometieron que el IBI iba a bajar. En cualquier caso es una barbaridad lo que se paga en este impuesto. Cuando pienso la cantidad de casas que hay en Madrid, solo con este impuesto tendría que haber dinero para todo y no es así. Estais de acuerdo que lo que pagamos no es lo que recibimos? </p>
";"26/10/2015 19";"107";"103";"4";"11";"1357921606";"9529"
"4216";"¿Se omite el Derecho a la Vivienda?";"<p>¿para cuántas personas existe el derecho efectivo y universal a la vivienda?</p>

<p>¿qué medios y organismos existen e informan sobre la situación del derecho a la vivienda?</p>
";"27/10/2015 02";"35";"16";"19";"3";"1339688194";"-137"
"4217";"Es esto un foro vacío de contenido?";"<p>Me pregunto si esto es un brindis al sol donde se le da al ciudadano un papelito para escribir sus quejas que luego se tira a la basura. No pretendo que se lleven a cabo todas y cada una de las propuestas pero está claro que, dado el número de ususarios, ninguna (o muy pocas) van a llegar a los 50000 y pico apoyos. Pero ... me pregunto si es realmente neceasario tantos apoyos para que una propuesta con sentido y que beneficie a la comunidad se lleve a cabo. Realmente hay algún concejal que se pasa por estos foros para captar ideas o al menos para ver donde están los problemas y las reivindicaciones de sus conciudadanos? Tienen usuarios registrados? Han escrito en alguna de las propuestas dando su opinión? Si no es así ... igual todo esto no tiene mucho sentido ... a mi particularmente no me gusta quejarme por quejarme. Espero estar equivocado :-)</p>

<p>Alguna opinión discordante o ejemplo de casos que han llegado a buen puerto? Algún miembro del gobierno municipal que explique como tienen en cuenta las propuestas?</p>
";"27/10/2015 09";"23";"18";"5";"7";"1353470472";"1017"
"4218";"I.V.A. SOBRE IMPUESTO ELÉCTRICO";"<p>Las compañías de suministro se adjudicaron un ""derecho de amortización"" de sus propios gastos con una operación directa que aparece en cada factura de cada consumidor/a.</p>

<p>Es excesivo afrontar el cobro de una multiplicación como se puede observar en el desglose de la factura, cuando se cobra por un lado el término de sobre otros conceptos, como el o la , mientras que al cierre de la misma se cobra el de todo lo anterior. Es por tanto, el resultado de multiplicar un impuesto de otro, una forma de inflar el coste del producto a los usuarios, cosa que habría que ver en que términos de legalidad se hace efectivo.</p>
";"27/10/2015 16";"28";"28";"0";"8";"1361820685";"2800"
"4219";"I.V.A. SOBRE IMPUESTO ELECTRICO";"<p> </p>

<p>Las compañías de suministro se adjudicaron un ""derecho de amortización"" de sus propios gastos con una operación directa que aparece en cada factura de cada consumidor/a.</p>

<p>Es excesivo afrontar el cobro de una multiplicación como se puede observar en el desglose de la factura, cuando se cobra por un lado el término de <strong><em>IMPUESTO ELÉCTRICO</em></strong> sobre otros conceptos, como el <em>CONSUMO</em> o la <em>POTENCIA</em> <em>CONTRATADA</em>, mientras que al cierre de la misma se cobra el <strong><em>I.V.A</em></strong>. de todo lo anterior. Es por tanto, el resultado de multiplicar un impuesto de otro, una forma de inflar el coste del producto a los usuarios, cosa que habría que ver en que términos de legalidad se hace efectivo.</p>
";"27/10/2015 16";"50";"50";"0";"2";"1364406438";"5000"
"4220";"PLACAS DE ZONA RESIDENTES EN EL CENTRO CON ILUMINACION ";"<p>AMPLIARON LAS ZONAS DE RESIDENTES EN EL CENTRO, PERO LAS PLACAS DE INDICACION NO SON SUFICIENTEMENTE INFORMATIVAS, PORQUE QUIEN CONDUCE POR LA NOCHE EN ESAS ZONAS SABE LO QUE DIGO. DE LA MISMA FORMA QUE FUERON CAMBIADAS LAS DE LOS TUNELES DE LA M30, PODRIAN HACER LO MISMO CON LA DE LA ZONA DE RESIDENTES , EMBAJADORES, OPERA....</p>
";"27/10/2015 18";"16";"13";"3";"3";"1356489482";"812"
"4221";"Alcohol en La Latina";"<p>Han puesto de moda en el barrio el beber. Es su gran negocio del barrio (y casi único). Hay garitos de todo tipo y para cualquier cliente. Incluso el espacio dejado por una piscina municipal se emplea, no siempre, para beber. En los alrededores de la discoteca Shoko y La Fuentecilla, hay botellón a cualquier hora de la madrugada cuando los bares cierran, con lateros. Grandes carteles luminosos, anuncian una marca, en los edificios en rehabilitación. Se va a crear una especie de museo de la cerveza de esa misma marca en la zona. Se anuncia en todas las guías turísticas. Resulta increible que con toda la cultura que alberga (museos, monumentos, mercado, biblioteca, en definitiva historia de Madrid), se le reconozca por poner de moda el consumo masivo de alcohol.</p>
";"28/10/2015 11";"53";"44";"9";"11";"1368463706";"2905"
"4222";"AUTODEFENSA DERECHOS LABORALES";"<p>Está PROHIBIDO que te descuenten de la nómina una herramienta desaparecida o rota , o un uniforme o cualquier producto que manipules en tu trabajo , para eso tienen un seguro y si no lo tienen es asunto de la empresa no del trabajador , ni aunque robes algo , no tienen derecho , solo un juez lo tiene , si en tu nómina te descuentan algo así ( sin indicarlo porque está prohibido)  escribe NO CONFORME , luego firmas y después denuncias , porque eso es ROBAR, y parece que nadie lo sabe .</p>
";"28/10/2015 18";"23";"20";"3";"2";"1368737710";"1478"
"4223";"¿CUANTO NOS CUESTA EL MANTENIMIENTO DE LA M-30 AL AÑO?";"<p>Prabablemente es uno de los datos más difíciles de encontrar en la prensa de los últimos años. Se puede complementar para aumentar la transparencia con el nombre de las empresas contratistas encargadas del mismo. Ser conscientes de este dato nos permitirá avalar definitivamente el Parque Madrid Río, las grandes obras de soterramiento de los viales, etc. No es suficiente con el dato de su coste total y el pago de los intereses que está generando. <strong>QUEREMOS CONOCER un dato más. El COSTE ANUAL DE MANTENIMIENTO</strong></p>
";"29/10/2015 10";"40";"33";"7";"6";"1376567709";"2145"
"4224";"ILUMINACIÓN CANCHAS DE IBM ";"<p>DESDE HACE UNOS AÑOS ENTRENO CON MI EQUIPO DE FÚTBOL SALA TODOS LOS JUEVES EN LAS PISTAS DE IBM SOBRE LAS 8 DE LA TARDE, QUE ES CUANDO LA GENTE SALE DEL TRABAJO O DE LAS CLASES. PARA MI SORPRESA ESTE AÑO NOS HEMOS ENCONTRADO QUE HAN QUITADO LAS LUCES Y NO PODEMOS JUGAR YA QUE A ESAS HORAS ES COMPLETAMENTE DE NOCHE. ESPERO QUE VUELVAN A PONER LAS LUCES SABIENDO ADEMÁS QUE  A  ESAS HORAS ES CUANDO HAY MAS GENTE . </p>
";"29/10/2015 11";"32";"29";"3";"6";"1378330408";"2356"
"4225";"¿Se debe revisar de forma más justa el valor catastral de las viviendas?";"<p>En el año 2012 realicé un estudio comparativo de la subida del IBI en las dos viviendas de que soy propietario. Una más modesta que tengo en alquiler y otra digamos más residencial donde vivo.</p>

<p>Descubri con asombro que mientras que en mi domicilio actual el incremento del IBI se debía a un aumento del 44,8% en el valor catastral, curiosamente en la vivienda modesta este aumento era del 78,2%.</p>

<p>Es ahí donde creo que reside la injusticia de lo que los madrileños pagamos anualmente en concepto de IBI y es por eso someto a debate la necesidad o no de revisar los valores catastrales de las viviendas de forma más justa en base a los que había en el año 2011.</p>

<p>A tener en cuenta también los dos componentes del valor catastral: suelo y construcción que deben ser analizados según las zonas de Madrid y el tipo de construcción de los edificios.</p>
";"29/10/2015 11";"101";"100";"1";"1";"1385158974";"9801"
"4226";"ESCUELA MUNICIPAL - FAMILIA NUMEROSA";"<p>ES INDIGNANTE QUE ACUDAS A UNA <strong>ESCUELA MUNICIPAL</strong> Y NO SE HAGA NINGÚN TIPO DE DESCUENTO POR FAMILIA NUMEROSA, HAGO REFERENCIA A LA ESCUELA MUNICIPAL DE <strong>PLÁCIDO DOMINGO,</strong> DONDE LAS CLASES CUESTAN <strong>30 EUROS </strong>Y NO HAY NADA DE AYUDA PARA FAMILIAS NUMEROSAS, Y LO PEOR DE TODO, ES QUE <strong>DEPENDE DEL AYUNTAMIENTO </strong>COMO MUCHOS OTROS CENTROS CULTURALES EN LOS QUE SI TE HACEN DESCUENTOS.</p>

<p>ALCALDESA REVISE ESTO POR FAVOR!</p>
";"29/10/2015 13";"58";"38";"20";"14";"1375025449";"1179"
"4227";"Utilicemos todas las PLAZAS DE TOROS para temas CULTURALES y NO para TORTURAR .";"<p><strong>En un mundo civilizado y en continua evolución en el año 2015  ,LA TORTURA a cualquier ser vivo ya no tendriá que formar parte de las diversiones de los seres humanos,pero lamentablemente aun existen personas que por sus interes económicos ( Toreros,apoderados,ganaderos y personas que són incapaces de colocarse en el lugar del toro ) continuan TORTURANDO a los inocentes TOROS, los cuales los llevan forzados a un recinto desconocido para ellos ,llamado ""PLAZA DE TOROS"" donde los meten vivos  y los sacan muertos o agonizando.......</strong></p>

<p><strong>Tenemos que darles otra utilidad a LAS PLAZAS DE TOROS.</strong></p>

<p><strong> Todos LAS PLAZAS DE TOROS tenemos que utilizarlas para temas CULTURALES y NO para TORTURAR a estos inocentes animales llamados ""TOROS DE LIDIA"".</strong></p>

<p>La 1ª PLAZA ANTITAURINA ya esta en marcha,la he construido en mi domcilio de Maella-ZARAGOZA-ESPAÑA ; quiero y deseo que sirva de semilla para que todas las PLAZAS TAURINAS del mundo las convirtamos en espacios CULTURALES .....</p>

<p>              En el GOOGLE ( HOMOMAQUIA )  le dais a IMAGENES Y VIDEOS y vereis de que se trata dicho tema y plaza.</p>

<p>                    ""HOMOMAQUIA ""</p>

<p>                                           LOS TOROS SON TOREROS </p>

<p>                                        Y LOS TOREROS TOROS.</p>

<p>https://www.youtube.com/watch?v=RoYexKHb2W8</p>

<p>            Ponte en el lugar del TORO y despues opina......</p>

<p>    Miguel Estaña</p>
";"29/10/2015 17";"170";"101";"69";"10";"1376898325";"1901"
"4228";"Metro norte A6 (unir Pozuelo con Moncloa)";"<p>Hace unos años se nos prometío que se haría el metro para unir la zona norte de Madrid, pero al final solo hicieron un tranvía que llega hasta Aravaca y luego hay que coger el cercanías... ¿no se podría hacer una ampliación de la vía para unir ""de verdad"" Pozuelo con Madrid, por ejemplo con Moncloa? Esto descongestionaria mucho el tráfico de entrada a Madrid todas las mañanas</p>
";"30/10/2015 11";"41";"36";"5";"6";"1388635540";"2721"
"4229";"Belenes en Madrid y  mercadillo navideño en la Plaza Mayor";"<p>Al actual Ayuntamiento :</p>

<p>Soy atea.   Pero me encantan los Belenes y me encanta el mercadillo navideño de la Plaza Mayor.  Incluso algunos años pongo un Belén en mi casa pues las figuritas me divierten.</p>

<p>Por otra parte los Belenes SON arte también y no veo por qué se tienen que suprimir. </p>

<p>No me está gustando nada la poca tolerancia que creo que está demostrando el actual Ayuntamiento sobre este tema.</p>

<p>Si Ustedes son ateos como yo .... cosa que no estoy segura de que sea realmente el caso .....   creo que un poco de TOLERANCIA permitiría el que los madrileños pudiesemos seguir teniendo Belenes preciosos en distintos puntos de Madrid, además de poder ir a comprar figuritas navideñas a la Plaza Mayor.</p>

<p>Para terminar diré que la tolerancia y el respeto de las opiniones de los demás .....  es lo que hace que unos gestores demuestren si son demócratas o no lo son y si están al servicio de la ciudadanía o al de sus opiniones particulares.  Se lo digo con respeto pero con igual firmeza.</p>

<p> </p>

<p> </p>

<p> </p>
";"30/10/2015 13";"203";"183";"20";"19";"1396235941";"14694"
"4230";"¿Como sería la página ideal de decide.madrid?";"<p>La página ahora mismo consta de debates y propuestas que se votan. ¿No creeis que hace falta una forma de elaborar juntos propuestas de tal forma que sean mas ricas? ¿Sería bueno una mayor participación de expertos (medicos, juristas) que ayuden a las propuestas? ¿Sería bueno hacer micro-foros para elaborar propuestas? ¿Ser'ia bueno conectar la página con otros movimientos ciudadanos? <strong>Este debate es un invitación a imaginar que tipo de participación queremos.</strong></p>
";"30/10/2015 17";"35";"31";"4";"50";"1392040344";"2391"
"4231";"Votantes Sierra Noroeste";"<p>Buenos días:</p>

<p>Por que los ciudadanos de la Sierra Noroeste no podemos verificar la cuenta y por lo tanto votar. Creo que formamos parte de la comunidad aunque no vivamos en la capital.</p>

<p>Yo no tenía conocimiento de la existencia de esta aplicación hasta que ustedes me enviaron un mensaje a mi correo electronico, en que que me animaban a participar y registrarme en la página. Me parece una idea interesante el que hayaís creado este portal, en el que se permite a los ciudadanos contribuir en la toma de decisiones. Pero no entieno el porqué registrarme si no se me permite votar las propuestas.</p>

<p>Quizás exista un portal dedicado especialmente a los habitantes de esta zona aunque desconozco su existencia. </p>

<p>Gracias por el tiempo que hayan dedicado a revisar mi solicitud.</p>

<p>Un cordial saludo, Andrea.</p>
";"31/10/2015 09";"23";"6";"17";"6";"1381330644";"-286"
"4232";"Hay una Ley que obliga a jubilados/das a pagar ascensores, y cobran 335euros mes";"<p>Hay una nueva ley que obliga a personas  jubilados y jubiladas a pagar ascensores, y cobran muchos 335 euros al mes.</p>

<p>Hay que dar subvenciones para que pueda esta gente pagar los ascensores, y muchos enfermos. quien ha hecho esta ley se ha pasado tres pueblos, seguro que ellos no estan en esta situacion, el despifarro que hay en este pais y a esta persanas no se las puede ayudar. Gracias.   </p>
";"01/11/2015 09";"33";"19";"14";"23";"1400548590";"287"
"4233";"Racionalizar las APR";"<p>Las Áreas de Prioridad Residencial son necesarias pero pueden tener efectos perversos. El APR de Ópera que entra hoy en funcionamiento no será el último, y todos ellos en conjunto pueden crear un efecto barrera a quienes viven cerca.</p>

<p>En desplazamientos largos en coche, las personas que van o vuelven de sus domicilios pueden verse obligadas a pasar por algunas calles del APR según estén organizados los sentidos de las calles, prohibiciones de girar etc.</p>

<p>No tiene sentido que un residente de una zona cercana a un APR tenga que dar una vuelta enorme para llegar a su domicilio, gastando más gasolina.</p>

<p>Por ello, considero que las prohibiciones de girar y los sentidos de algunas calles deben ser estudiados, para evitar que los trayectos hacia las autovías sean mucho más largos. Ejemplos:</p>

<ul>
	<li>Eliminar la prohibición de girar a la izquierda desde Gran Vía hacia San Bernardo,</li>
	<li>Eliminar la prohibición de entrar en Carlos V desde Ronda de Atocha,</li>
	<li>Cambiar el sentido a la calle de los Reyes, para permitir los desplazamientos en sentido Norte</li>
	<li>...</li>
</ul>
";"01/11/2015 21";"27";"22";"5";"4";"1409746602";"1385"
"4234";"Pintar de color morado el carril bici ";"<p>Se ganaría en seguridad vial, sería una advertencia para los conductores que en esa zona puede haber ciclistas que circulen a menos de 30. No sería necesario cambiar el firme de la calzada. Basta utilizar color. Los accidentes se limitarían al estar presente en los conductores que circular encima de ese color puedes encontrar ciclistas, y además, los ciclistas se limitarían a no abandonar ese espacio de la calzada.</p>
";"01/11/2015 22";"68";"25";"43";"2";"1395202423";"-661"
"4235";"Pisos Alquiler a precio justo";"<p>Me parece una vergüenza los precios abusivos de los pisos en alquiler, no se basan simplemente en la calidad de la vivienda, si no que te cobran la ubicación de la vivienda, aunque el piso este de pena. </p>

<p>Si un propietario tiene la suerte de tener más de un piso en propiedad, los inquilinos no tenemos por qué pagar la hipoteca de ambas viviendas. No veo justo que se paguen alquileres a precio de 600, 700 u 800 euros (como poco...) por viviendas que no son nuestras, cuando hay hipotecas mucho más baratas que un alquiler.</p>

<p>Se supone que un alquiler no debe costar más que un piso en propiedad... si no, ¿Dónde está la diferencia?   </p>

<p>Por favor que se ponga un precio máximo de alquiler para que todos podamos acceder a una vivienda digna.</p>
";"02/11/2015 11";"93";"83";"10";"8";"1421946457";"6515"
"4236";"LIMPIEZA EN BARRIO BERRUGUETE (TETUAN)";"<p>Las calles del barrio de Berruguete en tetúan están mas que sucias, llevan con basura de meses todas las calles y no pasa nadie a limpiar.</p>
";"02/11/2015 14";"46";"46";"0";"3";"1423040693";"4600"
"4237";"El Ayuntamiento dará subvenciones sí todos votamos a favor de los ascensores. ";"<p>El Ayuntamiento dará subvenciones si todos votamos a favor de los ascensores, y nos ayudará tanto a los que puedan pagarlos, como a los que no puedan hacerlo, hay que sacar un 2% de votos, más luego hay que hacer otra votacion para que se acepte. Creo que es asi no? </p>
";"02/11/2015 16";"58";"40";"18";"3";"1416571731";"1517"
"4238";"No mas publicidad callejera con panfletos sobre coches, farolas o fachadas...";"<p>Te parece correcto pegar anuncios en cualquier parte el mobiliario urbano, cierres metalicos, fachadas,etc..? Y que la ordenanza que lo regula no se pueda aplicar.</p>
";"02/11/2015 16";"147";"140";"7";"10";"1427689008";"12666"
"4239";"Basta ya de graffitis que no respetan la ciudad de Madrid";"<p>Desde hace ya unos unos Madrid se ha llenado de graffitis sin valor artístico alguno que no respetan ni los edificios ni los espacios públicos, lo que es aún más grave, los monumentos más antiguos y representativos de la ciudad. El graffiti es un elemento básico de expresión cultural urbana que está presente en Madrid desde los años 70, especialmente en los barrios más populares de la ciudad. Sin embargo en los últimos años esa expresión cultural urbana ha pasado a ser un deterioro absoluto de la ciudad, no respetando ningún elemento de la ciudad de Madrid, ni decorativos, ni culturales ni ornamentales. Hace unos meses atrás pude ver un graffiti en uno de los laterales del Puente de Segovia que afortunamente se eliminó unos días después, pero con el consiguiente deterioro del monumento por la limpieza y utlización de productos abrasivos además del coste para las arcas municipales. Mención especial merecen barrios como Chueca, Malasaña o Centro, donde los graffitis llenan y manchan los edificios, muchos de ellos de más de cien años, sin sentido y valor artistico nulo, simplemente destrozar y dañar el entorno.</p>
";"02/11/2015 23";"164";"158";"6";"3";"1431124408";"14643"
"4240";"El sistema público de alquiler de bicicletas, ¿por qué está fallando?";"<p>Después de muchos años de esperar un sistema público de alquiler de bicicletas en Madrid, logramos un servicio con una bicicletas electricas que son estupendas, pero como de costumbre, el sistema genera más críticas que elogios, ¿por qué?:</p>

<p>- Sistema caro, se pago desde la primera media hora, lo que desincentiva el uso como sustituto del transporte público/coche.</p>

<p>- La empresa que lo explota no está obteniendo la rentabilidad esperada y está desatendiendo el servicio. Las bicicletas cada vez están en peor estado, las bases de anclaje fallan constantemente y el suministro de bicicletas es muy irregular.</p>

<p>- La zona en la que opera el servicio es demasiado pequeña para el tamaño de Madrid, reducirla a la almendra central, excluyendo zonas como Madrid Río es a todas luces insuficiente.</p>

<p>- Y algo más, con lo que no contábamos ... el VANDALISMO, ejercido no sólo por delincuentes profesionales, sino también por ciudadanos anónimos, en la mayoría de los casos nuestros propios jóvenes. </p>

<p>Creo que los 3 primeros problemas tienen solución, e incluso el vandalismo de las mafías organizadas, también, sólo es necesario que ""la autoridad"" se lo proponga; pero que una parte de los ciudadanos de Madrid, especialmente los más jóvenes, hayan adquirido el hábito de pasar por un puesto de bicicletas e ir tocándolas una por una, para comprobar si hay alguna suelta y así aprovecharse del sistema, no es propio de una sociedad que se considera avanzada. </p>

<p> </p>

<p> </p>
";"03/11/2015 09";"57";"50";"7";"17";"1429173500";"3771"
"4241";"multa por escupir en la vía pública ";"<p>Cada día veo como varias personas escupen sin pudor en las calles de Madrid incluso dentro de las instalaciones del metro con total normalidad. No sólo es una falta de higiene sino también falta de respeto y convivencia con los demás.</p>

<p> </p>
";"03/11/2015 10";"183";"162";"21";"4";"1433898335";"12481"
"4242";"LICENCIAS MUNICIPALES";"<p>Estiamada alcaldesa. No entiendo que el ayuntamiento me amenace con cerrar mi actividad en el barrio de Ciudad Lineal cuando he solicitado tal autorización vía declaración responsable. Sabe tan bien como yo que en este sentido se reformó la norma conviniendo que el solo hecho de solicitar una licencia por declaración responsable autoriza automaticamente la puesta en marcha de la ctividad.</p>

<p>Resulta que algú firme funcionario del departamento jurídico de la junta municipal de Ciudad Lineal, que tiene el pan asegurado todos los meses, se pasa por donde le parece la norma y no hace más que amenazarme con cerrarme.</p>

<p>¿Cómo espera que pague el alquiler donde desarrollo mi actividad si no produzco?</p>

<p>¿Como pretende que cotice por un empleado que tengo contratado a la seguridad social si no me permiten producir y obtener resultados?</p>

<p>Estamos hablando de una actividad que no produce molestias ni residuos de ningún tipo. Se trata de que soy un emprendedor con muchas dificultades para sobrevivir y el señor funcionario se empeña en ponérmelo más difícil todavía. Que no estoy pidiendo nada que no sea lógico y fácil de entender. Qué así es imposible que salga adelante a cuenta de la crisis. Que debían ser más solidarios y no todo lo contrario. Que estoy deseando que lleguen las elecciones para intentar que cambie algo en el ayuntamiento. Que usted vino con un aura de entendimiento que facilitara las cosas y está claro que no ha cambiado nada, si no todo lo contrario. Que voy a cerrar a cuenta de ese estupendo departamento jurídico de Ciudad Lineal que me prohibe trabajar y salir adelante porque parece que solo piensa en recaudar. Por cierto las tasas de casi 500 euros ya han sido abonadas hace tiempo y a ese respecto no han puesto pegas de ningún tipo. ¡Fantástica gestión alcaldesa!</p>

<p>Qué pasa señora Carmena? Piensa hacer algo al respecto o sólo se trata de quedar bien con los ciudadnos proporcionándonos un portal de internet colorido y que pretende ayudar al ciudadano o quizás todo lo contrario. Lo siento alcaldesa pero con el cierre de mi actividad mis ilusiones se han ido por la alcantarilla a cuenta de un departamentyo jurídico que deja bastante que desear.</p>

<p>Me voy al paro que parece que es ahí donde quieren que esté. Penoso.</p>
";"03/11/2015 12";"30";"26";"4";"3";"1427532568";"1906"
"4243";"las multas de tráfico en la Comunidad de Madrid";"<p>Hace 40 años que conduzco y tengo en mi haber muy pocas multas pero durante estos últimos años del PP</p>

<p>en el Ayuntamiento me he sentido perseguida. El afán recaudatorio no ha tenido limites y he sentido que les</p>

<p>importaba un bledo regular o mejorar el tráfico. El único interés son las multas y cobrarlas caiga quien caiga.</p>

<p>Se debe perseguir a los inflactores y bestias al volante de todo tipo pero, por favor, no hagan que la ciudadania</p>

<p>se sienta perseguida por qué ahora mismo así nos sentimos un sector importante de los conductores.</p>
";"03/11/2015 16";"33";"31";"2";"5";"1430991216";"2724"
"4244";"Esterilización. Gatitos callejeros ";"<p>Campañas de esterilización por barrios de las colonias de gatitos.</p>
";"03/11/2015 16";"115";"106";"9";"6";"1435787630";"8940"
"4245";"Gobierno Abierto - Participacion ciudadana vs Programa de Gobierno";"<p> Programa de Gobierno o Solicitud de Ocurrencias.</p>

<p>He ahí el dilema.</p>

<p>Programamos para gobernar o como no hay programa, que ¨gobierne el ciudadano.</p>

<p>La participación es buena, si aporta valor añadido, el Programa es bueno, si no queda en agua de borrajas o es inconcreto o inexistente.</p>

<p>Si no hay cimientos nada se puede edificar, y mucho menos si esos ¨cimientos son aguas ¨movedizas.</p>

<p>Encantado de participar en este foro que creo positivo, aunque vea las agujas y no las vigas.</p>

<p> </p>
";"03/11/2015 18";"28";"13";"15";"2";"1417612805";"-92"
"4246";"Reparto de inversiones por distritos 2016";"<p>El otro día recibí por Facebook información  sobre las inversiones a realizar en los distintos distritos de Madrid durante 2016 y comparativa con 2015. Para mi sorpresa la inversión en mi distrito, Vicalvaro, uno de los más pobres y menos dotados de todo el municipio, era de un -44% respecto a 2015. La verdad es que no entiendo nada.</p>
";"03/11/2015 18";"19";"17";"2";"4";"1429095045";"1342"
"4247";"Privilegiar el uso de la vía pública para aparcar a los vecinos ";"<p>Vivo en la zona de ""El Carmen"", y en la vía pública está llena de automóviles que no son de los vecinos: pertenecen a gente que los deja aparcado para su venta; aparcan camiones y otro vehículos que se usan para el transporte de mercancías; aparcan coches que  pertenecen a talleres que  los están reparando en la calle; o son automóviles abandonados.</p>

<p>Por lo tanto:</p>

<p>1)  solicito privilegiar el uso de la vía pública para aparcar los automóviles de los vecinos</p>

<p>2) establecer una zona de Madrid para aparcar los automóviles que están en venta y los camiones para transporte de mercancías</p>

<p>3) hacer una limpia de coches abandonados</p>

<p>Agradezco a la Gente del Ayuntamiento esta canal abieto para que podamos hacer nuestras propuestas</p>

<p> </p>
";"03/11/2015 19";"27";"20";"7";"1";"1427024354";"962"
"4248";"pension de viudedad";"<p>que den la pension de viudedad a divorciadas que cumpliendo todos los requisitos, por unos dias de fecha se la han quitado, estando en el paro y sin ninguna prestacion</p>
";"03/11/2015 21";"29";"11";"18";"2";"1416132162";"-265"
"4249";"Afán recaudatorio de las multas";"<p>El PP lo inauguró y ustedes se lucran con ello. Es muy dificil renunciar a tanto dinero por principios ¿Verdad? Porque el sablazo de los parquímetros a los madrileños es de muerte. La calle es de todos y tenemos derecho a aparcar. Se montaron un negocio de escándalo y aquí todos callados. Han convertido a Madrid en una ciudad solo para ricos. </p>

<p>Uso el coche porque trabajo en tres sitios diferentes y tengo que usarlo. No me queda más remedio, y a pesar de que pago todos los impuestos por circular, por la gasolina, por el cobche, por el seguro, tengo que pagar por aparcar más de 5 euros diarios, y si se me pasa un poco multa de 90 y si no puedo pagar, recargo y recargo.</p>

<p>Las multas se inventaron para CORREGIR conductas, NO para recaudar, miles de multas diarias es un sablazo y nada más. Es abusivo y es discriminatorio, porque pago lo mismo yo que un millonario y paga lo mismo el que tiene que usar el coche (autónomos, familias numerosas) que el que lo usa por capricho.</p>

<p>Los mismos vicios del PP. Solo ha cambiado quién se mete el dinero en el bolsillo. Que lo disfruten.</p>
";"03/11/2015 22";"80";"66";"14";"9";"1434235595";"4290"
"4250";"¿A quién votar?";"<p>Hola. Mi nombre es Esteban Ullate, mi formación ingeniero técnico en mecánica y mi especialidad la gestión y organización de empresas. Aunque nunca pensé que me faltaría el trabajo, la realidad es que de los siete años que llevo viviendo en Madrid, solo he trabajado seis meses. El motivo de este debate es que me gutaría conocer opiniones en la medida de lo posible argumentadas, acerca de a quién votar. Gracias.</p>
";"03/11/2015 23";"15";"8";"7";"22";"1424746278";"53"
"4251";"Regulación de tráfico en la carretera de extremadura";"<p>Entre Cuatro Vientos y hasta llegar a la M-30, el ruido provocado por el tráfico de los vehículos que circulan por esta carretera se hace insoportable. Nuestros niños duermen acostumbrados al ruido. Entiendo que Madrid es una ciudad grande y por tanto, ruidosa, pero además de limitar la velocidad (algo que no se respeta) sería bueno que existieran semáforos u otro tipo de elementos que posibilitaran la reducción del ruido. Lo ideal sería poder soterrarla durante todo el tramo que hay viviendas.</p>
";"04/11/2015 09";"40";"28";"12";"5";"1432915073";"1120"
"4252";"Propuesta de campaña sobre cómo ayudar a los refugiados ";"<p>Muchos ciudadanos solidarios de madrid quisiéramos saber cómo ayudar a los refugiados y cuantas maneras hay de hacerlo. Creo que sería necesario plantear una campaña exclusiva en la que se facilite una metodología al ciudadano que quiera ofrecer ayuda. Si ya hay ONG's que tienen la infraestructura necesaria para llevar a cabo las misiones solidarias, trabajar conjuntamente con ellos, pero enfocándose y concretando acciones, no dispersándolas. Sería deseable pues que el propio ayuntamiento llevase a cabo una sola campaña de acción de ayuda a los refugiados efectiva y eficiente que constase de anuncios en televisión y radio, uso de marquesinas , etc... que expliquen claramente qué podemos hacer y cómo. </p>

<p>Gracias!!</p>

<p>mf</p>
";"04/11/2015 09";"51";"30";"21";"3";"1430304718";"529"
"4253";"¿La ley que regula el programa de colaboración social debe ser modificada?";"COLABORACIÓN SOCIAL Valorar si realmente las características del programa favorece a una persona en la reinserción laboral.

<p>""COLABORACIÓN SOCIAL"" Este programa del Real Decreto Legislativo 1/1994, de 20 de junio, dirigido a desempleados.</p>

<p>El programa de Colaboración Social se configura como una medida de empleo y formación, de carácter temporal, dirigida a la mejora de la empleabilidad de los desempleados perceptores de prestaciones y subsidios de desempleo, mediante la adquisición de nuevas competencias y su activación en la búsqueda de empleo.</p>

<ul>
	<li><u><strong>Ventajas del Programa:</strong></u></li>
</ul>

<p>- El programa se configura como una medida de empleo.</p>

<p>- Se adquiere experiencia en las funciónes y competencias a desarrollar <strong>en el ámbito público.</strong></p>

<p>- El programa incluye un periodo de<strong> orientación profesional</strong> que favorece la búsqueda de empleo.</p>

<ul>
	<li><u><strong>Desventajas del Programa:</strong></u></li>
</ul>

<p>- Es una ley con una condiciones <strong>del año 1994 que no se han modificado</strong>.</p>

<p>-<u><strong> La situación laboral actual no favorece la reinserción laboral</strong></u>.</p>

<p>-<u><strong> Al finalizar el programa</strong></u>, como carácteristica de la misma,<u><strong> tambien se termina de percibir la prestación por desempleo</strong></u> depende su duración.</p>

<p>- El estar en un organismo público ejerciendo el programa, <u><strong>no puntua para entrar en una bolsa de empleo</strong></u>.</p>

<p>- Según las condiciones del programa no permite la renovación del mismo sin tener en cuenta que el centro de trabajo<u><strong> hay gran volumen de trabajo.</strong></u></p>

<p>-<u><strong> La Colaboración tiene una duración determinada sin posibilidad de prórroga o prolongación.</strong></u></p>

<p>- La situación personal de cada colaborador  puede ser afectada:<u><strong> por la edad, las cargas familiares, etc</strong></u>.</p>

<p> </p>

<p><u><strong>SE PROPONE MODIFICAR LA LEY QUE REGULA LA COLABORACIÓN SOCIAL EN:</strong></u></p>

<ul>
	<li><strong>PRÓRROGA DEL MISMO SI LO REQUIERE EL CENTRO DE TRABAJO</strong></li>
	<li><strong>ENTRAR EN UNA BOLSA DE EMPLEO PARA OPTAR A UN PUESTO DE TRABAJO</strong></li>
	<li><strong>REALIZAR UN EXAMEN ELIMINATORIO DIRIGIDO A LOS COLABORADORES PARA OPTAR A  POSIBLES PLAZAS FIJAS</strong></li>
	<li><strong>VALORAR LOS MÉRITOS PROPIOS CONSEGUIDOS POR CADA COLABORADOR EN SU CENTRO DE TRABAJO.</strong></li>
</ul>
";"04/11/2015 10";"13";"13";"0";"0";"1435834307";"1300"
"4254";"Limpieza en la colonia Marconi.";"<p>Muy poca gente en Madrid  conoce que en el famoso polígono de Marconi, hay viviendas en las que más de 600 familias,  les toca convivir con la prostitución y todo lo que genera.</p>

<p>en los últimos meses lo más preocupante es la falta de limpieza en la zona ( es una emergencia sanitaria) dado a que los residuos que se generan no son simple basura que un momento dado puede oler mal y general su impacto ambiental, se amontonan miles de preservativos y servilletas higiénicas sin recoger y escombros que la gente va abandonando.</p>

<p>De momento el Sr Concejal Guillermo Zapata, todo muy buenas palabras pero todo se queda ahí....</p>

<p> </p>

<p>SOS_Marconi</p>
";"04/11/2015 11";"29";"28";"1";"1";"1438905453";"2606"
"4255";"Permisos a minusválidos";"<p>Porque cada vez tenemos más coches autorizados para minusválidos, y revisar las placas de aparcamiento de minusválidos, algunos ya han fallecido y todavía se mantiene las placas y los familiares hacen uso de la tarjeta.</p>
";"04/11/2015 12";"55";"52";"3";"9";"1441908632";"4632"
"4256";"MULTAS DE APARCAMIENTO EN EL HOSPITAL CLÍNICO";"<p>Me parece vergonzoso que la Policía Local entre en la manzana del Hospital Clínico a multar a quienes están estacionados como pueden, dado que no hay espacio suficiente para los pacientes y/o familiares.</p>

<p>¿Pretenden decirme que no hay otras prioridades?</p>

<p>Y encima, lo que ya es el colmo es que ven a los gorrillas Y NO HACEN NADA CON ELLOS.</p>

<p>Se ve que es prioritario multar a quienes han ido al hospital... no sé a qué, pero a cobrar por ""ayudar a aparcar"" seguro que no. Ni a tomarnos una copa.</p>

<p>De verdad, es que no entiendo las prioridades de SERVICIO AL CIUDADANO que establecen; pero multando en el Clínico no realizan ningún servicio de utilidad a la sociedad.</p>
";"04/11/2015 14";"70";"65";"5";"6";"1443121442";"5571"
"4257";"Subir el impuesto de Limpieza Municipal y exigir la calidad del mismo";"<p>No sé si a vosotros os pasa, pero cada día mi barrio está más sucio, los árboles más descuidados y la infraestructura peor mantenida, hace unos días pasé por la Moraleja y que envidia me dió el constatar lo bién que funcionan los servicios de mantenimiento de la gente que lo gestiona privadamente..</p>

<p>Señores del ayuntamiento por favor  subir los impuestos municipales lo que haga falta, pero nosotros como ciudadanos deberíamos tener también derecho a exigir la contraprestación  correspondiente ó en su defecto organizarnos para gestionar el mantenimiento y limpieza de nuestros barrios.</p>
";"04/11/2015 15";"50";"18";"32";"3";"1422783490";"-504"
"4258";"Menos funcionarios alquiler de viviendas";"<p>Hay servicios solapados de ""ayuda al aquiler de viviendas"", el de la comunidad, el del ayuntamiento y el de las juntas municipales grandes.</p>

<p>Que cierren dos de ellos y nos disminuyan los impuestos.</p>
";"04/11/2015 15";"28";"22";"6";"2";"1436526029";"1257"
"4259";"Cariil bici please";"<p>Hola, solicito un plan para que Madrid pueda ser una ciudad moderna con carriles bicis como en otras capitales en todas aquellas calles en los cuales sea viable (por ejemplo Castellana) y en las aceras anchas de más de 3 metros. Es un siuicidio usar bicis en esos carriles para coches donde alguien dibujó una bicicleta!!!</p>

<p> </p>

<p>Gracias</p>
";"04/11/2015 16";"113";"92";"21";"1";"1442232902";"5780"
"4260";"Dimisión de Carmena y convocatoria de nuevas elecciones";"<p>Porque necesitamos un gobierno serio que se centre en los problemas reales de los ciudadanos y no en gilipolleces, que gobierne para todos los ciudadanos y no sólo para aquellos que le rien las gracias, que genere confianza y no desconfianza o pavor en pensar cual será la proxima ocurrencia...</p>
";"04/11/2015 16";"205";"72";"133";"22";"1420971260";"-2142"
"4261";" Arreglar las calles";"<p>Estoy ya cansada de encontrarme agujeros por las calles de Madrid, por culpa de esos agujeros y los badenes se revienta las ruedas y los amortiguadores.</p>

<p>he tenido que cambiar las ruedas dos veces por agujeros enormes que no te queda otra que pasar por ahi, y tanto baden que se rompe los amortiguadores, ya he tenido que cambiar las bieletas por tanto bache y baden. yo no cobro un sueldo alto como para permitirme llevar el coche al taller cada dos por tres.  
Es indignante que tanto dinero se lleva la comunidad de tanto impuesto y esten las calles tan mal. </p>
";"04/11/2015 17";"125";"121";"4";"7";"1447625126";"11325"
"4262";"Edificio España";"<p> </p>

<p>Estudio arquitectura superior porque siempre me encantaron los edificios y las ciudades, especialmente los rascacielos puesto que pienso dedicarme a ello. Sin embargo gran parte de los arquitectos del mundo puesto que esto no es un problema exclusivo de Madrid o de España, tan solo les importa el dinero. Y los políticos no tienen ni idea de arquitectura. Y los chinos no tienen ni idea del sentimiento que sentimos muchos españoles a cerca de ese edificio ya que lo vemos como algo propio nuestro o por lo menos yo que ni tan siquiera soy de Madrid, soy gallega. Para mi gusto Madrid es la ciudad más bonita de España y lo es por sus edificios, y el edificio España o la Casa del Coño es uno de mis favoritos, puesto que es el edificio de arquitectura neobarroca más alto de Europa y muy pocos edifios neobarrocos hay en nuestro pais y aun menos de esas dimensiones. Pero lo que realmente hace importante a este es que es claramente de la escuela de chicago por lo tanto lo que tiene de especial es precisamente su estructura y las innovaciones tecnicas que supuso esta escuela, a si que las fachadas no son precisamente lo más importante. Y esque ademas no hay ningun otro o casi ningun otro edificio perteneciente a esta corriente arquitectonica en nuestro pais, y esque además la fachada trasera es de estilo neoyorquino un estilo muy extraño en nuestro pais.Estas tres cosas lo hacen único </p>

<p>Me parece vergonzosa la actuación de la empresa Wanda cuando presentaron las fotos del supuesto deterioro del edificio. Yo he visto esas fotos y en la mayoría es imposible averiguar de que edificio son, otras puede parecer que esta deteriorado por el estado de abandono y porque cuando se abandonó estaba siendo reformado y claro si sacas fotos en una obra abandonada con todo tirado sucio ect da una imagen un tanto deprimente. Todo se trata de una clara manipulación de la empresa para salirse con la suya y a una persona normal le puede colar pero a mi  no me la cuelan. Y aun tienen la cara de no presentar el proyecto porque nadie sabe que aspecto va a tener el nuevo edificio porque entre en la página oficial de Wanda y de  Norman Foster and Partners (que es la empresa que lleva el proyecto) y me sorprende porque de otros proyectos pone información e imágenes pero del de el Edificio España no hay nada. Puede ser que aun no tengan pesado el proyecto sin embargo ya lo quieren derribar a toda costa. </p>

<p>Además hace unos años este edificio estaba más protegido puesto que no se podía demoler ninguna parte pero lo cambio el gobierno del pp al ver que esta empresa lo compro  y estaba interesada en demolerlo y permitió que se demoliera por completo. Las leyes están para cumplirlas no para cambiarlas según los intereses de algunos, que yo apostaría a lo que fuese que esta empresa traería beneficios al gobierno.  Lo más injusto de todo esto es que como dije los políticos no tiene  ni idea de arquitectura y la inmensa mayoría tampoco tiene sensibilidad hacia ella ,pero la decisión del cambio de reconocimiento histórico no esta en manos de los arquitectos si no en la de los políticos cuando debería de ser al revés o mejor que estuviese la decisión en manos por una parte de los arquitectos y por otras de los ciudadanos. Puesto que un edificio puede ser privado pero su imagen no, puesto que los madrileños lo disfrutaran y por supuesto los turistas, los edificios nunca son 100% privados ya que forman parte de la vía pública y en este caso del interés cultural e histórico  y no creo que ninguna empresa del mundo por importante que sea se pueda adueñar de ello y ni tampoco del sentimiento que cada persona tiene acerca de ese edificio por eso veo fenomenal una consulta ciudadana y por supuesto tampoco puede faltar un arquitecto que evalué la conservación del edificio y obviamente ese arquitecto tendra que ser una persona seria que no actue en favor de nadie.</p>

<p>Por otra parte por tratarse de un símbolo de una ciudad debería de estar prohibido demoler y si no lo consideran un símbolo que lo declaren ya. Las ciudades son lo que son por sus símbolos  entendidos los símbolos como elementos muy característicos que las distinguen de cualquier otras, si los eliminamos nos quedaremos con una ciudad corriente como otra cualquiera, puede que si solo eliminamos uno, no o si, depende pero esto es efecto dominó el Edificio España no es el único edificio histórico que no está protegido en Madrid a si que hoy es el Edificio España otro día a saber cual querrán demoler. No tiene sentido demolerlo y volverlo a construir aunque pongan la escusa del material que pasaría si ahora se le diese por demoler la catedral de Santiago o la de Burgos por poner un ejemplo, y hacerla igual al milímetro con la escusa de que las piedras estén deterioradas ya no sería lo mismo.</p>

<p>Cuando escucho este tipo de noticias me entristezco muchísimo hasta el punto que llego  a llorar, me amargo, y me lo paso muy mal como veis me lo tomo de una manera muy personal pero yo soy así y nadie me cambiaran porque mi pasión es la arquitectura. Esto ES UNA BARBARIDAD QUE ME PRODUCE ESCALOFRIOS! POR  FAVOR MANUELA CARMENA NO PERMITA LA DEMOLICIÓN DE NINGUNA PARTE DE ESTE EDIFICIO NO LE PIDO QUE ENTIENDA LA ARQUITECTURA PERO SI QUE LA RESPETE. Le pido a Manuela que haga cumplir las leyes y que lo vuelva a subir a nivel 3 y que amenaze con expropiar el edificio y si aun asi sigue insistiendo en demolerlo pues que lo expropie antes de que sea demasiado tarde.Y mira tu por donde el ayuntamiento podria reavilitarlo para personas sin hogar y permitir la visistas de turistas a una parte del edificio como por ejemplo instalar un mirador publico para recaudar para poder recuperar la inversión que se hizo al expropiarlo y a reformarlo.</p>

<p>¿Y VOSOTROS QUE OPINAIS ? ¿SE DEBE O NO DEMOLER EL EDIFICIO ESPAÑA?</p>

<p> </p>
";"04/11/2015 18";"49";"36";"13";"10";"1438499113";"1689"
"4263";"PROSTITUCIÓN COLONIA MARCONI";"<p>buenas tardes a todos.</p>

<p>Vivo en la zona residencial de Marconi</p>

<p>Para nosotros una muy buena zona con el coegio de nuestros hijos en la puerta de casa.</p>

<p>Lo que puedo criticar al Ayuntamiento de Madrid y a su Alcadesa, es la dejadez en la que esta mi barrio.</p>

<p>las calles sucias, las papeleras sin vaciar.</p>

<p>La semana pasada han podado una ramas y éstas han permanecido mas de 10 dias tiradas en el suelo. Eso no pasa en el barrio de Salamanca</p>

<p> </p>

<p><strong>PERO EL PRICIPAL PROBLEMA:</strong></p>

<p>LA PROSTITUCIÓN</p>

<p><strong>No entiendo el motivo por el que se sigue permitiendo.</strong></p>

<p><strong>La policia no hace absolutamente nada, y las prostitutas han tomado el barrio.</strong></p>

<p><strong>ImagÍnense la situacion de pasar con los niños y que vean a estas mujeres semi desnudas.</strong></p>

<p><strong>A parte de esto, la inseguridad que sufrimos, ya que por las ncohes hacen hogueras por todo el polígono y es consentido por la Policia con el gran riesgo que conlleva.</strong></p>

<p><strong>HAGAN ALGO !!!</strong></p>

<p>DEJENSE DE PONER MULTAS DE RADARES ESCONDIOS Y DEMAS Y DEDIQUENSE A MULTAR A LOS CLINETES  DE LAS PROSTITUTAS. RECAUDEN CON LAS MULTAS DE LOS CLIENTES</p>

<p>ES BIEN FACIL, DOBLEN TURNOS DE LA POLICIA Y VERAN COMO EN UNA SEMANA TERMINAN CON ESTA LACRA PARA NUESTRO BARRIO Y LAS ARCAS DEL AYUNTAMEINTO SE VERÁN INCREMENTADAS POR LAS DENUNCIAS GENERADAS.</p>

<p>LES INTERESA????  YO CREO QUE NO...</p>

<p> </p>

<p>SRA. ALCADESA, DEMUESTREME QUE NO ES UNA MÁS... LE HE DADO MI VOTO, Y POR AHORA LO CONSIDERO UN ERROR.</p>

<p>HAGA ALGO, PREOCÚPESE POR NUESTRO BARRIO</p>

<p>UN SALUDO A TODOS Y GRACIAS</p>

<p> </p>

<p> </p>

<p> </p>
";"04/11/2015 19";"36";"31";"5";"0";"1440632396";"2238"
"4264";"SI, al arte urbano";"<p>El arte debe ser una parte importante de la expresión, en otros paises, en vez de haber tantas vayas publicitarias hay frases motivadoras y de educación constructivsta para la sociedad.</p>

<p>Mi nombre es Santiago García -Cazorla y me desperataron la creatividad hace dos años.</p>

<p>El arte debe ser una parte importante de la expresión, en otros paises, en vez de haber tantas vayas publicitarias hay frases motivadoras y de educación constructivsta para la sociedad, para que esta pueda superar sus etapas más duras.</p>

<p> </p>

<p>Yo estoy a favor del arte urbano y grafitero con beneficio de interes comun, no los tipicos malos, el pintar un paisaje o un poema, debe potenciarse ya que da motivación a los sociedad y esta debe ser artistica y creadora. </p>

<p> </p>

<p>Por ejemplo en Gracia los metros estan grafiteados.</p>

<p> </p>

<p>O por lo menos establecer un sitio donde se pueda desarrollar el arte libremente.</p>

<p> </p>

<p>Por ejemplo, si hay un poema que puede potenciar el que la gente no se rinda y que siga luchando por sus esfuerzos como por ejemplo: </p>

<p><strong>Oda a la no rendición</strong></p>

<p>Rendido,</p>

<p>Sin fuerza</p>

<p>Y sin energía</p>

<p>Todos caen en la compasión,</p>

<p>Yo caigo en la sin razón de la rendición</p>

<p>Solo ando con mis pensamientos envueltos en una nube que no me deja ver una claridad,</p>

<p>solo pienso en mi soledad</p>

<p>es cierto que poseo mi libertad, pero no se usarla,</p>

<p>por eso aunque no me siento agusto en mi nebulosa,</p>

<p>me siento atormentado y caído,</p>

<p>prefiero rendirme al no ver la luz ni la claridad de la libertad</p>

<p>no encuentro ninguna salida,</p>

<p>si la gente te guía y te equivcas, le echas la culpa a ellos,</p>

<p>es hora de tu soledad</p>

<p>es hora de tu rendición,</p>

<p>si te rindes que sea porque tu lo has decidió</p>

<p>puedes adquirir la fuerza para cambiar tu estado</p>

<p>si no te rindes</p>

<p>te daré una oportunidad más</p>

<p>si no te rindes</p>

<p>veras una vez más las estrellas y la luna relucir sobre el agua clara y cristalina de tu ser</p>

<p>si no te rindes te daré una mano para que la cojas</p>

<p>si no te rindes te acompañaré en tu camino</p>

<p>si no te rindes</p>

<p>todo esto lo tendrás si luchas y sacas tu fuerza</p>

<p>todo esto será tuyo si no haces caso a la rendición.</p>

<p>Rendición que dura palabra eres, rendición, yo soy mas duro</p>

<p>Valor, valor, energía, y coraje, para poder a la rendición.</p>

<p>Rendirme, no me hagas reir.</p>

<p>Al no rendirme sanaré,</p>

<p>Al no rendirme me salvaré,</p>

<p>Al no rendirme amaré</p>

<p>Al no rendirme cataré.</p>
";"04/11/2015 19";"58";"24";"34";"3";"1424405543";"-413"
"4265";"Crear meaderos publicos";"<p>Ya que queremos una ciudad de madrid, limpia y con buen olor, veo primordial, crear meaderos publicos, ya que los bares muchas veces no te dejan entrar a mear, si no eres cliente o no estás consumiendo, y hay veces que no te puedes aguantar a llegar a tu casa.</p>

<p>LA propuesta es para hombres y mujeres.</p>
";"04/11/2015 19";"118";"101";"17";"4";"1445043691";"7189"
"4266";"Plazas de minusválidos ocupadas por familiares o de almacen";"<p>Me paso el día viendo como en mi barrio (Carabanchel), las plazas de minusválidos las utilizan los familiares de los mismos, utilizan en muchos casos la tarjeta del padre, del hermano etc. Incluso fallecidos y me parece vergonzoso y no hay ningún control sobre ello.</p>

<p>Además hay casos como en la C/ Humanitarias  N1 hay una furgoneta aparcada que lleva meses sin moverse y la utilizan de almacén, lleva 5 meses en el mismo sitio, eso sí con la tarjeta duplicada y en teoría legal, lo he denunciado a movilidad y dicen que es mentira que la plaza está vacía, he tenido que volver ha hacer otro escrito con una foto de la misma, haber si me hacen caso, invitó a cualquier persona a que lo vea, que favor haga un escrito a movilidad, haber si así se lo creen.
Yo tengo movilidad reducida, y tanto un caso como el otro me chirría, la plaza la pedí yo y soy consciente que cualquiera puede aparcar, pero cinco meses.</p>
";"04/11/2015 20";"68";"65";"3";"6";"1446386840";"5926"
"4267";"S.E.R movilidad";"<ul>
	<li>hola! quiero comunicarles como trabajador de oficio obras, instalaciones..mi deseo y el de todos mis compañeros y conocidos autónomos y pymes, de la desaparición o extinción del sistema de limite de estacionamiento en zona azul o verde, por no poder realizar bien y a tiempo estimado con lo clientes nuestro trabajo, ya que nos Obligan a dejarlo a medias, teniendo que desplazar el vehículo a otro barrio durante otro breve periodo de tiempo, (no siempre hay parking privado y esto resulta una pérdida grande de tiempo y dinero, por no hablar de la contaminación que emite el vehículo en este trayecto obligado) PORFAVOR! ténganlo en cuenta. Nadie se niega a pagar, pero tenemos que hacer fácil nuestras labores. Estaríamos enormemente agradecidos si fuera posible eliminar este limite de tiempo.) además, cada vez somos más los que pagamos con tarjeta bancaria y no en todos funciona correctamente el sistema contactles.) MUCHAS GRACIAS por la atención. Un saludo a nuestro cordial excelentísimo ayuntamiento de Madrid.</li>
</ul>
";"05/11/2015 14";"53";"36";"17";"2";"1445403771";"1290"
"4268";"BARRIO DE LAS TABLAS ABANDONADO";"<p>Por favor, hago un llamamiento al Ayuntamiento de Madrid para que se ocupen del Barrio de Las Tablas en lo que se refiere a Servicios Públicos, ya que para muchas necesidades básicas y diarias tenemos que trasladarnos a otros barrios vecinos.</p>

<p>No entiendo que con la densidad de población especialmente infantil que hay aquí, no exista un Centro de Salud propio, ni una Biblioteca Pública, ni una Oficina de Atención al Cliente, ni una Comisaría de Policía, ni un Instituto de Educación Secundaria... Respecto a plazas en Colegios Públicos, me asombra que cada año se queden bastantes niños sin plaza y sea una odisea escolarizar a tu hijo/a. </p>

<p>¿Qué tipo de estudios hace el Ayuntamiento y en qué invierten su dinero? Estos problemas los tenemos desde hace unos cuantos años y absolutamente nada ha cambiado, y más que va a aumentar con el incremento de ciudadanos que se preveen cuando empiece a funcionar la central del BBVA con el 100% de sus empleados.</p>

<p>Otro tema que quería mencionar es la deficiencia de limpieza y la falta de árboles que den sombra y de zonas verdes. se echan en falta.  </p>

<p>Un saludo. Espero que con la presión de todos haya algún día algún cambio a mejor.</p>

<p> </p>
";"05/11/2015 15";"48";"46";"2";"2";"1452787755";"4216"
"4269";"Control Velocidad vehiculos a motor Sta María Cabeza ";"<p>Queremos proponer instalación de controles de velocidad de vehiculos a motor en el paseo Santa María De la Cabeza a la altura de los números 101/103 por la falta de ellos en esta zona con poca visibilidad y peligrosidad ya que hay en pocos metros un Colegio , un cruce  con poca visibilidad, una curva pronunciada y una salida de Bomberos. Los vehiculos a motor no minoran su velocidad provocando situaciones de peligro, entran desde la A42 direcciòn Madrid no respetan la velocidad a la que deberían de ir en una vía urbana con especial peligrosidad. </p>
";"05/11/2015 17";"26";"15";"11";"1";"1441130138";"230"
"4270";"Motos no,coches restringidos y falta de buses";"<p>Últimamente se habla de la restricción,en días de alta contaminación,de vehículos según la matrícula y las motos.ahora se habla de la supresión de líneas de buses o menos frecuencia de algunos de ellos.como pretende el ayuntamiento que nos movamos si todo eso se lleva a cabo?aunque,a las pruebas me remito,hoy se dice una cosa y al día siguiente se vuelve a lo anterior ya que los proyectos no son viables</p>

<p>se aceptan sugestiones....</p>

<p>p.d..contar con las zonas de acceso restringido vigentes y las proyectadas para 2016 y la quiebra de la empresa propietaria de las bicicletas </p>
";"05/11/2015 18";"22";"7";"15";"0";"1435237023";"-254"
"4271";"Quieres bicicletas ?";"<p>A mi nadie me preguntó si yo quería bicicletas en Madrid. Hay muchas protestas entorno a este tema y nadie se atreve a decir """" No bicicletas"""". Es políticamente incorrecto. No queda bien. Lo cierto es que nuestra ciudad no es adecuada para ellas, no es plana, no hay aceras amplias para hacer carril bici, compiten con los coches y los peatones. Yo soy peatón y uso transporte público, no tengo coche. Los ciclistas, con enorme esfuerzo pedalean, a punto del agotamiento, llevando una fila de taxis, autobuses detrás, retrasando el tráfico o metiéndose entre los coches, saltándose los semáforos o  bien van por la acera y te pasan a gran velocidad , tirándote al suelo, me voy a comprar un retrovisor. No llevan casco, ni luces,ni matricula , no son visibles , no siguen el código de circulación. Y si hay carril bici,tenemos la obligación de estar pendientes de ellos, de los coches, de las normas. No quiero bicicletas y si las hay que paguen impuestos y se regule su uso. Ya se que no me van a votar, no es ecológico, pero no quiero ciclistas atropellados, ni que me atropelle un ciclista. Lo mismo para patinadores, patinetes, corredores..., y toda persona que se pase por el forro las normas de circulación y el derecho del peatón. </p>
";"05/11/2015 21";"112";"43";"69";"35";"1434059485";"-998"
"4272";"Quiero ceniceros";"<p>Fumo, en la calle, no nos permiten otro sitio. Dónde tiro el pitillo?. Las papeleras, si las hay y no están rotas, tienen un cenicerito que suele estar sin la base, por lo que al apagarlo se cae la brasa, prende fuego al papel, lo he visto y han tenido que pedir agua en un bar para apagarlo. Llevo el filtro en la mano hasta que encuentro una papelera pero hay veces que no me queda otra que tirarlo al suelo, sobre todo esperando al autobús. Quiero ceniceros en condiciones, no tirar al suelo los cigarros. Gracias.</p>
";"05/11/2015 22";"61";"46";"15";"6";"1451081983";"2337"
"4273";"Tala de árboles";"<p>En la calle Ponzano han talado un árbol de una altura de más de 10 metros.No me han dado explicación.Aparentemente estaba sano.¿Porqué lo han talado sin darexplicación?Deberiamos de conocer los vecinos de la zona las razones.Tampoco me han sabido decir si van a plantar otro en su lugar.</p>
";"06/11/2015 00";"47";"39";"8";"1";"1453101462";"2572"
"4274";"Cero aforados";"<p><strong>Cero aforados,cero impunidad,cero sin vergüenzas,cero chorizos protegidos,</strong></p>

<p><strong>Todo aquel que la haga.. que la pague</strong></p>

<p> </p>
";"06/11/2015 08";"146";"138";"8";"2";"1464022340";"12287"
"4275";"Tren de Cercanias desde Chamarin hasta el Corredor del Henares";"<p>PARA LLEGAR HASTA LA ZONA DEL CORREDOR DEL HENARES DESDE CHAMARTIN HAY QUE DAR UNA VUELTA ENTERA A MADRID PASANDO POR ATOCHA . EXISTE VÍA PARA IR DESDE CHAMARTIN HASTA TORREJON PUES HAY TRENES CON PASAJEROS QUE SALEN HACIA BARCELONA POR ESA VÍA . ¿POR QUÉ NO SE HABILITA PARA CERCANIAS ? SE AHORRARÍA  HORAS DE VIAJE A MUCHÍSIMOS USUARIOS. </p>
";"06/11/2015 09";"43";"39";"4";"3";"1458668397";"3174"
"4276";"Por favor, que sólo guías profesionales y titulados puedan enseñar Madrid";"¿Merece la pena gastar dinero en campañas millonarias de marketing si la imagen última de la ciudad, la del guía turístico, no está regulada?

<p>Todos sabemos de la importancia del turismo en nuestro país. Y todos sabemos de la importancia del turismo en Madrid. Desde el Ayuntamiento no han parado hasta hace poco de gastarse el dinero en campañas millonarias par albergar juegos olímpicos, crear diferentes empresas que en teoría van a promocionar nuestra región y nuestra ciudad para atraer visitantes, hacer obras de remodelación de las oficinas de información turística...Y hay que reconocer que todo se podría dar por bueno si se cuidaran tantos y tantos otros detalles que, una vez aquí los posibles visitantes habría que cuidar: la seguridad de los turistas, las calles mejor asfaltadas, la limpieza de las calles, los edificios emblemáticos respetados...y también GUIAS de verdad PROFESIONALES  que enseñaran nuestra preciosa ciudad.   Y es que, gracias a una ley de hace ya demasiado, para GUIAR EN LA CIUDAD DE MADRID no es necesario NADA. Cualquiera puede ser guía turístico de esta ciudad. Usted mismo, puede leerse 4 cosas sobre la Cibeles, Carlos III y el Retiro, y ponerse a guiar un grupo de turistas en la ciudad. Y yo me pregunto: ¿merece la pena gastar dinero en promociones en el extranjero, en campañas de publicidad, si al llegar a  la ciudad no se está enseñando la ciudad como Dios manda sólo por no tener una regulación oficial lógica para los guías de la ciudad como tienen en otras comunidades autónomas?   Por experiencia le digo que Madrid es una ciudad que necesita ser enseñada. No es París con su Torre Eiffel y su Sena y su catedral tan aparentes; no es el Londres cosmolopita donde uno quiere perderse ; no es la obvia grandeza de la Roma imperial...Madrid ha perdido tanto patrimonio a lo largo de su historia, que hay que enseñarla con cariño para mostrar su grandeza arquitectónica y su importancia histórica (esa que la falsa modestia de la ciudad se empeña en ocultar)...Hay que saber preparar al visitante de Madrid para que, tras una visita a la ciudad, pueda captar por sí sólo la verdadera esencia de la Villa: su entrega al visitante y la vibrante vida que se respira en sus calles.   Los guías turísticos somos el eslabón último y la cara más evidente y cercana que experimenta el visitante de una ciudad. Si los guías y su cuidado y formación fallan, falla la política completa de promoción turística de esa ciudad.   Por favor, háganle este gran favor a Madrid: quiéranla un poquito y regulen la profesionalización de los guías turísticos de la ciudad para que Madrid tenga el lugar que le corresponde en el mundo.   </p>
";"07/11/2015 19";"60";"49";"11";"5";"1471773386";"3103"
"4277";"No retiren los belenes de la Plaza Mayor y el Ayuntamiento.";"<p>Buenos días a todos/as:</p>

<p>Yo no soy precisamente simpatizante del Partido Popular ni de ningún otro partido de derechas ni de la jerarquía católica ni del Opus, yo soy de izquierdas y repúblicano, católico de base también, esa es la verdad, estoy totalmente de acuerdo de la separación total de Iglesia y Estado y resto de las Administraciones Públicas como este ayuntamiento obviamente, pero retirar los belenes de la Plaza Mayor y el Ayuntamiento, como se rumorea que planea este Ayuntamiento a mi no me parece nada bien, un belén tiene un significado religioso cierto, pero es una TRADICIÓN HERMOSA que viene también del pueblo, una tradición que no hace daño a nadie y que es muy bonito, que a los niños les encanta además, poner un belén no ofende a nadie, a quien no le guste no va a verlo, es facil, pero a muchos madrileños le gusta y ya digo son tradiciones muy bonitas, hay que distinguir las cosas por favor, de una tradición que el pueblo gusta de tener y de mezclar Iglesia y lo público, que en este caso no veo que sea así, además si esto es un Ayuntamiento de todos, a la gente no le va a ofender conservar los belenes de la Plaza Mayor y del Ayuntamiento, al revés, sería un buen gesto.</p>

<p>Yo espero que esto sea escuchado, repito no soy un rancio derechista ni del Opus, distinguid las cosas, gracias.</p>

<p>OSCAR</p>
";"08/11/2015 09";"172";"152";"20";"34";"1483372217";"11665"
"4278";"Idea inteligente?";"<p>Parece una buena idea esto de Decide Madrid. La verdad es que es humo, la gente expresa sus deseos y para que se lleve a trámite hay que tener más de 53000 apoyos. Hay tanta gente en Decide Madrid???</p>

<p>Por lo que he visto es imposible conseguir los apoyos o pasarán mil años hasta que se consigan.</p>

<p>Un fiasco!!</p>
";"08/11/2015 09";"46";"33";"13";"16";"1474687427";"1434"
"4279";"Evitemos la CUTREZ";"<p>Madrid puede ser una ciudad bella, a pesar de mucha de la arquitectura cutre y decadente que tiene. Pero opino que muchos madrileños, además, colaboran en que el resultado final sea aún mucho más cutre.</p>

<p>Algunos ejemplos de cosas que me gustaría que desaparecieran de la ciudad:</p>

<p>1. Carteles publicitarios atados con cadenas a postes y señales de tráfico puestos por negocios cercanos, de forma totalmente ilegal.</p>

<p>2. Pintadas, pegatinas, carteles pegados por todos los sítios.</p>

<p>3. Fachadas de negocios, bares y tiendas, sin un mínimo de gusto y con materiales y acabados propios de un barrio de chabolas. Azulejos de baño cubriendo las fachadas de esos negocios. (Un pequeño paseo por Londres o por París dejará claro lo que quiero decir)</p>

<p>En resumen, no es sólo por el turismo. Es principalmente por los que vivimos en la ciudad y que lo hacemos rodeados de fealdad y cutrez.</p>
";"08/11/2015 11";"36";"34";"2";"1";"1479576278";"3022"
"4280";"No a la impunidad al los hurtos menores";"<p>Buenas noches</p>

<p>Hace unos días estaba trabajando en la zona de arganzuela y me robaron el bolso y el móvil mientras bajaba a entregar un paquete. Siempre cierro la furgo del reparto con la llave, pero esta vez no me funciono( como cuando hay un inhibidor de frecuencia) y decici cerrarlo con la cerradura. Cuando salí a los dos minutos, ya había desaparecido todo. Me encontraba en Madrid sin dinero,sin teléfono y tan siquiera abrigo que también se lo llevaron... Fui a comisaría a denunciar los echos, con la idea de que me dejaran llamar a alguien de mi familia( decir que era la primera vez que iba sola a trabajar a Madrid) y no pudo ser por qué la llamada era a un móvil. Una chica muy amable que esperaba a ser atendida fue la  que me lo prestó. A las 2 horas de esperar pase hacer la denuncia y el agente estaba muy cansado como para por lo menos dar muestras de que le interesaba algo lo que me había ocurrido... En fin. Los hurtos de esta magnitud quedan totalmente impunes, a nadie le importa un carajo, pero que sepan que la persona afectada no sólo pierde su dinero, pierde sus recuerdos, violan su privacidad y el trastorno que lleva hacer todo de nuevo. Me sentí nadie (literalmente) ya que no tenía nada con que identificarme y pensar que estaban tocando mis cosas, viendo mis fotografías con mi niño y mis conversaciones me sentí violada, y a nadie parece importarle. Si claro que hay cosas peores, pero esto les sale gratuito a los que lo hacen y lo saben. Así no va a cambiar nada</p>

<p>Angela</p>
";"09/11/2015 02";"145";"140";"5";"0";"1492142142";"13034"
"4281";"Mejorar la seguridad en la avenida del planetario";"<p>La avenida del planetario por la zona de los metales corta el parque Tierno Galván en 2, </p>

<p>La gente pasea a sus perros por el tierno galván sueltos, recordemos que, según la normativa del ayuntamietno de madrid, esto es perfectamente lícito de 19:00 a 10:00 en invierno y de 20:00 a 10:00 en verano.</p>

<p>A un lado y a otro de la avenida del planetario hay conejos, por lo que no sería la primera vez que un perro cruza dicha avenida persiguiendo un conejo, con la consiguiente inseguridad que esto supone para los coches que por haí circulan, para los dueños de los perros y para los propios perros.</p>

<p>Aunque lo que quería proponer es soterrar la avenida del planetario soy consciente de la embergadura y el coste de un proyecto como este por lo que <strong>""Propongo un valla que impidiera cruzar dicha avenida, aproximadamente empezando debajo del puente de las vias del cercanías hasta el tunel por el que atraviesa por debajo del planetario.""</strong></p>

<p>Realmente este el el tramo más peligroso de dicho parque.</p>
";"09/11/2015 10";"46";"43";"3";"1";"1489714601";"3739"
"4282";"Contenedores de reciclaje fuera de las plazas de aparcamiento";"<p>Por todo Madrid se ve últimamente cómo los contenedores de reciclaje se ubican en plazas de aparcamiento disponibles en las zonas ORA. En muchas ocasiones parece que esta ubicación sea a propósito para disminuir aún más las plazas de aparcamiento. Junto a los ensanches (a menudo innecesarios) de las aceras esto termina por imposibilitar el aparcamiento incluido en zonas reguladas.</p>

<p>Dado que muchas de esas aceras ya han sido enganchadas propongo que los contenedores se ubiquen por norma en las aceras en lugar de la calzada, devolviendo los espacios designados para aparcamiento a su fin original.</p>
";"09/11/2015 17";"62";"50";"12";"5";"1490571855";"3064"
"4283";"Mejorar el site: edición de debates y propuestas";"<p>Añadir la opción de editar un debate o propuesta y que esta sea revisada por un moderador para garantizar que los votos otorgados no han sido abusados al cambiar el contenido.</p>

<p>Hay un montón de propuestas llenas de faltas de ortografía o frases ambiguas. En ocasiones está aclarado en los comentarios pero lo propio seria poder editarlas, que fueran validadas, y reflejar la versión actual con el historial de cambios.</p>

<p>Por supuesto si el debate/propuesta no tiene ningún voto permitir editarlo a gusto.</p>
";"09/11/2015 19";"32";"28";"4";"2";"1490672387";"2100"
"4284";"Ruidos de pubs y discotecas, lo que acarrea...";"<p>A la contaminación acústica no se le hace mucho caso en Madrid centro pero crea muchisimo mal estar a los vecinos de Madrid, a la gente que vive en el centro, que parece ser que el centro sólo está destinado a que vengan turistas de todas las edades pero sobre todo , jovencitos que vienen a emborracharse , eso conlleva , gritos , cantos, vómitos etc......que es el centro de Madrid? ...Magalluf, (Mallorca), Estoy acostumbrada al ruido porque vivo en esta zona (Calle cruz, Sol) pero si me gustaría que al término de las discotecas la policia estuviera mas encima de que la gente no monte botellon y fiestecitas en la calle , suele ser de 5 a 6:30 de la mañana y que las discotecas fueran las primeras en alentar a la gente a que se dispersen y no se queden ahi  para no molestar a los vecinos....Que existimos!!!!! algunas Pubs lo hacen pero por desgracia la mayoría no. Por mucho que se llama a la policia no se hace nada,  se siguen haciendo grupitos todas la noches cantan,  gritan, tocan instrumentos , es demoledor para el descanso.  Sólo pido que se pueda dormir medianamente bien, se está echando a los vecinos de Madrid del centro por ruidos, es una pena . Me encanta mi barrio y me gustaría seguir en él. </p>
";"09/11/2015 20";"64";"57";"7";"7";"1494192113";"4453"
"4285";"Viva Manuela.";"<p>Manuela nos da alegría. Es la señora que nos cuida. Está canbiando nuestra vidas para mejor.</p>
";"10/11/2015 10";"117";"49";"68";"27";"1479971286";"-795"
"4286";"Multa de 600 euros por beber en la  calle";"<p>La multa por beber en la calle, ya sea una lata de cerveza o un gran botellón asciende a 600 euros. En el caso de que los agentes te den el resguardo de tu multa serán unos 360 euros si la pagas en menos de 15 dias, sino tendrás que abonar los 600.</p>

<p>Es desproporcional, no tienen en cuenta que esa multa va destinada principalmente a la gente jóven de este país. Teniendo en  cuenta que la tasa de paro más alta está en los jóvenes, simplemente existe para recaudar.</p>

<p>Espero que con el nuevo Ayuntamiento esto cambie, porque ya en Madrid Salud nos informaron de que había mucha gente jóven sufriendo este abuso.</p>

<p> </p>
";"10/11/2015 18";"84";"63";"21";"22";"1500927490";"3150"
"4287";"PLAZAS PARA DISCAPACITADOS EN POLIDEPORTIVOS PUBLICOS";"<p>Esto no es una sugerencia, es una solicitud. Tengo un hijo con una discapacidad intelectual, es usuario del carnet de deporte especial, pero resulta imposible que pueda a acceder a las plazas para recibir clases de natación (suele ser una por polideportivo) ya que las plazas estan ocupadas de por vida. </p>
";"11/11/2015 11";"26";"24";"2";"0";"1507654165";"2030"
"4288";"FALTA PRESENCIA POLICIAL";"<p>En los ultimo meses he notado que la presencia policial en el Barrio de Villaverde, concretamente en la Ciudad de los Angeles, brilla por su ausencia. En otros cursos escolares, habia presencia policial a la salida del instituto, y en el parque de la Ciudad de los Angeles, durante este curso no he visto ni un solo dia a la policia por la zona, a pesar de que se han producido peleas y altercados. Igualmente durante la noche se echa de menos presencia policial en el parque de la Ciudad de los Angeles para evitar el mal uso del parque, y los destrozos.</p>
";"11/11/2015 11";"60";"55";"5";"1";"1510920393";"4583"
"4289";"La opinión de los usuarios de Madrid no residentes también debería importar";"<p>Madrid siempre fue una ciudad inclusiva e integradora, aunque muchos nos tuvimos que ir a vivir a la corona metropolitana (cada uno por sus circunstancias) y sin embargo somos usuarios de la ciudad de ""a diario"" (aquí, otro abanico de circunstancias personales). No somos votantes pero decidimos cada mañana si venimos a Madrid en transporte público o en coche. También utilizamos las papeleras para no ensuciar, aprovechamos las fuentes para beber y, en definitiva, sufrimos o disfrutamos, colapsamos o mejoramos, casi todos los servicios de la ciudad. Somos, en el fondo, unos ciudadanos más... o eso creía yo. Hoy me siento excluido.</p>

<p>Mi sorpresa al registrarme en decide.madrid es que no puedo apoyar propuestas que tanto me afectan como el billete único de transporte público, que tanto condiciona mi forma de venir a diario a Madrid, por no estar empadronado. Para tener ese privilegio, tenemos que validar la cuenta confirmando nuestro lugar de residencia. Los no residentes sólo podemos votar debates. Bueno, me conformo.. pero a los dos minutos otra decepción: tampoco he podido votar a favor de un debate relacionado porque ""ya hay demasiados votos anónimos, valide su cuenta para votar"". </p>

<p>Habrá un porqué (o muchos) pero una ciudad abierta lo debería ser también aquí, aunque sólo fuera para los usuarios, que no residentes. Repito, hoy me siento excluido.</p>

<p>Por lo demás enhorabuena.</p>

<p> </p>
";"11/11/2015 15";"64";"25";"39";"8";"1492585933";"-546"
"4290";"No a la Sra. Carmena";"<p>Por favor, Sra. Carmena, disfrute de un merecido descanso después de tantos años de trabajo y deje el Ayuntamiento de Madrid  en manosde alguien con más experiencia política y alejado de populismos. Gracias.</p>
";"11/11/2015 16";"152";"32";"120";"11";"1493201565";"-1852"
"4291";"areas de prioridad residencial";"<p>Por qué se ha relajado la normativa que regulaba el acceso a las zonas de prioridad residencial?</p>

<p>Si se pretende reducir eltráfico y que solo tengan acceso residentes y servicios cual es la razón de facilitarlo a todos aquellos que alquilen o posean pisos o plazas de garaje en la zona? Además se les permite el acceso a tantos vehículos como posean y al menos a dos sin dar explicaciones. Se entiende que dos por cada piso o plaza de garaje lo que se multiplica con la existencia de cotitulares de pisos y plazas.</p>

<p>Por otro lado se deja a la Asociación de comerciantes la gestión de autorizaciones comerciales con la creación de una auténtica arbitrariedad</p>
";"11/11/2015 20";"18";"11";"7";"1";"1502863937";"244"
"4296";"Aparcamiento Bici-madrid en boca metro prosperidad";"<p>Sería bueno poder tener este servicio para desplazarnos hasta otros lugares y desahogar el tráfico en la zona</p>
";"12/11/2015 09";"33";"29";"4";"2";"1516901387";"2196"
"4297";"Recogida de basuras fuera de las horas punta";"<p>Siempre se habian recogido las basuras a las 5 o 6 de la madrugada, pero desde hace unos dias las están recogiendo a las 9 de la mañana justo la hora de la entrada de los niños al colegio, con los consiguientes atascos que eso conlleva, y empeorando la contaminación que ya tenemos. A parte de que a los propios basureros les ocasiona unas perdidas de tiempo inutules al tener que ir esquivando gente y coches para coger y dejar los cubos en la acera. Propongo que se vuelva al horario de madrugada que hemos tenido siempre.</p>
";"12/11/2015 10";"41";"33";"8";"1";"1516107175";"2012"
"4298";"#TúPreguntas: Carlos Sánchez Mato, concejal de Economía y Hacienda.";"<p>
</p><p>Hola a tod@s, soy Carlos Sánchez Mato, vuestro concejal de Economía y Hacienda</p>.

<p>Encantado de inaugurar la nueva aplicación de entrevistas colectivas que han diseñado en el Área de Participación Ciudadana y Transparencia, espero vuestras preguntas para responderlas mañana viernes 13 de noviembre a partir de las 13.00 horas. Mi principal labor al frente de la Concejalía de Economía y Hacienda es contribuir a hacer un modelo de ciudad más justa y con menos desigualdades. Apostamos por diseñar políticas fiscales redistributivas y que incidan en el gasto social. Y para hacerlo realidad necesitamos las aportaciones de los ciudadanos y ciudadanas de Madrid, necesitamos vuestra ayuda. Un saludo</p>

<p>Hola a todas y todos!! Soy Esther López Barceló, la directora de gabinete de Economía y Hacienda. En el área trabajamos en equipo, por lo que también estaré contestando a vuestras preguntas en estas entrevistas que han preparado desde Participación Ciudadana y que son una ventana de oportunidad a través de la cual poder comunicarnos activamente. Estamos trabajando en muchos temas como la inclusión de cláusulas sociales y medioambientales en la contratación pública o la incorporación de la perspectiva de género en todas nuestras políticas. Así que es fundamental que encontremos espacios de relación directa como este y así también seáis partícipes de todos estos cambios tan ilusionantes.</p>

<p>Carlos Sánchez Mato y Esther López Barceló</p>

<p>¡Podéis ir dejando vuestras preguntas ya mismo y votando las preguntas de los demás!</p>

<p>Actualización:</p><p>Carlos Sánchez Mato: 'Os tengo que dejar ya... Me ha encantado este rato y espero que me permitan volver a estar con tod@s en otra ocasión. Muchísimas gracias por la participación y las cosas que no me ha dado tiempo a responder, prometo hacerlo en próximas veces.'</p><p></p><p>Esther López Barceló: 'Gracias por las preguntas! Seguimos estando a vuestra disposición y esperamos poder tener más entrevistas colectivas en el futuro. Un abrazo, :)'</p>
";"12/11/2015 11";"87";"74";"13";"127";"1522439242";"5188"
"4299";"¿Y si cualquiera pudiera entrevistar a Manuela Carmena o los otros concejales?";"<p>Las entrevistas colectivas reinventan el concepto de entrevista poniéndolas en manos de la gente. Cualquier persona puede hacer cualquier pregunta, y la selección entre todas las recibidas las hacen los propios participantes. De esta manera no hay un entrevistador o un moderador que decida lo que se pregunta. Tú preguntas, tú decides.</p>

<p>La entrevista se desarrolla a través de Madrid Decide (http://decide.madrid.es). El día antes abriremos un espacio en la sección de Debates, donde empezar a recoger las preguntas recibidas. Arriba se presentará la persona que va a ser entrevistada, y en la parte inferior de comentarios cualquiera podrá dejar sus preguntas. Como los comentarios (en este caso las preguntas) se pueden votar en positivo o en negativo (con las dos flechitas que aparecen a su lado derecho), esto permite ordenar entre todas las preguntas las que consideréis más interesantes. Al día siguiente la persona entrevistada responderá en el orden en que las haya dejado la votación. ¿Sencillo, no?</p>

<p>Carlos Sánchez Mato, concejal delegado de Economía y Hacienda, abre la ronda de entrevistas. Podéis dejar ya vuestras preguntas en este enlace: https://decide.madrid.es/debates/4298 Él entrará a responder mañana viernes a las 13:00 h.</p>

<p>¡Y el lunes abriremos la entrevista a Manuela Carmena! que nos responderá el martes.</p>

<p>Te toca: #Túpreguntas.</p>

<p>P.D. Os recordamos que es importante que los comentarios que dejéis contengan una pregunta (así evitamos las respuestas a otro comentario).</p>
";"12/11/2015 11";"41";"34";"7";"15";"1517767023";"2239"
"4300";"Desempleo y empleo precario.";"<p>Con tanto desempleo que hay y empleo precario me sorprende que la gente no esté interesada en presionar para que se tome este tema mucho más en serio. Quizá sea porque al emigrar muchos españoles ya se va notando que hay más trabajos o no sé qué pasa? Yo creo que convendría que se creara algún tipo de comité para que estuviera encima del tema en serio y en profundidad.</p>

Crear un comité para el empleo sostenible en madrid

 annaglez     26/10/2015      Sin comentarios   
Código de la propuesta: MAD-2015-10-3470

Resumen de la propuesta A quién no le gustaría que hubiera más y mejor empleo de calidad . Empleo decente, empleo estable, empleo flexible, empleo al que se le hace un seguimiento continuado profundo

<p><u><strong>Esta asociación o comité sería con visión a trabajar a largo plazo, mínimo tres años</strong></u></p>

<p><strong>Madrid </strong>como <strong>capital de España </strong>podría ser referente de manera  seria en atajar la cuestión de conseguir bajar las cifras de desempleo y de aumentar las posiblidades de trabajo para todo el mundo en la ciudad. <strong>Es importante que se cree un comité que le haga un seguimiento en serio y profundo a la creación de más y mejor empleo</strong>. Empleo de calidad, flexible, empleo innovador, oportunidades para el crecimiento de la ciudad pero todo en equilibrio con el entorno. En equilibrio con el entorno natural y del medio ambiente pero también en equilibrio con las personas y sus vidas. Programas de empleo para todos los segmentos en riesgo de exclusión.  Las corporaciones hasta este momento tienen el bastón de mando pero deben moverse hacia las relaciones  de  equilibrio con sus trabajadores, con el medio ambiente y con todo. El comité debe animar a las empresas por voluntad de los ciudadanos a intentar alcanzar el máximo de equilibrio en sus relaciones, actuaciones y trabajos con todo el entorno y las personas. <strong>El comité debe animar a las empresas a las mejores prácticas para el medio ambiente. También debe animar a que las empresas no usen procesos de selección selectivos, sino que entrevisten a las personas en función de los perfiles que les interesen y al final que elijan a los candidatos a los que quisiera formar para el puesto en cuestión pero no hacer perder el tiempo a la gente en formación para después no elegirles para el puesto.</strong> Este comité debe velar por la calidad, la oportunidad de avanzar de todos siempre en equilibrio. Creo que nadie se tiene que subir a la chepa de nadie, ( ni los empresarios sobre la chepa de los trabajadores ni los trabajadores sobre la chepa de los empresarios). Todo por el bien del empleo en Madrid para el presente y para el futuro.<strong> Es importante que se anime a flexibilizar,  liberalizar e innovar el mercado de trabajo</strong>. Estaría muy bien copiar modelos de otros paises que funcionan para facilitar el empleo a la gente. <strong>Ver caravanas en las calles de Madrid sirviendo comida, carritos sirviendo comida, que se facilite a los agricultores ecológicos a traer sus productos a todos los barrios de Madrid y venderlos por ejemplo mensualmente en parques de todos los barrios de Madrid para que la gente pueda cada vez más acceder a buenos productos. Innovar, innovar, innovar en cuanto al empleo y dar facilidades no estar todo el rato poniendo impedimentos económicos y de todo tipo. Hay que tener un comité trabajando con todos los actores de la sociedad muy en serio para que todo esto se vaya poniendo en marcha. Que se pongan en funcionamiento métodos de vigilancia de la calidad pero que el ayuntamiento cobre el mínimo por licencias de puestos para que así den más facilidades a la gente para exponer sus productos y tengan oportunidad de competir y dar un buen servicio para sus clientes.</strong></p>

 
";"12/11/2015 18";"37";"35";"2";"1";"1522587294";"3121"
"4301";"a 70KM/h se contamina mas, dicho por la ucm, aumentar mucho el servicio publico";"<p>A ver si Inés Sabanes me lo explica..... si por ej. a 120 km/h el motor de mi coche esta un tiempo x encendido para llegar a mi curro , si voy a 70km/h mi motor estara un tiempo casi x al cuadrado contaminando, además, para ir a mi curro a 120km/h en sexta voy a 1800rpm a 70Km/h no puedo ir en sexta por q casi se me cala con lo cual reduzco dos marchas..y voy a 2200rpm...</p>

<p>entonces.... ¿ como estoy reduciendo la contaminación Ines? anda anda y en vez de tocar los hoevos a los de siempre.. ten un par y enfrentate a Cifuentes y duplique el servicio de transporte publico, conseguirlo si seria ser buena politica. además hay mucha gente que trabaja fuera, incluso para el ayuntamiento fuera de los horarios de transporte publico, Les quitas el coche y el transporte publico???</p>
";"12/11/2015 19";"43";"30";"13";"21";"1518017024";"1186"
"4302";"Oscuridad  en el Paseo del Comandante Fortea";"<p>Caminar por Comandante Fortea cuando ya ha anochecido es un peligro, ya que las pocas farolas que hay en la calle apenas iluminan la calzada.El problema es mayor si nos referimos a la torre del nº 25 ( junto al parque) y a las torres interiores que llegan hasta la plaza de San Pol de Mar.Esto no ocurre solo en esta calle, también en casi todas las aledañas.</p>

<p>Por otra parte, pido al Ayto. que limpie urgentemente las hojas otoñales que ocupan todas las aceras.Este barrio tiene un número alto de personas mayores que corren el peligro de escurrirse con ellas,y concretamente lo pido por mi madre,de 91 años,que no se atreve a salir de casa hasta que no se limpien las calles de hojas.</p>

<p>Gracias</p>
";"12/11/2015 21";"15";"14";"1";"1";"1519741916";"1213"
"4303";"Limitar trafico campus UCM";"<p>El campus de la UCM lo atraviesan al menos 3 grandes vías de circulación de automoviles. Con la N-VI poco se puede hacer, pero el trafico a toda velocidad (pese a los limitadores frente a la salida del M de Ciudad Universitaria, que son claramente insuficientes) es insufrible y un riesgo para las riadas de estudiantes que caminan por el campus. La tercera los coches que atraviesan desde la N-VI por la c/Jose Antonio Novais hacia Cuatro caminos saturan la calzada durante todo el día. El resultado aire contaminado, contaminación acústica (claxonazos, acelerones y frenazos), coches aparcados en todo resquicio de superficie libre. Hace falta más transporte público para llegar a C.U., respetando la necesidad de acceso a Madrid de los ciudadan@s, campañas que incentiven a estudiantes y personal a que dejen el coche en casa, y si aun así y todo hay tienen que hacerlo: Limitar el horario de acceso fuera de las horas punta?, cerrar al tráfico Avda Complutense los Domingos, y así mil posibilidades más...</p>
";"12/11/2015 22";"28";"16";"12";"2";"1513413620";"228"
"4304";"Madrid vetará aparcar en el centro a los vehículos de no residentes al persistir";"<p>http://www.eldiario.es/madrid/Madrid-prohibe-estacionar-residentes-polucion_0_451455984.html</p>
";"12/11/2015 23";"38";"16";"22";"11";"1507594985";"-252"
"4306";"Hay muchas propuestas repetidas -- Debe haber un moderador que una propuestas";"<p>Se necesitan 53.000 apoyos para que salga una propuesta (2% del censo) practicamente ninguna llega a los 2.000 apoyos pero luego hay otras propuestas practicamente iguales.</p>

<p>Debe haber un moderador que una propuestas, para que los apoyos no se disipen en varias propuestas iguales. Tambien debe filtrar que propuestas nuevas ya existen y también censurar las nuevas propuestas que ya existen y avisar a la persona que trata de meter una propuesta repetida, y enseñarle cual es la que ya existe</p>

<p>Es absurdo, sino se hace algo similar nunca llegará una propuesta o casi ninguna,</p>
";"13/11/2015 01";"209";"201";"8";"16";"1533142291";"18561"
"4307";"Medidas de circulación en Madrid por Alta Contaminación";"<p>Hola,</p>

<p>entiendo que la alta contaminación es un problema serio, pero no entiendo las medidas que se están tomando desde el Ayuntamiento de Madrid.</p>

<p>Yo soy residente en Getafe y trabajo en Madrid, utilizo mi coche para desplazarme cada día desde mi domicilio a mi oficina, pero con las medidas que están previstas tomar si no llueve este fin de semana no podré ir a trabajar. Un trayecto de 25 minutos en mi coche se convertiría que en transporte público tendría que coger tres transportes para llegar a mi lugar de trabajo con una media en tiempo de hora y media. Eso ya es malo, pero no es lo peor, dado que no puedo utilizarlo por motivos más serios, sufro de Neuralgía del Trigémino como consecuencia de una cirugia cerebral a la que fui sometida hace 3 años y medio. Los desencadenantes de ese terrible dolor son ruidos como voces, el viento, ect... el ir en transporte público es garantía de que se desencadena el dolor, entonces alguién me puede decir como puedo ir yo hasta mi oficina sin que sea una tortura para mi o tengo que sufrir unos dolores horribles y meterme más pastillas de las que ya tomo para poder mal llevar mi día laboral.</p>

<p>Adicionalmente y por si fuera poco, tengo a mi madre con 87 años, con Alzheimer, con problemas serios de movilidad y ahora además la pobre no ve por unas cataratas muy avanzadas. Hay que llevarla al médico, pero veo que el Ayuntamiento pretende que la lleve en transporte público, dado que dependiendo de la matrícula de mi único coche podré desplazarme un día si y un día no, pero si además no puedo aparcar, pues ya me contarán.</p>

<p>Tiene el Ayuntamiento previsto solucionar estos casos, me va a poner a mi disposición un taxi (transporte público) para ir a trabajar y para atender las necesidades sanitarias de mi madre. O bien, mi madre tiene que dejar de asistir a sus citas médicas hasta que llueva en Madrid, y yo tengo que dejar de trabajar por el mismo motivo. Esto último no sé como me afectaría, dado que mi empresa ayer anuncio una bajada de sueldo y un despido colectivo.</p>

<p>Agradecería enormente que alguién me dijera como puedo afrontar yo estas medidas. Si tuviera medios, probablemente tendría dos coches, uno con matrícula par y otro con matrícula impar, o bien me pagaría un taxi desde getafe a madrid para ir a trabajar. Pero como no es así, veo que estas medidas siempren van contra el que menos tiene y más tiene que perder.</p>

<p> </p>
";"13/11/2015 08";"55";"36";"19";"10";"1522671740";"1112"
"4308";"Fomentar Tele-Trabajo para reducir contaminación en Madrid.";"<p>Pienso que una solución razonable a la hora de reducir la contaminación en Madrid sería fomentar el Tele-Trabajo, tanto el Gobierno como los Ayuntamientos deberían de crear algún tipo de ventaja a las empresas que fomenten esta manera de trabajo muy aplicable por diferentes paises por el mundo. Seguramente existen muchos puestos de trabajo que no sería indispensable estar personalmente en las instalaciones de la empresa para realizar la tarea diaria. Esto a mi entender reduciría significativamente los miles de vehículos que se mueven diariamente. Ganaríamos todos, los empleados a la hora de reducir costes, las empresas que tendrían un trabajo más efectivo y la contaminación reduciendose considerablemente.</p>

<p>Hay que intentar buscar soluciones que beneficien no solo a que mejore nuestra calidad de vida sino a facilitar la en la medida de lo posible al trabajador y creo que con prohibiciones no se consigue.</p>

<p>Por ejemplo cuando saltaran valores altos de contaminación en vez de reducir 20Km/h la velocidad máxima en M-30 al día siguiente o los sucesivos días, que se opte por aplicar una medida a todos los trabajadores que su puesto de trabajo se pueda desarrollar desde su domicilio, se ha pensado cuantos coches dejarian de moverse diariamente con estas medidas? Y así las personas que no les quedase más remedio que acudir a su centro de trabajo no sufririan tanto atasco. </p>

<p>Esta claro que hay que pensarlo mejor que con mi explicación pero creo que sería una buena medida para realmente acabar con el movimiento tan enorme de coches diariamente que sufre Madrid.</p>

<p>Creo que hay que tomarse el tema de la contaminación muy enserio, provoca muchos problemas de salud.</p>
";"13/11/2015 09";"156";"144";"12";"14";"1534019605";"12184"
"4309";"Hechos...no suposiciones";"<p>Manuela, mi Alcaldesa, porque lo eres y como tal te quiero, por favor hay que ser más prudentes y pacientes para no dar razones a la derecha reaccionaria, con el tema de la contaminación ayer debarraste ...si no se tienen datos fehacientes lo mejor es declinar la invitación de la SER, no decir que probablemente se levante la prohibición de ir a 70 y al rato sea todo lo contrario, ahora mismo acabas de decir en RNE que el secretario de Fomento te ha dicho que reforzará los trenes de cercanías, que crees que Metro también lo hará, por favor no creas...en Metro(Comunidad) mientras no haya comunicación oficial de la Consejería de Transportes, no les des alas...te lo digo desde el cariño sincero que te tengo como Alcaldesa porque eres uan buena persona que sólo piensa en el bien común, como eres además jurista piensa en ""Hechos Probados"", hay que andar con pies de plomo, un abrazo.</p>
";"13/11/2015 10";"25";"5";"20";"7";"1512017293";"-300"
"4310";"Contaminación en Madrid ";"<p>Buenos días, </p>

<p>No estoy de acuerdo en absoluto con las medidas que se están abarcando en relación a la contaminación. Si bien es cierto que en Madrid sufrimos de esta última, sus niveles no son tan excesivos como para que ahora dejemos de utilizar los coches.</p>

<p>Tengo la somera sensación de que esta prohibición de vehículos ( basándose en la  contaminación), no es más que una excusa con ínfulas comunistas, para eliminar el derecho a la libertad y propiedad privada (mi coche y los del resto de ciudadanos y mi libertad y la del resto de ellos, para poder transitar por nuestra ciudad, la cual se mantiene con nuestras contribuciones e impuestos).</p>

<p>Si fuera de otra manera , ¿ Por qué casualmente, sólo se toman medidas con los coches y no con las calefacciones entre otros elementos, que provocan por cierto un mayor volumen de CO2 y óxido de nitrógeno?.</p>

<p>Finalmente pero no por ello menos importante y muy estrechamente relacionado con lo anterior, me gustaría aclarar que el metro no dispone de la limpieza suficiente desde hace ya algún tiempo, que las calles están más desastradas y  que la estacion de Príncipe pío está infame, con restos de orina, botellas y  sustancias  más peligrosas, que desde luego  también CONTAMINAN Madrid además de ser un peligro público. Todo esto parece haber caído en el olvido ya que se hace caso omiso a este problema que además, es desagradable.</p>
";"13/11/2015 11";"68";"24";"44";"10";"1510630161";"-705"
"4311";"Las grandes empresas deben facilitar a los empleados llegar a sus puestos";"<p>Las empresas, especialmente las grandes, que se beneficien de situar sus oficinas fuera de la almendra central o en los barrios de los alrededores de Madrid (Ejemplo: Las Tablas) son las que deben proporcionar una solución de transporte a sus empleados. Estas empresas se aprovechan de que los terrenos en estos lugares son más baratos, lo que no es juzgable, pero para los empleados es una odisea llegar a su puesto de trabajo y aparcar (porque tampoco se construyen grandes edificios con los aparcamientos necesarios) provocando atascos interminables como los que tienen lugar en la A-1. Aunque algunas compañías ya disponen de servicios de lanzadera o autobú, estas se deben reforzar y fomentar entre los empleados a todos los niveles, y es más, creo que debería ser una condición indispensable antes de que una empresa se sitúe en lugares como estos. Si esto no se consigue, la gente continuará desplazándose en su propio coche, ya que es totalmente inviable llegar a algunos centros de trabajo en bicicleta o andando (habría que atravesar una autopista!), y la flexibilidad de horarios es necesaria porque el problema es que la gente no comparte el coche porque nunca se sabe a qué hora termina su jornada laboral y la hora de salida es muy variable. </p>

<p>En mi opinión, es la única medida que acabaría con la contaminación, aunque obviamente tendría que ir acompañada de un refuerzo en el transporte público. En el caso de las pequeñas empresas, se podrían crear asociaciones entre las de la misma zona para poner autobuses.</p>
";"13/11/2015 14";"91";"80";"11";"2";"1532541746";"6065"
"4312";"EDIFICIOS PARA APARCAR,  no atascos, ruidos, accidentes, etc, en madrid capital.";"<p>Soy Maddec y en mi opinion, para la reducción de vehiculos en la capital y como consecuencia de ello (contaminación, atascos, ruidos, accidentes, saturación de aparcamientos, estres, etc), seria una muy buena idea, el crear aparcamientos en las vias de entradas de acceso a la capital y en las proximidades de las estaciones de bus, metro, cercanias y renfe, la idea serian LOS EDIFICIOS PUBLICOS DE APARCAMIENTOS (en otras ciudades de diferentes paises ya las tienen y con un magnifico resultado). de manera que las personas que vivan en las afuera de la capital y quieran desplazarse a ella, ya sea por trabajo o ocio, no tengan la necesidad de ir en su vehiculo a madrid capital, dejandolos en estos aparcamientos en las afuera de la capital y cojiendo el trasporte publico para acceder en ella, como ya dije antes, eso trae enormes beneficios como (el ahorro tiempo en buscar aparcamiento, ahorro de tiempo en general, ahorro en dinero para combustible y desgaste del vehiculo, evitando accidentes, ruidos de claxon y del propio vehiculo, evitar los radares de velocidad, estrés por la misma conducción, etc), beneficiando a no solo los conductores, sino tambien, a todos en general. esta es la idea y creo que tiene mas ventajas que inconvenientes.</p>

<p> </p>

<p> </p>
";"13/11/2015 17";"44";"38";"6";"2";"1530691486";"2763"
"4313";"Menos contaminación a cambio de gasto en parkings. Falta voluntad política.";"<p>Hoy he gastado más de 30 euros en parkings mal llamados públicos (son de gestión privada) por estacionar en Madrid por necesidades de trabajo. Para colmo mi coche (gasolina) no genera la contaminación que se queria atajar hoy. No obstante, tenía prohibido aparcar hoy en superficie.  He tenido más gasto que salario, porque se sigue castigando a las clases medias-bajas. Incongruencias de un gobierno que se dice social. Mucho ruido y teatro municipal, pero cero soluciones. Soy un currante obrero decepcionado con Manuela Carmena quien veo, sigue ayudando a la casta. Hacen falta parkings disuasorios y gratuitos en todas las entradas a Madrid desde unos 20 kms por todas las carreteras de acceso conectados a red de transporte público y en estaciones de metro y cercanías periféricas. Más frecuencia de metro y autobuses. Y bajada de precios. Responsabilidad de la Comunidad y del Ayuntamiento. No nos engañemos a ambos les falta voluntad y están vendidos al poder económico.</p>
";"13/11/2015 19";"23";"18";"5";"2";"1527339170";"1017"
"4314";"Medidas por polución ¿Qué hago con la furgoneta si tengo que trabajar en Madrid?";"<p>Tenemos una pequeña empresa de servicios de limpieza a domicilio, a los cuales normalmente vamos una persona con una furgoneta, donde llevamos nuestras máquinas y útiles para dichos trabajos. Algunos servicios de estos se realizan en un tiempo que va desde 2 horas hasta 5 horas, y en algunos casos todo el día.</p>

<p>Mientras se realizan estos trabajos hay que dejar la furgoneta en la calle, que es nuestro pequeño almacén de materiales y después usamos para desplazarnos al siguiente trabajo.</p>

<p>Para la semana que viene ya hemos quedado con clientes para cada día.</p>

<p>Por tanto me pregunto: si estas medidas continuan, ¿tengo que anular los compromisos con mis clientes? por que no hay manera de hacer el trabajo.</p>

<p>Ya sé que alguien me propondrá soluciones como:</p>

<p>- Que vaya alguien a dejar al trabajador y luego vaya a recogerlo (esta solución no es asumible para nosotros por el coste que supone, la pérdida de tiempo y si se trata de no contaminar, se contaminaría exactamente igual)</p>

<p>- Mete la furgoneta en un parking (mas costes, no siempre hay un parking cerca, cuando los materiales son pesados y la furgoneta alta no cabe en muchos aparcamientos; además seguimos contaminando)</p>

<p>Realmente estas medidas son un gran problema para una empresa que con las justas sale adelante, ya los costes de zona azul del mes son un gasto alto, además de las restricciones de tiempos, etc...</p>

<p>Creo que debería haber excepciones en estas medidas para profesionales, ya sé que no es fácil, pero es algo que hay que estudiar y no decidir a la ligera, como creo que se ha hecho.</p>

<p>Creo que en Madrid hay miles de personas trabajando diariamente en condiciones similares a las nuestras, si esto se alargase en el tiempo sería un gran problema.</p>

<p> </p>
";"13/11/2015 20";"37";"30";"7";"6";"1530464756";"1864"
"4315";"Carril bici";"<p>¿Estan de acuerdo con la creación de una red de carril bici que facilite el uso de este medio de transporte ecológico? </p>
";"14/11/2015 09";"136";"117";"19";"7";"1541791183";"8430"
"4316";"Marcar propuestas que ya están en el programa de Ahora Madrid";"<p>No me sé de memoria el programa con el que Ahora Madrid concurrió a las elecciones. Este es el enlace al pdf del programa: https://goo.gl/ZaxjdB. Veo en ""Propuestas Ciudadanas"" contenidos que ya están en dicho programa, como este punto del programa:</p>

<p>4.3.3. Articulación de medidas que garanticen la sostenibilidad en el derecho al acceso al agua</p>

<p>d) Implantar y mejorar las fuentes de agua potable públicas e incentivar el uso de agua canalizada.</p>

<p>Luego votar esta propuesta por ejemplo, con todo el respeto y en mi opinión, no añade nada nuevo: https://decide.madrid.es/proposals/648 (Recuperar las fuentes de agua potable). </p>

<p>Propongo que se marquen este tipo de propuestas con una etiqueta en color bien visible, no que se eliminen, pues no soy partidaria de borrar nada, sino de añadir información. Un usuario no tiene porqué saberse de memoria el programa y podría entender mal que se elimianra su propuesta.</p>

<p>Si se marcara como ya incluída en el programa del grupo, sería muy útil a la hora de agilizar el espacio de propuestas.</p>

<p> </p>
";"15/11/2015 16";"15";"10";"5";"2";"1542042200";"333"
"4317";"Prohibición de viviendas de uso turístico en edificios residenciales. ";"<p>La administración local debería prohibir las viviendas de uso turístico. Producen molestias continuadas imposibilitando el descanso de las personas que viven de manera habitual en dicho edificio. Además suponen un riesgo para la seguiridad al no quedar constancia de las personas que visitan el edificio. </p>
";"15/11/2015 22";"58";"41";"17";"8";"1549901906";"1696"
"4320";"#TúPreguntas: Manuela Carmena, alcaldesa de Madrid";"<p>Queridos amigos y amigas.
Estoy encantada de participar en este nuevo espacio de entrevistas colectivas que se ha impulsado desde el Área de Participación Ciudadana, Transparencia y Gobierno Abierto. Gobernar es escuchar y este espacio de participación directa de la ciudadanía se configura como una estupenda oportunidad de escucha; por ello os agradeceré que me enviéis vuestras preguntas e inquietudes a las que intentaré dar respuesta el próximo martes 17 a las 13:00.</p>

<p>Tenéis más información sobre esta nueva herramienta aqui: https://decide.madrid.es/debates/4299</p>

<p>Manuela Carmena</p>

<p>Actualización (13:00): Ya empiezo a responder a vuestras preguntas https://twitter.com/AbriendoMadrid/status/666590719474319360</p><p>Actualización (14:00): Gracias por vuestras preguntas. me hubiera gustado seguir y veros en directo, pero siempre este sistema de comunicación será mejor que nada. Gestionar una ciudad como Madrid es algo bien complejo. Por eso es tan importante que cada uno colabore y participe, pues las soluciones para los problemas de todos precisan la participación de todos. Es ya la hora de comer. ¡Muy buenas tardes!</p>";"16/11/2015 10";"175";"151";"24";"373";"1565768661";"10958"
"4321";"Olores por Valdemingomez";"<p>Buenas tardes, vivo en el Ensanche de Vallecas y muchos días es insoportable el olor que tenemos. Me gustaría saber si tienen pensado hacer algo con este tema o vamos a tener que seguir en verano sin poder abrir la ventana</p>

<p>Gracias</p>
";"16/11/2015 20";"83";"79";"4";"5";"1566694541";"7138"
"4322";"Transporte público horario nocturno";"<p>Buenas tardes,</p>

<p>Me dirijo nuevamente en la plataforma con esta posibilidad de dirigirnos a ustedes.</p>

<p>El tema sobre el que me gustaría poder hablar es el transporte público en horario nocturno (servicios búho EMT). Hice una propuesta en el apartado correspondiente cuando tuvo comienzo esta iniciativa.</p>

<p>Me gustaría saber si se van a tomar medidas. Si está presente en vuestros propósitos.</p>

<p>Gracias. Un saludo.</p>

<p> </p>

<p>Silvia</p>

<p> </p>
";"17/11/2015 13";"62";"60";"2";"1";"1573006882";"5612"
"4323";"PLAZAS Y TARJETAS APARCAMIENTO DISCAPACITADOS";"<p> Yo tengo tarjeta pero al ir a solicitar mi plaza me la han denegado porque según dice hay muchas en mi calle , que por cierto están ocupadas por personas que caminan perfectamente mientras si yo llego y no hay hueco me tengo que ir lejos con mi dificultad de desplazamiento  (llevo muletas  y unos aparatos para caminar.</p>

<p>Gracias y un saludo</p>
";"17/11/2015 13";"23";"16";"7";"8";"1563313933";"626"
"4324";"Ascensores en Buenavista";"<p>Buenos días señora alcaldesa. Bueno dudo en grado sumo que nos vaya a contestar a todos pero al menos quiero ponerle al corriente de la situación. Soy del barrio de Buenavista, en Carabanchel alto. Iré al grano. Hace un par de años, en nuestra comunidad de vecinos, se decidió implantar ascensores en todos nuestros edificios. Esta medida se votó en reunión obteniendo como resultado la mayoría un no, ya que cada familia hemos de pagar 20.000. Se instalaron en algunos edificios en los que todos los vecinos que vivían en el mismo sí lo querían. Hasta aquí todo perfecto. El tema es que los que sí querían ascensores llevaron todo esto a juicio, alegando que había personas con falta de movilidad y demás (en concreto dos vecinos de aproximadamente unos 100 que somos). La sentencia salió favorable para estos dos vecinos. Ahora el resto parece ser que tenemos que instalar los ascensores y pagar la salvajada de 20.000...Yo, sinceramente, le pido ayuda porque en nos vemos obligados a abandonar el domicilio ya que nos es imposible afrontar este dinero al igual que le pido ayuda para los dos vecinos. Quizá suene descarado, pero no estaría de más que el ayuntamiento asuma el gasto de dichos ascensores al menos para estos dos vecinos... Gracias de cualquier modo doña Manuela. </p>
";"17/11/2015 13";"15";"7";"8";"7";"1556081621";"-46"
"4325";"¿Porqué Madrid está tan sucio? ¿Qué hay previsto para solucionarlo?";"<p>Me gustaría que fuera la Corporación la que explicara cual es el motivo porque el que esta ciudad nuestra, tiene las calles tan sucias y de aspecto abandonado. Mi experiencia es que pasa en el centro y también en los barrios de la periferia.</p>

<p>¿Porqué pasa? ¿Que hará el ayuntamiento para resolverlo? ¿Cuándo podremos ver los resultados?</p>

<p>Gracias</p>
";"17/11/2015 16";"109";"107";"2";"16";"1577220889";"10307"
"4326";"¿Se debería sancionar a los infractores de los 2 días de medidas excepcionales?";"<p>El Ayuntamiento de Madrid se plantea no sancionar a los conductores que superaron los 70 km/h durante los días que se estableció esta limitación excepcional en la velocidad de circulación de determinadas vías. Igualmente, según El País, parece que los controladores del SER ""no se cebaron"" con los conductores que estacionaron en zona azul estando prohibido.</p>

<p>No acierto a entender de qué sirve establecer medidas de limitación del tráfico si después no se van a aplicar sus consecuencias. Me parece que el mensaje claro que se transmite al ciudadano es que se premia la infracción frente al cumplimiento de las normas.</p>

<p>No puede ser que la inmensa mayoría de conductores respete las restricciones y tenga, exactamente, el mismo tratamiento que los pocos que no las respetan, porque entonces no estamos hablando de medidas serias, sino de una broma que fomenta la impunidad.</p>

<p>¿Qué opináis, se debe perdonar a estos infractores de forma excepcional, o se debe aplicar la medida en su totalidad, incluyendo las correspondientes sanciones?</p>

<p> </p>
";"18/11/2015 10";"39";"24";"15";"7";"1571120085";"553"
"4327";"Belen en el Ayuntamiento";"<p>No soy homosexual, ni tengo nada en contra de ellos. No soy creyente ni tengo nada en contra de ellos. No todos los madrileños son homosexuales. No todos los madrileños son creyenyes. Por qué se expone en el Ayuntamiento la bandera del orgullo gay y no el belén en navidad?</p>
";"18/11/2015 15";"137";"104";"33";"39";"1581467318";"5389"
"4328";"Condiciones laborales trabajadores municipales acción e intervención social";"<p>Buenas tardes:</p>

<p>Me gustaría exponer la situación actual de los profesionales del ámbito de la acción e intervención social, que trabajamos en centros del ayuntamiento de madrid, en concreto en el área de servicios sociales cuya concesión la tienen empresas privadas.</p>

<p>Llevamos toda la vida trabajando en el sector, sin tener un convenio propio por lo que cada empresa ha estado aplicando el convenio que creía conveniente, tales como el Convenio de Residencias privadas y Centros de día, convenios del ámbito de la hostelería, convenios de oficinas y despachos etc. Convenios que nada tienen que ver con la actividad diaria que nosotros venimos realizando, como por ejemplo no es lógico, que los compañeros de Samur Social que están trabajando en unidades móviles, a pie de calle, haciendo intervención directa con personas sin hogar etc. tengan como convenio de referencia el convenio de oficinas y despachos.</p>

<p>Por otro lado comentar que aunque se nos exige una alta cualificación, capacitación y disponibilidad para desarrollar nuestro trabajo, puesto que muchos de nosotros trabajamos en lugares con jornada continua, ya que se trabaja las 24h al día los 365 días al año, esto no se ve recompensado por ninguna parte. Estamos cobrando 900 euros al mes (si llega) por trabajar de lunes a domingo, con festivos incluídos, muchos compañeros incluso son correturnos o trabajadores de turno de noche y cobran practicamente lo mismo, solo libramos un fin de semana al mes, no tenemos derecho a ponernos enfermos, porque no te puedes permitir coger una baja, cuando te están quitando dinero y mucho cuidado con decir nada, porque te vas a la calle.</p>

<p>En la actualidad y tras nueve años de negociaciones, se ha conseguido tener un convenio propio de referencia, el Convenio de Acción e Intervención Social (2015/2017), que es de obligado cumplimiento para las empresas que trabajan en este ámbito. Los profesionales del sector, celebramos este acuerdo, ya que es el inicio de la dignificación de nuestro sector. El problema llega cuando a la hora de aplicar el convenio, las empresas se amparan en no aplicarlo o si lo aplican al menos no en su totalidad, pudiendo descolgarse de diferentes materias como tablas salariales, jornada de trabajo etc (ya que la reforma laboral les ampara). y culpan al ayuntamiento de madrid de no recibir partidas presupuestarias suficientes para poder cumplir con el convenio de referencia.</p>

<p>Por todo lo expuesto anteriormente me gustaría saber cual va a ser la respuesta del ayuntamiento en este sentido, tanto para los contratos que siguen vigentes en la actualidad, como para los nuevos concursos que se vayan a celebrar en el futuro.</p>

<p>Nosotros por nuestra parte pedimos tener unas condiciones laborales dignas y el cumplimiento de la ley.</p>

<p> </p>

<p>Un saludo.</p>

<p> </p>
";"18/11/2015 17";"27";"23";"4";"1";"1578678101";"1618"
"4329";"Misero salario de ordenanzas empresa privada";"<p>Hola buenos días, mi exposición es en referencia al salario que perciben los ordenanzas de empresa privada en las juntas municipales, no voy a decir cuánto, que se interesen por favor los cargos públicos del Ayuntamiento, seguro que les impactará y no por lo bueno. En segundo lugar querría exponer en la situación de total desamparo que se encuentran al salir la empresa que presta el servicio y entrar otra nueva, en ese caso, como ya pasó en 2011, como ya he dicho con anterioridad, la situación de desamparo en la que se encuentran esos trabajadores es desalentadora, no tienen subrogación ni en convenio ni en pliegos de condiciones viene reflejado, esto segundo me parece aún peor, porque el ayuntamiento lo debería reflejar, por este motivo, se quedan en la calle, el drama de algunas familias es total, por eso les propongo revisar el pliego y dotar de ese pequeño detalle a los trabajadores reflejando que la empresa entrante se hará cargo de los trabajadores. Gracias.</p>
";"19/11/2015 07";"23";"19";"4";"1";"1583204974";"1239"
"4330";"Guardia y Custodia compartida";"<p>Este sistema de repartición del tiempo con los hijos en caso de separación, aconsejado por Sentencias del Tribunal Supremo como mas beneficioso para los menores, esta costando su implantación, en algunas Comunidades Autonomas más que en otras. Considero bastante importe que una institución de tanto peso en la Comunidad de Madrid como es el ayuntamiento se posicione en este sentido. Un saludo</p>
";"19/11/2015 12";"33";"28";"5";"4";"1587486878";"1951"
"4331";"Desprivatización de polideportivos municipales";"<p>Hacer pública toda la gestión de los polideportivos municipales, establecer un precio para empadronados y gente en exclusión, que no debe superar en ningún caso los 150 anuales para el abono multiuso.</p>

<p>Para ello hice la siguiente propuesta, a ver que les parece.</p>

<p>Gracias.</p>

<p>https://decide.madrid.es/proposals/5729</p>
";"20/11/2015 08";"129";"116";"13";"5";"1601909431";"9262"
"4332";"Enrique de Castro como Defensor del pueblo";"<p>Hay que recuperar los valores de las instituciones, pero que esos valores no se quede en una sola una frase. En Madrid y en resto de España una persona que ha peleado por los más débiles, por los excluidos del sistema. Oiremos desde la conciencia, desde la realidad , desde lo más profundo del sistema la voz de los que siempre han estado obligados a estar callados. A esos, ahora, son a los que más tenemos que escuchar.</p>

<p>  No cuesta nada oír, escuchar a los nunca oímos y escuchamos. Podemos apoyar desde Madrid para todos.</p>
";"21/11/2015 10";"19";"7";"12";"1";"1592285470";"-184"
"4333";"Las cosas bien hechas bien parecen";"<p>El parquimetro en sábado no es otra cosa que un sistema de recaudación puro y duro pensado por los anteriores gobiernos que solo pensaban en recaudar al pueblo para luego (como se ha demostrado posteriormente) llenarse ellos sus bolsillos con esos dineros.</p>

<p>Si tienes un familiar en estado avanzado de edad o enfermedad y quieres aprovechar los sábados para atenderle y hacerle compañía, pues te va a salir caro.  Hay muchos de nuestros mayores viviendo en las zonas de recaudación SER, y sus hijos y familiares no tienen derecho a usar esas zonas si no es pagando y solo por un tiempo máximo, con lo que cuidar de ellos incluso los sábados es un problema.  No sería mejor dotar a esos MAYORES de un distintivo, aún sin tener coche, que permitiera aparcar a un familiar en su barrio, durante el tiempo que se está con ellos. Sobre todo los sábados, día que muchos de nosotros mas jóvenes, al no trabajar, aprovechamos para ir a cuidarlos, atender sus necesidades y no tener condicionada nuestra visita a un tiempo máximo de atención y cuidados.</p>

<p>El hacer esto realidad no es tarea dificil, solo habria que contemplar el poder emitir un distintivo especial de aparcamiento en zona SER, aunque sea solo algunas horas, a nombre de los MAYORES que lo soliciten. Sus familiares podrían ir a solicitarlo con algún documento de la S.S. o similar de su familiar, ya sea por su estado avanzado de edad o su enfermedad, para que no tengan ellos personalmente que tramitarlo o recojerlo. El informe de S.S. o similar sería la forma de evitar la picaresca Española de solicitarlo para una persona que no lo necesita. Estaría bien que las disposiciones y normas Españolas estuvieran pensadas para el bien de los Españoles y no para el bien de los cofres del dinero.</p>
";"22/11/2015 10";"45";"35";"10";"3";"1615784477";"1944"
"4334";"Optimizar horarios servicio de limpieza para evitar horas punta de cada zona";"<p>Pregunta: ¿Para qué se saca la basura por la noche si no se recoge hasta la mañana siguiente? Al menos en Aluche.</p>

<p>He leído alguno de los debates relativos a los horarios de los servicios de limpieza (ref: https://decide.madrid.es/debates/2388) y querría debatir un punto más.  </p>

<p>Desde hace algún tiempo vengo observando que en horario punta (normalmente alrededor de las 9 de la mañana) encuentro a los servicios de limpieza recogiendo la basura o baldeando las calles en zonas cercanas a colegios y oficinas, o cercanas a zonas de carga y descarga en horario de uso, zonas en definitiva en las que el tráfico a esa hora es muy abundante.  Me pregunto si no se podría evitar, ya que es frustrante encontrar atascos porque están recogiendo los cubos de basura o baldeando...  Reconozco la labor y el esfuerzo de todas las personas dedicadas a la limpieza de la ciudad.  Sin ellos Madrid sería inhabitable, pero seguro que se puede mejorar el servicio.  </p>

<p>En plena era digital, con tantos datos que se pueden recabar y analizar rápidamente, ¿no se podrían estudiar las rutas de los servicios de limpieza y los puntos calientes de la ciudad para encontrar un mejor horario para todos?</p>

<p>Atentamente</p>

<p>Un ciudadano de Madrid</p>
";"22/11/2015 22";"56";"55";"1";"2";"1626686048";"5303"
"4335";"Linea telefónica 010 gratuita para los ciudadanos";"<p>Hola a todos/as, me estreno en este foro de debates para pedir a nuestro Ayuntamiento que el teléfono 010 de información ciudadana sea gratuito. Los madrileños necesitamos está línea telefónica para múltiples cuestiones, dudas, preguntas, aclarar ideas, etc., sin embargo el inconveniente de hacer uso de este teléfono es que nos cobran dinero. Sabemos que si nos acercamos a nuestra Junta de distrito nos atienden pero ¿y si no podemos? , ya que tenemos este servicio a nuestra disposición desde casa ¿podría haber igualdad para todos en su uso? en mi caso estoy desempleada y como muchas otras personas en mi situación intento ahorrar en gastos todo lo que pueda.</p>
";"22/11/2015 22";"175";"173";"2";"4";"1631852555";"16904"
"4336";"Utilidad de Madrid Decide / Número de apoyos necesarios/Agrupación de propuestas";"<p>El pasado jueves 19/11 me he registrado y mi sorpresa es al ver mi número de usuario, que ronda el 55000, y según se indica en las propuestas se deben de tener 53726 apoyos, por lo que de inicio, debe rondar el 98% de los usuarios registrados y teniendo en cuenta que no todos siguen utilizando el portal, es totalmente imposible que se alcancen los apoyos suficientes en ninguna de las propuestas.</p>

<p>Por otro lado no sé porqué no se implementa un sistema en el que si un usuario detecta que dos propuestas son similares, solicite la reagrupación de las mismas, les llegue un correo a los creadores y si ambos dos deciden que se pueden agrupar, se genere una nueva propuesta con el conjunto de los apoyos obtenidos (eliminando duplicados). Los administradores de la nueva propuesta serían ambos o los que ellos de común acuerdo decidieran.</p>

<p> </p>

<p> </p>

<p> </p>
";"23/11/2015 09";"114";"108";"6";"10";"1633562617";"9663"
"4337";"#TúPreguntas: Javier Barbero, concejal de Salud, Seguridad y Emergencias";"<p>Hola a todas y todos. Me presento. Soy Javier Barbero, vuestro concejal del Área de Salud, Seguridad y Emergencias. Antes de tomar posesión de este cargo, ejercía como psicólogo clínico en el Hospital Universitario La Paz. Creo en la deliberación como una de las mejores herramientas que tenemos las personas para acercar posturas, es por ello que siempre escucho antes de tomar una decisión. Veo como una gran oportunidad participar en este espacio de entrevistas colectivas porque me va a permitir escuchar vuestras preguntas, inquietudes y dudas que tengan que ver con mi ámbito de actuación. Os invito  a que participéis y juntos poder avanzar en la elaboración de un nuevo modelo de ciudad para Madrid más saludable. El martes 24 a las 14:00 h. estaré a este otro lado para responder vuestras preguntas.</p>
<p>Actualización (15:00): Estimadas madrileñas y madrileños. Para mí ha sido estupendo compartir reflexiones con vosotros, al hilo de vuestras preguntas. Sin comunicación no hay posibilidades de hacer una buena política ciudadana conectada con las preocupaciones y con los sueños de los vecinos y vecinas de Madrid. Afortunadamente, las nuevas tecnología y el trabajo magnífico del equipo de Pablo Soto, nos permiten poder acercarnos. Necesitamos de vuestro aguijón, de vuestro apoyo, de vuestro interés por todo lo que significa convivir en Madrid, con criterios de respeto y de ayuda mutua. Compartir con vosotros es una necesidad. También un lujo. Gracias!</p>";"23/11/2015 10";"56";"43";"13";"117";"1629215313";"2303"
"4338";"LA APP DEL AYTO";"<p>Si generan una aplicacion haganlo bien. filtren las propuestas para que no se repitan.</p>
";"23/11/2015 12";"80";"78";"2";"7";"1633880297";"7409"
"4339";"limpieza transporte seguridad, vale...¿no va a cambiar Madrid en nada mas?";"<p>un poco de esperanza de algo mejor y distinto por favor</p>
";"23/11/2015 15";"31";"24";"7";"4";"1626482331";"1316"
"4341";"¿Permitir la entrada de perros con correa en edificios públicos?";"<p>Si un edificio es público y puede entrar cualquier persona ¿Por qué no puede entrar un perro con su correa ( y si es un PPP con bozal como indica la legislación)? Si el perro se porta mal,como pasa con las personas,se les invita a irse y punto,pero no tenemos que presuponer que van a molestar.</p>
";"25/11/2015 00";"167";"67";"100";"8";"1624381737";"-1323"
"4342";"Dar la opción de eutanasia para violadores y maltratadores";"<p>Posibilidad de elegir la eutanasia para violadores y maltratadores. Puede ser una manera de desbloquear un conflicto político que no encuentra tratamientos efectivos.</p>
";"25/11/2015 14";"62";"19";"43";"5";"1632244750";"-735"
"4343";"Todos contra la violencia de Genero";"<p>insultar no es amar, pegar no es respetar, someter es inseguridad, sometimiento es miedo, no cerremos los ojos, a muchas nos ha costado mucho salir, rehacer nuestra vida, y aun así, cada dia es una lucha por conseguir sobrevivir con los recuerdos y la culpa, mi respeto hacia las 48 mujeres que este año se han marchado, y mi enhorabuena a todas las que si pudimos huir</p>
";"25/11/2015 14";"110";"106";"4";"6";"1656027186";"9829"
"4344";"Transporte público 'dogfriendly'";"<p>Madrid y su transporte público es una ciudad poco amigable para los perros como mascotas. Su normativa es muy restrictiva en comparación con otros países europeos lo que hace que los propietarios de perros tengamos que ser más asociales cuando nuestra naturaleza es la contraria. Por otro lado, nos obliga y condiciona a hacer uso del coche privado como medio de desplazamiento contribuyendo así a una mayor contaminación. </p>

<p>¡Por un Madrid Dogfriendly!</p>
";"25/11/2015 21";"163";"88";"75";"4";"1645600992";"701"
"4345";"Que las empresas paguen el coste del transporte de los trabajadores";"<p>Si el coste del transporte a la empresa de las materias primas y de la energía es un coste empresarial, el coste del transporte de los trabajadores debe de tener igual condición. El principal beneficiado del servicio de transportes municipal es la empresa y por eso debe pagarlo, porque es un compoente inherente a su actividad industrial. Además, gracias a él tiene a su disposición una inmensa oferta de trabajadores y no sólo los que podrian acceder andando, exceso de oferta que le permte disminuir los salarios.</p>

<p>Que la empresa asuma este coste laboral no permite considerarlo un ingreso del salario del trabajador pues es un elemento de coste de la empresa para poder disponer de los recursos humanos necesarios para su actividad industrial que, en consecuencia, formará parte de sus costes de producción.Eso, además, significaría una discriminaciòn laboral respecto a los trabajadores que pueden ir andando a su trabajo por estar cerca de su domicilio a los que no se le imputaría ese coste pero sí a los que, a igual trabajo e igual remuneraciòn,verían artificialmente elevado su salario para tender un coste empresarial que debe ser atribuido a la empresa.</p>

<p>Al trabajador le perjudica más que le beneficia el sistema de transporte municipal. Aunque es innegable el beneficio de poder encontrar un trabajo, probablemente mal pagado por exceso de oferta, esa opciòn le sale muy cara porque tiene un doble coste: en metálico el precio del transporte y en especies el del tiempo que pierde en ir al trabajo y regresar a su casa que en ciudades como Madrid o Barcelona puede alcanzar las dos horas diarias, a veces más, y el aumento de riesgos de accidentes in itinere que no es despreciable. </p>

<p>Este segundo coste desborda al trabajador y llega a su entorno familiar y social por las consecuencias nefastas que ello puede tener:</p>

<p>a.- para que la mujer - ¡la eterna víctima! - pueda verse liberada al poder ejercer una vida autònoma y realizando sus capacidades</p>

<p>b.- para ambos, al reducirse su tiempo para mantener una relaciòn social con su familia y amigos y en actividades de la sociedad civil y como consecuencia de esa falta de tiempo para desarrollar relaciones familiares y sociales aumenta el número de d delincuentes juveniles privados de una educaciò¡ón familiar adecuada en el momento en el que era necesaria.</p>

<p>c.- para los hijos a los que no ve en todo el día y no pocas veces los ve ya dormidos cuando vuelve del trabajo, una falta de relaciòn, mayoritariamente paternal, que implica además de una frustraciòn parental un deterioro en su educación afectiva y social</p>

<p>d.- para la sociedad civil, que como consecuencia de ello ve como disminuye el tiempo que los ciudadanos soidarios dedicaría a mil y una actividades socialmente beneficiosas.</p>

<p>Para enderezar este entuerto caben, entre otras, dos formas de plantearse la atención a este coste: a) de modo específico y b) de modo genérico.</p>

<p>a) El modo específico, menos eficiente, consiste en que los trabajadores entreguen a la empresa eljustificante de su coste (billetes diarios, bono mensual, coste del transporte privado con una tasa específica, etc.) lo que impica un coste de contabilidad indeseable.</p>

<p>b) El modo genérico, más eficiente, consiste en que cada empresa entregue a sus trabajadores un bono mensual de transporte municipal de precio reducido porque sólo es válido durante la jornada laboral porque se trata de atender un gasto vinculadio a la asistencia al trabajo.</p>

<p>Las ventajas de este segundo modelo son muchas.Ya hemos citado su mayr simplicidad respecto al gasto que implicaría el control de los billetes de todos y cada uno de los trabajadores. A ella se suma que muchos trabajadores para los que la disminuciòn del coste del transporte público no les compensa su mayor incomodidad respecto a ir en su propio vehículo verían ya más atractivo el uso del servico publico a coste cero:</p>

<p>La primera consecuencia, un beneficio social, sería la disminución de la contaminaciòn del medio ambiente;</p>

<p>la segunda consecuencia, otro beneficio social, sería la mayor rentabilidad de un servicio al aumentar sus usuarios</p>

<p>la tercera consecuencia, otro beneficio personal y social, sería la reduccion del paro al necesitarse más conductores para asumir el incremento de la demanda del servicio publico que está en situaciòn de colapso en horas punta.</p>

<p>la cuarta consecuencia, un beneficio personal y social, sería reducir el tiempo perdido en atascos al disiminuir el número de vehículos privados circulando, ya comentada más arriba.</p>

<p>la quinta consecuencia, otro beneficio personal y social, sería que al reducir el gasgto del transporte - ¡que además es más caro para quienes tienen que perder más tiempo en ir a su trabajo! - sería que esta disminución de coste gravando el salario aumentaría la demanda de bienes y servicios loque conribuiría a reecucir el paro: supuesto un precio medi de 50 /mes y 1 millon de trabajadores en Madrid eso incrementaría la capacidad de compra en 50 millones  mensualmente y oro tanto en las demás poblaciones.</p>

<p>En los conglomerados metropolitanos donde es habitual que los trabajadores vivan en los municipios adyacentes el ámbito del coste que deben sufragar las empresas debe limitarse asu propio ámbito municipal. De este modo si los trabajadores son ajenos al municipio donde está la empresa cabe una combinacion de uso de transporte privado hasta el límite del municipio y luego un transporte público, evitando así la contaminacion urbana por exceso de concentración de ciudadanos ajenos al municipio que sufren principalmente sus residentes.</p>

<p>Es de esperar que este esquema de imputacion de costes de tansporte, que por ser el más lógico es el máseficiente, acabe por ser incorporado por el Ministrio de Trabajo dentro de su regulación genérica. </p>
";"30/11/2015 11";"89";"61";"28";"4";"1695637199";"2261"
"4346";"#TúPreguntas: José Manuel Calvo, concejal de Desarrollo Urbano Sostenible";"<p>Soy José Manuel Calvo, doctor arquitecto. Mi compromiso político y social tiene su origen en la decisión de formar parte del cambio que nos trae la nueva política a partir del 15M. Actualmente asumo la responsabilidad del área de Gobierno de Desarrollo Urbano sostenible, cuyo objetivo es el de confeccionar y desarrollar un urbanismo en Madrid que concilie las sostenibilidad, la participación ciudadana y la absoluta transparencia. Estoy decidido a devolver Madrid a las personas, a puertas abiertas, desde la responsabilidad, el rigor, la sensatez y la modernidad. Apuesto radicalmente por el modelo de ciudad que lidera Manuela Carmena.</p>

<p>El miércoles 2 a las 13:00 h. responderé a vuestras preguntas.</p><p>Actualización (14:00): Os dejo de momento. Muchas gracias a tod@s por participar y lamento no haber podido responder todas las preguntas. Intentaré seguir respondiendo en la medida que el tiempo lo permita. Un fuerte abrazo,</p>";"01/12/2015 12";"72";"46";"26";"160";"1708606573";"1277"
"4347";"Guarderías hasta las 22 hs";"<p>Guarderías públicas hasta las 22 hs.</p>

<p>Por motivos profesionales muchos ciudadanos no terminan su jornada laboral hasta las 21 o 22 horas. Haría falta guarderías públicas ya que es imposible compaginar la vida laboral y familiar. </p>
";"01/12/2015 21";"70";"39";"31";"5";"1704542863";"445"
"4348";"METRO";"<p>Hola, me llamo M.Angeles y llevo ya casi 4 años en el paro (desesperación ),hace un mes y medio me enteré  que próximamente se iva abrir una convocatoria para el metro, aunque no se sabía cuando,  he ido a la oficina del inem varias veces para apuntarme, y no sabían nada de nada y no tenían ningún tipo de información , pues bien,  me he enterado que esa convocatoria ya se ha cerrado y ya se esta llamando a gente para llevar documentación y examinarse, sin haber tenido la oportunidad de apuntarme, como es posible que se habra y cierre una convocatoria sin que se enteren en las oficinas del inem??.</p>

<p>A donde tengo que acudir si volviesen  abrir otra convocatoria y poder apuntarme??.</p>

<p> </p>
";"02/12/2015 09";"18";"11";"7";"5";"1708583410";"244"
"4349";"se puede poner en marcha alguna clase de ayuda o subvencion";"<p>para los habitantes de Madrid sin niguna clase de ingresos y sin personas a su cargo,que nunca hayan cobrado ningun tipo de ayuda ni subsidio desde hace mas de 2 años y que evidentemente se encuentren al borde de la exclusion social</p>
";"02/12/2015 15";"29";"23";"6";"2";"1716743281";"1348"
"4350";"cALDERAS DE CARBON EN MADRID Y GASOIL";"<p>Hola, con la contaminacion que hay estos dias en Madrid, me sorprende leer que hay 500 calderas de carbon en Madrid, yo no puedo hacer propuestas por que vivo en un pueblo de la periferia, propongo que alguien empadronado en Madrid haga la peticion para sustituirlas por energias limpias (gas o biomasa) y las de gasoil tambien. </p>

<p>Siempre me he preguntado por que no se superan los limites de polucion en los meses de primavera y verano y siempre saltan en noviembre ¿seran las calderas?</p>
";"02/12/2015 16";"63";"55";"8";"9";"1722255635";"4103"
"4351";"Esta web sirve para algo??";"<p>Hacen falta en torno a 50.000 apoyos para que una propuesta se debata, y la que mas tiene son 7 mil y pico votos...!! Es bastante decepcionante, mejor gastar la pasta y el esfuerzo en otra cosa, sinceramente....</p>
";"03/12/2015 17";"94";"72";"22";"13";"1730841498";"3829"
"4352";"Pagar aparcamiento en los hospitales";"<p>Buenos días a todos, ésta mañana, a primera hora, he ido al hospital Infanta Leonor y cada vez que voy me llevo un cabreo impresionante por tener que pagar el aparcamiento. Me parece un abuso y rozando la sinvergozonería hacer esto. Normalmente a los hospitales la gente va en coche y cobrar por aparcar no me parece normal.</p>

<p>Saludos cordiales</p>
";"04/12/2015 09";"95";"82";"13";"21";"1740611267";"5955"
"4353";"Estimada Carmena: vehículos de alta gama que SI pueden aparcar en doble fila ";"<p><strong>Estimada Carmena</strong>,</p>

<p>No puedo empezar este debate sin manifestar la decepción que voy acumulando día tras día.</p>

<p>Espero que este sea el foro adecuado para ser leído:</p>

<p>Existe un coche que apoyo al 100%, que pasa por ""todos"" los barios con su cámara multando todo vehículo que invade el carril bus o que aparca en doble fila.</p>

<p>Sin embargo, en mi barrio (Reina Mercedes, Comandante Zorita, Basílica, ...) este coche DESAPARECE los sábados y domingos a mediodía. Un misterio.</p>

<p>Estoy cansado de llamar a la policía. Delante de <u>60 coches (no exagero) aparcados en doble fila</u> en el Opazo, Combarro, Gaztelu, ... el señor agente me dijo: ""<strong><em>TENEMOS ORDEN DIRECTA DE HACER LA VISTA GORDA</em></strong>"". </p>

<p><u>Juro aquí en público que esto es verídico.</u></p>

<p>Al día siguiente un vecino como yo que no se puede ir a comer en un Maseratti al Opazo, para en doble fila en la farmacia (mal por mi parte), y ahí está el coche con la cámara poniendo multas.</p>

<p>Es simplemente indignante esta doble vara de medir que lleva instaurada varios años, y que pensé que su Gobierno iba a erradicar de raíz. </p>

<p>Muchas gracias señora Carmena por su pronta intervención en este asunto.</p>

<p>(Por favor, añadir comentarios con mismo problema en más barrios, en lugar de abrir nuevos debates, así conseguiremos más apoyos).</p>

<p>Sergio J.</p>
";"04/12/2015 12";"96";"84";"12";"23";"1742247820";"6300"
"4354";"Parquimetros. El Chiringuito de los trabajadores sanitarios públicos.";"<p>Queria abrir un debate respecto a este curioso dato:</p>

<p>El personal de hospitales publicos y algunos centro de salud estan autorizados a aparcar en la zona de SER sanitaria sin abonar tarifa alguna con la mera colocación de un distitivo ""autofabricado""</p>

<p>¿es curioso que algunos profesionales PUBLICOS, tenga un privilegio como es aparcar en una zona regulada sin abonar la tarifa ni respetar la limitacion de horas maximas?  debe ser que con la plaza de MIR o de funcionario sanitario de dan un certificado de imposibilidad de utilizar el transporte publico. Es frustante ver como ciertos lobbies consiguen unos privilegios que no les corresponden a traves del chantaje.</p>

<p>Como muestra, SER  zona hospitalaria del hospital La Paz.</p>

<p>Pd: abstengansen los comentarios respecto a las urgencias medicas, estan contempladas y este caso no se refiere a ellos.</p>
";"04/12/2015 12";"40";"29";"11";"7";"1735265437";"1305"
"4355";"Ajustar el precio del transporte público al momento real";"<p>Mi propuesta se basa en ajustar el precio del transporte público al horario y las circunstancias del tráfico apoyándose en las nuevas tecnologías para informar al usuario en tiempo real.</p>

<p>En estos tiempos en los que todo el mundo mira al móvil más que a lo que tiene delante no es comprensible cómo un transporte como el Metro, en el que todo está monitorizado, el precio del billete no se ajuste al momento real.</p>

<p>Si nos encontramos en circunstancias como las actuales, en las que la contaminación del aire es muy alta, debería de haber ciertas promociones que fomenten que la gente use el transporte público para solventar el problema, como rebajas en el precio del billete, actual o futuro.</p>

<p>Si los ciudadanos pudieran obtener una información detallada instantáneamente, así como alertas en el móvil de que a determinadas horas los trenes están vacíos se podría ajustar el precio con alguna rebaja e informar al usuario más rápidamente, o incluso bonificarle para que siga usando en el futuro este transporte.</p>

<p>Además aunque no se utilizara en ese momento, desde la administración se podría concienciar al ciudadano de que usara más las infraestructuras de transporte públicas con ciertas alertas en el móvil, al igual que cualquier mensaje informativo relacionado como que se utilicen ciertas líneas de transporte si se desea llegar a un determinado destino.</p>

<p>En definitiva, sugerir al usuario qué debería de hacer y fomentar que usara más los medios de transporte públicos a través de las nuevas tecnologías.</p>
";"04/12/2015 12";"73";"60";"13";"5";"1739683340";"3863"
"4356";"Limpieza de colillas por niños!!!";"<p>que opinan sobre la última de la alcaldesa?los niños,con un premio como recompensa,recogen colillas de las calles.se afectará el concurso en horario escolar?sera una asignatura más?el premio es un paquete de tabaco entero?se acabaron las tardes en los parques?en Corea del Norte se hace exactamente igual con niños que provienen de familias de ""rebeldes"" o minusválidos como""mano de obra defectuosa"".que buen ejemplo a seguir</p>

<p>que paso con los famosos 500 nuevos empleados de limpieza?si los universitarios  y los niños limpian,las calles de la capital van a relucir más que nunca,cosa que en mi barrio,niño Jesus,no es el caso debido a las ratas muertas que hay desde hace 8dias y en la junta de distrito,una funcionaria me certifica que con ""esto del puente""hasta el miércoles no hay nada que hacer(.queja puesta el jueves a 9h23)</p>
";"04/12/2015 17";"88";"15";"73";"21";"1724182459";"-988"
"4357";"Medidas anti polución para Madrid propuestas ";"<p>sra alcaldesa, creo que todas las propuestas tanto de técnicos en medio ambiente como las ideas aportadas por los ciudadanos deberían tenerse en cuenta para hacer frente a esta situación de alta polución. No como algo puntual sino para mejorar el aire que respiramos todos, turistas incluidos que visiten la ciudad. Hagamos de Madrid un sitio mejor para nuestras familias. Por qué no valorar tantas propuestas hechas sobre mejoras en transporte público, conexiones tipo autobús lamzadera desde el extraradio al centro, parkings gratuitos cerca de m30, billete único de bus/metro para hacer trasbordos como ya se hace en otras capitales europeas, bicis disponibles fuera de m30, e incluso gratuidad de transporte público los días quese superen los niveles de alerta? Prohibir el parking en la zona ser no reduce l contaminación. Hay tránsito de coches aún y se puede aparcar en parkings de pago, es poco o nada efectivo. De hecho la zona verde obliga a mover el coche cada 2h aprox hace que haya mas movimiento de coches y arranques de motor y pardas que el propio tránsito. Seamos serios y hagamos las cosas con el apoyo de profesionales a la hora de tomar medidas. No seamos de copiar lo q se hace en ciudades como mexico df que sigue teniendo una elevadísima contaminación ni parís, hay que actuar pensando en medidas sostenibles en el tiempo y efwctuvas.suerte</p>
";"04/12/2015 23";"80";"77";"3";"13";"1748167588";"7122"
"4358";"que las empresas paguen un contributo mayor a la seguridad social ";"<p>los trabajadores y trabajadoras no solo regalan el tiempo y esfuerzo fisico al patron a cambio de un salario, tambien lo hacen con su salud que posteriormente debemos sufragarla con los impuestos, visto que el deterioro de esta salud esta fundamentalmente radicada en la actividad laboral son los empresarios los que deben aportar un mayor cantidad de dinero destinada a la sanidad.</p>
";"05/12/2015 08";"38";"18";"20";"2";"1732877388";"-94"
"4359";"Contaminación acústica en Malasaña";"<p>Me gustaría saber si aquel que está en su casa quisiera estar tranquilo, escuchar música, leer un libro, incluso dormir sin que parezca que tiene fiesta todos los días de la semana porque el ruido de la calle provocado por la gente que se agolpa parece que tiene la juerga en tu propia casa. Es lo que estoy sufriendo día tras días. Harta y cansada de usar tapones de los oídos para poder tener algo de descanso. Ocio si, pero dejando que los demás puedan también descansar.</p>
";"05/12/2015 11";"73";"62";"11";"7";"1749980850";"4331"
"4360";"De verdad tenemos que ver una Navidad tan sucia en Madrid?";"<p>MADRID SEPULTADA BAJO LA BASURA</p>

<p>Indudablemente, la mejor manera de ver algo limpio es no mancharlo, si es cierto, pero anoche a las 12 de la noche andar por el centro: plaza mayor, sol y calles cercanas daba vergüenza ajena. Adoro MADRID, pero anoche se sepultaba bajo la basura y no había nadie para remediarlo ¿De verdad no es posible algún servicio de limpieza especial por la noche los fines de semana? De verdad daba ganas de llorar uno creo que sea un tema de presupuesto. Son zonas muy determinadas en fechas muy concretas. Y no había Nadie. Desolador</p>
";"06/12/2015 11";"100";"90";"10";"11";"1762598164";"7200"
"4361";"Acogimiento de refugiados ----> inscripción de ""hogares""   (Actualizada).";"<p>*CONTINUACION*</p>

<p>De conformidad con el interés general y Recomendaciones del propio sitio, permitan todos Vds. por favor que soslayando la <u>re-iteracion del Texto</u> inicial  (véase   https://decide.madrid.es/debates/4164 )  se deje aquí limitada <em>constancia del propósito</em> a que dicha inserción anterior estaba entonces referida:</p>

<p>--  La directa e individual INICIATIVA de los <strong>ciudadanos particulares</strong> que a título estrictamente personal se han adelantado a sus propias ""instituciones"" para sobrepasarlas espontáneamente con una -ejemplar- dedicación, sin esperar ya más a que éstas consigan mientras organizarse en Recomendaciones, Sugerencias, Consejos, Arengas, Admoniciones ni Exhortos.</p>

<p>-- Por ello, aun redactada en idiomas inglés/árabe/alemán se les ofrece ahora esta revisión mediante su URL al siguiente sitio donde encontrar muestra  (http://www.refugees-welcome.net/ )  de los pasos con que caminan ya por otras latitudes... para admiración de propios y extraños.</p>

<p>Con gratitud sincera, por la consideración dispensada a cuant@s hayan prestado unos instantes de su tiempo, quédol@s muy profundamente deudor.</p>

<p>MchGrcs.</p>
";"06/12/2015 15";"35";"11";"24";"1";"1743552987";"-408"
"4362";"#TúPreguntas: Julio Lumbreras, experto en contaminación medioambiental";"<p>Doctor Ingeniero Industrial por la Universidad Politécnica de Madrid. Profesor Titular de Ingeniería del Medioambiente en la Escuela de Ingenieros Industriales de la Universidad Politécnica de Madrid. Subdirector de Ordenación Académica en la Escuela de Ingenieros Industriales. Miembro del grupo de investigación en Tecnologías Ambientales y Recursos Industriales de la UPM y el centro de Innovación en Tecnologías para el Desarrollo Humano de la misma Universidad. Representante de España en el grupo de trabajo del Convenio de Ginebra sobre modelización y evaluación integral de la calidad del aire. Coautor de 28 libros y 40 artículos en revistas internacionales. Participante en más de una cuarentena de congresos o talleres de ámbito nacional e internacional, en 33 proyectos de concurrencia competitiva y más de 30 proyectos con organizaciones privadas.</p>

<p>Miembro de la Mesa de Expertos del Ayuntamiento de Madrid que está trabajando en el nuevo Protocolo ante casos de alta concentración de NO2.</p>

<p>Puedes dejar tus preguntas sobre medioambiente, contaminación o calidad del aire. El miércoles 9 a las 18:00 h. se abrirá la entrevista coleciva.</p>
";"07/12/2015 16";"44";"36";"8";"74";"1771250078";"2290"
"4364";"Posibilidad de apoyar o no apoyar propuestas.";"<p>Buenos días,</p>

<p>me parece interesante que se puedan apoyar las propuestas ciudadanas pero creo que esta web debería ofrecer también la posibilidad de que los ciudadanos puedan mostrar su rechazo a las propuestas con las que no estén de acuerdo. Me parece que con esa opción se ganaría en democracia real para avanzar en las propuestas que tengan más apoyos y menos rechazos. ¿Que opinais sobre este debate para mejorar esta herramienta ciudadana?</p>

<p>Saludos.</p>

<p> </p>

<p> </p>
";"12/12/2015 11";"56";"46";"10";"1";"1818018515";"2957"
"4365";"Educar a fumadores";"<p>A la señora Carmena habría que recomendarle que en lugar de hacer recoger las colillas a los niños, tiene que ""EDUCAR"" a los fumadores que van por las calles de Madrid, tirándolas por todas partes, porque son unos ORDINARIOS, VULGARES, SUCIOS, GUARROS, MAL EDUCADOS, ASQUEROSOS, COCHINOS, INCULTOS que no tienen en absoluto consideración alguna con los demás ciudadanos que disfrutamos caminando por las calles de Madrid. Es así como van por allí, de un lado para otro en la acera tirándonos a la cara su ""humo cancerígeno"", sin importarles si es un anciano, una mujer embarazada, un discapacitado, un niño (a los que propone que recojan sus sucias colillas con sustancias tóxicas). Si señora Carmena, eduque primero a estos personajes que se creen dueños de la ciudad y que ya se molestaron hace unos cuantos años, cuando no les permitieron fumar en los bares, donde no se podía ya beber una caña o un aperitivo, ni degustar una tapa con tranquilidad, por estar eludiendo el humo.</p>
";"13/12/2015 10";"120";"99";"21";"14";"1830711247";"6434"
"4366";"Reconvertir solares abandonados y descampados en zonas verdes";"<p>sanear solares abandonados y descampados y reconvertirlos en parques y zonas verdes con zonas infantiles y aparatos de gimnasia para mayores.</p>

<p>en la calle vizconde de Matamala esquina con calle Bocángel hay un solar que lleva muchos años abandonado y vallado, sería una buena propuesta para la zona hacer un parque con zonas verdes donde la gente que vive aquí para pasear y eliminar un foco de suciedad</p>
";"16/12/2015 09";"195";"188";"7";"8";"1866146031";"17450"
"4367";"¿Es tan difícil que haya un pacto para promover el empleo sanitario público?";"<p>Es bien sabido que los hospitales públicos de Madrid son gestionados por la Comunidad de Madrid, ¿no podría el Ayuntamiento pactar con la Comunidad de Madrid y con los hospitales para que abran su bolsa de Empleo y contratar?, ya que hoy por hoy, tales bolsas están CERRADAS sin darnos oportunidad alguna sin tan siquiera poder entregar nuestro CV. </p>

<p>Por si a alguien le interesa, aqui dejo la propuesta que también está hecha, por si alguien la quiere apoyar.</p>

<p>https://decide.madrid.es/proposals/6728</p>

<p>Gracias.</p>
";"16/12/2015 12";"49";"43";"6";"0";"1859576738";"3246"
"4368";"Juntar propuestas similares o repetidas para poner unificar los votos";"<p>Esta web o el administrador de la misma deberia dar la posibilidad de juntar en una misma votación propuestas similares o complementarias para unificar las votaciones. Depues de revisar las diferentes propuestas que hay en esta web me he dado cuenta que hay muchas propuestas similares o complementarias y tendría que haber alguna forma de unificarlas en una sola o juntar varias propuestas complementarias relativas al mismo tema.</p>
";"16/12/2015 15";"195";"191";"4";"5";"1869205144";"18316"
"4369";"Ayudas para ascensores";"<p>Muchos de los los edificios y las personas de Madrid se van haciendo mayores, una gran mayoría de edificios no posee ascensor. Desde hace años se han eliminado las subvenciones de Comunidad y el coste puede estar entre los 80 y los 120 mil  por edificio, lo que supone un gran desembolso.</p>

<p>Creo que el ayuntamiento deberia ser consciente de la realidad de much@s de l@s madrileñ@s y ayudar a la instalación de ascensores y por tanto la eliminación de barreras arquitectónicas.</p>

<p> </p>
";"16/12/2015 19";"102";"92";"10";"2";"1865747729";"7396"
"4370";"Organizar tematicamente los debates de la web Madrid Decide";"<p>Los criterios que actualmente existen para filtrar la informacion de los debates y propuestas ( novedad, popularidad...etc) resultan insuficientes y tal vez seria mejor organizar tanto los  debates como las propuestas primero temáticamente y después hacer posible que se delimiten en función de los criterios mencionados anteriormente. Aunque se pueden etiquetar, hay demasiadas opciones y es un poco confuso.</p>
";"19/12/2015 11";"85";"82";"3";"1";"1893523158";"7621"
"4371";"Ciudadanos no empadronados";"<p>Vivo en un pueblo de la Sierra y trabajo en el centro, cerca de Cibeles, por lo que ""padezco"" la ciudad como cualquiera, pero no puedo participar en las propuestas.</p>
";"19/12/2015 12";"76";"24";"52";"29";"1870738017";"-884"
"4372";"Accesos Sanchinarro";"<p>Es necesario estudiar al alternativas al colapso que está sufriendo Sanchinarro y Las Tablas con la llegada de BBVA al barrio. Es necesario crear un acceso a M40 en las Tablas. También es necesario colocar badenes en Niceto Al calá Zamora 89-91, ya que es una calle plagada de colegios y los coches vienen lanzados de LAS Tablas</p>
";"20/12/2015 10";"75";"69";"6";"3";"1901490462";"5796"
"4373";"Actividades ludicas en el Pardo";"<p>El Pardo es una zona privilegiada por su contacto con la naturaleza y seria bueno,ya que no existe,la posibilidad de alquilar bicicletas y sillas de ruedas electricas, pues todos tienen derecho a estar en contacto con la naturaleza</p>
";"22/12/2015 11";"59";"44";"15";"7";"1916393750";"2162"
"4374";"Propuesta de cambio de calles franquistas, mis nombres ¿Que os parece?";"<p>Bachata de Belchite (Arganzuela)----- Doña Juana (Lo que propusieron)</p>

<p>Hermanos Falcó y Alvarez de Toledo (Barajas) ----- Plaza Mayor de Barajas</p>

<p>Muñoz Grandes------Hospital Militar</p>

<p>General García de la Herran---- Enrique Tierno Galvan</p>

<p>Juan Puyol ----- Plaza de la Movida Madrileña (Porque en el barrio de Malasaña fue el centro de la movida)</p>

<p>Plaza Arriba España------ Plaza de Blasco Ibañez</p>

<p>Caidos de los División Azul--------Real Madrid</p>

<p>General Asensio Cabanillas---------El Bosque</p>

<p>General Davila---------- Calle de la Loteria (Por el antiguo salón de la Loteria que estaba por la zona)</p>

<p>General Kirkpatrick------- Calle Charles Chaplin</p>

<p>Plaza Caudillo-------------Plaza de la Libertad</p>

<p>Calle Primero de Octubre-------- Rio Manzanares</p>

<p>Capitan Cortes------Mi idea era Luis Aragones, pero es del barrio de Hortaleza, pero voy otro personaje celebre del barrio, un escritor Isaac Rosa</p>

<p>Estanislao Gomez--------Nelsón Mandela</p>

<p>General Fanjul--------------Avda de Aluche</p>

<p>Avenida General Astray-------- Avda de San Isidro</p>

<p>Avenida del Arco de la Victoria-----Avda de la Universidad</p>

<p>Paseo de Sagardía-Ramos-------Paseo de Lina Morgan</p>

<p>Crucero Baleares------------ Angeles Rodriguez (La abuela rockera)</p>

<p>Francisco Iglesias-----------------Payaso Miliki</p>

<p>Comandante Zorita---------Martin Luther King</p>

<p>General Orgaz----------------América Latina</p>

<p>General Yague------------------John Lennon</p>

<p>General Varela-------------------Jose Saramago</p>

<p>Hermanos García Noblejas------Arturo Soria (continuación)</p>

<p>Pasaje General Mola-----Pasaje Principe de Vergara</p>

<p>Plaza Fernandez Ladreda--------Plaza Eliptica</p>

<p>General Moscardó---------------Africa</p>

<p>General Saliquet------------------Madre Teresa de Calcuta</p>

<p> </p>

<p>Yo creo que son buenos nombres, ¿Y a vosotros?  ¿Qué os parece?.</p>

<p> </p>

<p> </p>
";"22/12/2015 20";"116";"41";"75";"31";"1903528204";"-1201"
"4375";"Sobre perros y demás";"<p>Mucho discutimos sobre si los perros manchan y molestan, pero se nos olvida, a mi juicio, lo principal:  Los humanos ¿tenemos derecho a ellos?   Me lo recuerda cuando leo sobre los esclavos, que definimos: Que carecían de libertad y derechos propios por estar sometidos de manera absoluta a la voluntad y el dominio de otras personas que es su dueña y que pueden comprarlos o venderlos como si fueran una mercancía.</p>

<p>¿No hacemos igual con los animales?  ¿Hasta cuando?  Y encima nos escudamos en que les cuidamos y atendemos... como a los esclavos, que también mantenían por el valor que tenían.</p>
";"24/12/2015 12";"72";"31";"41";"33";"1923129661";"-430"
"4376";"NO AL CAMBIO DE NOMBRES DE LAS CALLES EN MADRID";"<p>Soy un madrileño que nació en Democracia, y que estudió la historia de España en los libros de texto. Creo que el cambio del nombre de las calles es un debate político, pero que va a influir en el día a día de los ciudadanos, que respetamos dicho debate, pero que nos mantenemos ajenos a el. Me gustaría saber quién se va a hacer cargo de los costes económicos, y de tiempo, en el cambio de domiciliaciones, documentos oficiales, tarjetas sanitarias, registro de la propiedad.... Por favor, cuando se tomen decisiones políticas  de esta índole, piensen en las consecuencias pragmáticas de ello.</p>
";"24/12/2015 13";"260";"132";"128";"43";"1931954145";"203"
"4377";"Posibilidad de solicitar las placas de las calles que cambien de nombre";"<p>Dado que esas placas se han pagado con dinero público (osea, dinero de todos los madrileños que durante años, mes a mes, han pagado religiosamente sus impuestos con su esfuerzo y su trabajo) no vería mal entregar las placas a los madrileños que lo soliciten.</p>

<p>Supongo que la idea inicial del ayuntamiento será tirarlas (o reciclarlas), pero para muchos madrileños,por un motivo u otro, esas calles tienen un significado emocional, histórico, familiar o de niñez, y nos gustaría tener esas placas como recuerdo.</p>

<p>Sé que otros muchos madrileños no compartirán mi sentimiento hacia una/s determinada/s placa/s, y poniendo por delante de ellos todo mi respeto, pido el mismo hacia mi idea.  </p>

<p>¿Creeis que debería abrirse un listado de solicitud de las placas? Eso, o directamente plantarnos el día que las retiren y pedírselas amablemente al operario, aunque dudo mucho que tenga órdenes de cedérselas a quien se acerque a pedírselas.... </p>
";"28/12/2015 04";"70";"26";"44";"6";"1957532819";"-668"
"4378";"RESPETO A LAS TRADICIONES: LOS REYES MAGOS Y LA CABALGATA.";"<p>¿Jugaríamos con las tradiciones de otras religiones? ¿Por qué las tradiciones cristianas/católicas y españolas no merecen el respeto de nuestros políticos? No seamos ""falsos progresistas"". Dejemos de urgar donde ni es necesario ni nadie nos ha llamado a hacerlo.</p>

<p>Dediquen sus esfuerzos de innovación y su creatividad para aquellos aspectos que realmente lo demandan, y no para chafar creencias y tradiciones, que, aunque no les guste, comparten muchos ciudadanos.</p>

<p>Dejen a nuestros Reyes Magos que sigan siendo lo que son: Gaspar, Melchor y Baltasar.</p>

<p>La igualdad de la mujer no requiere de patochadas, si no de un verdadero trabajo por igualarnos en derechos. Como mujer no me aporta nada ""hacer de hombre"" ni copar puestos de altura por cubrir porcentajes, lo que de verdad me gusta es que valoren mis cualidades y mi potencial como profesional y como persona, independientemente de mi sexo.</p>

<p>Por favor, dejen de ser ""tan progres"" o acabarán con las raíces y valores de nuestra sociedad.</p>
";"28/12/2015 09";"228";"134";"94";"36";"1974295329";"2350"
"4379";"Agrupar las sedes judiciales de manera sostenible";"<p>Las sedes judiciales disgregadas por todo Madrid generan muchos retrasos en señalamientos de vistas y suponen un lastre a la implantación de la nueva oficina judicial. La Ciudad de la Justicia, lanzada para acabar con esta dispersión, acabó en fiasco por el modelo especulativo en el que se apoyaba y, al cancelarse la operación, lo bueno que ésta pudo traer se perdió.</p>

<p>En definitiva, un agrupamiento de sedes tiene muchas ventajas, entre las que se puede citar la mayor proximidad y agilidad de la Administración de Justicia y el ahorro en tiempos de desplazamiento.</p>

<p>¿Por qué no, superado el caduco modelo de campus, se crea un palacio de Justicia en vertical, que albergue todos los órganos en unos pocos edificios de gran altura, con gran aprovechamiento del suelo, energética y económicamente sostenible y en un área no alejada del centro (Castellana Norte, Operación Mahou...)?</p>
";"28/12/2015 12";"56";"48";"8";"4";"1979494196";"3428"
"4380";"Replanteamiento de las glorieta Carlos V y rotonda en Pº Infanta Isabel";"<p>La glorieta Carlos V y la ""semi rotonda"" en Pº Infanta Isabel (monumento a las víctimas del 11-M) son un despropósito circulatorio. A continuación una muestra de los problemas:</p>

<ul>
	<li>Muchísimo tráfico, al encontrarse entre varios ejes de alta capacidad (casi ""autopistas urbanas"": Pº Santa María de la Cabeza, Ronda de Atocha, Ciudad de Barcelona y Avda Mediterráneo. Se deberían hacer nuevos planteamientos para distribuir el tráfico por otros ejes, y bajar el número de carriles en esa zona. </li>
	<li>Peligroso y poco práctico para bicicletas. Lo cual es un despropósito teniendo en cuenta que Atocha es un intercambiador importantísimo y que está rodeado de al menos tres bases de biciMad (que por cierto, están bastante mal situadas si el interés es hacer continuidad del cercanías).</li>
	<li>Sentido Embajadores -&gt; Conde Casal: la anchura de la calzada varía al salir del paso inferior desde Ronda de Atocha frente al monumento a las víctimas del 11-M (desaparece el carril izquierdo sin señalización), con lo cual la única forma de hacer el cruce en coche (por ejemplo: Ronda de Atocha -&gt; Ciudad de Barcelona) es rápido y a lo loco. Lo cual está <strong>MAL</strong>, y es aún peor teniendo en cuenta que es el centro de Madrid, y que pasan coches por ahí constantemente. Va en contra de la pacificación del tráfico que deberíamos lograr.</li>
	<li>Sentido Conde Casal -&gt; Sta María de la Cabeza: de nuevo los carriles varían enormemente a su cruce con cada intersección, con lo cual a cada semáforo se convierte en una carrera de ver quién quema más rueda para ponerse en su carril (o alternativamente: quién se queda último y bloquea el paso hasta conseguir reposicionarse donde debe), los coches tratan de cruzar tres o cuatro carriles como pueden y la señalización es casi inexistente (tanto vertical como horizontal). Se trata de un reto curioso que mucha gente tiene que hacer con frecuencia y termina siendo parte del problema de que Madrid sea sucio, ruidoso y esté lleno de coches.</li>
</ul>

<p> </p>
";"28/12/2015 16";"74";"67";"7";"7";"1983525779";"5432"
"4381";"Una pregunta:";"<p>¿Alguien podría indicarme de qué forma se ""marca"" como inapropiadas las propuestas que por la razón que sea así se consideren?</p>

<p>He visto varias así calificadas, pero no encuentro dónde o cómo hacerlo.</p>

<p>Gracias y disculpas por ""utilizar"" los Debates para preguntar.</p>
";"28/12/2015 16";"25";"16";"9";"2";"1973013672";"448"
"4382";"ACCESO A COMPRA DE LAS ANTIGUAS  VIVIENDAS DE PROTECCION OFICIAL DE SANCHINARRO";"<p>Buenos días, escribo aquí para recordar la situación que padecemos los inquilinos de promociones de alquiler de protección oficial, Mi vivienda, como es el caso de tantas otras, pertenecía a una promoción de la EMVS y está en Sanchinarro, En su día tuvimos ya la mala suerte de que, en vez de ofrecernolas con opción a compra, unicamente nos dieron la opción de alquilarla y la EMV nos dijo que seguramente a los 10 años, cuando revisaran los contratos nos las ofrecerían a compra, Pero justo antes de que cumplieran los 10 años de contrato ""nos vendieron"" a la empresa privada Lazora dejándonos sin ninguna opción para al fin poder invertir nuestro dinero en comprarnos una casa;</p>

<p>Muchos vecinos ya se habían ido antes de esto ante la imposibilidad de invertir el dinero del alquiler en una compra y de los que nos quedamos, al hacer Lazora la revision de los contratos, muchos tuvieron que marcharse pues por sus ingresos se les dobló el precio del alquiler; Yo como estoy en paro tuve ""suerte"" y no me han subido el alquiler pero sigo invirtiendo un dinero que podía ser hace mucho la letra de la casa y por lo que les escribo pues se que muchas otras familias están en mi caso ya que estas medidas de la venta de promociones sociales perjudicaron a muchas personas (promociones como la de Carabanchel, Vallecas etc) por favor miren si al menos, aunque la gestión de estas viviendas quede en manos de Lazora , cabría la posibilidad de llegar a algún acuerdo para que podamos al fin comprar nuestras casas y que nuestra situación mejores y no tiremos el dinero en alquileres; Gracias por su atención y su ayuda inestimable; Cordialmente</p>

<p>Paula</p>
";"30/12/2015 13";"39";"24";"15";"5";"1992152342";"553"
"4383";"Papeleras amarillas ";"<p>Se podría poner en las farolas una papelera amarilla y la verde por el otro lado. Al menos cada 2 o 3 farolas? Igualmente poner al lado de las verdes que están de pie. Madrid recicla </p>
";"30/12/2015 23";"85";"63";"22";"5";"2002206021";"3038"
"4384";"El IBI baja en 2016???";"<p>Hola, </p>

<p>Según las noticias publicadas, el ayuntamiento de Madrid ha aprobado una bajada del IBI del 7% para todos los inmuebles residenciales. Pero me ha llegado la comunicación de lo que me van a cobrar por IBI en pago a la carta y es algo superior a lo pagado este año. </p>

<p>Alguien sabe por qué no aplican la bajada? O la aplican más adelante?</p>

<p>Gracias</p>
";"31/12/2015 11";"65";"59";"6";"5";"2010910840";"4810"
"4385";"Las propuestas que han prosperado que se añadan a las urnas";"<p>asi todo el pueblo puede votar y decidir</p>
";"02/01/2016 19";"54";"44";"10";"6";"2031025597";"2770"
"4386";"Contenedor para el aceite usado en los barrios";"<p>Son muchos los municipios en España que ya cuentan con contenedores fijos para depositar el aceite (bien volcándolo directamente en el contenedor, depositándolo en botellas, o en un envase especial que al ser introduccido en el contenedor, éste te devuelve uno nuevo). Sin embargo, hasta ahora en Madrid para reciclar el aceite hay que llevarlo a los puntos limpios (alejados de los núcleos urbanos, teniendo que acceder en coche y desconocidos por muchas personas) algún contenedor en centros comerciales o contenedores móviles que llegan a tu barrio un día a la semana, en horario muy restringido, sin saber nadie dónde están, por lo que no se utilizan, ya que hay personas que ni siquiera saben de la existencia de este servicio.</p>

<p>Para evitar que madrileños y madrileñas sigamos contaminando el agua de esta manera y desperdiciando un producto que aún puede ser muy útil en otros ámbitos (como para generar energía), ¿por qué no poner contenedores fijos en los barrios? Contenedores a los que la gente pueda acceder sencillamente, igual que a los de cartón o plástico, como ya existen en muchas ciudades. Contenerdores a mano para facilitar que todo el mundo pueda hacer uso de ellos cualquier día y conseguir así que nuestra ciudad sea un poquito más respetuosa con el medio ambiente.</p>

<p>Frente a esa necesidad que veníamos detectando de conversaciones con amig@s y compañer@s, hemos decidido crear esta propuesta https://decide.madrid.es/proposals/7025 ¿Qué os parece?</p>
";"04/01/2016 19";"234";"224";"10";"7";"2060798908";"20485"
"4387";"Villa de Vallecas";"<p>Creo que es necesario aprobechar y mejorar las precarias instalaciones deportivas que tenemos en Villa Vallecas, pongo como el ejemplo el espacio sobrante de terreno que tenemos en el polideportivo Cerro de Almodovar donde se pondrian hacer unas pistas de Padel con lo cual incrementariamos la actividad deportiva de los vecinos y la rentabilidad del polideportivo.</p>
";"05/01/2016 13";"40";"26";"14";"0";"2052880581";"780"
"4388";"Aire contaminado en el Aeropuerto";"<p>El día 6 volé de Madrid Barajas (Adolfo Suárez) de vuelta a mi nuevo hogar en Alemania. Es ya al menos la segunda vez que me choca la <u><strong>PESTE a gasolina /diesel</strong></u> que hay a partir del control de seguridad de la T2. Esta vez hablé con alguno de los empleados de esa zona. ""Pobres, !cómo podeís trabajar con este olor! ?Cómo es que no hacen algo?..."". Ya lo han denunciado, pero <strong>AENA no hace nada</strong>. Un hombre incluso padece de los pulmones. Otra me dijo que depende de cómo sople el viento... Esta gente se pasa unas 8 horas al día en ese lugar!! <strong>Es <u>insalubre</u>!! </strong>Alguien debería hacer algo!!</p>

<p>Yo no estoy empadronada. Alguien puede empezar una propuesta? En nombre de esa gente: Gracias!</p>
";"07/01/2016 23";"52";"44";"8";"1";"2083234229";"3046"
"4389";"Bien por acabar con los espectáculos con animales, pero también con los toros.";"<p>Aplaudo la iniciativa de terminar de una vez con los espectáculos en los que los animales están involucrados, pero no entiendo porqué no se hace extensivo a la tauromaquia y a todas las fiestas populares con encierros, etc. Hay tradiciones que son tan crueles que merecen dejar de serlo YA MISMO, por favor adopten una postura mucho más drástica con este tema. BIEN por haber liberado a los animales de formar parte de la Cabalgata de Reyes. Esto sí hay que quitarlo, los villancicos y las referencias religiosas no se por qué se quitan, cuando la Navidad es una fiesta de origen cristiano y aunque me encantó que se explicara el recorrido de los Reyes Magos y las referencias ecológicas al calentamiento del Planeta y las desigualdades y las guerras para concienciar a los niños, creo que la noche de Reyes debe conservar su magia y su sentido original, que es muy bonito independientemente de que se crea o no se crea en ello; por otra parte, siendo una fiesta de interés cultural, no se puede negar la cultura de la que procede: la cristiana. Si queremos ser ejemplo de apertura, multiculturalidad y riqueza, no empecemos por destruir nuestra propia historia. Somos un país con una fuerte tradición cristiana, nos guste o no, y hay ciertas cosas que no deberíamos destruir. Sería como quemar todos los cuadros con temética religiosa, quemar las catedrales que forman parte de nuestro patrimonio artístico... Está bien cambiar las cosas porque es muy necesario, pero con criterio por favor. No les demos alas a los que piensan que mejor que sigan los de siempre aunque roben, engañen y nos vendan a la banca. Muchas gracias.</p>

<p> </p>
";"08/01/2016 18";"179";"125";"54";"2";"2091167744";"4958"
"4390";"Cambiar los contenedores de residuos actuales por contenedores soterrados.";"<p>Estaria bien que se cambairan los actuales contenedores por contenedores soterrados, como en muchos municipios de la Comunidad de Madrid y España.</p>

<p>Los contendores soterrados <strong>no requieren reparaciones ni mantenimiento, salvo su correcta limpieza</strong>; reduce gastos de recogida al disminuir las frecuencia de vaciado; evita el abandono de bolsas de basura fuera de los contenedores; duplica la capacidad del contenedor, ya que el propio peso de los residuos produce una compactación automática; evita malos olores y la propagación de plagas urbanas; su construcción hermética impide el contacto de la basura con el subsuelo; aprovecha la flota de camiones de recogida existente; y el diseño de los buzones es muy accesible, incluso para niños y minusválidos.</p>

<p>Mientras que los actuales son quemados, se vuelan con el aire fuerte invadiendo las carretera con el peligro que supone, generan fuerte olores cuando se acumula la basura, hay gente que no tiene facil acceso a ellos. (Niños, ancianos, personas discapacitadas, etc...), Esteticamente son perjudiciales para el entorno urbano.</p>
";"09/01/2016 16";"153";"122";"31";"5";"2102861966";"7256"
"4391";"No al cierre de la escuela de tenis municipal en las pistas de la calle Arganda";"<p>Hace un par de días nos comunicó Luis, el profe y ""director"" de la escuela de tenis de las pistas de la calle Arganda en Arganzuela, que el ayuntamiento le comunicó el cierre de la escuela el pasado 20 de diciembre sin ninguna explicación. Luis, el profe de tenis, como todos le conocemos en el barrio, lleva muchos años prestando este servicio a la comunidad de Arganzuela. Por poner un ejemplo, mis dos hijos y yo hemos atendido sus cursos y actividades. Siempre con precios razonables e incluso mas baratos que un polideportivo municipal. </p>

<p>Muchos alumnos, creo que unos 400, han sido perjudicados por esta medida unilateral de la concejalía de deportes, tomada a mitad de curso. Luis no sabe la razón, ni tampoco el ayuntamiento le da una solución para los alumnos perjudicados, la mayoría niños. También son perjudicados los 4 o 5 jóvenes que colaboran con él impartiendo clases, a la vez que se forman como monitores.</p>

<p>Que yo sepa, y he hablado con otros usuarios, no hay ninguna queja de la escuela, incluso los comercios y bares de la plaza apoyan su continuidad porque Luis ""hace barrio"" y es del barrio.</p>

<p>En definitiva abro modestamente este debate para intentar que la concejalía recapacite en su decisión.</p>
";"10/01/2016 13";"69";"61";"8";"20";"2111845890";"4685"
"4392";"Repoblar con árboles zonas aledañas a Madrid";"<p>Quiero abrir un debate sobre la propuesta es la de repoblar con arbolado autóctono grandes zonas deforestadas de territorios, propios, cercanos y aledaños a la capital que pertenecen a otros municipios en los que viven los propietarios de muchos de los 900.000 vehiculos que cada día entran Madrid y que son, en gran parte, responsables de la contaminación del aire. Pasaría por un acuerdo previo con estos municipios y debería contar con apoyo de los medios humanos y materiales que puede aportar el Ayuntamiento de Madrid para su mantenimiento inicial ya que dispone de una gran plantilla de profesionales. Se podrian realizar campañas de voluntariado que participaran en este proyecto.</p>

<p>Me parece éste un medio útil para divulgar ideas de actuación, pero poco efectivo para realizarlas. No creo que nadie que no disponga de medios extraordinarios pueda recopilar los apoyos necesarios para que le presten oídos a las propuestas y solicitudes que se leen en esta web (quizá por la misma estructura que tiene).  Creo que ésta es una solicitud lógica, efectiva, barata, factible e ilusionante para unos habitantes dispuestos a colaborar en cambiar una ciudad maltratada por la contaminación, por el tráfico, por el exceso de zonas ajardinadas frente a zonas que se puedan equiparar a un paisaje (lo que critico es lo mucho que en ellos se invierte en crear espacios artificiales frente a lo poco que se dedica a crear espacios naturales). Muchos de los alrededores de la capital y de su término municipal son zonas semidesérticas cuando podrían albergar buenos bosques autóctonos. Incluso bosques que acompañen en su recorrido la cantidad de terreno adyacente a las muchas autovías y autopistas que merodean la ciudad.</p>

<p>Si estais de acuerdo podéis mostrar en esta dirección vuestro apoyo:</p>

<p>https://decide.madrid.es/proposals/6779#comments</p>
";"10/01/2016 20";"162";"157";"5";"6";"2119984370";"14730"
"4393";"DEVOLVER GESTION DE INSTALACIONES DEPORTIVAS A ENTIDIDAS VECINALES";"<p>Desde la entrada del PP las instalaciones deportivas han ido pasando a empresas privadas y quitándoselas a entidades deportivas y vecinales que llevaban años gestionándolas.</p>

<p>Devolución de la gestión a estas entidades para una gestión más popular y para los ciudadanos de Madrid.</p>
";"12/01/2016 06";"80";"61";"19";"1";"2125382352";"3202"
"4394";"Que las próximas Cabalgatas de Reyes sean como han sido siempre";"<p>Nada hay más ruin que jugar con la ilusión de los niños. No hay ninguna necesidad de manipular lo que llena de ilusión a nuestros pequeños.</p>
";"12/01/2016 17";"231";"122";"109";"24";"2124232539";"686"
"4395";"Control de calidad del asfaltado";"<p>Creo que sería necesario controlar la calidad del asfaltado de las calles, y en caso de que sea mala, obligar a la empresa a volver a asfaltar o multarla y no volver a contratarla.</p>

<p>Por ejemplo, he estado unos 5 años viajando en autobús desde Atocha hasta la Plaza de Lima, y es una vergüenza: hace unos dos años hicieron obras en el carril bus, y a los dos meses ya había baches gigantes (ahí siguen) y alfalto deformado</p>
";"12/01/2016 21";"103";"99";"4";"8";"2138419233";"9131"
"4396";"Equipo de voluntariado de emergencia";"<p>La idea de esta propuesta es la creación de un equipo de voluntarios que ayude en casos de desastres naturales.</p>

<p>Cada vez el cambio climático esta afectando a nuestro mundo. La mayoría de días se puede ver como hay catástrofes naturales en todo el mundo. Aquí en España nos afecta especialmente en riadas, grandes nevadas y sobre todo incendios.</p>

<p>En Madrid los grandes incendios forestales y las nevadas copiosas que hay en la sierra y que deja incomunicada a personas son las catástrofes que mas nos aceptan. Últimamente con las grandes lluvias muchos de nuestros vecinos se les inundan las casas, garajes, comercios...</p>

<p>La idea es la creación de un equipo de voluntarios que ayuden a las personas que le afecte la catástrofe de algún modo.</p>

<p>Para que nos hagamos una idea podemos poner el ejemplo de un incendio cerca de un pueblo. </p>

<p>El equipo de voluntarios ayudarían a las personas de ese pueblo a desalojados y acompañarlos a un sitio seguro donde se les ayudaría. También se les puede ayudar a salvar a sus animales, a sacar cosas de su casa antes de que se queme o simplemente hacer un cortafuegos para que su casa no se queme.</p>

<p>Otro ejemplo sería una inundación en un distrito de Madrid.</p>

<p>La gente que estuviera afectada se le ayudaría sacando el agua de su lugar, limpiar el sitio, ayudarles en tanto comida como en refugio en donde los tuvieran que llevar.</p>

<p>Hay un sinfín de motivos de como ayudar, pero lo importante seria el apoyo y compañía que se les da.</p>

<p>Para todo esto, esta claro que esos voluntarios necesitarían una formación y en el caso de actuar unas herramientas para ayudar.</p>

<p>Esta idea si se lleva al cabo sería la primera ciudad en tener un equipo de voluntarios así. Es cierto que a lo mejor la formación y herramientas que se necesita puede salir un poco caro  pero se estaría cubriendo una necesidad que cada vez es mayor.</p>

<p> </p>

<p>Por ultimo quiero dar las gracias por su tiempo y atención.</p>
";"13/01/2016 19";"53";"36";"17";"5";"2137293308";"1290"
"4397";"Desahucios.";"<p>Por favor... Que se cumpla lo prometido.</p>

<p> </p>

<p>http://redpress.es/2016/01/15/vuelven-los-desahucios-tras-las-elecciones/</p>
";"15/01/2016 22";"66";"52";"14";"25";"2162890360";"2993"
"4398";"Vigilantes parquimetro y limpieza?";"<p>Por qué no asignar a los vigilantes de los parquímetros que pueblan la mayoría de las calles de Madrid de 9 a 21:00 para que tambien denuncien y avisen a los servicios de limpieza/medio ambiente de puntos negros de basura en calles, comerciantes que sacan basuras fuera de horario o vecinxs insolidarios que tiran basura a las calles. No les impediría hacer su función recaudatoria de la gestion del aparcamiento y ayudaria a limitar suciedad y vigilar la no actuacion de las empresas concesionarias. </p>
";"16/01/2016 15";"100";"94";"6";"2";"2175074887";"8272"
"4399";"Casa de baños Bravo Murillo";"<p>Qué uso tiene la casa de baños en Bravo Murillo? un edificio entero en buen estado cerrado a cal y canto, algun uso debe tener. No puede ser reformado en albergue refugio para deshauciadxs, sin techo, o solución habitacional transitoria para personas que lo necesiten? </p>
";"16/01/2016 15";"53";"46";"7";"3";"2170737017";"3384"
"4400";"Perros y alergias";"<p>Por lo que llamamos estilo de vida occidental, las alergias aumentan su número y se agravan. Por el mismo estilo de vida, cada vez somos más propensos a tener mascotas dentro de nuestras viviendas, con la consiguiente denigración de las condiciones higiénico-sanitarias, creación de alergias motivadas por la caspa, epitelio, de la piel del perro o por su saliva, la bajada de nuestras defensas, y con ello, acentuación de las alergias venidas por otras causas. A nuestro organismo le provoca la liberación de la  histamina y de otras sustancias químicas que  ocasionan inflamación en la mucosa nasal, ocular o bronquial. Y no solamente ocurre dentro de nuestra vivienda, sino que, al moverse el perro fuera de ella, sirve de agente propagador a otras personas. Seamos conocedores conscientes y consecuentes, y entendamos que, al vivir en sociedad, dependemos todos unos de otros.</p>
";"16/01/2016 19";"60";"17";"43";"25";"2154093346";"-736"
"4401";"ABRIR EL PARDO A TODOS";"<p>Actualmente el 80% del Pardo está cerrado yes imposible acceder, todos madrileños deberiamos poder acceder todos a él.</p>
";"16/01/2016 20";"135";"95";"40";"17";"2171557464";"3870"
"4402";"Linea de autobus por la M30";"<p>Linea de autobus que circule por la M30 (carril exclusivo) con paradas en puntos estrategicos.</p>

<p>Hay zonas en la M30 donde puede ponerse perfectamente una parada de bus (sin peligro para los viajeros) y donde no se pueda, podrá salir y entrar por la siguiente entrada a la M30.</p>
";"16/01/2016 20";"88";"61";"27";"14";"2170078991";"2356"
"4403";"Propuestas de los ciudadanos";"<p>¿Qué ocurre con las propuestas que se plantean en esta web y que no tienen un número significativo de apoyos? ¿Nadie del Ayuntamiento lashecha un vistazo y las ignora, o se tienen en cuenta?</p>
";"17/01/2016 20";"56";"49";"7";"9";"2183648300";"3675"
"4404";"#TúPreguntas: Nacho Murgui, concejal de Coordinación Territorial y Asociaciones";"<p>Soy Nacho Murgui, delegado del Área de Coordinación Territorial y Asociaciones y concejal del distrito de Retiro, donde he residido toda mi vida. Desde este área de gobierno queremos conseguir que Madrid tenga un Ayuntamiento más cercano a la ciudadanía y que pueda responder a las demandas cotidianas con agilidad y responsabilidad. Además, somos conscientes de que Madrid tiene un rico tejido social organizado, y por ello tenemos como meta abrir espacios donde las asociaciones tengan una presencia relevante como representantes de una parte importante de la sociedad. Mi compromiso, como parte de este equipo de gobierno, es llevar a cabo lo que en la campaña fue un lema y ahora consideramos una forma de hacer: gobernar escuchando; por eso el martes 19 estaré disponible para contestar a vuestras preguntas a partir de las 13:00 h.</p>
<p>Muchas gracias a todos y a todas por las preguntas y propuestas. Obviamente esto no agota las posibilidades de diálogo. Os animo a que acudáis a los espacios de participación ciudadana que estamos articulando en los distritos (el foro local y las mesas temáticas que se desprenden de él), a que toméis la palabra en los plenos y a que nos sigáis haciendo llegar vuestras dudas, propuestas, críticas y sugerencias por todos los canales que consideréis oportunos.</p>
<p>Saludos!</p>";"18/01/2016 09";"33";"23";"10";"40";"2184572889";"906"
"4405";"Alguien del ayuntamiento lee estas propuestas? ";"<p>Alguien del ayuntamiento lee estas propuestas? O sólo las que tengan 50.000 votos?</p>
";"20/01/2016 10";"97";"88";"9";"11";"2212147281";"7167"
"4406";"Mejora de la página web de Madrid Decide";"<p>Somos muchos los ciudadanos que estamos pidiendo en las propuestas ciudadanas un MODERADOR un «operario humano» que gestione y UNIFIQUE las propuestas repetidas (puesto que el diseño de la página no ha contemplado que esto se haga automáticamente) para darle un sentido a dichas propuestas que van camino de transformarse en un saco sin fondo (y sin sentido).</p>

<p>Hacen falta cambios en esta página. </p>

<p>El Ayuntamiento que ha creado esta herramienta no puede sentarse a esperar que haya cien mil propuestas sin haberlas leído ni una sola vez. ¿Cómo se hará la selección? ¿Quién y cómo unificará propuestas similares? ¿No debería previamente de establecerse un panel de propuestas más interesantes e incluso uno de más votadas (pero habiendo pasado antes un criterio de unificación)?</p>

<p>El ejemplo más claro es el de «la limpieza de la ciudad» debe de haber 3000 propuestas más o menos explicadas, más o menos argumentadas o focalizadas... Las ETIQUETAS deberían de llevar a un panel de gestión de propuestas similares para poder votar sobre una de ellas en lugar de volver a escribir una específica.</p>

<p>Idem con los barrios, debería de haber unas etiquetas (diferentes y destacadas) que funcionaran como CARPETAS de contenidos diferentes. SI quieres ver las propuestas de Orcasitas, pues vas a esa Carpeta y ahí escribes o votas y no que estén mezcladas con las genéricas, de todo Madrid. Así sus concejales podrían EMPEZAR A TOMAR NOTA de cosas que preocupan más específicamente en su distrito.</p>

<p>Idem con las votaciones, he calculado que al ritmo de votaciones y gente dada de alta en la página se pueden tardar cinco o seis años en recibir los 53.000 votos para que empiece a ser tenida en cuenta. Para que esto funcione debe de haber una mayor PROMOCIÓN de esta página. Somos muy pocos los que estamos votando y explicándonos y así jamás conseguiremos que niguna propuesta salga adelante.</p>

<p>Si esta página no se dinamiza y toma nota de las propuestas ya hechas de CAMBIOS EN LA PROPIA PÁGINA, redactadas todas ellas con buena intención y mejores deseos, esta herramienta de consulta se va a quedar en agua de borrajas para «alegría de los totalitarios y para decepción de los que creemos en la Democracia Participativa» y aquí cito a un comentarista de los más activos en las discusiones que estamos teniendo para mejorar la página.</p>

<p>Hagan algo, por favor.</p>

<p>Un saludo.</p>

<p> </p>

<p> </p>

<p> </p>
";"20/01/2016 22";"145";"134";"11";"14";"2219153078";"11366"
"4407";"Sobrecoste y uso excesivo de sirenas en el SAMUR";"<p>Ambulancias de Soporte Vital Básico con sirenas y a velocidad elevada ¿qué control se realiza?</p>

<p>Dan un gran servicio, ¿pero verdaderamente es necesaria tanta inversión para ser municipal? ¿Con Hospitales tan cerca es necesario tanta instrumentalización/movilización de recursos?</p>
";"21/01/2016 15";"47";"27";"20";"4";"2212181964";"402"
"4408";"#TúPreguntas: Pablo Carmona, concejal de los distritos de Salamanca y Moratalaz";"<p>Soy Pablo Carmona Pascual, concejal presidente de los distritos de Moratalaz y Salamanca. Doctor en Historia por la Universidad Complutense de Madrid, investigador y profesional del mundo del libro, he participado en el Observatorio Metropolitano de Madrid y desde hace más de 25 años en diferentes movimientos vecinales y sociales de la ciudad.</p>

<p>El próximo <strong>día 26 de enero a las 13:00 h.</strong> abriremos un foro de preguntas que puede servir de primer punto de encuentro para debatir vuestras inquietudes y propuestas. Creo que el mejor modelo político es aquel que se basa en la relación directa entre las instituciones y las personas. Por ello os invito a que participéis y a que iniciemos los debates que harán de nuestra ciudad un lugar mejor para vivir.</p>

<p>También os animo a que continuemos el diálogo en los consejos, foros y asambleas abiertos en los distritos y de los que os podréis ir informando a través de la Junta Municipal de Salamanca y de Moratalaz. Además os animo a escribir a los correos electrónicos pablosalamanca@madrid.es y a pablomoratalaz@madrid.es con todas las dudas, sugerencias y propuestas que queráis hacernos llegar.</p>

<p>Un saludo y muchas gracias.</p>
";"22/01/2016 17";"41";"28";"13";"58";"2228384103";"1024"
"4409";"Sanciones APR Opera";"<p>Desde este verano estoy llevando a un compañero de trabajo a su hotel que está en la zona APR de Ópera. La señalización es lamentable y en ningún momento yo sabía que estaba entrando en una zona de acceso restringido. De hecho existía una moratoria en la que no se sancionaban durante los primeros meses. Pero claro, si nadie avisa de que se está cometiendo una infracción pero que no se sancionará por existir una moratoria, pues claro, nadie se da por enterado y que pasó al final. Que seguimos accediendo al esa zona y he empezado a recibir multas desde primeros de noviembre. Casi 400 euros!!! ¿De verdad piensan que no me importa que me multen y accedo porque quiero? Si me avisan la primera vez ya no vuelvo a hacerlo.</p>

<p>He leido que en otras zonas APR tambien hay muchas incidencias. Por favor, mejoren esta gestión.</p>

<p>¿Alguien se ha encontrado o conoce a alguien en esta situación?</p>
";"23/01/2016 21";"26";"20";"6";"1";"2238182046";"1076"
"4410";"Escuela de Fútbol municipal San Blas.  ¿Que valores aporta?";"<p>Soy un usuario de esta escuela hace varios años, tiene virtudes y defectos, pero en la suma considero que se trata de un servicio de gran utilidad y que aporta buenos valores y oportunidades a nuestros chavales.</p>

<p>Como se controlan estas escuelas por parte del ayuntamiento o juntas de distrito?</p>

<p>Que pasa cuando una escuela municipal, se convierte en un cortijo?</p>

<p>Alguien valora el trato que reciben los chavales?</p>

<p>Creo que los valores morales para niños de 14 / 15 años está muy por encima de los deportivos.</p>

<p>Bajo mi opinión, tener al frente de unos niños personas que les animan a dar patadas y hacer daño a otros niños, y si no lo hacen amenazarlos (cumpliendo su amenaza) con no salir en los partidos.  Es como para hacérselo mirar.</p>

<p>Imagino que todos tendremos una opinion y una preocupación por estos temas que afectan a nuestros chavales.</p>

<p> </p>
";"25/01/2016 09";"26";"20";"6";"0";"2253398384";"1076"
"4411";"Esto te interesa ";"<p>Se ha abierto una Propuesta con el título Digitalizar las calles para que se las pueda identificar por un número a efectos de ahorro y seguridad.</p>

<p>Es una especie de Distrito Postal pero tendría más precisión, ya que determinaría una calle, avenida, travesía, plaza</p>

<p>Imagina que vas a escribir en un sobre una dirección, o teclearla,  o buscarla en un callejero manual, o rellenar un impreso: ¿ no es es más fácil y sencillo poner, por ejemplo, poner 9823, 0156,59025, que: Nuestra Señora de Salvatierra, Zumalacárregui, o Balbuena ( ¿con B o con V? ) ?</p>

<p>Te lo agradecerá el taxista cuando le digas una dirección que ha de buscar en el navegador, así como Correos, repartidores de paquetería</p>

<p>Como van a permanecer referencias al quedar las placas que ahora están puestas en Avenidas,  Plazas, Glorietas, Carreteras, además de haber monumentos, edificios, sedes oficialessiempre podremos indicar los lugares por al final de la avenida de América, a su izquierda, o entre Cuatro Caminos y el Corte Inglés de La Castellana</p>

<p>Todo es cuestión de acostumbrarnos, como  identificar la cuenta bancaria, el DNI, el de la Seguridad Social, los teléfonos de familiares y amigos</p>

<p>Lo que digo aquí para mayor difusión y, como nos va a afectar a todos, aparte de leer la Propuesta Digitalizar las calles sería recomendable lo hables con personas de tu entorno, para que también decidan.</p>
";"25/01/2016 12";"62";"21";"41";"14";"2241251856";"-677"
"4412";"Instalar una noria en la explana del Puente del Rey al igual que el London Eye";"<p>Al igual que el London Eye.Con bastante altura y con cabinas moderas y espaciosas.</p>

<p>Serviría como reclamo turístico para gente de fuera como a los madrileños.Sería un perfecto mirador y enseña de identidad para Madrid.Con vistas a la Casa Campo,Sierra del Guadarrama.Plaza España.Palacio Real,Catedral de la Almudena,Madrid Rio.......</p>

<p> </p>
";"25/01/2016 21";"162";"58";"104";"6";"2243348194";"-1646"
"4413";"Diferenciar para evitar desaparecer esta página";"<p>El <strong>debate</strong> es un acto de comunicación y exposición de ideas diferentes sobre un mismo tema entre varias personas, con lo que se le da forma, mejora y operatividad con los argumentos expuestos por cada uno, y más si son en cantidad y muy razonados.</p>

<p>Por otra, tildar de impropio un tema sin haber cumplido los puntos  que requiere debatir, es frustrar la idea, el fin con que nos han facilitado este medio, y malhumorar al autor, que dejará de escribir.</p>

<p>Es sabido de antemano que los temas pueden causar sorpresa, incredulidad, animosidad, perjudicar nuestros intereses y más si no somos muy sabidos del tema o no lo hayamos entendido. Normal.</p>

<p>Para esto está el debate, para preguntar, proponer otros puntos de vista, argumentar lo que requiere a veces reflexión previa.</p>

<p>Como están proliferando últimamente marcas de Improcedencia, para no perjudicarnos todos, se ruega atenernos todos a lo que significa el verbo debatir.    Gracias.</p>
";"26/01/2016 14";"37";"28";"9";"6";"2266572033";"1437"
"4414";"Una joya histórica la estatua de Alvaro de Bazan de la Plaza de la Villa";"<p>Parece que existe una propuesta del Partido Socialista de sustituir la estatua de Alvaro de Bazán que está situada en la Plaza de la Villa por una nueva estatua de Tierno Galván. Me parece bien que Madrid haga una homenaje a Tierno que fue un buen alcalde, pero no eso suponga quitarnos una joya como es esa estatua de Benllure, fijense ustedes en ella, en hermosísima, es una estatua de bronce de un hombre maduro, para mí una de las más bellas de Madrid, es un deleite observar la belleza de su factura que enbelleze todavía más si es posible a una plaza ya de por sí hermosísima del Madrid histórico que no requiere de ninguna intervención. Es por ello que les ruego que coloquen la nueva estatua del Profesor en cualquier otro sitio.</p>

<p> </p>
";"26/01/2016 21";"77";"67";"10";"6";"2274691749";"4959"
"4415";"El Ayto de Madrid multa en la nueva zona residencial de ópera, sin avisar";"<p>Tengo que denunciar la mala imagen que está ocasionando en el Ayuntamiento de Madrid por el hecho de comenzar a denunciar en la nueva zona residencial de Ópera desde el 2 de Noviembre y explico los motivos:</p>

<p>Llevo trabajando en esta zona desde hace al menos 4 años y tengo el parking dentro de la zona residencial, pero fuera de ella.</p>

<p>1.- no costaba ningún trabajo haber puesto una pareja de la Policia municipal, el mismo día 2 de noviembre y los siguientes, avisando que atravesar esta zona podría ocasionar una multa, teniendo en cuenta que algunos llevamos años haciendo ese trayecto. Otra opción hubiera sido poner carteles en los parking de la zona, indicando, la única forma de acceder a dichos parking.</p>

<p>2.- la primera multa es del 2 de noviembre, me llega el 18 de enero, de haber seguido pasando por dicha zona, me hubieran llegado más de 50 multas. Menos mal que me di cuenta la décima vez que pase por ella, es decir, tengo 10 multas.</p>

<p>3.- todos sabemos el daño que ha hecho el pp en España y uno de los cambios introducidos es que si recurres la multa pierdes el 50% de bonificion y si la pagas pierdes el derecho a reclamarla.</p>

<p>4.- en mi caso es aún más sangrante, accedo a un parking que está en la zona de exclusión pero que está fuera, es tan complicado entenderlo que me tuve que bajar el plano de la zona y me costó una media hora entenderlo.</p>

<p>Puedo reconocer que como no me enteré, es que soy un poco tonto y tengo que págar, pero los comentarios de gente que le ha pasado lo mismo que a mí es, si todos son iguales, lo único que quieren es el dinero. Hoy hablando con un trabajador del parkin, me dice que le están llamando de toda España, diciéndole que llevan viniendo a Madrid desde hace años y es la primera vez que reciben multas de este tipo.</p>

<p>Estas actitudes no ayudan a conseguir un Ayuntamiento más abierto y da una mala imagen de Madrid. A día de hoy sigue sin haber suficiente información de a que parkin se puede ir y a cuales no.</p>

<p>Me gustaría que se buscará una solución general, me preocupa mi caso pero también el de tanta gente que se ha visto afectada.</p>

<p>Os pido a los afectados y a los que se solidarizan, que usemos este debate para protestar.</p>

<p> </p>

<p>Ayuntamiento madrid</p>
";"26/01/2016 21";"58";"18";"40";"14";"2255109553";"-682"
"4416";"Reforma de la Plaza de España";"<p>Por primera vez se va a realizar en Madrid la reforma de un lugar tan emblemático como la Plaza de España contando con la voluntad ciudadana.</p>

<p>Hoy, día 28 de enero, se harán públicas las 18 preguntas mediante las cuales la ciudadanía podrá decidir aspectos como:</p>

<p>¿Se debe reformar la Plaza de España?</p>

<p>¿Mantendrías el monumento a Cervantes?</p>

<p>¿Debería soterrarse el tráfico y hacerla íntegramente peatonal?</p>

<p>¿Debe crearse un corredor verde que comunique la Plaza de España con la Casa de Campo y el parque del Oeste entre otros lugares?</p>

<p>Durante 40 días todos los mayores de 16 años empadronados en Madrid podrán dar su opinión, y con las respuestas que consigan más apoyos se configurará un concurso internacional de ideas para hacer la reforma de la plaza. Por último, también será la ciudadanía quien decida cuál de los proyectos que se presenten a ese concurso será el que se  lleve a la práctica.</p>

<p>Cosas como estas no se han hecho en nuestra democracia hasta ahora, y pueden situar a Madrid en la vanguardia de la política y sentar un precedente que sirva para consolidar una nueva forma de tomar decisiones en los asuntos públicos, en la que se de prioridad a lo que entre todos decidamos que debe ser prioritario; solo hace falta que una buena parte de la ciudadanía decida participar en el proceso aportando su punto de vista.</p>
";"28/01/2016 13";"504";"392";"112";"403";"2296862526";"21777"
"4417";"REGULACIÓN DE LA FASE ÁMBAR EN LOS SEMÁFOROS DE MADRID";"<p>Según el Ayuntamiento de Madrid los semáforos tienen una duración en fase ámbar de al menos 3 segundos, lo cual se aleja con mucho de los tiempos recomendados por la Dirección General de Tráfico (DGT) que exige que tanto las fases verde, ámbar y rojo inferiores a 35 segundos o superiores a 150, no sean aconsejables por poner en peligro la vida tanto de peatones como conductores.</p>

<p>Según el Artículo 146 C) del Reglamento General de Circulación indica que las luces ámbar no intermitentes y las rojas fijas son iguales a todos los efectos (el conductor debe parar antes del semáforo en condiciones de seguridad), la DGT considera que al menos en la fase ámbar, al igual que el resto, debería establecerse un mínimo de 35 segundos y un máximo de 150.</p>

<p>Seguro que en más de una ocasión os habeis cuestionado la duración del semáforo en ámbar, normalmente por excesivamente corta. Pues bien, tanto en la Ley de Seguridad Vial, como en el Reglamento General de Circulación, no se especifica nada al respecto, por tanto, en la normativa aplicable no hay ningún tiempo fijado obligatoriamente.</p>

<p>Como todos sabemos y pensamos, se están usando estos medios como fin recaudatorio y no con el fin de minimizar el número de accidentes. Por lo menos, en los semáforos con el sistema foto-rojo, la fase ámbar debería durar más de 3 segundos con el fin de avisar al conductor y su reacción para frenar con seguridad sin poner en peligro a los demás.</p>

<p>Con este debate solicito la colaboración y participación de presentar un recurso al Ayuntamiento de Madrid con el fin de tomar las medidas legales oportunas para aumentar la fase ámbar antes de cambiar a rojo. Podéis aportar las soluciones y vías a seguir y participación de todas las asociaciones posibles para tomar las soluciones y medidas oportunas lo hantes posible.</p>

<p>Yo ya he puesto una Instancia General en ""sede.madrid.es (https://sede.madrid.es/portal/site/tramites/menuitem.1f3361415fda829be152e15284f1a5a0/?vgnextoid=213ddd9d6baed010VgnVCM2000000c205a0aRCRD&amp;vgnextchannel=f47ea38813180210VgnVCM100000c90da8c0RCRD) con Número de anotación: 20160084282 y animo a todos los demás ciudadanos a realizar lo mismo con la siguiente información:</p>

<p><strong>EXPONE:</strong></p>

<p><strong>A/A Excma. Sra. Alcaldesa de Madrid, Manuela Carmena:</strong></p>

<p>Según el Ayuntamiento de Madrid, dice que los semáforos en la fase ámbar para cambiar a rojo es aproximadamente de unos 3 segundos, un tiempo bastante escaso y no recomendado por la Dirección General de Tráfico (DGT) poniendo en peligro la vida tanto de peatones como conductores.</p>

<p>La Dirección General de Tráfico (DGT) ha señalado que las fases de un semáforo, verde, ámbar y rojo, cuya duración sea inferior a 35 segundos o superiores a 150 segundos son de difícil comprensión por el conductor y, por tanto, no son aconsejables.</p>

<p>Es decir, la DGT recomienda que al menos la fase ámbar, al igual que el resto de fases, debería durar como mínimo 35 segundos. Precisamente, por este motivo, teniendo en cuenta que la duración era inferior, ya se ha dictado alguna sentencia favorable al conductor en la que se anulaba la sanción, por que ese juzgado, concretamente, ha considerado que la duración inferior a los 35 segundos es de difícil comprensión para los conductores.</p>

<p>Según el Artículo 146 C) del Reglamento General de Circulación indica que las luces ámbar no intermitentes y las rojas fijas son iguales a todos los efectos (el conductor debe parar antes del semáforo en condiciones de seguridad), la DGT considera que al menos en la fase ámbar, al igual que el resto, debería establecerse un mínimo de 35 segundos y un máximo de 150.</p>

<p>https://decide.madrid.es/debates/4417 con este enlace de debates de Madrid, se solicita la colaboración ciudadana y recogida de firmas y participación de todos con el fin de que se soluciones este problema bastante grave y que nos afecta a todos</p>

<p><strong>SOLICITA:</strong></p>

<p>Se solicita al Ayuntamiento de Madrid la revisión de todos los semáforos de Madrid ya que según indicáis la fase ámbar para cambiar a rojo es aproximadamente de 3 segundos, un tiempo escaso y que pone en duda la seguridad de los automovilistas y los ciudadanos.</p>

<p>Se solicita su revisión y que se ajusten a las indicaciones de la DGT y no de afán recaudatorio.</p>

<p>tanto en la Ley de Seguridad Vial, como en el Reglamento General de Circulación, no se especifica nada al respecto, por tanto, en la normativa aplicable no hay ningún tiempo fijado obligatoriamente.</p>

<p>Como todos sabemos y pensamos, se están usando estos medios como fin recaudatorio y no con el fin de minimizar el número de accidentes. Por lo menos, en los semáforos con el sistema foto-rojo, la fase ámbar debería durar más de 3 segundos con el fin de avisar al conductor y su reacción para frenar con seguridad sin poner en peligro a los demás.</p>

<p>En el caso de no hacer caso omiso a esta instancia se procederá a elevarla a Organismos superiores con el fin de iniciar una investigación contra la falta de gestión por parte del Ayuntamiento de Madrid en relación a la seguridad de la circulación sobre la fase ámbar que provoca más frenazos y accidentes y su afán recaudatorio sin respetar los derechos de los ciudadanos.</p>

<p>-------</p>

<p>Como aporte extra, considero que ya es hora de ponerse en serio en estos asuntos que nos afectan a todos.</p>
";"28/01/2016 15";"118";"107";"11";"11";"2294801691";"8705"
"4418";"Que el servicio de recogida de ropa usada se destine a donaciones ";"<p>Actualmente el servicio municipal de ropa usada de Madrid tiene un convenio firmado por Ana Botella con la empresa Ecotextile Solidarity para la recogida de la ropa que todos dejamos en los contenedores dedicados a ello. Habitualmente pensamos que esta ropa luego se distribuye en entidades como Cáritas o cualquier servicio que se dedique a vestir a gente con menos recursos económicos. Pero esto es erróneo. <strong>Ecotextile Solidarity</strong> es una empresa con fines de lucro y paga al ayuntamiento 3.200 Euros anuales por cada uno de los 170 contenedores de los que luego saca la ropa que venderá en mercadillos nacionales e internacionales. Más información de lo que sucede a día de hoy: http://ccaa.elpais.com/ccaa/2015/08/16/madrid/1439756053_982755.html</p>

<p>Esta es la propuesta creada a tal motivo: https://decide.madrid.es/proposals/7463</p>
";"28/01/2016 15";"195";"188";"7";"1";"2298528518";"17450"
"4419";"CON NECESIDADES SOCIALES , NO ES CUESTIÓN DE CONTENTAR  A  WANDA.";"<p>La plaza España   no tiene que  ser  reformada ,  tenemos problemas gravisimos con la dependencia , tenemos problemas gravisimos con los deshucios, tenemos problemas grvisimos  con la polución  que mata a las personas en Madrid , tenemos problemas gravisimos  con  las   empresas   privadas que contratan  servicios con el ayuntameinto y la precariedad  y despidos laborales  que  sale de las mismas ( Recordar la remunicipalización de los servicios públicos). </p>

<p>Pues para todo eso  y mucho más hay que poner recursos  necesarios y prioritarios , y no especular  con las necesidades , os pongo un ejemplo:</p>

<p>Es como  si necesitamos reformar  nuestra  casa  por necesidades dotacionales, y  nulamos   la partida a la instalación de calefacción por querer montar   en nuestro cuarto de baño los paramentos de marmol de carrara. CREO QUE AHORA SE ENTIENDE PERFECTAMENTE ...</p>

<p><strong>NO A LA REFORMA DE LA PLAZA ESPAÑA , NO ES NECESARIA  NI PRIORITARIA. </strong></p>

<p><strong>QUE L A PARTIDA PRESUPUESTARIA  SE DESTINEN A NECESIDADES REALES  Y NO  ESTÉTICAS.</strong></p>

<p> </p>
";"28/01/2016 18";"80";"28";"52";"10";"2273274034";"-839"
"4420";"#TúPreguntas: Esther Gómez, concejala de los distritos de Latina y Carabanchel";"<p>Hola, soy Esther Gómez, concejala de los distritos de Latina y Carabanchel. En este último distrito he crecido y he vivido siempre. Estudié Ciencias Físicas y hasta las elecciones llevaba 15 años trabajando como administrativa en una empresa de telecomunicaciones, donde era la representante sindical de mis compañeros. He participado como activista en defensa de la sanidad, del agua y la educación pública, de los derechos sociales y de la recuperación de equipamientos públicos para el distrito de Carabanchel. Como vocal-vecina, colaboré con las asociaciones de vecinos, varias asociaciones de madres y padres de alumnos, asociaciones culturales y deportivas, ejerciendo un rol de transmisora y defensora de sus demandas hacia la Junta de Distrito.</p>

<p>Estoy encantada de participar en este nuevo espacio y os animo a que me hagáis llegar vuestras consultas o comentarios. Estaré aquí para responder a vuestras preguntas el próximo <strong>martes 2 de febrero a las 13:00 h.</strong></p>
";"29/01/2016 12";"76";"63";"13";"122";"2301834907";"4144"
"4421";"Calle a Melchor Rodriguez";"<p>quiero proponer sustituir el nombre de la Avenida Ciudad de Barcelona por Avenida Melchor Rodriguez García </p>
";"29/01/2016 18";"61";"6";"55";"8";"2285938079";"-481"
"4422";"Propuesta para la creación de una linea de autobús fantasmagórica";"<p>  Para más información: http://dominguet.blogspot.com.es/2016/01/propuesta-para-la-creacion-de-un.html</p>

<p><strong>Notas generales</strong></p>

<p>El arte puede ir más allá de la reflexión y la forma, esto es, puede convertirse en un medio, en un medio de transporte, en un autobús azul de la Empresa Municipal de Transportes transformado en medio de participación y de encuentro, en un espacio político.   </p>

<p><strong>A propósito de los autobuses fantasma  </strong></p>

<p>Los autobuses fantasma son arte. Cualquier freno, agresión, o maquinación para acabar con la propuesta, se considerará un atentado a la libre expresión y al desarrollo artístico.</p>

<p>Estos autobuses serán inesperados, sin parada fija, sin ruta, sin horarios preestablecidos, sin destino. Recorrerán la ciudad en un circuito errático, a la deriva. Cualquier parada será su parada y recogerán a aquellos viajeros que lo soliciten; de la misma manera los viajeros se apearán a voluntad. Sin horarios ni ruta, no habrá forma de prever su llegada, serán una aparición, una sorpresa.   </p>

<p>En los autobuses fantasma quedará en suspenso el reglamento de la EMT, esto es, el precio del billete no será fijo, sino a voluntad, se podrá hablar con el conductor si este lo desea, cualquier norma podrá reefijarse, en constante mutación, por acuerdo entre viajeros y conductor.   Se trata de propiciar encuentros, experiencias vitales, pensamientos y nuevas conexiones neuronales, acción, acuerdos, nuevas formas de ver, un aprendizaje continuo donde construir acuerdos. El autobús será un nuevo espacio político, múltiple, que generará nuevos espacios y usos: es el autobús el que está a disposición del usuario. Todo puede ocurrir. Se rompe lo establecido, la rutina. El autobús será una convocatoria permanente a lo inesperado.</p>

<p><strong>Información práctica  </strong></p>

<p>Los autobuses fantasma no podrán distinguirse del resto. Su color y aspecto exterior será el mismo. Lo que puede cambiar es su interior, esto es, no hay cambios de apariencia sino de ser. La única identificación externa será su nombre: ""Fantasma"" o ""F"". Los conductores serán funcionarios o voluntarios. El coste para el erario público será mínimo, pues no se abrirá una partida presupuestaria para estos autobuses fantasmagóricos. Se utilizará un conductor de plantilla o/y se convocará  a voluntarios para su conducción. Se apartará uno de los autobuses de la flota para este uso. Se imprimirán pegatinas con el nombre del autobús que serán pegadas en todas las paradas del gran Mandril.    </p>
";"30/01/2016 10";"60";"12";"48";"32";"2290662329";"-720"
"4423";"Descanso vecinal";"<p>¿Realmente es necesario que un sábado o incluso en domingo, se pase en la plaza donde vivo, Luca de Tena, 28045. la maquina para soplar hojas a las 7:30 de la mañana? Me parece que es desafortunado (no tendrá horas el día) y una falta de respeto al descanso de los ya por si sufridos vecinos de uno de los barrios con más contaminación acústica y ambiental de Madrid.</p>
";"30/01/2016 16";"86";"76";"10";"3";"2313391727";"5832"
"4424";"MULTAS EN LA NUEVA ZONA RESIDENCIAL DE OPERA";"<p>Recientemente he recibido 10 multas por atravesar la nueva zona residencial de Opera, en otro hilo anterior se han identificado 3 casos más, similares al mío.  Parece ser que son 40.000 el número de multas puestas. Queremos utilizar este foro para expresar nuestra queja al Ayuntamiento y en la medida de lo posible se dé un trato justo a las personas que se hayan visto afectadas. Sabemos que los afectados en ningún caso han pretendido incumplir la normativa municipal.</p>

<p>Los motivos de las denuncias en estos 4 casos son las siguientes:</p>

<p>1.- Muchos llevamos utilizando esta zona desde hace años, es la zona residencial más amplia de las que hay en Madrid y por costumbre hemos seguido utilizando el mismo trayecto que se utilizaba siempre.  Recuero que en esta zona se cambio hace unos años el sentido de una calle y los primeros días estuvo un coche de la policía municipal informando. En este caso no se han visto policias avisando de posibles multas.</p>

<p>2.- Los carteles son pequeños y con mucho texto, imposible de leer a no ser que te bajes del coche.</p>

<p>3.- Los textos indican que se puede atravesar la zona para ir a los parkings pero no dice a que parkings (por ejemplo el de Isabel la Católica no vale y el de las Descalzas Reales si).</p>

<p>4.- Las multas han llegado 60 días después de haber cometido la infracción (las de trafico llegan en la misma semana) esto ha hecho que mucha gente no se haya enterado y las multas hayan sido repetitivas. Parece ser que no han llegado antes por un colapso de los servicios municipales, pero este colapso ha producido un perjuicio a los propios denunciados, que de haberse enterado antes de la infracción, hubieran cometidos menos infracciones.</p>

<p>5.- Tal y como está la nueva ley de multas, si las pagas obtienes una reducción del 50% pero pierdes el derecho a reclamar y si no las pagas y reclamas, por la información que he obtenido de la Mutua y de Race la posibilidad de que nos las quiten es casi nula.</p>

<p>También queremos expresar que en ningún caso estamos en contra de las medidas que está tomando el Ayuntamiento con respecto a la contaminación y al uso de los vehículos privados en el centro de nuestra ciudad.</p>

<p> </p>

<p>El objetivo de este hilo, como hemos dicho antes, es tener un sitio común donde expresar nuestros caso, evitar que esto le pida pasar a otros e intentar que el Ayuntamiento reconozca que las multas podrían ser injustas y quizás obtener la devolución de lo pagado. He creado una dirección de correo para ir identificando a los afectados, informar de los trámites realizados e ir como grupo al Ayuntamiento. Dicho e-mail es multas.opera@gmail.com</p>

<p>Desde mi punto de vista se podría haber informado mejor, por ejemplo poniendo carteles en los parking de la zona, poniendo señales en el suelo, poniendo carteles en los locales y oficinas de la zona, etc.  Aun estamos a tiempo.</p>

<p> </p>
";"31/01/2016 12";"58";"37";"21";"38";"2314980236";"1020"
"4426";"Subida de precios encubierta en el abono de uso libre de los polideportivos";"<p>Resulta que ahora la clases de Ciclo no están incluidas en el Abono. Hasta Enero incluido las clases de Ciclo estaban incuidas en el Abono de USO LIBRE con la Sala de Musculación y la Piscina. Pero resulta que este mes ya no. Tienes que decidir entre pagar 29,65 por Piscina y Sala de Musculación o 35 por las Clases. Se suponia que este AYUNTAMIENTO iba a bajar los precios de los polideportivos para fomentar la vida sana, pero no parece que lo haga... Además el descuento de los parados sigue siendo solo en los abonos de mañana.</p>
";"01/02/2016 20";"51";"21";"30";"2";"2314965655";"-370"
"4427";"se necesitan contenedores de reciclaje en montecarmelo-arroyofresno";"<p>yo reciclo y no me gusta que me pongan difucultades a la hora de vertir los vidrios,etc.</p>
";"01/02/2016 21";"53";"48";"5";"3";"2334247635";"3894"
"4428";"PROPUESTA DE CIUDADANOS, DE CREAR LINEA DE AUTOBÚS EMBAJADORES CAÑADA REAL ";"<p>Estoy totalmente en contra de la propuesta de Ciudadanos de crear una línea de autobús Embajadores- Cañada Real para llevar a los drogodependientes y terminar con las cundas. Eso sería el colmo para los vecinos de la Glorieta de Embajadores, que verían que el problema que llevan padeciendo años, se instalaría definitivamente en su zona para siempre.</p>

<p>Yo propongo que se lleven la parada de ese autobús a las puertas de la casa del que lo ha propuesto. ¡Ya está bien!. Lo que queremos los vecinos es que desaparezcan los problemas que origina esta situación y con un autobús cada vez vendrían más usuarios de la droga y inseguridad que padecemos se incrementaría.</p>
";"02/02/2016 09";"72";"28";"44";"21";"2319743857";"-622"
"4429";"Impulsar un espacio de negocios en el sur de Madrid para Empresas tecnológicas";"<p>Vemos tristemente como la mayoría de empresas se van a Alcobendas, Rozas, Moraleja, centro de Madrid o a las afueras. En el sur de Madrid necesitamos espacios para que las grandes, medianas y pequeñas empresas tecnológicas puedan instalarse a bajo coste y con buenas infraestructuras. De esta manera estoy seguro de que el tráfico sería mucho menor (puesto que tenemos que recorrenos todo madrid hasta llegar al Norte muchos) y la riqueza se repartiría.</p>

<p>Es posible tener un Sur tecnológico fuerte con buen transporte público.</p>

<p>Un saludo.</p>
";"02/02/2016 12";"108";"97";"11";"8";"2342964245";"7724"
"4430";"Parque  San Isidro (Carabanchel)";"<p>Buenos días,</p>

<p>Soy una vecina del barrio de Carabanchel, y paseo a diario con mi perra por el parque San Isidro. Es una pena que dicho parque, que en general está bien cuidado (sobre todo cuando se acercan las fiestas que le dan nombre), tenga las fuentes tan sumamente sucias. Es completamente insalubre el estado de las mismas de un tiempo a esta parte. Además, cuando se va acercando el buen tiempo se acercan familias de patos, y no sólo los perros se refrescan en ellas, si no que muchas veces hay niños que también lo hacen. De igual manera que se cuida en general el entorno del parque, creo que las fuentes también forman parte de él y que, si no van a estar limpias, estarían mejor vacías, ya que el estado de ese agua es repugnante.</p>

<p>Un saludo.</p>
";"02/02/2016 13";"44";"34";"10";"1";"2336616023";"1854"
"4431";"BICIMAD en torno a Madrid Río";"<p>Quisiera saber por qué, cual es el criterio que se ha seguido para no colocar BICIMAD torno a Madrid Río (P Pío, Puente de Segovía, Puente de Toledo, ...)</p>
";"02/02/2016 15";"120";"99";"21";"6";"2342712775";"6434"
"4432";"Ciudad pionera en España en puestos de carga eléctrica de automóviles";"<p>Me gustaría mucho que Madrid diera un gran paso en este tema. Es ver el mapa de cargadores Tesla repartidos por Europa y se me cae la cara de vergüenza (https://www.teslamotors.com/en_GB/supercharger?redirect=no)</p>

<p>Pienso que en cuanto haya más cargadores repartidos por Madrid, mayor será el interés de la gente en tener un coche que no contamine y mayor será la bajada de precio de este tipo de modelos. Yo estoy deseando poder quitarme mi coche diesel de encima por un coche eléctrico, pero desgraciadamente la oferta es muy poca, normalmente cara y no hay lugares donde pueda cargarlo. Si eso cambiara, ayudaríamos mucho a paliar la contaminación que nos asola.</p>
";"02/02/2016 16";"149";"132";"17";"11";"2345674187";"10187"
"4433";"Implementación de iluminación LED";"<p>Sustituir progresivamente la iluminación de las farolas que actualmente usan convencionales por bombillas LED que supondrán un ahorro en la factura de la luz y serán mas ecológicas. Al igual que se ha hecho con los semáforos.</p>

<p>También sería apropiado sustituir la iluminación de los monumentos por bombillas de este tipo. Además de que se pueda regular su intensidad dependiendo de la hora y/o de la luz natural.</p>
";"02/02/2016 18";"238";"224";"14";"20";"2350163553";"19764"
"4434";"¿Los madrileños no residentes deben tener derecho a apoyar propuestas?";"<p>Muchos madrileños desarrollamos nuestra actividad profesional (trabajo, universidad, etc.) la mayor parte de nuestro día a día en la capital. Estamos, por tanto, expuestos a las políticas que se llevan a cabo desde el ayuntamiento. Es evidente que no nos afecta como a un vecino más de Embajadores, pero sí especialmente en algunos aspectos. La movilidad y el transporte público, podrían ser un ejemplo.</p>

<p>Como cualquier madrileño tenemos un apego especial por la que ha sido siempre nuestra ciudad, y deseamos poner nuestro granito de arena para construir un proyecto de ciudad de vanguardia y mejor para todos, ya sea apoyando propuestas como por un Madrid verde y sostenible.</p>

<p>Sería por todo esto razonable, en mi opinión, que los madrileños no residentes podamos al menos apoyar iniciativas.</p>

<p>Un cordial saludo y mis felicitaciones por esta herramienta de debate ciudadano. Será muy importante en el futuro.</p>

<p>Seguid trabajando en ello.</p>
";"02/02/2016 19";"100";"37";"63";"6";"2323195559";"-961"
"4435";"Cambios en la red de autobuses de la EMT";"<p>Existe un buen puñado de propuestas y peticiones para mejorar el servicio de autobús en distintas zonas de Madrid, bien creando líneas nuevas, bien alargando o cambiando líneas existentes. Creo que sería interesante unificar todas ellas en un debate que permita ver cuales deberían ser los cambios más necesarios a realizar en la actual red de autobuses.</p>
";"02/02/2016 20";"101";"90";"11";"5";"2346070302";"7039"
"4436";"El Ayto. a partir de este año quiere localizar los carnavales en Tetuán.";"<p> </p>

<p> </p>

<p> </p>
";"03/02/2016 08";"50";"16";"34";"13";"2329717830";"-576"
"4437";"Calle Alamedilla/calle garganta de los montes";"<p>Buenos días ,abro este debate porque vivimos como aislados entre Méndez álvaro y Vallecas separados por las vías de  tren y Renfe, y pagamos un I.B.I. excesivo.Estamos aislados, y las prstaciones de servicios de limpieza,basura ,jardines,iluminación,mobiliario urbano ,etc ,es pésimo.Nuestra vivienda es del año 2009,tenemos una sóla papelera ,la calle cerrada con adoquines de hormigón,unas obras que no terminan.Somos de clase obrera,pero pagamos nuestros impuestos y muy altos,nos gustaría que al que corresponda,nos miren como tenemos los ""jardines"",limpieza,seguridad,mobiliario.En algunos sitios ni salimos,nuestra calle,la calle Alamedilla 33,es fantasma.Por favor papeleras ,bancos,somos obreros pero honestos.</p>
";"03/02/2016 12";"23";"12";"11";"3";"2336878029";"52"
"4438";"Limpiar y vigilar que los caminos rurales esten limpios";"<p>Limpiar y vigilar que los caminos rurales que hay en el término municipal de Madrid esten limpios de escombros y basuras. Que los pasos bajo las autovías y trenes estén limpios y con salida de aguas para que no haya charcos.</p>

<p>Queremos poder salir de Madrid andando o en bici, pero hay quien usa los caminos como basureros. El campo de Madrid sería bonito si no tuviese basura.</p>

<p>Pongo como ejemplo los caminos del sureste de Madrid que llevan a Perales del Río, a la Cañada, etc.</p>

<p>Especialmente sucios están los camninos que son la vía de servicio de la M-50, Avda. Mayorazgo, etc.</p>
";"04/02/2016 23";"69";"63";"6";"1";"2366255885";"5204"
"4439";"No quiero esperar a que haya maltrato animal para actuar.";"<p>Que en los colegios motiven a pensar a los niños. Que los enfoquen a ser más respetuosos y empáticos con todos y todo Si todos los niños supieran ser agradecidos no habrían tantos animales maltratados ni abandonados en unos cuantos años. Si supieran que cada vida importa, no habría basura en las aceras... porque supieran respetar el mundo y cada una de las cosas que en él hay. Ni chicles para que pisemos, ni para que los pájaros se atraganten ni plásticos para que contaminemos mares ni las tortugas se asfixien. Ni maltratadores sin corazón. Es más fácil no intentarlo, pero lo más fácil no siempre es lo mejor. ¡Ayudenme!, enderecemos sus raíces, las bases de esta sociedad sin escrúpulos, corrijamos el problema desde abajo, los niños son el futuro del mundo, nosotros el día de mañana nos iremos, pero ellos se quedarán y sólo harán lo que hoy les hemos enseñado a hacer.</p>

<p>Si en los colegios TAN SOLO SOLTARAN UNA FRASE QUE DURA DOS SEGUNDOS Y PERDURA TODA UNA VIDA. Si colaboraran. Si educaran con amor, en amor. Si no se contradijeran tanto. Si predicaran con el ejemplo. Si tan solo hicieran esos pequeños cambios.</p>

<p>Si tan sólo impulsaran EL RESPETO POR LA VIDA, el respeto. En unos cuantos años, mejoraría mucho el respeto a los profesores, los casos de acoso escolar o bullyng, los de animales abandonados, el tráfico de animales, la contaminación, la suciedad en la ciudad, campos, ríos, playas y mares. Si le dieran un enfoque motivador a las excursiones, uno que pueda mantenerse tras investigaciones y preguntas. Que respete la vida y a los que la viven. Si motivaran más a los niños con explicaciones del para qué y del porqué.</p>

<p>Quiero empezar por pedir que paren de llevar cada año, uno tras otro. A los niños de primaria al mismo circo con animales y al mismo zoológico. Que no hagan la práctica en contra de lo que en teoría enseñan. En Ética, en Naturales o en Sociales. Y que si se decide llevar a un niño aun así a ver animales estresados y con esterotipias o adiestrados haciendo cosas impropias de su especie, sean informados de cómo, por qué y para qué hemos hecho eso con ellos. Que se enseñe a respetar la naturaleza y se piense en la vida antes de ensuciar el mundo. Ultimamente los padres andan muy ocupados entre trabajo y redes sociales como para explicar a sus hijos que todos los seres vivos sienten y sufren y acabamos sufriendo todos las consecuencias. Propongo que se lleven de excursión a los niños a lugares donde aprendan el valor de las buenas acciones, si de ver animales se trata: Refugios y protectoras.</p>
";"05/02/2016 12";"121";"108";"13";"6";"2373375396";"8479"
"4440";"CERCANÍAS EN LA PLAZA ELÍPTICA";"<p>Buenas tardes!</p>

<p>Para empezar sé que esto no es competencia del ayuntamiento sino del estado pero quería expresar las ganas que tenemos los vecinos de Carabanchel de que llegue una<strong> estación de cercanías al distrito</strong>. Propongo la Plaza Elíptica como emplazamiento adecuado pues en <strong>esta plaza es el segundo espacio mas contaminado de madrid </strong>según los medidores de contaminación del ayuntamiento y todos somos conscientes de los <strong>altos niveles de contaminación</strong> que nuestra ciudad está sufriendo, necesitamos un cambio. Además, el intercambiador que dispone la plaza realiza rutas a ciudades del sur como Parla, Leganés, Fuenlabrada, Valdemoro, Pinto, Getafe, Illescas o Toledo, con lo que no solo beneficiaría a los vecinos de Carabanchel.</p>
";"05/02/2016 19";"56";"44";"12";"8";"2370793845";"2514"
"4441";"¿que se puede hacer para reducir el precio de la vivienda en Madrid?";"<p>Me parece una BURRADA el precio de la vivienda en Madrid, después de 2 meses dedicando aproximadamente una hora al día a buscar pisos por internet, me he dado cuenta de que las opciones para una persona que NO comparte piso y con un presupuesto para alquilar de 600 euros (que es casi el SMI :S)  son: </p>

<ol>
	<li>ZULOS bien comunicados, he llegado a ver cosas de hasta 15 metros cuadrados por 450 euros o de 20 por 500 euros en zonas del centro. </li>
	<li>Sótanos de 20-30 metros cuadrados, muchos sin ventanas :S por 500-600 euros</li>
	<li>Cosas decentes, 1 piso con al menos una habitación, van de 500 euros en adelante... </li>
	<li>Cosas MUY MAL comunicadas por 400 euros (por ejemplo, el Ensanche de Vallecas esta genial), peeero, te obligan a usar el coche si no quieres tragar con 1 hora y cuarto ida y vuelta del trabajo. </li>
</ol>

<p>Considero que soy una persona que NO necesita ayuda para vivir en un piso, pero me resulta curioso lo caro que esta todo en Madrid. Incluso un compañero de trabajo que vive en Barcelona al venir a Madrid me ha dicho que esta todo CARÍSIMO... si viniese de Villafranca del Tomate lo entendería, pero de Barcelona me extraña. </p>

<p>Por mi parte, seguiré buscando, es cierto que de vez en cuando se alinéan los planetas y encuentras un ""chollo?"" que podría ser un piso con una habitación por 450 euros dentro de la M-30... que debería ser lo normal. </p>

<p>Cosas que he echado en falta mientras buscaba pisos: </p>

<ol>
	<li>Una plataforma oficial del Ayto. de Madrid, estaría bien una buena web que permita a los particulares ofrecer sus pisos, donde también estén las casas de los bancos o las de protección oficial. Por ejemplo, buscar cosas de alquiler con opción a compra estaría interesante. </li>
	<li>Mejor comunicación en los barrios del sur (Carabanchel, Aluche, Latina, Vallecas...), hay partes que están a 30 minutos andando (según Google Maps) de la parada de metro más cercana. Yo he llegado a pensar en alquilar algo por ahí e ir en bici a la parada del metro :S es una opción realista pero Madrid no es para bicis ¿más carriles ciclistas quizá podría valer? Aunque sea carriles ciclistas que vayan desde ciertas zonas a paradas de Metro, yo que sé... y que sean carriles bici de verdad, no pintura entre farola y farola. Un tranvia que recorra el sur de este a oeste también podría estar chulo. </li>
	<li>Mejor comunicación con los pueblos del norte. Esto es cosa más de la Comunidad de Madrid que del Ayto. pero yo he valorado irme a vivir a un pueblo y comprar un coche. Te permite vivir en un piso bonito, pero lo que ahorras del piso lo gastas en coche, al final el gasto es casi hasta un poco más alto que vivir en un zulo de Madrid, con el agregado de que con mucha seguridad de que te aislas un poco de tu entorno de Madrid, por lo que al final compensa más buscar directamente en la ciudad. Si estuvieran bien comunicados con más líneas Renfe (pueblos como Cobeña, el Algete...) seguro que tendrían más gente, pero estando aislados difícil. </li>
	<li>Controlar quien especula con la vivienda. Yo flipo al ver como algo básico como la vivienda es fruto de la especulación, buscando pisos he conocido caseros que te hablan de tener 3 y 4 viviendas disponibles para alquilar en el mismo edificio... sobretodo tocar este tema con bancos.</li>
</ol>

<p>A mi no se me ocurre mucho más. Por eso abro este debate. Me gustaría puntualizar que la búsqueda de piso que he hecho ha sido bastante humilde, sólo un piso con salón, habitación, cocina y baño, y me ha sido indiferente (más o menos), la zona, tras buscar por el centro, el sur, y el norte, me he dado cuenta de que esta siendo casi imposible encontrar cosas decentes sin hacer más de una hora de camino al trabajo o sin poder ahorrar para tu futuro. </p>

<p>¿el Ayto. de Madrid ha llegado a tocar este punto? La cosa es ver si puede hacer algo sin necesariamente dar ayudas a viviendas. Lo que veo es que un piso decente en Madrid se va hasta 3 veces casi (800 euros) el sueldo oficial, imposible de pagar si no es compartiendo... y encima ahora no desgraba alquilar =( </p>

<p> </p>
";"07/02/2016 01";"79";"72";"7";"9";"2387783301";"5924"
"4442";"Dimision de la consejala de cultura";"<p>Lo de los Reyes Magos es una tontería de la derechona. Pero el incidente de los titiriteros proterroristas, por mucho que alegue desconocimiento, es de tal gravedad que obliga a la dimisión inmediata por responsabilidad política. Ya estaba cansado de los oidos sordos de los anteiores, creía que Carmena aportaba mayor sensibilidad democrática.</p>
";"07/02/2016 23";"224";"123";"101";"83";"2389290856";"1208"
"4443";"¿Debería tener Valdebebas en sus calles los 4 tipos de contenedores soterrados?";"<p>solo contamos con visibles de vidrio y papel...lo orgánico y el plástico, se almacena en una estancia habilitada por cada vivienda...generando olores y gasto por parte de la comunidad</p>
";"08/02/2016 19";"80";"61";"19";"3";"2400844760";"3202"
"4444";"sustituir los badenes de Valdebebas por otros menos agresivos para el coche";"<p>existen otras soluciones para disminuir la velocidad, pero si es con badenes, se podrían colocar otros que no destrocen los coches</p>
";"08/02/2016 19";"129";"113";"16";"0";"2405857848";"8496"
"4445";"Qué os parece que los supermercados tiren la comida? No deberían mejor DONARLA?";"<p>En Francia se MULTA a los supermercados que tiren comida, pero tampoco quieren mantener productos que estén a punto de caducar en sus estantes al día siguiente. De esa manera se empuja a los comercios a donar la comida a las caridades.</p>

<p>Se podrían crear también puntos de recogida diaria de alimentos o algo asi también, ¿no?</p>
";"09/02/2016 15";"296";"287";"9";"6";"2420656461";"26954"
"4446";"COLABORACIÓN DEL AYUNTAMIENTO EN MEJORA URBANIZACION EN HOSPITALES PÚBLICOS";"<p>Sin entrar en delimitar el ámbito que corresponde o no a la Comunidad de Madrid y ante la dejación de ésta, creo que se debería mejorar el entorno de los hospitales públicos ubicados en Madrid. Por poner un ejemplo, el entorno del Hospital Universitario de La Paz es como una trampa y fuente de torceduras y fracturas por el mal estado de pavimentos y problemas de accesibilidad.</p>
";"10/02/2016 13";"60";"51";"9";"0";"2419702778";"3569"
"4447";"Pasado, presente y futuro de Plaza España. ¿Por qué remodelarla?";"<p>Como parte del proceso de participación ciudadana #DecidePlazaEspaña, el jueves 11 de febrero se celebrará el primer debate abierto: Pasado, presente y futuro de Plaza España. ¿Por qué remodelarla?"".</p>

<p>Durante el acto habrá una ronda inicial de intervenciones por parte de los expertos convocados, tras la cual se dará lugar a un debate con los asistentes. Queremos conseguir una conversación fluida y abierta entre todos y todas, para que podamos dar luz a muchas dudas que afloran diariamente sobre este espacio de Madrid.</p>

<p>Los expertos convocados son Alberto Telleira, Jose Mª Ezquiaga, Antonio Prieto, Fernando Roch (Escuela Técnica Superior de Arquitectura de Madrid), Rafael Narbona, Carlos Sambricio, Miguel Angel Troitiño, así como vecinos y vecinas de la zona. Asistirán también técnicos municipales, y los concejales delegados de las Áreas de Gobierno de Desarrollo Urbano Sostenible, José Manuel Calvo y de Participación Ciudadana, Transparencia y Gobierno Abierto, Pablo Soto.</p>

<p>Este primer debate tendrá lugar en el Colegio Oficial de Arquitectos de Madrid (c/ Hortaleza, 63) a las 18:30 h. De forma paralela, iniciamos un debate aquí para que puedas participar online en el mismo. </p>
";"10/02/2016 18";"78";"56";"22";"18";"2419546134";"2441"
"4448";"Poder compartir noticias en la sección de debates";"<p>Actualmente podemos poner un link de la siguiente manera http://www.eldiario.es/madrid/ninos-enteraron-obra-ininteligible_0_482602676.html lo cual está bien pero creo que sería más interesante que al compartir el link figurara una foto o un clik al link directamente desde el post. Sin tener que entrar en el debate.</p>
";"11/02/2016 11";"22";"5";"17";"0";"2412570916";"-272"
"4449";"Los madrileños ya pueden opinar sobre el futuro de Plaza de España";"<p>http://madridfree.org/decide-madrid-plaza-espana/</p>";"11/02/2016 13";"104";"90";"14";"5";"2432463015";"6576"
"4450";"¿Está la concejalía de cultura promoviendo un ideario excluyente?";"<p>Por diversas actuaciones y noticias que vemos todos en los medios, uno podría pensar que la concejalía de cultura está apostando por impulsar actuaciones que no representan a la mayoría de los ciudadanos de Madrid (probablemente ni siquiera a la mayoría de los votantes de Ahora Madrid, entre los que me incluyo).</p>

<p>Diversos errores han causado malestar sin necesidad y da la impresión de que las tareas se encomiendan a gente con un sesgo ideológico muy marcado. Igual que no me siento representado por un ministro como Fernandez Díaz y su sesgo ultra-católico, tampoco lo voy a hacer por gente anti-lo-que-sea, y vemos como la aplicación de la memoria histórica (que parecía más bien una redada contra lo que huela a derecha), el tema de reyes mayos, el contrato de obras de teatro a antisistemas (con todo mi respeto a su ideología), etc. tiene todo un tufillo anti-XXX. ¿Qué necesidad hay?</p>

<p>¿Qué opináis, creeis que la concejalía actúa en nombre de todos los madrileños?</p>
";"11/02/2016 20";"95";"59";"36";"37";"2428699163";"1428"
"4451";"#TúPreguntas: Jorge García Castaño, concejal de los distritos Centro y Chamberí";"<p>Hola a todas y a todos, soy Jorge García Castaño, concejal presidente de Centro y Chamberí. Anteriormente he sido diputado en la Asamblea de Madrid en la legislatura 2003-2007 y concejal en el Ayuntamiento de Madrid de la Corporación 2011-2015, en la que ejercí como portavoz en la Comisión de Economía y Hacienda. Creo firmemente que los distritos juegan un papel fundamental en la transformación de Madrid en la ciudad que queremos y las instituciones y los vecinos debemos trabajar juntos para conseguirlo. Encuentros como #TúPreguntas nos brindan una excelente oportunidad para intercambiar ideas e inquietudes. Espero vuestras preguntas el próximo <strong>martes 16 de febrero a las 13.00 h.</strong> Un saludo.</p>
";"12/02/2016 10";"107";"45";"62";"141";"2430642062";"-714"
"4452";"Cómo se asegura que los asesores a dedo donarán el excedente de su sueldo?";"<p>La expareja de Zapata, contratada a dedo como asesora (porque tiene buen CV y demás), no cobrará 51.000 euros, sino 36.000 (más que un maestro funcionario de carrera con varios años de experiencia), porque donará el excedente (el PP, el PSOE y Ciudadanos votaron en contra de limitar el sueldo del personal eventual). En todo caso, cómo se asegura que este dinero se donará de verdad?</p>

<p>Creer que la corrupción se va a acabar porque al fin han llegado los 'buenos' (los enésimos) a la política es ser muy ingenuos. La gente heroica y pura es una minoría absoluta de la población. El 'pueblo' no es honrado, el 'pueblo' es mayoritariamente corrupto si se le presenta la oportunidad. Y la <em>corrupción</em> empieza por formas <em>suaves</em>. Todo depende de dónde situemos la línea de lo aceptable. No se acabrá la corrupción con confianza, sino con controles y garantías.</p>

<p>Y qué pasará con los <em>hackers</em> de Carmena, también contratados a dedo con sueldos de hasta 71.000 euros? También donarán el excedente? O de eso simplemente no se habla porque, a diferencia del caso del aborto, no es tan fácil de difuminar ideológicamente?</p>
";"14/02/2016 12";"84";"66";"18";"21";"2459374949";"3771"
"4453";"ampliar las aceras de la milla de oro museística ";"<p>son muuuuy estrechas desde el Paseo de Recoletos a la altura de la calle Prim hasta pasado el Reina Sofía por la Ronda de Segovia. en ambos sentidos pero sobre todo en el derecho hacia el sur.</p>

<p>Me parece más importante ampliar estas aceras que remodelar otras calles madrileñas porque unen los mejores museos de España (y del mundo) y están muy frecuentadas a todas horas por residentes y turistas. Y hacerlo con arboledas pues no hay que olvidar que el ""cemento"" es un pecado con tanto calor como hace tantos meses...</p>

<p>Una pena que no se apoye la cultura de los museos como se debe en esta ciudad tan rica en ellos. </p>

<p>¿Consideráis necesaria esta ampliación de aceras?</p>

<p> </p>
";"14/02/2016 22";"107";"76";"31";"1";"2461370055";"3196"
"4454";"Poner más servicio de metro";"<p><strong>Madrid</strong> necesita un servicio de metro completo. Los usuarios de la red necesitamos más frecuencia de trenes en horas menos concurridas como fines de semana, festivos u horas nocturnas.</p>

<p> </p>
";"16/02/2016 19";"251";"233";"18";"2";"2490379428";"19958"
"4455";"Policia municipal ----> comportamiento deleznable.";"<p>Intolerable el espectáculo de estos ""caballeros"" que, absolutamente ajeno al espíritu de cuantos <strong>Servidores Públicos</strong> nos honramos en atender a la ciudadanía, han ofrecido en la capital esta mañana contra su Edil responsable para seguridad.</p>

<p>Sobran las palabras, y falta toda lógica  (véase además https://decide.madrid.es/debates/4106 ) ante la adecuada política de <em>reserva</em> y <em>contención</em> emprendida por el Consistorio, que se ve sin embargo <u>irónicamente corroborada</u> por los desmanes sufridos a manos de esos mismos ""honorables"" agentes a quienes todos quisiéramos ver definitivamente alejados del contacto ciudadano.</p>

<p>Por nuestra propia desprotección, y el temor causado tras dicha algarada, invocamos desde aquí la pronta conclusión de las medidas abordadas por el <strong>área de Seguridad</strong> en el más inmediato plazo.  Con nuestro apoyo al Concejal, deseamos una inaplazable RACIONALIZACIÓN de efectivos y medios materiales conforme a las misiones que realmente le son propias a un Ayuntamiento, huyendo de alardes innecesarios (tan del gusto de la anterior Corporación) más propios de un <em>sainete decimonónico</em> al más puro estilo ""Gilbert &amp; Sullivan"".</p>

<p>MchGrcs.</p>
";"16/02/2016 20";"125";"52";"73";"31";"2463643896";"-873"
"4456";"Protección para los comercios del centro de Madrid";"<p>Cada día Madrid se parece más y más a un centro comercial en el que las mismas franquicias pueblan cada calle. En los últimos años se han perdido tiendas de música, teatros, cines y muchos otros negocios y la última víctima se ha anunciado esta semana: la sala Joy Eslava, que se convertirá en otra tienda de ropa de una marca grande.</p>

<p>Esta situación provoca una disminución en los puestos de trabajo (las cadena de ropa y similares proporcionan menos puestos que el pequeño comercio y que la mayoría de los negocios que reemplazan), quita carácter a la ciudad y amenaza el turismo, ¿pues quién querrá tomar un avión para conocer un simple centro comercial al aire libre?</p>

<p>Por ello reclamamos al Ayuntamiento de Madrid un plan de protección del pequeño comercio y de negocios tradicionales y establecidos, al estilo del que tienen otras grandes ciudades europeas como París. Este plan puede incluir desde medidas de incentivación del consumo en este establecimiento hasta la protección de los propios locales para que no sea tan fácil el cambio de actividad, como ya se hizo en su día para evitar que el Santiago Bernabéu tuviera uso distinto del deportivo.</p>
";"17/02/2016 11";"195";"174";"21";"4";"2494818421";"13652"
"4457";"¿En qué creen que se ha malgastado el dinero público en Madrid? ";"<p>Por ejemplo, en Villaverde Alto, en ciertas calles principales han cambiado en pocos años (diría cuatro) tres veces los bancos del Paseo de forma innecesaria, supongo que por dar trabajo a alguna contrata de algún conocido. No estaban estropeados, no estaban viejos y no eran incómodos. ¿¿ En qué han desperdiciado el dinero público en tu barrio?? </p>
";"17/02/2016 17";"58";"51";"7";"17";"2492758497";"3868"
"4458";"¿SANCIONAR A DISCOTECAS QUE DISCRIMINAN POR SEXO EN EL PRECIO DE LA ENTRADA?";"<p>En Madrid numerosos bares y discotecas cobran precios de entrada diferentes en función del sexo del cliente (ejemplos:""chicas gratis, chicos 10""). En algunas incluso se impide la entrada a varones por debajo de una determinada edad (23, 24 años etc.). Se trata de casos de DISCRIMINACIÓN SEXUAL que sufren miles de jóvenes cada fin de semana sin que el Ayuntamiento ni ninguna otra administración hasta la fecha se haya decidido a tomar medidas contra estas prácticas que, además de abusivas son ILEGALES según la legislación vigente:</p>

<p>La Ley Orgánica 3/2007, de 22 de marzo, para la igualdad efectiva de mujeres y hombres, aplicable a toda persona, física o jurídica, que se encuentre o actúe en territorio español, define el principio de igualdad de trato entre mujeres y hombres como la ausencia de toda discriminación, directa o indirecta, por razón de sexo.</p>

<p><strong><u>En materia de acceso a bienes y servicios y su suministro</u></strong>, la Ley Orgánica 3/2007, que incorpora al ordenamiento español la Directiva 2004/113CE, sobre aplicación del principio de igualdad de trato entre hombres y mujeres en la materia, en su artículo 69 establece que Todas las personas físicas o jurídicas que, <strong>en el sector público o en el privado</strong>, suministren bienes o <strong>servicios</strong> disponibles para el público, ofrecidos fuera del ámbito de la vida privada y familiar, <u>estarán obligadas, en sus actividades y en las transacciones consiguientes, al cumplimiento del principio de <strong>igualdad de trato entre mujeres y hombres</strong>, <strong>evitando discriminaciones, directas o indirectas, por razón de sexo</strong></u>; si bien añade que serán admisibles las diferencias de trato en el acceso a bienes y servicios cuando estén justificadas por un propósito legítimo y los medios para lograrlo sean adecuados y necesarios.</p>

<p> Entre los <em>propósitos legítimos </em>para admitir diferencias de trato se recogen, en los considerandos de la citada Directiva, en el punto 16, la promoción de la igualdad de género o de los intereses de los hombres o de las mujeres (organizaciones de voluntarios del mismo sexo), la libertad de asociación (en los casos de afiliación a clubes privados para un solo sexo), la organización de actividades deportivas (acontecimientos deportivos para uno de los sexos), pero señalando, como también recoge la Ley para la Igualdad, que toda limitación deberá ser adecuada y necesaria.</p>

<p>También establece la Directiva que <em>el principio de igualdad de trato en el acceso a bienes y servicios no exige que se ofrezcan en todos los casos prestaciones o instalaciones compartidas para hombres y mujeres, <strong>toda vez que no se ofrezcan de manera más favorable a uno de los sexos</strong></em>.</p>

<p>Como queda patente en la Ley, la práctica de cobrar precios de entrada diferentes en función del sexo del cliente en bares y discotecas es ILEGAL y no tiene justificación legal alguna, por lo que deberá ser perseguida por los AYUNTAMIENTOS, que son las administraciones públicas competentes en materia de consumo e inspección de locales de ocio nocturo.</p>

<p>Por tanto, esta petición solicita al Ayuntamiento de Madrid que, a través del Instituto Municipal de Consumo, Área de Inspección, asuma su responsabilidad de perseguir las prácticas de trato DISCRIMINATORIO POR RAZÓN DE SEXO sancionando a los locales que quebranten la citada LEY PARA LA IGUALDAD EFECTIVA DE MUJERES Y HOMBRES.</p>

<p>Así mismo serían muy recomendables campañas de sensibilización de la juventud para dar a conocer los derechos de los ciudadanos en materia de acceso a locales de ocio nocturno y animarles a denunciar este tipo de prácticas.</p>
";"17/02/2016 19";"315";"286";"29";"22";"2500552785";"23333"
"4459";"IBI - Eliminarlo definitivamente";"<p>Que el Ayuntamiento de Madrid exponga cuanto dinero necesita y para que lo quiere.</p>

<p>Que los habitantes de Madrid decidan que gastos quieren pagar.</p>

<p>Que los habitantes de Madrid que trabajen, paguen solo 120  por persona al año al Ayuntamiento en concepto de Donación.</p>

<p>Que las Donaciones al Ayuntamiento sean desgrabables en la declaración de la renta.</p>

<p>Que si al final del año sobra dinero, las personas que pusieron dinero en ese gasto, paguen menos dinero al año que viene.</p>
";"17/02/2016 23";"239";"168";"71";"12";"2494345187";"6818"
"4460";"¿No tenéis capacidad de decisión?";"<p>Soy una persona con poco tiempo libre y cuando voto en unas elecciones electorales lo hago para que personas preparadas y con unos conocimientos tomen decisiones para mí país y ciudad por mí, esperando que sean las mejores para todos. Por eso voto a los que para mi punto de vista se parecen más a mis ideas. Digo yo que si quisiera ser la que decida qué es mejor y peor en cada caso me metería en política! No?</p>

<p>Con esto quiero decir.... Hagan su trabajo bien que para eso les pagan a ustedes! No para que los que no cobramos por ello tengamos que perder nuestro tiempo en ver que votamos y que no diariamente!</p>

<p> </p>
";"18/02/2016 10";"105";"27";"78";"6";"2480287826";"-1311"
"4461";"No denunciar a los ocupas en Usera";"<p>Soy una vecina del barrio de Usera. Vivo en una vivienda proporcionada por la EMVS y pago religiosamente mis impuestos para lo cual me esfuerzo en trabajar. Si un día llego a mi domicilio y me encuentro con que una persona llamada ""ocupa"" ha ""ocupado"" mi casa o la de uno de mis vecinos...qué debo hacer? ¿No llamo a la policía? ¿Debería permitirle hacerlo aún a sabiendas de que puedo quedarme yo misma en la calle? Eso es lo que nos aconseja nuestro gobierno municipal y por ende nuestra alcaldesa, según un cartel que hay en la Junta de Distrito de Usera. </p>

<p>http://www.msn.com/es-es/noticias/espana/carmena-pide-a-los-vecinos-que-no-llamen-a-la-polic%C3%ADa-si-detectan-un-okupa/ar-BBpEbfo?li=BBpmbhJ&amp;ocid=mailsignout</p>

<p> </p>

<p> </p>
";"18/02/2016 11";"164";"53";"111";"19";"2479334308";"-1874"
"4462";"Hay que identificar todas las propuestas que no sean competencia municipal";"<p>Esta página (que me parece una gran idea) está llena de propuestas de temas que no son competencia municipal, hechas por ciudadanos, por desconocimiento, por dejadez, porque no tienen otro sitio donde hacer propuestas, o por boicotear un poco la página.</p>

<p>El caso es que cuando se entra, un gran porcentaje de las propuestas son sobre horarios o trazados del metro, educación, o sanidad....</p>

<p>Yo le propondría al Ayuntamiento un poquito de control, y que mueva este tipo de propuestas a una sección de ""propuestas otras administraciones"" o algo asi. Que no las borren que seguro que alguien hablaba de censura y cosas así....</p>
";"19/02/2016 13";"155";"143";"12";"8";"2515670890";"12085"
"4463";"Tú decides";"<p>Durante los próximos meses el Ayuntamiento de Madrid va a proponerte que seas tú el que decidas cómo debe ser la ciudad en la que vives. Y un grupo de gente se va a empeñar en que no puedas decidir nada. No te enfades con ellos, viene ocurriendo así en cada país cada vez que se introducen mecanismos de democracia directa.</p>

<p>Los  primeros en oponerse probablemente sean los políticos tradicionales. En 1993 una encuesta holandesa mostraba que menos de un cuarto de los concejales estaban a favor de los referéndums vinculantes. En 1998 la mayoría del parlamento danés se pronunció en contra de los mismos. Desde los años 50 los grandes partidos políticos alemanes se estuvieron turnando en contra y a favor de la democracia directa justo con la misma frecuencia con la que ganaban y perdían el control del gobierno.</p>

<p>Y  el argumento será, disfrazado de una manera u otra, siempre el mismo: el miedo. En concreto, el miedo a ti, que eres parte de eso que todavía da más miedo que llamarán la gente. Dirán que la gente no debe tomar las decisiones sino los expertos, porque no están preparados ni educados  para ello. Lo mismo que proclamaba, por ejemplo, en los años 20 el político socialista belga Hubin en contra del derecho de voto femenino; a pesar de lo fácil que era mirar atrás en la historia y ver cómo cada vez que un colectivo supuestamente no preparado para tomar decisiones lo hacía, esta era precisamente una de las claves para reducir profundamente su desigualdad. Dirán que la gente es irresponsable y no puede tomar decisiones conflictivas como aumentar los impuestos o ayudar a reducir la deuda. A pesar de ver, por ejemplo, como sistemáticamente en los estados de Estados Unidos con referéndums vinculantes la deuda se reduce un 7% respecto a los que no los tienen; al mismo tiempo que veinte años de estudios en países de la OCDE muestran también sistemáticamente la correlación entre gobiernos que duran poco o que piensan que van a perder las siguientes elecciones y el aumento de la  deuda.</p>

<p>Dirán que si la gente decide peligrarán los derechos humanos y los de las minorías. Sin mirar cualquier caso como por ejemplo el de Zurich, donde a nivel regional se aprueba el 80% de los referéndums que mejoran la situación de las minorías; y se olvidarán de esos políticos que, a golpe de decisión individual, ponen cuchillas en las fronteras o le quitan la sanidad a los inmigrantes. Y aunque los datos reflejen los mismos resultados una y otra vez, de década en década, de país en país, mantendrán sus posiciones basándose en una especie de sentido común de cómo es la gente, unas grandes verdades sobre el ser humano, el bien y el mal, que no deben ser cuestionadas porque obviamente ya sabemos la respuesta sin necesidad de mirar lo que realmente ocurre. Sin importar lo que se ve en los 200 referéndums que se votan en Suiza al año, o los 100 que se llevan a cabo en Alemania, o los 2000 referéndums iniciados por la ciudadanía en EEUU hasta el cambio de siglo. Porque el miedo no necesita datos.</p>

<p>El  Ayuntamiento de Madrid, sin embargo, sí cree que debes votar. Por eso desde ahora, por ejemplo, va a romper la larga tradición de grandes obras decididas en pequeños despachos, y te va a preguntar a ti si quieres que se reforme una de las plazas más importantes de la ciudad, Plaza España, y si es así cómo querrías que fuera la plaza. Y va a hacer exactamente lo que diga la mayoría. Y a continuación va a coger una parte de los presupuestos y te va a preguntar cómo deben gastarse, como ha hecho París,Nueva York o Reikiavik. Y luego te va preguntar sobre ordenanzas, como ha hecho con la Ordenanza de Transparencia antes siquiera de ponerse a discutirla con los demás partidos. Y así un tema tras otro.</p>

<p>Entonces probablemente los que tienen miedo a que decidas se pongan técnicos. Sabotearán el mecanismo como por ejemplo en Hamburgo, cuando en los años 60 introdujo los referéndums ciudadanos requiriendo un absurdo 10% de apoyos para llevar los temas a consultas. Utilizarán los tribunales, como cuando el (políticamente elegido) Tribunal Constitucional alemán dictaminó en el año 2000 que la democracia podía ser dañada si se permitían los referéndums ciudadanos. Y aprovecharán cualquier mecanismo de bloqueo como el uso de quorum en las votaciones. Te citarán algún caso anecdótico de una votación donde participó una minoría y salió un resultado raro, y se olvidarán del uso sistemático y eficaz del quorum como mecanismo de boicot. Como por ejemplo en el referéndum del 86 en Alemania donde la CDU que estaba en contra consiguió frenar el referéndum por falta de quorum invitando a actuar con calma y a fiarse de ellos en esa decisión, el CVP en Bélgica en el 98 que lo hizo invitando a la gente a quedarse en casa, o hasta los obispos en Italia en el 2005 en contra de la ley de reproducción asistida que, directa y llanamente, explicaron que el boicot aprovechando el quorum era la mejor manera de que ganara el no. Por supuesto, todos se olvidarán de mencionar el hecho de que no exista quorum en las elecciones y no  parezca preocuparle a nadie. En fin, vas a tener que acumular buenas dosis de paciencia...</p>

<p>(Puedes leer el texto completo aquí: http://diario.madrid.es/blog/2016/02/15/tu-decides/)</p>
";"19/02/2016 14";"120";"97";"23";"20";"2511846329";"5981"
"4464";"Multas a la hora de la salida del colegio";"<p>En las últimas semanas se están poniendo multas de 200 euros (nada más y nada menos) por aparcamiento en las cercanías del colegio de mis hijos en San Blas (colegio Newman). Me temo que ha habido orden de hacerlo, pues la actitud chula y nada pedagógica de los agentes es evidente. Agradecería que fueran educados, que dejaran un tiempo razonable de estancia en zonas razonables (una doble fila permite el paso de otros coches) y que no jugaran a ser pequeños dictadores con placa. Se trata de media hora y no me parece que la única solución sea maltratar con 200 euros a personas que ya luchan bastante por sacar adelante la familia.</p>
";"19/02/2016 20";"140";"61";"79";"27";"2494068803";"-784"
"4465";"Aplicar un Expediente de Regulación de Empleo en la policía municipal";"<p>Después de haber eliminado la unidad de antidisturbios de la policía municiopal, animo al Ayuntamiento de Madrid a dar un paso más.</p>

<p>Visto el comportamiento de buena parte de los que pertenecían a esas unidades, dudo mucho que estén capacitados psicológicamente como para que anden patrullando las calles. Pienso que supondrían un grave peligro para la seguridad y libertad de la ciudadanía.</p>

<p>Sabiendo que legalmente no sería posible aplicar un ERE como tal, habría que pensarse muy bien donde recolocarles, donde se ganen el sueldo digna y honradamente y en beneficio de la ciudad. Y por supuesto, bajo una supervisión contínua.</p>

<p>Saludos</p>

<p> </p>
";"20/02/2016 08";"141";"44";"97";"10";"2498468705";"-1653"
"4466";"Autobuses EMT con soporte para bicicletas en la parte frontal";"<p>Hola, en otros paises los autobuses llevan el soporte para bicicletas en la parte frontal, así el usuario y conductor tienen contacto visual todo el tiempo durante la carga y descarga.</p>

<p>Esta medida favoreceria la movilidad y el uso de la bicicleta.</p>

<p>Gracias.</p>

<p> </p>

<p>Nota: Actualmente el soporte se encuentra en la parte de atras, en algunas lineas, al lado del tubo de escape....</p>
";"20/02/2016 14";"199";"152";"47";"4";"2521769290";"8020"
"4467";"Un Madrid más limpio: limpieza de las fachadas d los ministerios Cibeles-Neptuno";"<p>Creo que de un tiempo para acá los barrios más emblemáticos del centro de Madrid han ido poco a poco mejorando su limpieza y arreglando sus fachadas. No entiendo como aún una zona como el paseo del Prado en el lado en el que va de la plaza de Cibeles a la de Neptuno, mantenga fachadas de edificios que pertenecen nada menos que a los ministerios de economía o el de Sanidad, absolutamente grises y envejecidas. Además la iluminación y el espacio para pasear de de dicho lado del paseo es estrecho,  oscuro y triste. Creo que nuestra ciudad se merece que un espacio tan emblemático disfrute de una mejora para que todos los madrileños y  quien visite nuestra maravillosa ciudad disfruten de un espacio agradable y no oscuro y gris  como ahora.</p>
";"20/02/2016 21";"99";"82";"17";"1";"2524232047";"5383"
"4468";"Los que pagamos la zona Ser, somos residentes 24 horas al día todo el año. ";"<p>No comprendo por qué si ya existe la zona azul para aparcamiento comercial está permitido a los no residentes aparcar en la zona verde. Los residentes lo somos 24 horas al día 365 días al año. Y estamos pagando una cuota para tener cierta prioridad a la hora de aparcar. Precisamente las horas en las que es más difícil  coinciden con el cierre de los comercios. Los parquímetros deberían estar activos todo el día, todos los día, incluídos los festivos, o restringir el uso a no residentes fuera de esas horas. En todo el centro a partir de las 10 de la noche, y sobre todo los fines de semana, estacionar es misión imposible con el perjuicio que se ocasiona a los vecinos que pagan su cuota, es como si a partir de determinada hora ya no fueras residente de tu propio barrio.</p>
";"22/02/2016 08";"121";"84";"37";"3";"2535447515";"3262"
"4469";"Plaza España: Movilidad, Medio Ambiente y Energía";"<p>El próximo 25 de febrero se celebrará el segundo debate abierto #DecidePlazaEspaña, que abordará Plaza España. Movilidad, Medio Ambiente y Energía"". El debate tendrá lugar en el Colegio Oficial de Ingenieros de Caminos, Canales y Puertos<strong> </strong>(c/ Almagro, 42) a las 18:30 h. </p>

<p>Los expertos convocados son Iván Villarubia, Pilar Vega, Julio Pozueta, Tomas Fernández, Carlos Lahoz, Miguel Álvarez, Susana Canogar, así como vecinos y vecinas del barrio. Asistirán también técnicos municipales, y los Concejales de Desarrollo Urbano Sostenible, José Manuel Calvo y de Participación Ciudadana, Transparencia y Gobierno Abierto, Pablo Soto.</p>

<p> De forma paralela, iniciamos un debate aquí para que puedas participar online en el mismo.</p>
";"22/02/2016 14";"94";"73";"21";"14";"2540162478";"4038"
"4470";"Que se desbloquee la operación chamartin.";"<p>Generara empleo y regenerara sustancialmente la zona .</p>
";"22/02/2016 15";"244";"185";"59";"14";"2543072903";"9553"
"4471";"Que se formulen bien las preguntas de los debates para saber qué contestar";"<p>Muchos debates de esta lista no dejan claro a qué botón hay que dar. Las preguntas están mal formuladas</p>

<p>por ejemplo: ¿En qué creen que se ha malgastado el dinero público en Madrid?</p>

<p>esta pregunta no se puede contestar con un SI o un NO</p>

<p>Otras que son una negación como No denunciar a los ocupas en Usera inducen a error. Si contestamos SI es Si que NO? o Si que SI?</p>
";"22/02/2016 23";"109";"103";"6";"1";"2549157042";"9166"
"4472";"Ascensores en edificios de Lavapies";"<p>El barrio de Lavapies cada dia se deteriora más debido a la falta de ascensores que provoca que sus pobladores originarios tengan que abandonar el barrio. Es un deber solidario del resto de vecinos ayudar a estos vecinos, en su mayoria ancianos y de bajos ingresos , a instalar ascensores que les posibiiten salir a la calle. Muchos viven encerrados en sus propias viviendas. El Ayuntamiento deberia de ser solidario y ayudar un poco. Se han suprimido todas las ayudas que existian en el pasado.  La nueva administración municipal deberia de demostrar su conciencia social y ayudar a estos vecinos a mejorar su calidad de vida.</p>
";"23/02/2016 03";"79";"53";"26";"2";"2541564910";"1811"
"4473";"Utilidad de la zona verde de aparcamiento regulado.";"<p>Se supone que la zona verde sirve para permitir el aparcamiento sin perjudicar a los residentes. Para tener tu coche en dicha zona debes estar censado, debes tener el coche a tu nombre (si está a nombre de un familiar o una empresa no puedes), y pagar anualmente por una tarjeta que no es gratis</p>

<p>De 9 a 21 es más que probable que no encuentres aparcamiento, pues, aunque sea pagando, todo el mundo puede hacer uso de esa zona. Pero puede ser aun peor, porque cualquiera sabe que el SER no actúa en los horarios en los que suele ser necesario encontrar aparcamiento como residente, es decir, cuando uno vuelve a casa después de trabajar. Y las visitas aunque sean familiares están obligadas a pasar por caja al igual que cualquier no residente.</p>

<p>La zona verde debería de funcionar en horarios en los que el residente hace uso de ella, es decir, 24 horas, incluido noches y fines de semana. Y debería de habilitarse un sistema para obtener la tarjeta verde incluso si el coche está a nombre de una empresa. Para las visitas familiares bastaría un ticket electrónico a modo de autorización equivalente al que se obtiene en los parquímetros, pero asociado a la tarjeta de la persona residente.</p>
";"23/02/2016 12";"63";"43";"20";"0";"2545094445";"1569"
"4474";"Autopistas Bici en las 6 radiales de Madrid (N-I...N-VI)";"<p>Muchos madrileños, utilizaríamos a diario la bici o e-bici, paea acceder desde barrios / pueblos periféricos, al trabajo al centro de Madrid.</p>

<p>""Autopistas"" en sentido metafórico; carriles bici limpios de obstáculos / peligros, cruces, paradas absurdas, etc. = mínima inversión, máxima eficacia = Ciudad más Amigable = es lo que están haciendo países avanzados y sus grandes ciudades</p>
";"23/02/2016 15";"198";"165";"33";"14";"2554575840";"11000"
"4475";"No mas botellones, barbacoas, ni fiestas sudamericanas sin permiso en Pradolongo";"<p>Es indignante ver como al pasear por el parque de Pradolongo te encuentras gente de botellón, con la música a unos volúmenes que parecen festivales de verano, haciendo barbacoas usando las papeleras como rejilla, vomitos, meadas y demas desperidicios nos encontramos los que hacemos deporte o sacamos a nuestros perros, pero lo que indigna de verdad es que hay una comisaría dentro del parque y jamás he visto a un policía llamando la atención de estas conductas que de hecho son ilegales. He visto agresiones de sudamericanos a sus mujeres que ponen los pelos de punta, debido a las borracheras que se cojen sin ningun control. ¿Hasta donde vamos a llegar? ¿Qué pasa que como es Usera no merecemos mantener un poco de seguridad en nuestras calles/parques?</p>
";"23/02/2016 15";"253";"222";"31";"31";"2557155954";"16759"
"4476";"Centros abiertos gratuitos en vacaciones";"<p>Que a sucedido, de repente , con los centros abiertos gratuitos en vacaciones . Esta próxima Semana Santa nos encontramos con que los centros que abrían en periodos vacacionales, y gratuitos. De repente se esfumaron. Mal.... Qué hacemos los padres con nuestros hijos si trabajan los dos o uno monoparental. Si puedes pagarlo a los centros abiertos en inglés. Hay, pero si tienes pocos recursos  que ... No se recorta en educación , ni en derechos ya adquiridos ... No, no , no muy mal señora carmena ... No me empecéis a decepcionar. Por qué estas cosas sociales ni se tocan.. Una pitada gorda muy mal</p>
";"23/02/2016 20";"36";"19";"17";"2";"2540937675";"105"
"4477";"Centros abiertos gratuitos en vacaciones";"<p>Que a sucedido, de repente , con los centros abiertos gratuitos en vacaciones . Esta próxima Semana Santa nos encontramos con que los centros que abrían en periodos vacacionales, y gratuitos. De repente se esfumaron. Mal.... Qué hacemos los padres con nuestros hijos si trabajan los dos o uno monoparental. Si puedes pagarlo a los centros abiertos en inglés. Hay, pero si tienes pocos recursos  que ... No se recorta en educación , ni en derechos ya adquiridos ... No, no , no muy mal señora carmena ... No me empecéis a decepcionar. Por qué estas cosas sociales ni se tocan.. Una pitada gorda muy mal</p>
";"23/02/2016 20";"47";"29";"18";"1";"2545412358";"678"
"4478";"Centros abiertos gratuitos en vacaciones";"<p>Que a sucedido, de repente , con los centros abiertos gratuitos en vacaciones . Esta próxima Semana Santa nos encontramos con que los centros que abrían en periodos vacacionales, y gratuitos. De repente se esfumaron. Mal.... Qué hacemos los padres con nuestros hijos si trabajan los dos o uno monoparental. Si puedes pagarlo a los centros abiertos en inglés. Hay, pero si tienes pocos recursos  que ... No se recorta en educación , ni en derechos ya adquiridos ... No, no , no muy mal señora carmena ... No me empecéis a decepcionar. Por qué estas cosas sociales ni se tocan.. Una pitada gorda muy mal</p>
";"23/02/2016 20";"79";"56";"23";"1";"2549771428";"2339"
"4479";"Que Correos  vuelva a poner buzones en los barrios";"<p>Correos hace ya algun tiempo que quito los buzones de las calles, obligando al ciudadano a desplazarse a las oficinas incluso de otros barrios cercanos .Si ya no se da servicio de recogida de cartas, pues que se privatice de una vez , nos ahorramos dinero y asi seguro que se volveran a poner buzones en todos los barrios.</p>
";"23/02/2016 23";"139";"117";"22";"3";"2557032552";"7996"
"4480";"ropa";"<p>Debeis de poner contenedores para ropa en el distrito de moncloa, por todas las calles, como habia antes,  si teneis que hablar con empresas privadas para ello, no importa, si no al final, nunca vas al punto limpio, pues es tarde o de noche, y está sujeto a un horario, ya las parroquias no cogen la ropa, por eso es muy importante que pongais contenedores para ropa en toda la ciudad, al lado de los de plástico y de botellas. gracias. me encantaria.</p>
";"24/02/2016 14";"71";"59";"12";"3";"2560487501";"3905"
"4481";"árboles";"<p>Talar arboles que sean mas de 3 pisos, aunque sea en fincas privadas, no hay apenas mantenimiento y ha habido varios accidentes por culpa de que los particulares no tienen dinero para cortarlos y el Ayuntamiento lo deja en manos de ellos. Yo vivo al lado de un arbol de mas de 10 pisos de altura en el distrito de  Moncloa en la calle Los Vascos, y no hay forma de que se tale el árbol. Cualquier dia puede haber un accidente. Lo digo en serio. Me preocupa aunque los árboles dan oxigeno, es mas importante la seguridad de los viandantes. Me parece un escaqueo del Municipio el que se deje esto  en manos de los particulares, o se podría enviar cartas o requerimientos municipales  para que los podasen.¡ o que lo hiciera el Ayuntamiento.</p>
";"24/02/2016 14";"76";"23";"53";"4";"2542045504";"-907"
"4482";"Poner fuentes como las de Madrid Río en parques como el Retiro";"<p>Madrid en verano es un auténtico infierno, y por desgracia no hay playas ni ríos para refrescarnos, por eso estaría bien que en los parques como el Retiro pusieran fuentes de chorro (como las que hay en Madrid Río) para que los niños puedan jugar y refrescarse. En el centro apenas hay piscinas públicas al aire libre y su precio es caro. Y para los niños que no disponen de piscina y se tienen que pasar tres meses de auténtico infierno sería una gran alegría, además es una obra que no es muy costosa y perduraría en el tiempo.</p>

<p>Ciudades como París dónde tampoco hay playa ya disponen de sistemas parecidos. No pido que abran la  piscina del mundial 86  (que ya está hecha, es al aire libre y lleva años cerrada) aunque esaría fenomenal, pero me imagino que no salrá a cuenta, pero por lo menos poner unas fuentes para que los niños se puedan refrescar en verano.</p>

<p>Este debate también lo he ""propuesto"", así que la gente puede votar por él.</p>
";"24/02/2016 14";"160";"137";"23";"0";"2564218636";"9761"
"4483";"Ahora Madrid-Podemos";"<p>Vaya por delante que os apoyé y os apoyo, porque a fecha de hoy os considero la opción menos mala, a mi criterio. Pero existen algunas cosas que mi débil y corrompida mente no llega a alcanzar. No os voy a felicitar por los logros ""es vuestra obligación"" pero si voy a criticar vuestros desaciertos ""es mi obligación"" por haberos eligido. <strong>RITA</strong> no tienes que disculparte por lo de la capilla. Diste visibilidad a lo que muchisimos pensamos. Bien me representas, <strong>PEEEERO</strong>, tu padre puede ser el mejor y más preparado dentro de su gremio, ni lo dudo, pero por el pequeñito hecho de ser tu padre, nunca deberia haber podido optar a ese puesto. Después de eso ¿que resquicio moral te puede quedar, para abrir la boca ""con razón o sin ella"" para despotricar y triturar cualquier acto de amigismo, corruptela, trafico de influencias....? Muy a mi pesar, tu solita por ... te metiste en un lodazal <strong>QUE NO OLVIDAREMOS</strong>. Lo del concejal <strong>Zapata</strong>, no merece ni mención, eso fué un lichamiento politico, puro y duro, al que no tuvisteis ... de oponeros. Hallá cada cual con su conciencia ""el que la tenga"". <strong>Manuela</strong>, te respeto y admiro profundamente porque a tu edad con la vida resuelta, meterse en estos berengenales, no ahi que hecharle h... nooo, lo siguiente.<strong> </strong>Tu voluntad y deseo se está viendo eclipsada por tu negligencia. Sabes de sobra desde el primer segundo, que estas sobre arenas movedizas. Antes de decir buenos dias, tienes que tener muy claro, como y de que forma lo vas a decir. Sabes de sobra que tienes detrás 200 mil hienas esperando agazapadas para destrozarte. <strong>JODEEEER, </strong>no es tan difícil no darles motivos, os juro desde mi mas profunda sinceridad, que a veces desde afuera, es imposible comprender como se puede ser tan .... para dar pie y opción a tantas cosas que publicamente decimos despreciar. Es inaudito. To be continued, me queda el de la laca y alguno más.</p>
";"24/02/2016 15";"65";"19";"46";"6";"2542448566";"-789"
"4484";"Posible deficiencia en el sistema de votación de los presupuestos participativos";"<p>Ante todo, me encanta la idea donde todo el mundo pueda opinar/participar en que gastar el dinero público pero he detectado que para que una propuesta sea llevada a estudio necesitas el apoyo de 56000 personas, ahora bien, si haces una propuesta para tu barrio lo normal es que sólo vote a favor gente de tu barrio, ya que una inversion que quieras hacer para un distrito no la apoyará nunca gente de otro distrito, lógicamente votará algo que le repercuta como beneficio para su distrito.</p>

<p>Bien pues para sacar adelante una propuesta en Usera que la poblacion es de 134000 habitantes necesito el apoyo de casi el 50% de los habitantes del barrio, algo muy complicado porque hay mucha gente mayor que no tiene internet o que no saben de este portal, etc...  Y realmente lo siento si alguien hace una propuesta para el barrio de Barajas ya que el total de los habitantes(48000) no llega ni al minimo establecido para llevar una propuesta adelante.</p>

<p>Con lo cual creo que solo podrán salir adelante propuestas que engloben a todo Madrid o que esten apoyadas por alguna organizacion politica o no gubernamental que tenga muchos seguidores.</p>

<p>Espero que todo esto no sea una perdida de tiempo y que por lo menos alguien del ayuntamiento gaste tiempo en leer las propuestas que no tienen un apoyo masivo ya que igualmente pueden ser muy interesantes para el barrio.</p>

<p>¿Qué opinais? ¿será una pérdida de tiempo total? ¿sólo saldrán adelante las propuestas impulsadas por organizaciones politicas o no gubernamentales pero con muchos seguidores?</p>
";"24/02/2016 16";"93";"88";"5";"16";"2566012079";"7853"
"4485";"vigilar las ayudas que reciben algunas familias.";"<p>he trabajado en los servicios sociales y lo he visto de primera mano. venir a pedir todo tipo de ayudas y tener el audi en la puerta, ir llenas de oros o autonomos que no declaran todo y que le den las plazas en los colegios que tus hijos no pueden accede,r que luego dicen no poder pagar y se lo pagamos entre todos y tu con tu sueldo de 900  ni ayudas (gracias a ""dios"", te vas arreglando) y esta gente dejando las arcas vacias que tanta falta para otras cosas.</p>
";"25/02/2016 10";"233";"224";"9";"12";"2577256443";"20669"
"4486";"Centro de salud en valdebebas";"<p>Propuesta de abrir un centro de salud en el barrio de valdebebas ya que el crecimiento en numero de vecinos es notable y no se dispone de un centro de salud cercano</p>
";"25/02/2016 17";"100";"93";"7";"1";"2575745985";"7998"
"4487";"Fomentar el Civismo en la Comunidad";"<p>Muchas de las iniciativas que se llevan puede tener buenas intenciones y acaban fracasando por falta de civismo de los conciudadanos.</p>

<p>Por ejemplo Madrid-Bici es una iniciativa estupenda para reducir la contaminación de la ciudad y ha sido bien aceptada por la gran mayoria de los madrileños. Sin embargo, desde su puesta en marcha, se han robado mas de 1000 bicicletas lo que hace que el servicio sea muy costoso. Hasta se cuelgan videos y se publican posts de ""trucos"" para robar estas bicicletas.</p>

<p>Como ciudadanos debemos mirar por el bien de nuestros vecinos y no sólo no participar en estas actividades sino perseguir y denunciar actividades incivicas, incluso proponer activiades que fomenten el civismo desde la educación, para que estas inciativas sean sostenibles en el tiempo y hagan de esta ciudad un mejor lugar donde vivir.</p>
";"25/02/2016 19";"140";"134";"6";"4";"2578698410";"12251"
"4488";"Posibilitar la cría a aves como vencejos y poner refugios para murciélagos";"<p> Cada vez hay menos lugares para que estas preciosas aves críen debido a las rehabilitaciones que tapan todos los agujeros y huecos de los edificios. Asimismo, en las obras nuevas no pueden encontrar huecos para hacer sus nidos. Propongo que el Ayuntamiento encuentre edificios públicos en zonas donde haya colonias de vencejo común o pálido y ponga cajas nido para que puedan sacar a las próximas generaciones adelante.</p>

<p>En el caso de los murciélagos poner refugios para estos mamíferos voladores que nos libran de tantas moscas y mosquitos de noche como los vencejos por el día.</p>
";"27/02/2016 23";"92";"73";"19";"1";"2593904941";"4284"
"4489";"Sopladores de hojas. Desde las 8 de la mañana y de dos en dos. INSOPORTABLE.";"<p>No hay mucho más que decir, hay 5 propuestas con más de 100 votos cada una, pero ahí siguen.</p>

<p>Puse una queja por escrito en mi distrito, y me respondieron que evitarían hacer uso de estos aparatos en un horario tan temprano. Pero en la práctica todo sigue igual.</p>

<p>Es insoportable.</p>
";"29/02/2016 11";"93";"85";"8";"8";"2612552591";"7037"
"4490";"#TúPreguntas: Pablo Soto, concejal de Participación y Transparencia.";"<p>Hola, soy Pablo Soto, concejal delegado del Área de Gobierno de Participación Ciudadana, Transparencia y Gobierno Abierto. Nací en Madrid en 1979 y desde muy joven me interesó mucho la tecnología, lo que me hizo convertirme en desarrollador de software. Puse en marcha proyectos en Internet relacionados con tecnologías peer-to-peer que usaron millones de personas, y esto de alguna manera me acercó al activismo. Especialmente en los últimos 5 años -desde el 15M- he participado en muchas iniciativas con el objetivo de hacer posible una democracia real, en la que podamos tomar las decisiones entre todos y todas.</p>

<p>Desde que creamos esta nueva Área de Gobierno hemos lanzado unas cuantas iniciativas innovadoras en Madrid: las propuestas ciudadanas, los presupuestos participativos, la publicación de agendas de todos los concejales de Gobierno, el borrador de la Ordenanza de Transparencia, el proceso de Plaza de España, o este espacio de debate son algunos ejemplos.</p>

<p>Estoy encantado de participar en este espacio y os animo a que me hagáis llegar vuestras consultas o comentarios. Estaré aquí para responder a vuestras preguntas el próximo <strong>miércoles 2 de marzo a las 13:30 h.</strong></p>

<p> </p>

<p><strong>Actualización miércoles 2 de marzo a las 13:58 h: </strong>Hola! Perdón por la tardanza y gracias por vuestras preguntas! Empiezo a contestar ;-)</p>

<p><strong>Actualización miércoles 2 de marzo a las 15:20 h: </strong>Muchas gracias a todos y todas, ha sido muy interesante, y espero que os hayan satisfecho mis respuestas. Un saludo y hasta pronto!</p>
";"29/02/2016 19";"44";"32";"12";"41";"2609580794";"1454"
"4491";"Suciedad en barrios de Puente y Villa de Vallecas causadas por los excrementos";"<p>Buenas noches, </p>

<p>Voy a trabajar todos los días a Puente de Vallecas y es muy desagradable tener que estar mirando al suelo todo el rato para no pisar ningún excremento de perro. </p>

<p>Tanto el distrito de Puente de Vallecas como el de Villa de Vallecas se ha mejorado en la limpieza general pero lo de los excrementos es insoportable.</p>

<p>Sé que no es culpa del ayuntamiento sino del civismo de cada uno de los dueños de los perros pero hay que encontrar una solución urgente.</p>

<p>Muchas gracias.</p>
";"29/02/2016 23";"95";"91";"4";"10";"2618994985";"8333"
"4492";"Gestión de viviendas de protección en fuencarral-el pardo";"<p>Hola vecinos! Me gustaria comenzar un debate sobre la vivienda de nuestro barrio! Resulta que las últimas viviendas de protección de nuestro barrio han sido para gente con muchos ahorros y sueldos elevados. Que pasa con la gente trabajadora? TAMBIEN TENEMOS DERECHO! Solo pido que hagan nuevas construcciones de proteccion oficial a las que podamos optar todos y no solo ""algunos"".</p>

<p>Que la gente joven del barrio no se tenga que ir a otros barrios y podamos vivir y criar a nuestros hijos donde lo hemos hecho nosotros.</p>

<p>VIVIENDAS DE PROTECCION PARA TODOS</p>

<p> </p>
";"01/03/2016 10";"29";"20";"9";"8";"2612423718";"758"
"4493";"INSTALACIONES PARA PADRES Y NIÑOS";"<p>Necesitamos instalaciones para padres,niños y jovenes donde podamos hacer vida con un techo como tienen los mayores.Poder juntarnos por las tardes y fines de semana en los que el tiempo no nos acompañe.Cuando hace frio,llueve o hace mucho calor nos tenemos que quedar en casa o ir a centros comerciales. Pudiendo juntarnos para charlar, hacer talleres o simplemente que los niños jueguen.</p>
";"01/03/2016 10";"76";"63";"13";"11";"2619041225";"4144"
"4494";"La Plaza España como ágora. Vivir la plaza como parte del barrio y de la ciudad.";"<p>El viernes 4 de marzo se celebra el 3º debate de Plaza España. Será en el Colegio Oficial de Arquitectos de Madrid (COAM) c/ Hortaleza, 63, a las 18:30 h. Se titula <strong>La plaza como ágora. Usos. Vivir la plaza como parte del barrio y de la ciudad""</strong> y será el último antes de que se cierre el cuestionario de participación ciudadana sobre la posible remodelación de Plaza España. </p>

<p>En este último debate queremos escuchar, por ello vamos a dar directamente la palabra a la sala; queremos conseguir una conversación fluida y abierta entre todos y todas, para que podamos dar luz a las muchas dudas que afloran diariamente sobre este espacio de Madrid.</p>

<p>Los invitados a este espacio de tertulia son Isabela Velázquez, Isabel González, Lourdes Vaquero, Jesús Leal, Araceli Turina, Fernando Terán Troyano, representantes del Colegio Oficial de Arquitectos de Madrid (COAM) y representantes Colegio Oficial de Ingenieros de Caminos, Canales y Puertos (COICCP). Asistirán también técnicos municipales y vecinos y vecinas del barrio, así como los Concejales de Desarrollo Urbano Sostenible, José Manuel Calvo y de Participación Ciudadana, Transparencia y Gobierno Abierto, Pablo Soto.</p>

<p>De forma paralela abrimos este debate online para que, en el caso de que no puedas asistir presencialmente, aportes tus opiniones y comentarios. ¡Gracias!</p>
";"01/03/2016 10";"72";"52";"20";"10";"2616169511";"2311"
"4495";"Lo que debería haberse hecho es impedir que se fuera Wanda";"<p>El chino tenía un gran proyecto que habría impulsado una zona cada día más degradada, sin un  de coste para el contribuyente y con la creación de muchos puestos de trabajo, pero los prejuicios ideológicos lo impidieron.</p>

<p>Ahora conservamos un edificio de dudoso gusto, anticuado  que se cae a cachos, eso sí, con la fachada intacta, y a gastar dinero del contribuyente para rehabilitar la zona, hala!</p>

<p> </p>

<p> </p>
";"02/03/2016 20";"127";"46";"81";"6";"2613185643";"-1267"
"4496";"¿Es cosa mía o la Comunidad de Madrid esta más sucia que nunca?";"<p>Desde hace ya algún tiempo me llevo dando cuenta que la Comunidad de Madrid esta cada vez más sucia, contenedores de reciclaje hasta arriba de desperdicios, cubos de basura hasta arriba, y las calles llenas de suciedad.</p>

<p>Esto está pasando por toda la Comunidad de Madrid, tanto en el Centro como por la periferia, y creo que no es de recibo el estar paseando por la calle, y tener que tener cuidado con tal de no pisar un excremento de perro, o de resbalarme un día de lluvia por que la calzada esté llena de hojas.</p>

<p>Considero que habría que invertir dinero en limpiar Madrid, en vez de gastar el dinero de las arcas del estado en colgar carteles diciendo que <em>Tener suerte no es pisar un excremento de perro sino tener un barrio limpio </em>o similares.</p>
";"03/03/2016 14";"109";"88";"21";"9";"2641185988";"5409"
"4497";"El Sálvame ""revolucionario"" o la Sociedad del Espectáculo";"<p>¿Realmente merece tener poder una opción política que cuando le toca hablar sobre el futuro de España empieza a hablar de besos y ligoteos? Esta es la nueva ""casta"" ""revolucionaria"", que juega a cotilleos adolescentes mientras nuestro futuro como ciudadanos y país tiembla.</p>

<p>Me da vergüenza ajena el espectáculo que se da, el sueldo que cobran, mientras millones de personas lo están pasando realmente mal, mientras les pagamos por dar una solución a sus problemas, y ellos juegan a la ""revolución"" y al ""Sálvame"", todo mezclado. </p>

<p>Me gustaría que el Gobierno del Ayuntamiento de Madrid se posicionara, igual que no ha tenido reparo en hacer con otras cosas (titiriteros, Reyes Magos, Okupaciones...) y rompiera una lanza contra sus socios por dar una imagen lamentable, digna de la chiquillería quinceañera, mientras están recibiendo sueldos públicos pagados por todos.</p>

<p>¿Reprobará Carmena y su equipo estas conductas?</p>

<p>Guy Debord premonizaba en La Sociedad del Espectáculo la degradación verdulera a la que están llevando a la política la nueva ""casta revolucionaria"". </p>
";"04/03/2016 23";"47";"27";"20";"8";"2645838603";"402"
"4498";"Buzón de administradores  ----->   necesitamos un ""canal"" directo.";"<p>Hace ya varios días que alguno de los usuarios vienen experimentando notables dificultades, al menos para introducir sus particulares intervenciones en el área de PROPUESTAS sin que al parecer exista razón evidente ninguna que les pudiera  -por cancelación de Perfil, ó quiza suspension cautelar individualizada-  hacer saber mediante <em>anuncio personalizado</em> al margen de la material <strong>inaccesibilidad</strong> al ""cajetín"" para comentarios recién abierto.</p>

<p>Sin pervertir la natural fluidez de estas utilidades  (enajenando el propósito fundamental a que se abre este Foro público)  echamos sin embargo en falta un cierto acogimiento, para tranquilidad de propios y extraños, que nos ponga al alcance de la vista un discreto ""botón del panico"" sobre el cual pulsar cada vez que nos ocurra ese simpático <u>Houston: tenemos un problema</u> a todos familiar en algún momento de nuestra navegacion.</p>

<p>Por ello, nos preguntamos si el próximo diseño de <em>interfaz visible</em> nos ofrecerá en algún rincón de nuestra pantalla el DIRECTO conocimiento  (sin ""excavar"" a profundos niveles de imágenes sucesivamente jerarquizadas)  con carácter emergente tanto de <em>viñetas</em>, <em>ventanas</em>,<em> carteles</em> ó <em>avisos</em> <strong>operativos</strong> como en su caso de algún Piloto Automático al que confiar nuestro ""aterrizaje suave"" cuando <u>nos lleve de la mano</u> otra vez al punto de partida.</p>

<p>Quizá ya existe, aunque no sea del todo obvio. O a lo mejor, fué sencillamente retirado por utilización abusiva.  No obstante como sin duda los programadores no ignoran al menos se espera la presencia  -en remoto-  de un Técnico de Apoyo que se halle siempre dispuesto al rápido auxilio y quien actuando discretamente como cualquier MODERADOR permanezca ""a la escucha"" leyendo <u>constantemente</u> este <strong>canal directo</strong> que desde aquí ahora estamos reclamando.  Es justo... y necesario.</p>

<p> </p>

<p> </p>
";"05/03/2016 11";"18";"10";"8";"2";"2649527018";"111"
"4499";"#TúPreguntas: Guillermo Zapata, concejal de Fuencarral-El Pardo y Villaverde";"<p>Soy concejal de los distritos de Fuencarral-El Pardo y Villaverde. He dedicado toda mi vida a la escritura, a veces de guiones de televisión, a veces de artículos de todo tipo, a veces de novelas. He dirigido tres cortometrajes (uno de ellos fue la pieza en español más vista de la plataforma youtube con más de 100 millones de visitas) También he trabajado como profesor en varias escuelas de cine del mundo.

Llevo participando en iniciativas políticas desde que estaba en la facultad, en el movimiento vecinal en mi barrio de origen, Aluche, a través de la Comisión de Juventud y Movimientos Sociales de la FRAVM, en el Patio Maravillas, el 15M en sus diferentes expresiones, y finalmente ayudado a componer el movimiento municipalista en Ganemos Madrid y Ahora Madrid.</p>

<p>Estaré aquí el <strong>miércoles 9 a las 13:30 h.</strong> para responder a las preguntas que queráis plantearme desde ahora.</p>
";"07/03/2016 11";"60";"33";"27";"101";"2674663736";"330"
"4500";"Rotonda avenida del cerro milano con avenida de la gavia cortada ";"<p>La rotonda de la Avenida del Cerro Milano con la Avenida de la Gavia lleva cerrada en un carril debido a un socabon. Lleva varios meses cortada al tráfico, pero sin ningún movimiento para ser reparada. ¿cuanto tiempo tenemos que esperar para que las ineficiencias del barrio sean reparadas?</p>
";"07/03/2016 17";"28";"24";"4";"4";"2679170233";"1714"
"4501";"Fijar posición con respecto a la contratación de familiares";"<p>Creo que nuestro argumentario tiene un punto negro en la cuestión de la contratación de familiares. Por ahí el ataque es facilísimo y además pone en cuestión la autoridad moral de Podemos/Ahora Madrid, que es su mayor fortaleza. Lo merezcan o no, los familiares de primer (incluyendo parejas de hecho) o segundo grado de responsables políticos de una determinada entidad pública no deberían beneficiarse de ninguna contratación en el ámbito de dicha entidad (o en cualquier otra en el caso de líderes políticos) si no es mediante una oposición.</p>

<p>Hay muchas personas y muchos trabajos en el mundo, por lo que garantizar que no haya ninguna sospecha de nepotismo debe priorizarse. A la corrupción no se llega de un día para otro, se empieza con gestos aparentemente nimios.</p>
";"10/03/2016 14";"32";"27";"5";"3";"2708064815";"1856"
"4502";"Que no pagemos todos los daños provocados por vehiculos";"<p>Propongo que se busque un medio para poder reclamar al Consorcio de Compensación de Seguros los daños provocados por vehículos al mobiliario urbano, por ejemplo los bolardos arrancados por coches.</p>
";"10/03/2016 16";"30";"23";"7";"10";"2706926639";"1226"
"4503";"#TúPreguntas: Mauricio Valiente, concejal del distrito de Chamartín";"<p>Hola, Soy Mauricio Valiente Ots, Tercer Teniente de Alcalde y Concejal-Presidente del Distrito de Chamartín.</p>

<p>Nací el 31 de agosto de 1966 en Madrid. Soy licenciado y doctor en Derecho por la Universidad Complutense y la Universidad Carlos III de Madrid. Abogado especializado en asilo, inmigración y derechos humanos. He trabajado de coordinador del servicio jurídico y secretario general de la Comisión Española de Ayuda al Refugiado (CEAR), donde sigo siendo miembro de su Comité Ejecutivo y abogado voluntario.</p>

<p>He participado desde muy joven en diferentes organizaciones políticas y en movimientos antirracistas, de solidaridad y de defensa de los derechos de los inmigrantes.</p>

<p>El próximo día <strong>15 de marzo a las 13:00 h.</strong> abriremos un foro de preguntas que puede servir de primer punto de encuentro para debatir vuestras inquietudes y propuestas. Construyendo un Madrid más justo y abierto.</p>

<p>También os animo a que continuemos el diálogo en los consejos, foros y asambleas abiertas en los distritos de la ciudad.</p>

<p>Un saludo y muchas gracias.</p>
";"11/03/2016 16";"31";"21";"10";"72";"2718367551";"745"
"4504";"#TúPreguntas: Aluminio para depurar el agua del Canal de Isabel II";"<p>Mi pregunta es muy concreta: ¿utiliza el Canal de Isabel II sulfato de aluminio para depurar el agua?</p>

<p>Como comienza a saberse, el aluminio es muy peligroso para la salud humana y todavía no se sabe que cantidades se encuentran en el agua una vez filtrada.</p>

<p>De hecho, como consumidor de agua del grifo, me gustaría saber que metales contiene ese agua.</p>
";"12/03/2016 11";"16";"12";"4";"3";"2722387973";"600"
"4506";"Activar una línea de WhatsApp en el Ayuntamiento para comunicar incidencias ";"<p>¡Qué fácil sería arreglar los mil y un problemas habituales en las calles si tuviéramos una línea de WhatsApp del Ayuntamiento! Ese semáforo estropeado, esa loseta suelta, esa papelera a reventar, esa señal mal indicada, etc.etc. Con este sencillo sistema la resolución de problemas menores tendrían una solución rápida.</p>
";"13/03/2016 21";"76";"59";"17";"8";"2742044822";"3260"
"4507";"Presupuestos participativos - Propuestas sobre carril bici";"<p>Espacio de debate sobre propuestas de inversión en relación al carril bici.</p>

<p>Se crea este espacio para que las personas que hayan formulado propuestas de inversión similares u otras personas interesadas en este tema, puedan formular conjuntamente una propuesta en el proceso de presupuestos participativos. En el caso de que esta finalmente sea creada, deberá ser formulada a través del siguiente enlace: https://decide.madrid.es/participatory_budget/investment_projects/new, y en su caso, eliminar las propuestas individuales.</p>

<p>Ese espacio se ha creado para facilitar la fase de apoyos y votaciones, y así evitar que se diluyan los apoyos entre propuestas similares. Cualquier cambio debe realizarse antes de que finalice la fase de propuestas el 31 de marzo, y recomendablemente con antelación suficiente para valorar su viabilidad.</p>
";"15/03/2016 11";"54";"40";"14";"30";"2756760537";"1925"
"4508";"Comisión Ordinaria de Participación Ciudadana, Transparencia y Gobierno Abierto";"<p>El viernes 18 de marzo a las 9:30 h. se celebra la Comisión Permanente Ordinaria del Pleno de Participación Ciudadana, Transparencia y Gobierno Abierto del mes de marzo.</p>

<p>Las Comisiones son abiertas al público y se celebran en el Salón de Comisiones del Pleno, Plaza de la Villa, n.º 4.</p>

<p>Orden del Día: http://www.madrid.es/UnidadesDescentralizadas/UDCPleno/Actividad/ComisionesOrdinarias/Corporacion2015-19/PCTGA/2016/2016-03-18/OD_CPCTGA_18_03_16.pdf </p>

<p>Una vez finalizada, publicaremos el vídeo completo de la Comisión en nuestro canal de YouTube: https://www.youtube.com/channel/UCFmaChI9quIY7lwHplnacfg</p>
";"15/03/2016 17";"18";"6";"12";"1";"2745054036";"-200"
"4509";"Presupuestos participativos- Propuestas Parque de la Gavia";"<p>espacio de debate sobre propuetas de inversión en relación con el parque de la Gavia</p>

<p>Se crea este espacio para que las personas que hayan formulado propuestas de inversión similares u otras personas interesadas en este tema, puedan formular conjuntamente una propuesta en el proceso de presupuestos participativos. En el caso de que esta finalmente sea creada, deberá ser formulada a través del siguiente enlace: https://decide.madrid.es/participatory_budget/investment_projects/new, y en su caso, eliminar las propuestas individuales.</p>

<p>Ese espacio se ha creado para facilitar la fase de apoyos y votaciones, y así evitar que se diluyan los apoyos entre propuestas similares. Cualquier cambio debe realizarse antes de que finalice la fase de propuestas el 31 de marzo, y recomendablemente con antelación suficiente para valorar su viabilidad.</p>
";"18/03/2016 12";"22";"14";"8";"3";"2780980894";"381"
"4510";"Presupuestos participativos - Propuestas Polideportivo Sanchinarro";"<p>Espacio de debate sobre propuestas de inversión en relación al polideportivo de Sanchinarro</p>

<p>Se crea este espacio para que las personas que hayan formulado propuestas de inversión similares u otras personas interesadas en este tema, puedan formular conjuntamente una propuesta en el proceso de presupuestos participativos. En el caso de que esta finalmente sea creada, deberá ser formulada a través del siguiente enlace: https://decide.madrid.es/participatory_budget/investment_projects/new, y en su caso, eliminar las propuestas individuales.</p>

<p>Ese espacio se ha creado para facilitar la fase de apoyos y votaciones, y así evitar que se diluyan los apoyos entre propuestas similares. Cualquier cambio debe realizarse antes de que finalice la fase de propuestas el 31 de marzo, y recomendablemente con antelación suficiente para valorar su viabilidad.</p>
";"18/03/2016 12";"44";"33";"11";"6";"2786111213";"1650"
"4511";"Accesos desde la A-3 con el Ensanche de Vallecas";"<p>Espacio de debate sobre presupuestos de inversión en relación con los accesos desde la A-3 con el Ensanche de Vallecas.</p>

<p>Se crea este espacio para que las personas que hayan formulado propuestas de inversión similares u otras personas interesadas en este tema, puedan formular conjuntamente una propuesta en el proceso de presupuestos participativos. En el caso de que esta finalmente sea creada, deberá ser formulada a través del siguiente enlace: https://decide.madrid.es/participatory_budget/investment_projects/new, y en su caso, eliminar las propuestas individuales.</p>

<p>Ese espacio se ha creado para facilitar la fase de apoyos y votaciones, y así evitar que se diluyan los apoyos entre propuestas similares. Cualquier cambio debe realizarse antes de que finalice la fase de propuestas el 31 de marzo, y recomendablemente con antelación suficiente para valorar su viabilidad.</p>
";"18/03/2016 13";"51";"43";"8";"7";"2789081689";"2950"
"4512";"Presupuestos participativos- Propuesta polideportivo en plaza de la Cebada";"<p>espacio de debate sobre propuesta de inversión en relación a la construcción de un polideportivo u otros usos en plaza de la Cebada</p>

<p>Se crea este espacio para que las personas que hayan formulado propuestas de inversión similares u otras personas interesadas en este tema, puedan formular conjuntamente una propuesta en el proceso de presupuestos participativos. En el caso de que esta finalmente sea creada, deberá ser formulada a través del siguiente enlace: https://decide.madrid.es/participatory_budget/investment_projects/new, y en su caso, eliminar las propuestas individuales.</p>

<p>Ese espacio se ha creado para facilitar la fase de apoyos y votaciones, y así evitar que se diluyan los apoyos entre propuestas similares. Cualquier cambio debe realizarse antes de que finalice la fase de propuestas el 31 de marzo, y recomendablemente con antelación suficiente para valorar su viabilidad.</p>
";"18/03/2016 13";"39";"30";"9";"4";"2786257009";"1615"
"4513";"Presupuestos participativos- Propuestas Centro Cultural Ensanche de Vallecas ";"<p>espacio de debate sobre propuestas de inversión en relación con la construcción de un Centro Cultural en el Ensanche de Vallecas</p>

<p>Se crea este espacio para que las personas que hayan formulado propuestas de inversión similares u otras personas interesadas en este tema, puedan formular conjuntamente una propuesta en el proceso de presupuestos participativos. En el caso de que esta finalmente sea creada, deberá ser formulada a través del siguiente enlace: https://decide.madrid.es/participatory_budget/investment_projects/new, y en su caso, eliminar las propuestas individuales.</p>

<p>Ese espacio se ha creado para facilitar la fase de apoyos y votaciones, y así evitar que se diluyan los apoyos entre propuestas similares. Cualquier cambio debe realizarse antes de que finalice la fase de propuestas el 31 de marzo, y recomendablemente con antelación suficiente para valorar su viabilidad.</p>
";"18/03/2016 13";"30";"20";"10";"2";"2782794113";"666"
"4514";"Presupuestos participativos - Propuestas puntos de recarga vehículos eléctricos";"<p>Espacio de debate sobre propuestas de inversión en relación con puntos de recarga de vehículos eléctricos</p>

<p>Se crea este espacio para que las personas que hayan formulado propuestas de inversión similares u otras personas interesadas en este tema, puedan formular conjuntamente una propuesta en el proceso de presupuestos participativos. En el caso de que esta finalmente sea creada, deberá ser formulada a través del siguiente enlace: https://decide.madrid.es/participatory_budget/investment_projects/new, y en su caso, eliminar las propuestas individuales.</p>

<p>Ese espacio se ha creado para facilitar la fase de apoyos y votaciones, y así evitar que se diluyan los apoyos entre propuestas similares. Cualquier cambio debe realizarse antes de que finalice la fase de propuestas el 31 de marzo, y recomendablemente con antelación suficiente para valorar su viabilidad.</p>
";"18/03/2016 13";"43";"34";"9";"7";"2787489242";"1976"
"4515";"Presupuestos Participativos- Espacios para perros";"<p>Espacio de debate sobre propuestas de inversión en relación con espacios para perros en parques.</p>

<p>Se crea este espacio para que las personas que hayan formulado propuestas de inversión similares u otras personas interesadas en este tema, puedan formular conjuntamente una propuesta en el proceso de presupuestos participativos. En el caso de que esta finalmente sea creada, deberá ser formulada a través del siguiente enlace: https://decide.madrid.es/participatory_budget/investment_projects/new, y en su caso, eliminar las propuestas individuales.</p>

<p>Ese espacio se ha creado para facilitar la fase de apoyos y votaciones, y así evitar que se diluyan los apoyos entre propuestas similares. Cualquier cambio debe realizarse antes de que finalice la fase de propuestas el 31 de marzo, y recomendablemente con antelación suficiente para valorar su viabilidad.</p>
";"18/03/2016 14";"61";"33";"28";"20";"2781796192";"270"
"4516";"Presupuestos participativos - Propuestas alumbrado LED";"<p>Espacio de debate sobre propuestas de inversión en relación con sustitución de alumbrado por LED.</p>

<p>Se crea este espacio para que las personas que hayan formulado propuestas de inversión similares u otras personas interesadas en este tema, puedan formular conjuntamente una propuesta en el proceso de presupuestos participativos. En el caso de que esta finalmente sea creada, deberá ser formulada a través del siguiente enlace: https://decide.madrid.es/participatory_budget/investment_projects/new, y en su caso, eliminar las propuestas individuales.</p>

<p>Ese espacio se ha creado para facilitar la fase de apoyos y votaciones, y así evitar que se diluyan los apoyos entre propuestas similares. Cualquier cambio debe realizarse antes de que finalice la fase de propuestas el 31 de marzo, y recomendablemente con antelación suficiente para valorar su viabilidad.</p>
";"18/03/2016 14";"52";"48";"4";"13";"2791951442";"4061"
"4517";"¿Cambiamos el nombre del distrito de Hortaleza a Hortaleza-Canillas?";"<p>Es en los siglos XII y XIII cuando aparecen por primera vez los nombres de Hortaleza y Canillas, asentamientos que nacieron al noreste de la Comunidad y Villa de Madrid a ambos lados del arroyo de las Rejas, como consecuencia de la repoblación castellana llevada a cabo para asentar el territorio conquistado a las tropas musulmanas.</p>

<p> </p>

<p>A lo largo de los siglos XIX y XX, Hortaleza y Canillas contaron con Ayuntamientos propios e independientes. Es el 30 de marzo de 1950 cuando el antiguo municipio de Canillas fue absorbido por Madrid mediante Decreto de anexión promulgado por el Ministerio de la Gobernación de 1949, dentro del proyecto denominado Gran Madrid. Un día después sucedió lo mismo con Hortaleza.</p>

<p> </p>

<p>Al contrario que el resto de municipios absorbidos a la capital, como Hortaleza, Vallecas, los Carabancheles, Vicálvaro o Villaverde, Canillas continua desaparecido del mapa administrativo de la capital. </p>
";"18/03/2016 15";"76";"28";"48";"12";"2771941052";"-736"
"4518";"Prohibición de giros a la izq en tramoC\ Alcalá. Ventas-Canillejas";"<p>El gran problema de la calle Alcalá en el distrito de Ciudad Lineal son los atascos. Los giros a la izquierda y los coches en doble fila suelen ser los causantes de que este tramo se sature diariamente. El ruido y la contaminación es insoportable. Además de la perdida de tiempo diaria y el embotellamiento de rotondas de tráfico como Ventas, el cruce de Ciudad Lineal o la glorieta de Canillejas que pueden repercutir en el flujo de la M30, la calle Arturo Soria o la A-2.</p>

<p>Por ello, los vecinos pedimos una restructuración sensata del tráfico.</p>
";"20/03/2016 03";"28";"22";"6";"6";"2801539096";"1257"
"4519";"futura Tarjeta única  ----->  diferente proveedor y mejor calidad.";"<p>Las incontestables ventajas de un <em>soporte</em> para albergar los circuitos <strong>micro-electrónicos</strong> de reconocimiento y tarificación a Pasajeros en el transporte público, ahora transcurridos varios años de su introducción, ya no consiguen ocultar alguno de sus más ""chuscos"" inconvenientes...  alteración ó borrado de registros digitales almacenados, pésima impresión externa, inmediato evejecimiento fisico hasta su cuarteo ó fragmentación, onerosa substitución, atenuación de alcance a proximidad, etc.</p>

<p>Además de acumular el progresivo VENCIMIENTO anticipado (por su inaudita programación) en cuanto transcurren algunos meses <strong>de treinta-y-un-días</strong> consecutivos, para quebranto de ajustadas economías familiares limitadas a un estricto lapso mensual, uno de los peores inconvenientes que provocan es la <u>reemisión</u> para cualquiera de los ANTIGUOS clientes que <u>ya constaban</u> previamente registrados. Y si les tuviese además que ser expedida por causa ""no imputable"" encima el asunto ya cobra tintes auténticamente delictivos.</p>

<p>Haciendo gala de la <em>MarcaEspaña</em> por el intrépido chip que tan simpáticamente se nos ""salta"" del DNI allá por donde vamos, nadie se muestra en cambio divertido ni burlón frente a una <em>DinersClub</em>, <em>AmericanExpress</em>, <em>VisaGold</em> ó incluso -efectivamente, lo han adivinado- cualquiera de las <strong>tarjetas ""black""</strong> tan al uso últimamente.  Entonces  ¿porqué rayos el material polímero de nuestro AbonoTtes es tan jod-damente frágil, que obliga a PAGAR al usuario para substituirlo sin trancurrir siquiera medio año de utilización?  ¿porqué no ha de sancionar el Cons.Reg.Ttes a su deficiente proveedor, lesionando por el contrario a quienes somos -no se olvide- su <strong>Cliente</strong> final?  ¿para <em>salvar a quién</em> se <u>empeñan en ocultar</u> las obvias estadísticas por ""fatigas del material"" acumuladas a este respecto?</p>

<p>Cándidos usuarios suponen (con acierto, supongo) que su elaboración requiere materiales y manufactura, pero la sospecha del clásico PRE-PLANNED OBSOLESCENCE nos ronda la cabeza hasta el punto de sentirnos dolorosamente estafados.  Allá donde las impresoras en color multi-funcionales son ya incluso más baratas que su propio juego de Tinteros intercambiables -por poner un ejemplo sencillo-, mucho nos tememos que las <u>injustificables tasas</u> de Seis Euros por plástico no albergan en realidad si no el ""soterrado"" escamoteo de <em>pestilentes</em> negocios paralelos de todo punto intolerables.</p>

<p>Y es aquí donde parece razonablemente llegado el momento de plantarnos: cualquier tarjeta bancaria dura físicamente muy por encima de los tres a cinco años de vigencia (asignados a la clase más modesta ""a Débito"") y no pierden el color ni -lo más importante- la información contenida.  Exijamos por todo ello una <strong>ejemplar Tarjeta Municipal</strong> con los debidos <em>requisitos industriales</em> de la más alta calidad, con que apercibir -de paso- a los gerentes autonómicos correspondientes del oprobio que supone su ridicula ejecutoria profesional.</p>

<p>Instemos desde aquí al propio Consistorio para que <u>urgentemente proceda</u> ya con su inmediata PUESTA EN SERVICIO a título preliminar ""en pruebas"" incluyendo cuantos Servicios y Utilidades dispersos necesitaban antes otras muchas operaciones inconexas, y se adelante así con un novedoso* diseño en su propio Desafío frente a los paupérrimos resultados del <em>endeble</em> ""producto"" Autonómico.</p>

<p> </p>

<p>(*) Si fuera necesario mediante consulta a expertos -y/ó concurso de ideas- para constante mejora sobre intemperie, compatibilidad, resistencia, almacenamiento, etc. de consiguientes Versiones que satisfagan requerimientos específicos (nuevos tanto como antiguos) de operatividad funcional.    </p>

<p> </p>

<p> </p>

<p> </p>

<p> </p>
";"20/03/2016 15";"30";"27";"3";"12";"2809604570";"2160"
"4520";"Participación personas mayores en los Presupuestos Participativos";"<p>Llevo días intentando encontrar cómo pueden participar las personas mayores disfuncionales tecnológicamente, pero con altas dosis de sensated, en los presupuestos participativos, y solo he encontrado que sea a través de cita previa en las oficinas de atención al ciudadano del ayuntamiento.</p>

<p>Esta opción retraerá mucho la participación, y estamos generando barreras.</p>

<p>Abro debate para que entre tod@s demos una solución.</p>
";"20/03/2016 19";"23";"19";"4";"4";"2808382589";"1239"
"4521";"Presupuestos participativos- Propuestas Pasarela Santa Eugenia";"<p>Espacio de debate sobre propuestas de inversión en relación con la pasarela de Santa Eugenia</p>

<p>Se crea este espacio para que las personas que hayan formulado propuestas de inversión similares u otras personas interesadas en este tema, puedan formular conjuntamente una propuesta en el proceso de presupuestos participativos. En el caso de que esta finalmente sea creada, deberá ser formulada a través del siguiente enlace: https://decide.madrid.es/participatory_budget/investment_projects/new, y en su caso, eliminar las propuestas individuales.</p>

<p>Ese espacio se ha creado para facilitar la fase de apoyos y votaciones, y así evitar que se diluyan los apoyos entre propuestas similares. Cualquier cambio debe realizarse antes de que finalice la fase de propuestas el 31 de marzo, y recomendablemente con antelación suficiente para valorar su viabilidad.</p>
";"21/03/2016 13";"25";"17";"8";"4";"2812810487";"612"
"4522";"Presupuestos participativos-Propuesta de soterramiento de cubos de basura";"<p>Espacio de debate sobre propuestas de inversión en relación con el soterramiento de cubos de basura</p>

<p>Se crea este espacio para que las personas que hayan formulado propuestas de inversión similares u otras personas interesadas en este tema, puedan formular conjuntamente una propuesta en el proceso de presupuestos participativos. En el caso de que esta finalmente sea creada, deberá ser formulada a través del siguiente enlace: https://decide.madrid.es/participatory_budget/investment_projects/new, y en su caso, eliminar las propuestas individuales.</p>

<p>Ese espacio se ha creado para facilitar la fase de apoyos y votaciones, y así evitar que se diluyan los apoyos entre propuestas similares. Cualquier cambio debe realizarse antes de que finalice la fase de propuestas el 31 de marzo, y recomendablemente con antelación suficiente para valorar su viabilidad.</p>
";"21/03/2016 13";"62";"47";"15";"4";"2817708511";"2425"
"4523";"Recuperar el parque tierno galván";"<p>Espacio de debate sobre propuestas de inversión en relación con la recuperación del parque de tierno galván</p>

<p>Se crea este espacio para que las personas que hayan formulado propuestas de inversión similares u otras personas interesadas en este tema, puedan formular conjuntamente una propuesta en el proceso de presupuestos participativos. En el caso de que esta finalmente sea creada, deberá ser formulada a través del siguiente enlace: https://decide.madrid.es/participatory_budget/investment_projects/new, y en su caso, eliminar las propuestas individuales.</p>

<p>Ese espacio se ha creado para facilitar la fase de apoyos y votaciones, y así evitar que se diluyan los apoyos entre propuestas similares. Cualquier cambio debe realizarse antes de que finalice la fase de propuestas el 31 de marzo, y recomendablemente con antelación suficiente para valorar su viabilidad.</p>
";"21/03/2016 14";"70";"59";"11";"6";"2820561778";"4045"
"4524";"Parque Manolito Gafotas";"<p>Espacio de debate sobre propuestas de inversión en relación con la Construcción de un parque Manolito Gafotas en el Pau de Carabanchel</p>

<p>Se crea este espacio para que las personas que hayan formulado propuestas de inversión similares u otras personas interesadas en este tema, puedan formular conjuntamente una propuesta en el proceso de presupuestos participativos. En el caso de que esta finalmente sea creada, deberá ser formulada a través del siguiente enlace: https://decide.madrid.es/participatory_budget/investment_projects/new, y en su caso, eliminar las propuestas individuales.</p>

<p>Ese espacio se ha creado para facilitar la fase de apoyos y votaciones, y así evitar que se diluyan los apoyos entre propuestas similares. Cualquier cambio debe realizarse antes de que finalice la fase de propuestas el 31 de marzo, y recomendablemente con antelación suficiente para valorar su viabilidad.</p>
";"21/03/2016 14";"34";"21";"13";"6";"2812429832";"494"
"4525";"Residencia para mayores en Carabanchel ";"<p>Espacio de debate sobre propuestas de inversión en relación con la creación de una nueva residencia para mayores en Carabanchel</p>

<p>Se crea este espacio para que las personas que hayan formulado propuestas de inversión similares u otras personas interesadas en este tema, puedan formular conjuntamente una propuesta en el proceso de presupuestos participativos. En el caso de que esta finalmente sea creada, deberá ser formulada a través del siguiente enlace: https://decide.madrid.es/participatory_budget/investment_projects/new, y en su caso, eliminar las propuestas individuales.</p>

<p>Ese espacio se ha creado para facilitar la fase de apoyos y votaciones, y así evitar que se diluyan los apoyos entre propuestas similares. Cualquier cambio debe realizarse antes de que finalice la fase de propuestas el 31 de marzo, y recomendablemente con antelación suficiente para valorar su viabilidad.</p>
";"21/03/2016 14";"40";"31";"9";"2";"2816875635";"1705"
"4526";"Biblioteca pública/centro social en Carabanchel ";"<p>Espacio de debate sobre propuestas de inversión en relación con la creación de una Biblioteca pública y centro social en Carabanchel.</p>

<p>Se crea este espacio para que las personas que hayan formulado propuestas de inversión similares u otras personas interesadas en este tema, puedan formular conjuntamente una propuesta en el proceso de presupuestos participativos. En el caso de que esta finalmente sea creada, deberá ser formulada a través del siguiente enlace: https://decide.madrid.es/participatory_budget/investment_projects/new, y en su caso, eliminar las propuestas individuales.</p>

<p>Ese espacio se ha creado para facilitar la fase de apoyos y votaciones, y así evitar que se diluyan los apoyos entre propuestas similares. Cualquier cambio debe realizarse antes de que finalice la fase de propuestas el 31 de marzo, y recomendablemente con antelación suficiente para valorar su viabilidad.</p>
";"21/03/2016 14";"40";"31";"9";"2";"2816889107";"1705"
"4527";"Solar Antonio López y conexión Madrid Río";"<p>Espacio de debate sobre propuestas de inversión en relación con el uso para un solar en la calle Antonio López y conexión con Madrid Rio.</p>

<p>Se crea este espacio para que las personas que hayan formulado propuestas de inversión similares u otras personas interesadas en este tema, puedan formular conjuntamente una propuesta en el proceso de presupuestos participativos. En el caso de que esta finalmente sea creada, deberá ser formulada a través del siguiente enlace: https://decide.madrid.es/participatory_budget/investment_projects/new, y en su caso, eliminar las propuestas individuales.</p>

<p>Ese espacio se ha creado para facilitar la fase de apoyos y votaciones, y así evitar que se diluyan los apoyos entre propuestas similares. Cualquier cambio debe realizarse antes de que finalice la fase de propuestas el 31 de marzo, y recomendablemente con antelación suficiente para valorar su viabilidad.</p>
";"21/03/2016 14";"36";"29";"7";"1";"2817265196";"1772"
"4528";"Campo de fútbol del Hogar (Puerta Bonita)";"<p>Espacio de debate sobre propuestas de inversión en relación con el uso del antiguo campo de fútbol del Hogar en Puerta Bonita para construcción de instalaciones deportivas.</p>

<p>Se crea este espacio para que las personas que hayan formulado propuestas de inversión similares u otras personas interesadas en este tema, puedan formular conjuntamente una propuesta en el proceso de presupuestos participativos. En el caso de que esta finalmente sea creada, deberá ser formulada a través del siguiente enlace: https://decide.madrid.es/participatory_budget/investment_projects/new, y en su caso, eliminar las propuestas individuales.</p>

<p>Ese espacio se ha creado para facilitar la fase de apoyos y votaciones, y así evitar que se diluyan los apoyos entre propuestas similares. Cualquier cambio debe realizarse antes de que finalice la fase de propuestas el 31 de marzo, y recomendablemente con antelación suficiente para valorar su viabilidad.</p>
";"21/03/2016 14";"25";"14";"11";"3";"2809618568";"168"
"4529";"Presupuestos participativos-Propuesta Parking gratuito Villa Vallecas";"<p>Espacio de debate sobre propuestas de inversión en relación con la construcción de un parking gratuito</p>

<p>Se crea este espacio para que las personas que hayan formulado propuestas de inversión similares u otras personas interesadas en este tema, puedan formular conjuntamente una propuesta en el proceso de presupuestos participativos. En el caso de que esta finalmente sea creada, deberá ser formulada a través del siguiente enlace: https://decide.madrid.es/participatory_budget/investment_projects/new, y en su caso, eliminar las propuestas individuales.</p>

<p>Ese espacio se ha creado para facilitar la fase de apoyos y votaciones, y así evitar que se diluyan los apoyos entre propuestas similares. Cualquier cambio debe realizarse antes de que finalice la fase de propuestas el 31 de marzo, y recomendablemente con antelación suficiente para valorar su viabilidad.</p>
";"21/03/2016 15";"22";"15";"7";"2";"2813080974";"545"
"4530";"Presupuestos Participativos-Propuesta Biblioteca en el Ensanche de Vallecas";"<p>Espacio de debate sobre propuestas de inversión en relación con la construcción de una Biblioteca en el Ensanche de Vallecas</p>

<p>Se crea este espacio para que las personas que hayan formulado propuestas de inversión similares u otras personas interesadas en este tema, puedan formular conjuntamente una propuesta en el proceso de presupuestos participativos. En el caso de que esta finalmente sea creada, deberá ser formulada a través del siguiente enlace: https://decide.madrid.es/participatory_budget/investment_projects/new, y en su caso, eliminar las propuestas individuales.</p>

<p>Ese espacio se ha creado para facilitar la fase de apoyos y votaciones, y así evitar que se diluyan los apoyos entre propuestas similares. Cualquier cambio debe realizarse antes de que finalice la fase de propuestas el 31 de marzo, y recomendablemente con antelación suficiente para valorar su viabilidad.</p>
";"21/03/2016 15";"46";"39";"7";"7";"2819824037";"2713"
"4531";"Prespuestos participativos-Propuestas Espacio canino en el Ensanche de Vallecas";"<p>Espacio de debate sobre propuestas de inversión en relación a la construcción de un espacio canino en el Ensanche de Vallecas</p>

<p>Se crea este espacio para que las personas que hayan formulado propuestas de inversión similares u otras personas interesadas en este tema, puedan formular conjuntamente una propuesta en el proceso de presupuestos participativos. En el caso de que esta finalmente sea creada, deberá ser formulada a través del siguiente enlace: https://decide.madrid.es/participatory_budget/investment_projects/new, y en su caso, eliminar las propuestas individuales.</p>

<p>Ese espacio se ha creado para facilitar la fase de apoyos y votaciones, y así evitar que se diluyan los apoyos entre propuestas similares. Cualquier cambio debe realizarse antes de que finalice la fase de propuestas el 31 de marzo, y recomendablemente con antelación suficiente para valorar su viabilidad.</p>
";"21/03/2016 15";"40";"22";"18";"4";"2810725610";"220"
"4532";"Remodelación accesos a la estación de Chamartín";"<p>Remodelación de los accesos a la estación de Chamartín.</p>

<p>Se crea este espacio para que las personas que hayan formulado propuestas de inversión similares u otras personas interesadas en este tema, puedan formular conjuntamente una propuesta en el proceso de presupuestos participativos. En el caso de que esta finalmente sea creada, deberá ser formulada a través del siguiente enlace: https://decide.madrid.es/participatory_budget/investment_projects/new, y en su caso, eliminar las propuestas individuales.</p>

<p>Ese espacio se ha creado para facilitar la fase de apoyos y votaciones, y así evitar que se diluyan los apoyos entre propuestas similares. Cualquier cambio debe realizarse antes de que finalice la fase de propuestas el 31 de marzo, y recomendablemente con antelación suficiente para valorar su viabilidad.</p>
";"21/03/2016 15";"45";"41";"4";"13";"2821667945";"3371"
"4533";"Canchas de baloncesto al aire libre en Chamberí";"<p>Creación de canchas de baloncesto al aire libre en el distrito de Chamberí</p>
";"21/03/2016 16";"35";"24";"11";"3";"2814918586";"891"
"4534";"Presupuestos participativos - Propuestas Biblioteca Latina";"<p>Espacio de debate sobre propuestas de inversión en relación con la creación de bibliotecas en el distrito de Latina.</p>

<p>Se crea este espacio para que las personas que hayan formulado propuestas de inversión similares u otras personas interesadas en este tema, puedan formular conjuntamente una propuesta en el proceso de presupuestos participativos. En el caso de que esta finalmente sea creada, deberá ser formulada a través del siguiente enlace: https://decide.madrid.es/participatory_budget/investment_projects/new, y en su caso, eliminar las propuestas individuales.</p>

<p>Ese espacio se ha creado para facilitar la fase de apoyos y votaciones, y así evitar que se diluyan los apoyos entre propuestas similares. Cualquier cambio debe realizarse antes de que finalice la fase de propuestas el 31 de marzo, y recomendablemente con antelación suficiente para valorar su viabilidad.</p>
";"21/03/2016 16";"26";"17";"9";"6";"2813555086";"523"
"4535";"Biblioteca en Las Tablas";"<p>Creación de una biblioteca pública en Las Tablas</p>
";"21/03/2016 16";"44";"32";"12";"3";"2816744052";"1454"
"4536";"Presupuestos participativos - Propuesta de baños públicos";"<p>Espacio de debate sobre propuestas de inversión en relación con la construcción de baños públicos.</p>

<p>Se crea este espacio para que las personas que hayan formulado propuestas de inversión similares u otras personas interesadas en este tema, puedan formular conjuntamente una propuesta en el proceso de presupuestos participativos. En el caso de que esta finalmente sea creada, deberá ser formulada a través del siguiente enlace: https://decide.madrid.es/participatory_budget/investment_projects/new, y en su caso, eliminar las propuestas individuales.</p>

<p>Ese espacio se ha creado para facilitar la fase de apoyos y votaciones, y así evitar que se diluyan los apoyos entre propuestas similares. Cualquier cambio debe realizarse antes de que finalice la fase de propuestas el 31 de marzo, y recomendablemente con antelación suficiente para valorar su viabilidad.</p>
";"22/03/2016 10";"49";"32";"17";"6";"2822617189";"979"
"4537";"Presupuestos participativos - Villa de Vallecas";"<p>El próximo martes 29 de marzo, en la Biblioteca Pública Municipal 'Gerardo Diego' (c/ Monte Aya, 12), tendrá lugar la segunda reunión sobre Presupuestos Participativos en el Distrito con el objeto de la presentación de iniciativas y estudio de proyectos que se vienen trabajando en las Mesas creadas en los 'Estados Generales'. El plazo de presentación de iniciativas para dichos Presupuestos termina el 31 de marzo. Queremos escuchar las propuestas de las Mesas de trabajo sin dejar de lado las propuestas a título individual y que entre todas y todos elijamos las que son mejores para el Distrito.</p>

<p>Abrimos este debate online para que aportes tus opiniones y comentarios. ¡Gracias!</p>
";"22/03/2016 10";"29";"19";"10";"9";"2821611676";"589"
"4538";"Presupuestos participativos. Propuestas Autobuses en el Ensanche de Vallecas";"<p>Espacio de debate sobre propuestas de inversión en relación con los autobuses en el Ensanche de Vallecas</p>

<p>Se crea este espacio para que las personas que hayan formulado propuestas de inversión similares u otras personas interesadas en este tema, puedan formular conjuntamente una propuesta en el proceso de presupuestos participativos. En el caso de que esta finalmente sea creada, deberá ser formulada a través del siguiente enlace: https://decide.madrid.es/participatory_budget/investment_projects/new, y en su caso, eliminar las propuestas individuales.</p>

<p>Ese espacio se ha creado para facilitar la fase de apoyos y votaciones, y así evitar que se diluyan los apoyos entre propuestas similares. Cualquier cambio debe realizarse antes de que finalice la fase de propuestas el 31 de marzo, y recomendablemente con antelación suficiente para valorar su viabilidad.</p>
";"22/03/2016 10";"27";"20";"7";"2";"2823086327";"962"
"4539";"Presupuestos participativos-propuestas autobuses Ensanche de Vallecas";"<p>Espacio de debate sobre propuestas de inversión en relación con los autobuses Ensanche de Vallecas</p>

<p>Se crea este espacio para que las personas que hayan formulado propuestas de inversión similares u otras personas interesadas en este tema, puedan formular conjuntamente una propuesta en el proceso de presupuestos participativos. En el caso de que esta finalmente sea creada, deberá ser formulada a través del siguiente enlace: https://decide.madrid.es/participatory_budget/investment_projects/new, y en su caso, eliminar las propuestas individuales.</p>

<p>Ese espacio se ha creado para facilitar la fase de apoyos y votaciones, y así evitar que se diluyan los apoyos entre propuestas similares. Cualquier cambio debe realizarse antes de que finalice la fase de propuestas el 31 de marzo, y recomendablemente con antelación suficiente para valorar su viabilidad.</p>
";"22/03/2016 10";"36";"29";"7";"3";"2825726671";"1772"
"4540";"Presupuestos participativos-Propuestas Escuelas infantiles Retiro";"<p>Espacio de debate sobre propuestas de inversión en relación con la creación de Escuelas infantiles en Retiro</p>

<p>Se crea este espacio para que las personas que hayan formulado propuestas de inversión similares u otras personas interesadas en este tema, puedan formular conjuntamente una propuesta en el proceso de presupuestos participativos. En el caso de que esta finalmente sea creada, deberá ser formulada a través del siguiente enlace: https://decide.madrid.es/participatory_budget/investment_projects/new, y en su caso, eliminar las propuestas individuales.</p>

<p>Ese espacio se ha creado para facilitar la fase de apoyos y votaciones, y así evitar que se diluyan los apoyos entre propuestas similares. Cualquier cambio debe realizarse antes de que finalice la fase de propuestas el 31 de marzo, y recomendablemente con antelación suficiente para valorar su viabilidad.</p>
";"22/03/2016 11";"28";"17";"11";"2";"2820042731";"364"
"4541";"Presupuestos participativos-propuestas Escuela infantil Retiro";"<p>espacio de debate sobre propuestas de inversión en relación con las Escuelas infantiles en Retiro</p>

<p>Se crea este espacio para que las personas que hayan formulado propuestas de inversión similares u otras personas interesadas en este tema, puedan formular conjuntamente una propuesta en el proceso de presupuestos participativos. En el caso de que esta finalmente sea creada, deberá ser formulada a través del siguiente enlace: https://decide.madrid.es/participatory_budget/investment_projects/new, y en su caso, eliminar las propuestas individuales.</p>

<p>Ese espacio se ha creado para facilitar la fase de apoyos y votaciones, y así evitar que se diluyan los apoyos entre propuestas similares. Cualquier cambio debe realizarse antes de que finalice la fase de propuestas el 31 de marzo, y recomendablemente con antelación suficiente para valorar su viabilidad.</p>
";"22/03/2016 11";"22";"12";"10";"2";"2817283231";"109"
"4542";"Presupuestos participativos-Propuestas carril bici Retiro";"<p>Espacio de debate sobre propuestas de inversión en relación con el carril bici en Retiro</p>

<p>Se crea este espacio para que las personas que hayan formulado propuestas de inversión similares u otras personas interesadas en este tema, puedan formular conjuntamente una propuesta en el proceso de presupuestos participativos. En el caso de que esta finalmente sea creada, deberá ser formulada a través del siguiente enlace: https://decide.madrid.es/participatory_budget/investment_projects/new, y en su caso, eliminar las propuestas individuales.</p>

<p>Ese espacio se ha creado para facilitar la fase de apoyos y votaciones, y así evitar que se diluyan los apoyos entre propuestas similares. Cualquier cambio debe realizarse antes de que finalice la fase de propuestas el 31 de marzo, y recomendablemente con antelación suficiente para valorar su viabilidad.</p>
";"22/03/2016 12";"38";"21";"17";"3";"2819223532";"221"
"4543";"Presupuestos participativos-Propuestas Polideportivo JM Cagigal.";"<p>Espacio de debate sobre propuestas de inversión en relación con el Polideportivo JM Cagigal.</p>

<p>Se crea este espacio para que las personas que hayan formulado propuestas de inversión similares u otras personas interesadas en este tema, puedan formular conjuntamente una propuesta en el proceso de presupuestos participativos. En el caso de que esta finalmente sea creada, deberá ser formulada a través del siguiente enlace: https://decide.madrid.es/participatory_budget/investment_projects/new, y en su caso, eliminar las propuestas individuales.</p>

<p>Ese espacio se ha creado para facilitar la fase de apoyos y votaciones, y así evitar que se diluyan los apoyos entre propuestas similares. Cualquier cambio debe realizarse antes de que finalice la fase de propuestas el 31 de marzo, y recomendablemente con antelación suficiente para valorar su viabilidad.</p>
";"22/03/2016 14";"25";"14";"11";"6";"2819886870";"168"
"4544";"Presupuestos Participativos- Biblioteca en Aravaca";"<p>Espacio de debate sobre propuestas de inversión en relación con una Biblioteca en Aravaca</p>

<p>Se crea este espacio para que las personas que hayan formulado propuestas de inversión similares u otras personas interesadas en este tema, puedan formular conjuntamente una propuesta en el proceso de presupuestos participativos. En el caso de que esta finalmente sea creada, deberá ser formulada a través del siguiente enlace: https://decide.madrid.es/participatory_budget/investment_projects/new, y en su caso, eliminar las propuestas individuales.</p>

<p>Ese espacio se ha creado para facilitar la fase de apoyos y votaciones, y así evitar que se diluyan los apoyos entre propuestas similares. Cualquier cambio debe realizarse antes de que finalice la fase de propuestas el 31 de marzo, y recomendablemente con antelación suficiente para valorar su viabilidad.</p>
";"22/03/2016 15";"25";"15";"10";"2";"2821117445";"300"
"4545";"Presupuestos Participativos- Propuestas Biblioteca C. Campo/ Col. Manzanares";"<p>Espacio de debate sobre propuestas de inversión en relación con una posible biblioteca en el Barrio Casa de Campo / Colonia Manzanares</p>

<p>Se crea este espacio para que las personas que hayan formulado propuestas de inversión similares u otras personas interesadas en este tema, puedan formular conjuntamente una propuesta en el proceso de presupuestos participativos. En el caso de que esta finalmente sea creada, deberá ser formulada a través del siguiente enlace: https://decide.madrid.es/participatory_budget/investment_projects/new, y en su caso, eliminar las propuestas individuales.</p>

<p>Ese espacio se ha creado para facilitar la fase de apoyos y votaciones, y así evitar que se diluyan los apoyos entre propuestas similares. Cualquier cambio debe realizarse antes de que finalice la fase de propuestas el 31 de marzo, y recomendablemente con antelación suficiente para valorar su viabilidad.</p>

<p> </p>
";"22/03/2016 16";"27";"16";"11";"9";"2822597209";"296"
"4546";"Presupuestos Participativos- Propuesta sobre polideportivo Las Tablas";"<p>Polideportivo municipal en el barrio de Las Tablas</p>
";"23/03/2016 13";"35";"23";"12";"1";"2833038166";"722"
"4547";"¿Qué propuestas de inversión te parecen prioritarias para Moncloa-Aravaca?";"<p>En el contexto de los presupuestos participativos, l@s vecin@s decidirán qué inversiones (una inversión es adquirir algo o construirlo y cuya duración sea superior a un año) se harán en su distrito por un importe determinado. En el caso de Moncloa-Aravaca la cuantía será de 1.129.851 euros. ¿Como vecino de ese distrito, qué inversión consideras prioritaria?</p>
";"23/03/2016 15";"16";"8";"8";"10";"2828341907";"0"
"4548";"Creación de una Banda de Música para el Distrito de Arganzuela";"<p>Creación de una Asociación de amigos de la Música Arganzuela </p>

<p>Abro debate sobre la necesidad, de poder formar una Asociación Musical para el Distrito de Arganzuela. Aprovechando la oportunidad que nos da el Ayuntamiento de Madrid, de poder participar en el presupuesto para el año 2017, he presentado una propuesta de inversion para la adquisición del instrumental necesario para la formación de una banda de Música en el Distrito de Arganzuela</p>

<p>Al ser una asociación sin animo de lucro y no profesional, que entre sus fines esta el acceso a la cultura musical para jóvenes y mayores de ambos sexos , con la creación de una academia gratuita para impartir clases de solfeo e instrumentación y director musical, el profesorado se sufragaría con una cuota mensual y popular, solo necesitaría la cesión en uso de un local apropiado para ensayos e impartir las clases, todo autogestionado de forma libre y democrática para su funcionamiento. </p>

<p>No me extenderé en desglosar la repercusión y disfrute social que supondría para todo el Distrito y por ende para la Ciudad de Madrid, el disponer de una herramienta tan básica y necesaria en una sociedad moderna y participativa.</p>

<p>Plantilla banda Arganzuela.</p>

<p>Viento madera:</p>

<p>20 clarinetes, 6 saxos alto, 6 saxos tenores, 2 saxo barítono, 1 clarinete bajo,  2 fagot, 2 requintos,  2 oboes, 5 flautas, 1 flautín.</p>

<p>Viento metal: </p>

<p>9 trompas, 7 trompetas en sib,  1 trompeta piccolo,  2 fliscornos, 4 bombardinos, 6 trombones, 1 trombón bajo, 4 tubas,</p>

<p>Percusion:</p>

<p>Timbales (4), Bombo de calle y otro de concierto, Gong, 2 cajas, Platillos, Xilófono, Vibráfono, Pequeña percusión (pandereta, caja china, ratchet, látigo, triángulo etc...</p>

<p>1 Piano. Necesrio para clases de solfeo</p>

<p> </p>
";"27/03/2016 13";"52";"30";"22";"16";"2871988166";"461"
"4549";"Presupuestos participativos - Propuestas Mercado Sanchinarro";"<p>Espacio de debate sobre propuestas de inversión en relación con la creación de un mercado municipal en Sanchinarro.</p>

<p>Se crea este espacio para que las personas que hayan formulado propuestas de inversión similares u otras personas interesadas en este tema, puedan formular conjuntamente una propuesta en el proceso de presupuestos participativos. En el caso de que esta finalmente sea creada, deberá ser formulada a través del siguiente enlace:https://decide.madrid.es/participatory_budget/investment_projects/new, y en su caso, eliminar las propuestas individuales.</p>

<p>Ese espacio se ha creado para facilitar la fase de apoyos y votaciones, y así evitar que se diluyan los apoyos entre propuestas similares. Cualquier cambio debe realizarse antes de que finalice la fase de propuestas el 31 de marzo, y recomendablemente con antelación suficiente para valorar su viabilidad.</p>
";"28/03/2016 11";"41";"29";"12";"0";"2883648903";"1202"
"4550";"Madrid periferia es Madrid.Participación total ya!!!";"<p>Buenas  veo impotente las participaciones de propuestas y votos ante mis ojos.No vivo en la capital pero sí nací en Madrid capital.En Moncloa.Ahora vivo en Móstoles y me indigna no poder votar.Lo que pido a comun de todos los madrileños es que toda comunidad autónoma de Madrid tengamos los mismos derechos que los qye viven en la capital.gracias.</p>
";"28/03/2016 17";"36";"8";"28";"15";"2873887914";"-444"
"4551";"MADRID SALUD ha censurado todos los comentarios en su web.";"<p>He observado hoy que MADRID SALUD ha eliminado de su web todos los comentarios. Donde habia multitud de comentarios acerca de las actuaciones sancionadoras realizadas con falsedad por los agentes de policia. Supongo que os da igual esto. Lo que tambien me causa curiosidad es que algunos debates o propuestas parece que disminuyen de votos.</p>
";"28/03/2016 17";"37";"31";"6";"6";"2889440675";"2094"
"4552";"CUANDO EL RIO SUENA  AGUA LLEVA";"<p>QUE PASA  CON LA BOLSA DE TRABAJO DEL AYUNTAMIENTO , HAY MANIPULACION,</p>

<p>LOS SINDICATOS MEJOR CALÑLADOS .SON CASTA</p>

<p> </p>
";"29/03/2016 22";"42";"21";"21";"2";"2889544817";"0"
"4553";"#TúPreguntas: Inés Sabanés, concejala de Medio Ambiente y Movilidad";"<p>Soy Inés Sabanés, actual delegada de Medio Ambiente y Movilidad del Ayuntamiento de Madrid.</p>

<p>Nací en Cubells (Lleida) en 1953, pero vivo en Madrid desde los años 70. Soy licenciada en Educación Física y trabajé en educación, aunque mi mayor experiencia está en la política y en la administración.</p>

<p>Me incorporé a la política en los años 80 y he desempeñado cargos de responsabilidad institucional con Izquierda Unida, desde 1996 y hasta 2011, como concejala del Ayuntamiento de Madrid y como diputada en la Asamblea de Madrid, cargos desde los que he luchado para conseguir poner las instituciones al servicio de la ciudadanía y del bien común.</p>

<p>En 2011, al acabar mi última legislatura en la Asamblea de Madrid, me incorporé a mi trabajo en el Ayuntamiento de Madrid, en proyectos de Calidad e Innovación. Ese mismo año me incorporé a EQUO, y en la actualidad soy co-portavoz de la Mesa de Madrid. Desde 2014 también he participado en espacios comunes de confluencia, a través de Ganemos Madrid y Ahora Madrid.</p>

<p>En 2015 me presenté a las elecciones al Ayuntamiento de Madrid como candidata de Ahora Madrid. Desde junio de ese mismo año soy delegada del área de Medio Ambiente y Movilidad y como tal, mi prioridad es conseguir una ciudad más moderna y sostenible.</p>

<p>Otras de mis actuales responsabilidades son la presidencia de la Empresa Municipal de Transportes y la vicepresidencia del Consorcio Regional de Transportes. </p>

<p>Estaré aquí el <strong>viernes 1 de abril a las 11:00 h.</strong> para responder a las preguntas que queráis plantearme desde este momento. Saludos.</p>
";"30/03/2016 09";"73";"46";"27";"145";"2906188219";"1197"
"4554";"Presupuestos participativos - Puente de Vallecas";"<p>El próximo martes 5 de abril, en el Centro Cultural Alberto Sánchez (c/ Risco de Peloche, 14), tendrá lugar la segunda reunión sobre Presupuestos Participativos en el Distrito con el objeto de la presentación de iniciativas y estudio de proyectos que se vienen trabajando en las Mesas creadas en los 'Estados Generales'. El plazo de presentación de iniciativas para dichos Presupuestos termina el 31 de marzo. Queremos escuchar las propuestas de las Mesas de trabajo sin dejar de lado las propuestas a título individual y que entre todas y todos elijamos las que son mejores para el Distrito.</p>

<p>Abrimos este debate online para que aportes tus opiniones y comentarios. ¡Gracias!</p>
";"31/03/2016 11";"18";"12";"6";"1";"2910122600";"400"
"4555";"Proceso de #PresupuestosParticipativos en Fuencarral - El Pardo. ";"<p>Abrimos este hilo de debate en relación al proceso de ""Presupuestos Participativos"" en el Distrito de Fuencarral - El Pardo. </p>

<p>Queremos conocer tus comentarios y tus opiniones sobre todo este procedimiento. Participa! </p>

<p>Gracias!</p>
";"31/03/2016 12";"20";"12";"8";"8";"2910103631";"240"
"4556";"Pleno Ordinario de abril en el Distrito de Puente de Vallecas";"<p>El próximo miércoles 5 de abril de 2016 a las 18 horas en el Salón de Plenos de la Junta Municipal de Distrito de Puente de Vallecas se celebrará el Pleno Ordinario correspondiente al mes de abril.</p>

<p>Se puede consultar el orden del día aprobado al efecto en los siguientes links:</p>

<p>https://twitter.com/JMDpvallecas/status/715861821866041344</p>

<p>https://twitter.com/JMDpvallecas/status/715862037742661632</p>

<p>Recordamos que la entrada a los plenos es totalmente libre para las vecinas y vecinos.</p>
";"01/04/2016 13";"16";"8";"8";"0";"2915640922";"0"
"4557";"#TúPreguntas: Rommy Arce, concejala de los distritos de Arganzuela y Usera";"<p>Soy Rommy Arce, actual concejala presidenta de los distritos de Arganzuela y Usera. Nací en Lima en 1977 y llevo residiendo en España desde mediados de los años 90. Me licencié en Historia del Arte y Documentación por la Universidad Complutense de Madrid y posteriormente obtuve el título de máster universitario en Bibliotecas y Servicios de Información Digital por la Universidad Carlos III de Madrid. Hasta mi incorporación al Ayuntamiento de Madrid ejercía como bibliotecaria en la Universidad Complutense de Madrid. En los últimos años tengo que destacar mi colaboración profesional en la implementación de bibliotecas en los campamentos de refugiados saharauis de Tindouf con la Asociación Escritores por el Sáhara-Bubisher de la que soy miembro. He sido representante sindical con CCOO y he estado implicada en diversas iniciativas ciudadanas desde el 15M, pasando por la fundación del círculo de Podemos en Vallecas.
Estaré encantada de responder a vuestras preguntas el <strong>martes 5 de abril a las 13:00 h.</strong> Saludos.</p>
";"01/04/2016 15";"48";"18";"30";"127";"2923324665";"-450"
"4558";"Uso privado de un espacio publico";"<p>Que le parece a la concejala de arganzuela por ahora madrid, q se use un espacio publico, en frente del metro arganzuela planetario, para uso y disfrute como parking privado de los coches privados de los policias. Valla, asfaltado y pintado, pagado por¿... Buen mensaje para potenciar el uso del transporte publico, buen mensaje para los q pedimos  zonas verdes, bibliotecas en el barrio... ¿Pueden otros empleados coger espacios publicos otras zonas de madrid y hacer lo mismo?</p>

<p>indignacion</p>

<p> </p>
";"01/04/2016 19";"36";"21";"15";"1";"2922968287";"350"
"4559";"autobuses viejos en vallecas";"<p>Por Qué los autobuses de vallecas, son los más viejos que tiene la emt o los más deteriorados?. Es que no pertenecemos a Madrid igual y pagamos el transporte lo mismo que el resto de viajeros? El porqué de estos autobuses tan falto de limieza y mantenimiento. </p>
";"02/04/2016 10";"48";"42";"6";"3";"2938175509";"3150"
"4560";"Terrazas. Horario de cierre y espacio público que ocupan";"<p>En los distritos centro y Chamberi es un despropósito para el descanso de los ciudadanos que las terrazas cierren a las 2 de la madrugada , hora en que además del ruido de los clientes se inicia el de la recogida del mobiliario de la citada terraza.  Por otro al Lado la ocupación de espacio que invaden sobrepasando el límite físico de las fachadas de lo locales, hacen que ocupen un espacio público que no le corresponde .</p>

<p>Estas de acuerdo en que las terrazas se recogan las 0h. Y que sólo ocupen el limite de su fachada?</p>

<p> </p>

<p> </p>
";"02/04/2016 11";"104";"79";"25";"11";"2938249717";"4101"
"4561";"ELIMINAR O SUSTITUIR LOS SEPARADORES DEL CARRIL BUS ";"<p>Separadores carril bus</p>

<p>Estos separadores de olor azul con forma de aleta de tiburón han causado infinidad de accidentes de peatones y vehículos. Se podrían sustituir por otros de menor volumen y que no suponga una barrera .</p>

<p>Esta Ud de acuerdo en retirar o sustituir los separadores del carril Bus</p>
";"02/04/2016 21";"59";"42";"17";"5";"2939299423";"1779"
"4562";"Terminar de tapar M-40 en Hortaleza";"<p>Los vecinos de San Lorenzo-Hortaleza durante muchos años pasamos de ver las ovejas a sufrir  ruido de los coches que pasan por la M-40.</p>

<p>Solicito terminar de cubrir la M-40 y aparte de no soportar el ruido se podría cruzar  mas facilmente al otro lado ya que hay muchas empresas.</p>
";"02/04/2016 23";"46";"39";"7";"0";"2942509863";"2713"
"4564";"Centro de salud en Valdebebas";"<p>Apertura de un centro de atención primaria en Valdebebas</p>
";"03/04/2016 12";"94";"82";"12";"0";"2951418515";"6106"
"4565";"Propuestas difíciles de que se tengan en cuenta.";"<p>No hay casi ni una propuesta que alcance ni el 3% de lo que piden para tenerlas en consideración.</p>

<p>He hechado un vistazo y las que más tienen es alrededor de 500.</p>

<p>Habría o que hacer más publicidad de la págna: Decide Madrid..., o cambiar el sitema.</p>
";"03/04/2016 13";"63";"58";"5";"5";"2951506048";"4879"
"4566";"Fuera nazis de nuestros barrios";"<p>Desde hace ya un tiempo, vemos como en el centro de Madrid, concretamente el barrio de Chamberí, se ha instalado el famoso ""Hogar Social Madrid"". Personas de ultraderecha, violentas, que ocupan con total impunidad edificios abondanados con el lema "" ayuda a los nacionales"".</p>

<p>Nada mas lejos de la realidad. Día tras día, en barrios como Cuatro Caminos, Tetuan o Chamberí no han dejado de producirse palizas a jovenes inmigrantes, amenazas a cajeras en los supermercados donde recogen comida y amedrentan a cualquiera que no comulge con sus violentas ideas.</p>

<p>Por último, sólo recordar que este ""grupo"" es autor del ataque a la mezquita musulmana de la M-30.</p>

<p>¡FUERA RACISTAS DE NUESTROS BARRIOS, FUERA VIOLENCIA DE NUESTRAS CALLES!</p>
";"03/04/2016 21";"151";"121";"30";"22";"2954739870";"7292"
"4567";"Limpieza de cacas de perros de las calles";"<p>Es una vergüenza la suciedad que hay en las calles, multas ya y denuncias públicas (con evidencia de foto y video) para aquellos dueños de los perros que no recojan las cacas de sus perros. Hoy en día  y con las nuevas tecnologías (Whatsapp, Telegram, etc..) existentes debería permitirse hacer una reclamación online para retratar a los dueños que no recojen las cacas de sus mascotas. Todo los vecinos sabemos quienes son pero ante la  falta de pro-actividad por parte del ayuntamiento debería permitirse denunciar a los vecinos haciendo llegar un vídeo o foto del guarro-dueño.</p>

<p> </p>
";"04/04/2016 16";"225";"217";"8";"17";"2969269626";"20156"
"4568";"Propuestas redundantes";"<p>He observado que hay bastantes propuestas que se repiten en todo o en una gran parte. Seguramente eso supone una división de apoyos, lo cual añadido a que la cantidad de votos a alcanzar es enorme, es posible que dificulte esta iniciativa tan positiva.</p>

<p>Habría que hacer una labor de unificación. Pero no sé si es posible.</p>
";"04/04/2016 21";"123";"116";"7";"7";"2968142689";"10279"
"4569";"Preuspuestos participativos, apoyos a más de un distrito";"<p>¿Por qué apoyar solo las propuestas de un único distrito? Vivo en Chamartín pero me muevo y he vivido en Chamberí y me gustaría apoyar propuestas en ambos distritos... Me parece bien que se cuente con un número limitado de apoyos por persona y que se pidan unos datos mínimos para que no se líen los presupuestos participativos de modo caótico, pero no hay porqué apoyar las propuestas de un solo distrito, se vive y trabaja con frecuencia en distintos distritos madrileños. Gracias, espero que consigamos entre todos una ciudad mejor...    </p>
";"05/04/2016 17";"64";"56";"8";"1";"2972069551";"4200"
"4570";"reformar los pasos de peatones en distrito salamanca";"<p>necesito apoyo  para reformar  el paso de peatones de la esquina alcalá con mendez pelayo  ya qe mi madre es minusvalida y ya nunca pasa por ahi .Hemos llamado  varias veces por telefono y no nos han hecho caso  asique os pediria que me ayudaseis en esta causa </p>
";"06/04/2016 14";"42";"31";"11";"4";"2976015993";"1476"
"4571";"Madrid solidario. A ti, ¿en qué te gustaría colaborar?";"<p><strong>Voluntarios por Madrid</strong> es el nombre del programa municipal de voluntariado del Ayuntamiento de Madrid.</p>

<p>Contamos ya con la participación de 11.000 personas y desarrollamos anualmente más de 100 proyectos solidarios en todos los ámbitos de la vida de la ciudad: reparto de alimentos, acompañamiento a menores hospitalizados, apoyo a refugiados, a personas sin hogar, apoyo escolar, tenencia responsable de animales, activdades deportivas, culturales, medioambientales, etc.</p>

<p>Voluntarios por Madrid promueve la ciudadanía activa con una innovadora idea de voluntariado que te posibilita participar cuando y como quieras en aquello que más te interesa, disfrutando de lo que haces y proporcionándote nuevas amistades. Te damos la oportunidad de ser parte activa de tu ciudad.</p>

<p>Si necesitas más información, llámanos al<strong> teléfono gratuito 900 777 888</strong>.</p>

<p>Nos gustaría conocer qué te animaría a tí a participar con nosotros y cuáles serían tus motivaciones para formar parte de nuestro equipo de personas solidarias.</p>
";"06/04/2016 16";"70";"58";"12";"29";"2981133908";"3811"
"4572";"#TúPreguntas: Francisco Pérez, concejal de Villa de Vallecas y Pte. de Vallecas";"<p>Soy Francisco Pérez Ramos, concejal de Puente y Villa de Vallecas. Trabajé como administrativo hasta 1994 en el Banco Bilbao Vizcaya. En 1992 realicé el curso de Especialista Universitario en Animación Socio-Cultural de la Facultad de Educación de la Universidad Complutense de Madrid. Al año siguiente, redacté el Proyecto de Desarrollo Local del Casco Antiguo de Vallecas (Publicado por el Nudo de la Red), seleccionado dentro del Catálogo Español de Buenas Prácticas Urbanas para la Conferencia Habitat II organizada por la ONU en Estambul. También redacté y dirigí la parte española del Proyecto Transnacional ""Le Cheile"" co-financiado por la Unión Europea en el marco de la iniciativa RECITE II.</p>

<p>He trabajado profesionalmente como consultor en temas de desarrollo y comunicación comunitaria. En 1993 fundé Tele K, la televisión local de Vallecas, y he sido presidente de la Asociación de Televisiones Locales de Madrid y de la Asociación Estatal de Organizaciones de Televisión Local ""G-9"". Hasta 2012 he sido director de la Escuela Audiovisual de Vallecas. También he participado en la fundación de escuelas y emisoras de televisión comunitaria en Chile, Ecuador y Bolivia.</p>

<p>En el ámbito del activismo vecinal he sido presidente de la Asociación de Vecinos del Puente de Vallecas y de la Federación de Asociaciones para el Desarrollo Comunitario de Vallecas. He participado en la fundación de varias iniciativas y asociaciones ciudadanas como la Batalla Naval de Vallecas, la Cofradía Marinera de Vallecas, el Ateneo Republicano o la fiesta de La Karmela, entre otras.</p>

<p>En la actualidad soy miembro de la Mesa Coordinadora de Ahora Madrid y del Consejo Ciudadano Municipal de Podemos.</p>

<p>El próximo <strong>martes 12 de abril a las 13:00 h.</strong> estaré aquí para responder a vuestras preguntas. Saludos.</p>
";"08/04/2016 14";"42";"16";"26";"135";"2993717367";"-380"
"4573";"Calle General Ricardos entre las calles Blasa Pérez y Algorta.";"<p><strong>¿ Que utilidad se puede dar a este solár abandonado ?</strong></p>

<p>Algunos vecinos prefiren un parque, una plaza, otros una comisaría de policía...</p>

<p>Plaza de El Boliche en memoria de nuestro vecino Lorenzo Aparicio pintor  ""naif"" que realizaba sus obras aquí, los más mayores os acordareis los días soleados en la calle dando forma a sus ""alucinantes"" obras. </p>

<p>Podemos abrir un debate</p>

<p> </p>
";"10/04/2016 00";"35";"29";"6";"2";"3011666643";"1905"
"4574";"Pleno Ordinario 13/04/16 de Junta Municipal de Fuencarral - El Pardo";"<p>Este es el Orden del día para el Pleno ordinario del próximo 13 de abril: </p>

<p>http://www.madrid.es/UnidadesDescentralizadas/FuencarralElPardo/Orden/2016/13abril2016.pdf</p>

<p>Abrimos este hilo de debate para conocer tu opinión acerca de los diferentes puntos que en él se incluyen. </p>
";"11/04/2016 12";"20";"8";"12";"5";"3013261406";"-160"
"4575";"Realizar un Bypass soterrado de la M-30 a su paso por el cierre norte";"<p>Realizar un bypass de la M-30 que permita reconducir el tráfico de los coches que llegan por la rama oeste de la M30 por un canal subterráneo que pase por debajo de Monforte de Lemos y desemboque una vez pasado el nudo norte, en las conexiones con la M30 (rama este) o con la A1 y M-11. De esta forma se paliría gran parte de los atascos que sufre diariamente tanto la Avenida de la Ilustración como el nudo norte.</p>

<p>Ventajas adicionales:</p>

<ul>
	<li>Reducción del número de horas perdidas en atascos por los conductores</li>
	<li>Reducción del número de vehículos en circulación por superficie: menos rudio, reducción de contaminación</li>
	<li>Ayudaría a fuidificar le tránsito de vehículos que deben cruzar la Avenida de la Iustración, facilitando las conexiones a través de Ginzo de Limia y Avenida de Betanzos del Barrio del Pilar con la parte de Herrera Oria.</li>
</ul>
";"11/04/2016 15";"102";"83";"19";"9";"3031106260";"5207"
"4576";"Gastar menos y reducir impuestos";"<p>Acabo de ver que estáis pidiendo ideas para gastar 60 millones, por favor terminar de pagar primero la deuda del ayuntamiento y cuando estéis en números azules bajar los impuestos.</p>
";"12/04/2016 18";"121";"97";"24";"7";"3042747664";"5852"
"4577";"Edificio España";"<p>El simbólico Edificio España hoy se encuentra en peligro de desaparecer, debido a la mala e injusta gestión de estos últimos años. Ya sabemos que solo se va a conservar la fachada principal ya que es lo que exige el actual nivel 3. O tal vez  entre todos conseguimos que se conserve, las cuatro fachadas y la estructura. Le fue otorgado el nivel 2 estructural en el año 1997 y fue incluido en el BIC. A principios de este siglo el edificio se fue abandonando progresivamente hasta el cierre en 2006 del hotel quedando totalmente abandonado. En 2005 se puso a la venta junto con Torre Madrid y en ese mismo año lo compro el  Santander, para reformarlo supuestamente respectando el entonces nivel 2, y conservando los usos originales. Se comienza la reforma pero en 2008 se abandona. Durante la reforma, el cineasta Víctor Moreno graba un documental sobre los trabajos de los obreros, donde se puede apreciar como son destrozados los interiores. El Banco Santander bloquea la exhibición de este documental ya que el propietario cree que la cinta perjudica a su imagen. A pesar de que en ningún momento se menciona el nombre del mismo. Hasta que el Santander no se desprende del edificio, el documental no puede ser visualizado (2014). Es en el año 2014 cuando el Banco Santander pide al entonces gobierno de PP que se rebaje el nivel de protección y se retire del BIC. El gobierno del PP le concede su deseo y el edificio pasa a tener un nivel 3 ambiental  y queda a la venta. De este forma el valor en el mercado se reduce. En este mismo año la empresa del multimillonario chino Wang Jianlin (Wanda Group) compra el edificio para convertirlo en centro comercial, viviendas y hotel. Para ello contrata al grupo de arquitectos Foster and Partnes y al Estudio Lamela Arquitectos. Todos estos estudios tienen información de sobra de todos sus proyectos, también sucede lo mismo con la página de Wanda. Sorprende que del proyecto del edificio España no haya ni rastro en la página de Foster y solo se hace una breve mención en las páginas de Wanda y Estudio Lamela. En esta última se menciona que la fachada y los laterales deben de conservarse (lo cual es lógico ya que es lo único que exige el nivel 3). Pero la empresa Wanda lleva insistiendo desde el primer momento en derribar por completo el edificio para luego supuestamente reconstruir al milímetro la fachada principal. Esto solo se podría hacer si la fachada estuviese muy deteriorada hasta punto de suponer un peligro. Por lo que los técnicos de Wanda elaboran un informe alegando todo esto. Obviamente el ayuntamiento de Madrid no se fía de la imparcialidad del informe, por lo que encarga a la Comisión Local de Patrimonio la elaboración de dos informes técnicos para estudiar si es posible que las fachadas se mantengan en pie mientras se derriba el interior. Los informes no son sacados a concurso público. Estos informes demuestran que se pueden conservan perfectamente las fachadas sin suponer ningún peligro y que las informaciones del informe elaborados por los técnicos de Wanda son totalmente falsas como por ejemplo los argumentos de la supuesta aluminosis etc.  En estos últimos meses están saliendo cada día noticias contradictorias, con esto me refiero que llevamos meses escuchando Wanda abandona el proyecto y Wanda continua con el proyecto. En esta página se inicia un proceso participativo sobre la reforma de Plaza España muy polémico debido a la falta de información de si realmente se necesita esta reforma y que intereses particulares hay detrás. Lo que si se sabe es que pretende ser un proceso democrático para que los ciudadanos pueden decidir el futuro de su plaza. Pero realmente quien financia la reforma es Wanda ya que es una plaza pública-privada. Y los interese de las empresas se ponen por encima de la ciudadanía en especial el interés de Wanda que sabemos que está presionando al ayuntamiento para que no se tenga en cuenta el proceso participativo.</p>

<p>A muchos nos sorprende la actitud del nuevo gobierno, el hecho de que siga conservando el nivel de protección impuesto por el PP y que priorice el interés de las grandes empresas frente a los ciudadanos y las grandes inversiones frente al patrimonio. Por eso desde esta propuesta ciudadana pido que se vuelva a conceder el nivel 2 estructural con el fin de que la empresa que lo vaya a comprar en el caso de que se pusiese a la venta realice una reforma que garantice la conservación del edificio y de modo que se le pueda dar un uso para que vuelva a tener la vitalidad que llego a tener en el pasado.</p>

<p>Resumen de irregularidades:</p>

<p>-Ocultismo en los trabajos de reforma del proyecto del Banco Santander.</p>

<p>-Presunta irregularidad a la hora de rebajar del nivel de protección del edificio.</p>

<p>-Ocultismo en el propio proyecto de Wanda. A día de hoy seguimos sin saber que aspecto tendrá el nuevo edificio.</p>

<p>-La empresa Wanda intenta saltarse la legalidad vigente.</p>

<p>-Informe técnico falso con información inventada realiza por los propios técnicos de Wanda.</p>

<p>- Dos informes que no salen a concurso público.</p>

<p>-Intento de acabar con un proceso participativo por parte de Wanda.</p>

<p>- Posible filtración de información falsa a la prensa por parte de Wanda, con el fin de presionar al ayuntamiento para hacer realidad sus caprichos.</p>

<p>Por último quiero agradecer a Madrid Ciudadanía  y Patrimonio, Procoam, ACIBU, Ecologistas en Acción y especialmente a la plataforma Salvemos el Edificio España; por todo lo que están haciendo y el apoyo recibido. Y por supuesto a todas las personas que han firmado la petición ¡No al derribo de Edificio España! de change.org y a las personas que han apoyado esta propuesta.</p>

<p>Podeis apoyarme en la propuesta ciudadana https://decide.madrid.es/proposals/66-suban-a-nivel-2-estructural-al-edificio-espana Muchas Gracias</p>

<p> </p>
";"13/04/2016 15";"73";"51";"22";"3";"3046782466";"2026"
"4578";"Votar propuestas: no admiten firma electrónica";"<p>No puedes votar con firma electrónica. Me parece muy raro, ya que esta forma es la más fiable.</p>

<p>Para poder votar, te piden datos muy personales como tu móvil y tu email.  Y todo eso se queda en su Base de datos. No me parece serio. </p>

<p>Además, con sus datos y su método es mucho menos seguro que la firma electrónica: puedo registrarme como mi compañero de trabajo, mi compañero de piso, etc. </p>

<p>Si se admite, su portal (que se menos fiable) ¿por qué no admiten la firma electrónica?</p>

<p> </p>
";"13/04/2016 15";"27";"18";"9";"2";"3043136817";"600"
"4579";"Acceso al hospital Infanta Leonor (265 VOTOS): Fusión de las 10 propuestas...";"<p>Hay 10  propuestas con el mismo asunto.. ¿no se puede notificar a alguien del foro para que se fusionen en una?</p>

<p> </p>

<ol>
	<li>Acceso al hospital Infanta Leonor (265 VOTOS)</li>
	<li>Túnel en Camino de Vasares para cruzar al hospital Infanta Leonor</li>
	<li>Comunicar BºSta Eugenia y Hosp Infanta Leonor</li>
	<li>Acceso al hospital Infanta Leonor desde Santa Eugenia como se prometió.</li>
	<li>PASO BAJO LAS VIAS DEL CERCANIAS AL HOSPITAL INFANTA LEONOR</li>
	<li>Paso al hospital Infanta Leonor desde Santa Eugenia y La UVA</li>
	<li>Mejoras accesibilidad hospital infanta leonor</li>
	<li>Acceso al Hospital Universitario Infanta Leonor</li>
	<li>Acceso peatonal sin rodeos al Hospital Infanta Leonor (278 VOTOS)</li>
	<li>Comunicación con hospital infanta leonor</li>
</ol>
";"13/04/2016 18";"71";"66";"5";"2";"3054426519";"5670"
"4580";"¿ POR QUÉ SON DIFERENTES LOS PARQUES? SON OBSOLETOS, FEOS Y SUCIOS";"<p>Hola, vivo en <strong>Hortaleza en la calle monovar (barrio apostol santiago),</strong> tengo 3 parques relativamente cerca de casa, uno justo al lado, tengo una niña de 22 meses, que todas las tardes al volver de la guardería y con la intención de compartir con ella una hora, le digo: chiqui vamos al parque!!! y me responde: no, no no. Cuando me acerco a la puerta del parque me dice: chino chino o futbol, futbol. Me entristece, y por qué dice chino o futbol? pues porque prefiere ir a esos lugares que al parque, los parques que tenemos cerca de casa, son parques tristes (un caballito que está descolorido por el sol la madera hecha polvo por el tiempo, un tobogán pequeñito y de los tres parques <strong>NINGUNO tiene columpio para bebé</strong>, el que tiene, me queda a unos 4 kilómetros aproximadamente), son un poco feo, simples y aunque los limpian de forma eventual, están llenos de caca de perros porque <strong>hay DUEÑOS de perros IRRESPONSABLES</strong> que dejan entrar a sus perros a que planten su particular excremento, también está <strong>lleno de caca de gatos</strong>, y se trata de gatos callejeros, tenemos varios vecinos que se dedican a dar de comer a esos GATITOS y los gatitos se van a los parques que tiene tierra blandita (y mi portal) y plantan su especial pinito. POR LO QUE <strong>CUANDO VAMOS A UN PARQUE DEBEMOS DE TENER 20 MIL OJOS PARA QUE <u>EL BEBE NO SE LLEVE TIERRA A LA BOCA, NO PISE O SE SIENTE ARRIBA DE UNA CACA DE PERRO O DE GATO Y SENTARME YO CON ELLA EN EL COLUMPIO PARA QUE SE PUEDA COLUMPIAR</u></strong>, consecuencias? no es un columpio para que soporte mi peso (70 kilos) y además se me pega un dolor de espalda de tres pueblos. Total.............que debemos de tirar de parques privados si nos lo queremos pasar pipa, y eso cuesta muuuuuuchooooooo dinero!!!!!!  POR LO QUE NO SOLO DE TRATA DE QUE ARREGLEN UNOS PARQUES INFANTILES, SI NO TODOS LOS PARQUES INFANTILES, yo creo que nuestros parques están como están porque es una zona en la que viven muchas personas mayores y en sus años ya habrían disfrutado sus hijos de ellos. TOCA RENOVAR, TOCA HACERLOS BIENPOR QUÉ EXISTE TANTAS DIFERENCIAS EN LOS PARQUES? si yo me paseo por la zona de alto estándar de Madrid tienen unos parques que lo flipas, y si te vas a un barrio relativamente antiguo como el mío y de gente humilde TIENES UNOS PARQUES QUE NINGUN NIÑO QUIERE JUGAR ALLI COMO LA MIA.</p>
";"14/04/2016 10";"51";"44";"7";"2";"3057897307";"3192"
"4581";"¿Debería movilizarse la sociedad civil para que lleguen los refugiados?";"<p>El Ayuntamiento de Madrid esta preparado para recibir a los refugiados y más de 400 personas voluntarias están dispuestas a colaborar en tareas de acogida y ayuda. Pero los refugiados no llegan. Observamos todos los días imágenes vergonzosas en los medios de comunicación. ¿Debería movilizarse la sociedad civil para cambiar esta situación?</p>
";"14/04/2016 10";"170";"102";"68";"22";"3054171303";"2039"
"4582";"¿ por qué nadie administra la WEB DECIDE?";"<p>Buenos días,</p>

<p>Si bien esta web puede brindar grandes ideas tanto en las propuestas como en los presupuestos participativos, el caos de la página la hacen bastante ""inútil"": ¿por qué el Ayuntamiento de Madrid consiente este desorden absoluto sin utilidad para nadie de la forma en la que está creada? Parece que reina el ""Divide y vencerás"", está todo tan repetido que es imposible que los madrileños aunemos fuerzas para sumar por una iniciativa o propuesta y conseguir sus votos.  ¿No hay nadie en el ayuntamiento con competencia para poner orden en este servicio para los madrileños prestando un ""buen servicio""? ¿no hay nadie en el Ayuntamiento responsable de la web decide y que organice esta web en condiciones?. Si crean cosas con el dinero de los madrileños, haganlo bien, esta web como está realizada actualmente es una gran chapuza que nos hace perder mucho tiempo a los madrileños. Si la idea es que la gente no participe, lo consiguen... mucha gente entra una vez, ve el pesimo sistema de orden y caos y no vuelve a entrar en esta web. Propongo la creación de Aministradores sin demora para las siguientes táreas:</p>

<p>- <u><strong>FIltrar propuestas para Presupuestos participativos ANTES de votar</strong></u>: ¿como es posible que se puedan votar medidas en los presupuestos participativos sin que un administrador haya fusionado las ideas que son iguales un una única? Falta un administrador que indique a las personas que las crearon, por si hay alguna diferencia, si están de acuerdo en su fusión, sumando ambos votos (salvo que se repitieran por una misma persona en las dos). Esta tárea debería hacerse con rápidez. A la hora de contar los votos, es imposible saber cuál va primera pues habría que sumar todas las que con el mismo tema están creadas y son tantas que es imposible. Asimismo, no tienen orden y deberían de tener un orden por temática dentro de un distrito o del municipio.</p>

<p>-<u><strong>Ordenar las Propuestas por temas y fusionar las de contenido igual como en el caso anterior</strong></u>. Fusionar ideas de contenido similar para que todos conozcamos los votos reales que tiene una propuesta, con un misma idea hay tantas que es imposible conocer el número de votos real, igual hay alguna idea que ya supera los 50.000 votos y es imposible saberlo de la forma que está organizada. Asimismo, se debería crear un Link que permita quitar un voto ya dado y anularlo.</p>

<p>Está web es un caos, espero que pongan orden, fusionen, y permiten deshacer un voto ya dado o poder eliminar(modificar en un tiempo) un comentario.</p>

<p>Gracias, saludos</p>
";"14/04/2016 15";"116";"107";"9";"15";"3064983040";"9039"
"4583";"Subvenciones para pymes con obligacion de contratar minimo un trabajador. ";"<p>Hola,</p>

<p>Una buena medida para paliar el paro, creo que sería facilitar subvenciones a la creacion de pymes pero con obligacion de contratar a un trabajador dandolo de alta en SS. Creo que es una idea que se podría regular en la que todos los ciudadanos pueden estar implicados tambien en la inmigracion, fomentando el uso de la economía y su crecimiento.</p>

<p>Un saludo</p>
";"14/04/2016 16";"51";"45";"6";"0";"3060962755";"3441"
"4585";"Reforma de calles en el Barrio de Chueca ";"<p>Se ha anunciado la reforma de varias calles del barrio de Chueca. Ahora es la ocasión para que se soterren todos los cables de fibra que se están colocando desde hace unos meses en las fachadas.
La mayor parte de las fachadas del barrio están protegidas, se obliga a los vecinos a restaurarlas con soluciones constructivas más caras pero que embellecen la ciudad. No es de recibo que los vecinos tengan que invertir cantidades extras mientras que las grandes compañías abaratan costes colocando el cableado de cualquier manera en las fachadas.</p>
";"14/04/2016 22";"46";"34";"12";"4";"3059594174";"1626"
"4586";"¿La nueva iluminación LED  mejora la contaminación lumínica de Madrid?";"<p>Hay numerosas propuestas que solicitan que todo el alumbrado de la ciudad sea transforme en alumbrado LED. En principio, el principal argumento es que las luces LED son más eficientes energéticamente. Sin embargo, esto no es cierto(: https://en.wikipedia.org/wiki/Luminous_efficacy). Los LED tienen una eficiencia energética igual a las lámparas actuales de Sodio. Tienen otras ventajas, como que es más sencillo enviar su luz al lugar que se quiere iluminar y por tanto es posible usar lámparas de menor potencia, o es más facil regular la intensidad de las mismas (pero no significa que no se pueda hacer con otros tipos de lámparas).</p>

<p>Sin embargo, las lámparas actuales emiten mucha más luz azul con los consecuentes mayores efectos en el medio ambiente y en las salud de las personas. La elección de este alumbrado se realizó sin el perceptivo estudio de impacto ambiental.</p>

<p>Los LED det tipo de Madrid (hay otros tipos de LED menos contaminantes) producen más de 50% más de Contaminación luminica (SLI) (http://journals.plos.org/plosone/article?id=10.1371/journal.pone.0067798).</p>

<p>¿No deberia realizarse un estudio de impacto ambiental en condiciones para que no aumente la contaminación luminica de Madrid? (https://decide.madrid.es/proposals/3418-por-un-madrid-con-estrellas-y-mas-saludable)</p>

<p> </p>
";"14/04/2016 23";"87";"74";"13";"5";"3065047366";"5188"
"4587";"Cia de Mobiliario Urbano   ----->   despojada tras haberla vaciado de Personal.";"<p>Nos impide la rabia considerar otras aproximaciones más  ( ¿cómo decirlo suavemente? )  diplomáticas: la muy cuestionada -tras investigaciones paneuropeas por su afición al trafico de influencias-  transnacional belga <strong>JeanClaudeDecaux</strong> no ha hecho sino un desembarco más asimilable al <u>abordaje de piratas</u> que al civilizado <em>Leveraged-BuyOut</em> requerible entre consorcios comerciales... se quedó con instalaciones, contratos y maquinaria lanzando POR LA BORDA al resto de efectivos (y sus familias) humanos en el vistoso sector de las Marquesinas, Rotulaciones y demás aditamentos sobre la vía publica hasta hace poco desempeñado aquí en esta capital por la <strong>compañía española de mobiliario urbano</strong> CEMUSA que pasa a ser absorbida / deglutida / excretada.</p>

<p>Llama poderosamente nuestra atención la ausencia de cautelas con las que el Consistorio suele sin embargo proteger en otros conocidos supuestos tanto a los trabajadores sub-rogados como  (en definitiva)  a los clientes finales que somos  -no se olvide-  los propios vecinos de Madrid y demás transeuntes.  Seguimos escuchando un ""clamoroso silencio"" por parte de nuestras Autoridades municipales, quienes a buen seguro no se hallan ignorantes de ninguno de estos extremos.  Por lo que parece exigible no sólo su <u>pronunciamiento oficial</u> sino también -y muy especialmente- las explicaciones a la <em>trancredísima</em> inhibición de que viene haciendo gala frente a tales desmanes.</p>

<p>Casi trescientas personas, más de doscientas cincuenta familias, y la desesperación de sus allegados en suma, vienen presas de la angustia aguardando alguna palabra de aliento.  Y los lectores de este Foro, también.</p>

<p>Exijamos ejemplar rigor en las adjudicaciones, revisando y en su caso retrotrayendo, actuaciones que lesionen irrenunciables PROTECCIONES sociales con tantísimo esfuerzo conseguidas en el pasado.  ¿Dónde queda la confianza puesta por el electorado, y hasta dónde alcanza la soberbia de inoperantes políticos?</p>

<p>Jesús ¡qué vergüenza!</p>

<p> </p>

<p> </p>
";"17/04/2016 20";"21";"14";"7";"0";"3084042939";"466"
"4588";"Lanza tu pregunta para el Pleno Abierto";"<p>El próximo fin de semana celebramos el Pleno Abierto. Tienes aquí toda la información: https://decide.madrid.es/plenoabierto</p>

<p>Envía a continuación tu pregunta para cualquiera de los grupos políticos y apoya las que más te gusten.</p>

<p>Si tu pregunta está entre <strong>las cinco más votadas al finalizar el jueves, te contactaremos para invitarte a formularla en persona</strong> en el Pleno del día 24 a todos los grupos políticos.</p>
";"18/04/2016 12";"238";"223";"15";"788";"3109789182";"19489"
"4589";"Derechos adquiridos...¿papel mojado?";"<p>Buenas tardes a tod@s.</p>

<p>Los empleados de Madrid Movilidad llevamos años luchando por alcanzar determinados derechos que han costado enormes sacrificios para su defensa. </p>

<p>Desde hace dos años y debido a las incongruencias del equipo del gobierno municipal anterior, Madrid Movilidad fue absorbida por la EMT.</p>

<p>Las pasadas elecciones produjeron el esperado vuelco electoral con el que la mayoría de las clases trabajadoras nos identificamos. En aquellos momentos, pensamos que nuestros derechos adquiridos estarían a salvo. Sin embargo, las circunstancias en las que se pretenden fusionar ambos convenios comienzan a darnos alguna pista de las verdaderas intenciones de la mesa negociadora.</p>

<p>Nosotr@s, los trabajadores de Madrid Movilidad _ ya extinta pero con convenio propio aún en vigor_ nos preguntamos y lanzamos a su vez un SOS por la consideración de nuestras pretensiones, que no son otras que las de permanecer y conservar los avances sociales y económicos conseguidos con años de lucha.</p>

<p>Muchas gracias. </p>
";"18/04/2016 18";"57";"45";"12";"17";"3100289129";"2605"
"4590";"#TúPreguntas: Montserrat Galcerán, concejala de Tetuán y Moncloa-Aravaca";"<p>Nací en Barcelona, pero resido en Madrid desde los años 70. Soy doctora en Filosofía por la Universidad Complutense de Madrid y catedrática de la misma universidad donde he desarrollado toda mi carrera académica. He publicado diversos libros y artículos sobre filosofía y política.</p>

<p>Participé en mi juventud en los movimientos antifranquistas hasta el advenimiento del PSOE en 1982 que finalizó aquel ciclo de luchas. Desde los años 90 empecé a participar de nuevo en el movimiento antiglobalización y en las nuevas experiencias de movilización ciudadana. Contribuí a crear la Universidad Nómada, un grupo de producción intelectual actualmente integrado en la Fundación de los Comunes. He participado activamente en los conflictos en defensa de la Universidad con motivo de la implantación del Proceso Bolonia, así como en el movimiento feminista. También formé parte del Foro Social de Madrid.</p>

<p>Me interesan especialmente los temas de educación: como antigua profesora de enseñanza media, actual profesora de Universidad y madre de tres hijos, que han asistido a escuelas públicas, creo tener un buen conocimiento de la educación pública, de sus méritos y deméritos.</p>

<p>Desde junio de 2015 soy concejala presidenta de los distritos de Tetuán y Moncloa-Aravaca. Estaré en este foro de debate para responder a vuestras preguntas el próximo <strong>miércoles 20 de abril a las 10:30 h.</strong> Hasta entonces.</p>
";"18/04/2016 18";"28";"12";"16";"47";"3091828732";"-171"
"4591";"Instalación paneles informativos tiempo de espera autobuses en todo Madrid";"<p>Actualmente sólo algunas paradas de autobus tienen paneles informativos sobre el tiempo de espera de los autobuses.</p>

<p>Una mejora notable del servicio sería que los hubiese en absolutamente todas y cada una de las paradas.   Me refiero, claro está, a paneles ""solares"" y que sean del tipo  ""escritos y silenciosos""  y no a paneles  ""con voz""  que meten demasiado ruido.</p>

<p>Ya sé que hay una aplicación para móviles que nos da el tiempo de espera, pero los ciudadanos no tenemos obligación de tener un móvil y, sobre todo, los turistas tampoco.   Añado que, por ejemplo, en París, hay estos paneles en ""todas"" las paradas.</p>

<p>Ello también nos permitiría a los madrileños el  ""controlar y constatar""  los intervalos de paso de los autobuses y poder hacer propuestas de mejora en tal o cual línea.  También, si tenemos prisa, el saber que el siguiente autobús va a tardar más de 15 minutos en llegar nos permitirá tomar decisiones como ir a pie o tomar un taxi.</p>

<p>De paso, no estaría de más que se aumentase el número de autobuses de la línea 61.</p>

<p> </p>
";"20/04/2016 04";"126";"115";"11";"6";"3120528176";"9492"
"4592";"Un político obtiene el tercer grado y otros que roban menos pagan años dentro";"<p>Barcenas, Mario Conde, Fabra, Rato..</p>
";"20/04/2016 21";"81";"73";"8";"3";"3125208592";"5858"
"4593";"Servicios públicos de calidad para todos";"<p>Los servicios sociales deberían prestarse a través de instituciones y empresas públicas, en las que el objetivo fuera la atención integral y personalizada del ciudadano; especialmente y de forma prioritaria la atención sociosanitaria de las personas más vulnerables y necesitadas, nuestros mayores. Servicios de calidad para todos ellos, que no pueden plantearse como el negocio de unos pocos.</p>
";"21/04/2016 09";"101";"92";"9";"22";"3131920381";"7560"
"4594";"Cobertura móvil Linea 10 Casa de Campo-Puerta del Sur";"<p>La linea 10 de metro es una de las que soporta mayor afluencia de público en Madrid; dando un servicio a ciudades dormitorio como Alcorcón, Móstoles, Pozuelo, Boardilla... y barrios como Campamento, Aluche, Cuatro vientos... Desde la parada de Casa de Campo se pierde la señal de telefonía movil dejando sin servicio a todos estos madrileños.  El trayecto requiere de una inversión no muy amplia para dar este servicio; el recorrido consta de unos 9 kilómetros y de unos 22 minutos aproximadamente.</p>
";"21/04/2016 11";"63";"49";"14";"3";"3126726234";"2722"
"4595";"Utilidad monitores de vagones en linea 10 de metro";"<p>Volver a dar uso de los monitores de los vagones en linea 10 de metro, asi se podría indicar las incidencias en el servicio de metro de Madrid.</p>

<p>Además se le podría dar un uso publicitario de carácter público (publicidad de exposiciones, teatro, eventos de la Comunidad y del Ayuntamiento) informando de las novedades de la región, como ya existe en las paradas; y uso publicitario privado (empresas privadas) para obtener beneficios económicos que repercutan en una bajada en el precio del billete y/o mejora de las instalaciones y servicios de Metro de Madrid</p>
";"21/04/2016 11";"66";"60";"6";"2";"3130432166";"4909"
"4596";"ESTRUCTURAS DE OPRESION Y DESTRUCCION DE LA VIDA SOCIAL EN MADRID";"<p>QUIERO ENTABLAR UN DEBATE SOBRE LOS MECANISMOS DE EXTERMINIO DE LA VIDA SOCIAL QUE SE ESTAN APLICANDO DURANTE AÑOS EN ESTA CIUDAD  Y EL RESTO DEL MUNDO.ES EXTREMADAMENTE URGENTE ALERTAR A LA POBLACION SOBRE LOS METODOS DISEÑADOS POR LA ELITE PARA SOMETER A LA HUMANIDAD.TENEMOS QUE ASUMIR NUESTRA RESPONSABILIDAD Y DESCUBRIR LA VERDAD.</p>
";"21/04/2016 13";"35";"12";"23";"120";"3122781048";"-377"
"4597";"Suprimir las ayudas y subvenciones a las grandes superficies y corporaciones";"<p>Buenos días,</p>

<p>A día de hoy las leyes otorgan a las grandes superficies las mismas subvenciones que las pequeñas y medianas empresas. Se propone debatir la posibilidad no de reducir las facilidades y ayudas a las grandes superficies y corporaciones, sino negárselas de lleno. Las ayudas del Estado Español y de las Comunidades, es decir, las ayudas públicas debieran de ser única y exclusivamente para los que las necesitan, no para los que las piden.</p>

<p>Llevamos en crisis ya ¿cuanto tiempo? Una gran superficie no dejará de vender en España por no recibir ayudas ni subvenciones si el negocio es bueno, y en España el negocio es rotundamente bueno. Séase el caso de Carrefour:</p>

<p>- De siempre, se otorga subvenciones a quien de trabajo al sector femenino (cuantos cajeros masculinos hay en Carrefour? y en el Corte Inglés?).</p>

<p>- De siempre, se otorga subvenciones a quien contrate a sectores minoritarios, como los extranjeros (qué porcentaje de cajeros/as son españoles en las grandes superficies?)</p>

<p>No busco discriminar. Busco que las grandes superficies NO TENGAN la posibilidad de verse subvencionadas por acciones legales que buscan la ayuda mutua: ""te doy trabajo, te devuelvo una parte de lo que pagas"". Teniendo todavía en mente el caso de Carrefour, aporto este link: </p>

<p>http://www.eleconomista.es/distribucion/noticias/7034845/09/15/Carrefour-cuadruplica-su-beneficio-neto-en-Espana-y-mantiene-las-ventas.html</p>

<p>Me parece muy bien que el sector de las grandes superficies y corporaciones ganen mucho dinero. Ello quiere decir que existe negocio en España. Ahora, las arcas públicas no debieran de estar para ayudar a las grandes superficies, sino a los negocios que realmente necesiten este tipo de ayuda: las empresas pequeñas y medianas. Las grandes superficies se benefician ya de por si de comprar en origen productos lascívamente baratos para luego venderlos en sus grandes superficies a un valor disponible para quien pueda comprarlo, como por ejemplo el Atún al Natural de marca Carrefour, el pack de 3 latas pequeñas, por 3.15eur*, como puede comprobarse en el Centro Comercial La Gavia. El resto de precios en este hipermercado para el resto de sus productos es similar. </p>

<p>* Precio comprobado en la etiqueta del lineal donde está expuesto para la venta, el 21/04/2016.</p>

<p>No estoy aquí para solicitar que bajen los precios de los productos alimencios en Carrefour. Ellos hacen negocio, y marcan precios. La gente decide si los compra o no. Ahora, aquí sí se propone debatir si una gran superficie DEBE PERCIBIR SUBVENCIONES. Teniendo en cuenta el link aportado, entiendo que NO.</p>

<p>Muchas gracias por leer mi propuesta.</p>

<p>Espero que se pueda debatir, y espero... que tras su debate, llegue la petición a hacerse efectiva, porque simplemente, no me parece justo que los que más tienen, saquen provecho de las ayudas que el Estado (y las Comunidades Autónomas) otorga. Pueden salir adelante por sí solos.</p>
";"22/04/2016 14";"126";"115";"11";"5";"3144690217";"9492"
"4598";"¿Sirve para resolver algo esta página, o sólo es desahogo?";"<p>Tengo la impresión de que sólo para desahogo.</p>

<p>Mis quejas principales (ruido nocturno, de borracheras, vandalismo, etc.) y la limpieza en calles del centro debido al poco civismo (cacas, transeúntes que también mean porque ven a otros hacerlo impunemente...) están recogidas en varios debates aquí..., desde hace meses. Quedan sepultadas por decenas de otras propuestas, hasta que de nuevo alguien la ""refresca"", abre de nuevo lo que estuvo abierto con otro título y frases... </p>

<p>No veo utilidad en este instrumento sino acopio de quejas que ahí quedan...</p>
";"25/04/2016 14";"119";"103";"16";"12";"3173223923";"7530"
"4599";"#TúPreguntas: Yolanda Rodríguez, concejala de Ciudad Lineal y Hortaleza";"<p>Hola, Soy Yolanda Rodríguez, Concejala Presidenta de los Distritos de Ciudad Lineal y Hortaleza.</p>

<p>Nací en Madrid, en el barrio de Simancas, estudié en Ciudad Lineal y soy trabajadora del Ayuntamiento de Madrid. Activista social desde hace 26 años. Formo parte de Ganemos desde sus inicios y he participado en asambleas vecinales 15M, en la Coordinadora de Entidades Ciudadanas y el Consejo Territorial de San Blas. También soy cofundadora de la Red de Solidaridad Popular ""La Enredadera Blasca"" y he sido representante sindical en el Ayuntamiento.</p>

<p>Encabezo con ilusión dos Distritos a los que he estado vinculada en mi vida, Ciudad Lineal y Hortaleza. Luchar contra la injusticia social es mi prioridad, si bien las competencias de las Juntas Municipales son aún reducidas.</p>

<p>El próximo día <strong>28 de abril a las 11:30 h.</strong> abriremos un foro de preguntas que puede servir como punto de encuentro para debatir vuestras inquietudes y propuestas. Construyendo un Madrid más justo y abierto.</p>

<p>También os animo a que continuemos el diálogo en los espacios de participación ciudadana de Hortaleza y Ciudad Lineal, que vamos ampliando.</p>

<p>Un saludo y muchas gracias.</p>
";"25/04/2016 17";"44";"28";"16";"81";"3167812718";"763"
"4600";"#TúPreguntas: Rita Maestre, concejala portavoz del grupo municipal Ahora Madrid ";"<p>Hola, soy madrileña del barrio de Ventas, tengo 27 años. Estudié Ciencias Políticas en la Facultad de Políticas y Sociología de la Universidad Complutense. Soy portavoz del gobierno en el Ayuntamiento de Madrid y delegada del área de Coordinación de la Junta de Gobierno y Relaciones con el Pleno. Un Ayuntamiento donde, desde Ahora Madrid, estamos desarrollando unas políticas que estén al servicio de la gente. Por ejemplo, en estos 10 meses hemos reducido la deuda en 871 millones de  y, al mismo tiempo, aumentado el gasto social un 26,1 %.</p>

<p>Tenemos un largo trabajo por delante para ejecutar también unos presupuestos que demuestran que se puede ser austero y al mismo tiempo aumentar ese gasto social.</p>

<p>Estaré aquí para responder a vuestras preguntas el <strong>martes 3 de mayo a las 12:00 h.</strong> Saludos.</p>
";"29/04/2016 16";"75";"29";"46";"104";"3199760240";"-657"
"4601";"suciedad en madrid";"<p>Hoy viernes 29 de abril, he visto como un hombre de unos 60 años en la linea 6 de autobus ha quitado la pegatina de su botella de agua, y la ha tirado troceada entre el suelo del autobus y la calle cuando se abrian las puertas, no es la primera vez que veo algo asi, y curiosamente siempre son personas mayores.</p>
";"29/04/2016 18";"122";"118";"4";"9";"3217878863";"11026"
"4602";"¿Consideras que falta coordinación en la web de participación ciudadana?";"<p>Desde que me registré en Madrid Decide, veo muy necesario que se realice un control de calidad estricto en la coordinación de los asuntos de participación ciudadana.</p>

<p>Por un lado, no es comprensible que la página de ""PROCESOS SECTORIALES"" solo tenga dos temas (Plaza de España y Ordenanza de Transparencia), cuando existen tantos proyectos dispersos que no se están beneficiando de la creciente base de usuarios que tiene esta web: mercado de frutas de Legazpi, alegaciones a distintos proyectos como el centro comercial en Madrid Río... Algunos de ellos (Legazpi) tienen su propia página web. Otros, como el proyecto de reforma de la plaza Barceló (distrito Centro), no tuvieron ninguna web de participación ciudadana, y por tanto muchos ciudadanos no están mínimamente informados sobre los mismos.</p>

<ul>
	<li>Propuesta: Un epígrafe dedicado a cada uno de ellos serviría para abrir un debate para determinar su necesidad y conocer el proyecto en sí mismo, y un sistema de etiquetas y colores daría información sobre el trámite administrativo, apertura y cierre de la fase de votación, participación en una encuesta, presentación de una alegación, etc.</li>
</ul>

<p>En las áreas de ""DEBATE"" y de ""PROPUESTAS"" algunos grandes temas aparecen dispersos en cientos de propuestas distintas, muchas de ellas formuladas de manera repetitiva e imprecisa, cuando podrían tener un lugar destacado dentro del cual la información se pudiese agrupar y ordenar en distintos subforos. Es el caso de los carriles bici, el concurso público de bancos para sentarse, los aseos públicos, los centros deportivos, biciMAD, EMT, parques y jardines, limpieza viaria, etc.</p>

<ul>
	<li>Ejemplo: Dentro de un gran capítulo titulado ""CARRILES BICI"" se pueden presentar encuestas sobre su necesidad, número, ubicación, recorrido, puntos estratégicos que deben conectar (zonas residenciales, oficinas, centros deportivos, centros educativos), objetivos que se deben perseguir (eficiencia, establecer una vía rápida para atravesar la almendra central, conectar los distritos vecinos que actualmente tienen déficit de transporte público, como Moratalaz y Vallecas, debido a la configuración radial y no mallada de la red de metro), estimaciones presupuestarias de cada una de las ejecuciones...</li>
</ul>

<p>Además, la forma en que la información está presentada en las diferentes webs del Ayuntamiento no responde a un criterio visual homogéneo: sitios sin diseño adaptativo frente a otros que sí lo incorporan, diferentes tipografías, no respeto a la identidad corporativa del Ayuntamiento (colores, logo del Ayuntamiento, tamaño de los banner).</p>

<ul>
	<li>Ejemplo: La página de participación ciudadana ""DATOS ABIERTOS"", cuya reforma aparece anunciada desde que se creó este website en septiembre de 2015, a día de hoy mantiene todavía el diseño antiguo.</li>
</ul>

<p>Por último, desconozco si hay o no un manual de identidad corporativa que determine qué criterios técnicos deben reunir todas las páginas web del Ayuntamiento.</p>

<ul>
	<li>Propuesta: Si no hay manual corporativo tiene que haberlo; y si lo hay y no se respeta tiene que respetarse, porque la transparencia institucional también pasa por la correcta ordenación de la información de los sitios web oficiales.</li>
</ul>
";"30/04/2016 14";"124";"120";"4";"2";"3225904818";"11225"
"4603";"¿Qué pasa con las obras aprobadas del barrio de adelfas?";"<p>Aunque se aprobó el plan urbanístico del barrio de adelfas y en la página del ayuntamiento se indica que las obras empezarán antes del verano de 2015, las obras no han empezado.</p>

<p>La calle Barrilero no está asfaltada en su totalidad y carece de aceras en la parte última de la calle . Además, los coches aparcan en las aceras y rara es la vez que la policía pone multas.</p>

<p>Aunque en una reunión de distrito nos dijeron que estimaban que las obras empezaran en Febrero estamos casi en Mayo y aún no han empezado.</p>

<p>¿Qué pasa con las obras?</p>

<p> </p>

<p> </p>
";"30/04/2016 21";"20";"14";"6";"0";"3215165130";"560"
"4604";"Elecciones. Más programa y menos marketin.";"Me apena que la política sea un producto de marketin de manera que el que tiene más recursos pueda atraer a más adeptos. Votamos influidos por campañas de imagen más que por el fondo de los programas de gobierno. Programas de gobierno que al final son también un producto de publicida, todos son buenos, bonitos y baratos. Habrá alguna manera de acabar con eso? Es triste que votemos a unos colores, como si fuesemos hinchas de un equipo de fútbol. Podemos decir que votamos con objetividad? Que se puede hacer para cambiar esto? ";"02/05/2016 10";"84";"81";"3";"11";"3242744651";"7521"
"4605";"Eliminar los festejos taurinos y las subvenciones";"<p>He creado este debate para dar a conocer. La propuesta ciudadana https://decide.madrid.es/proposals/105-eliminar-los-festejos-taurinos-y-las-subvenciones ya que hace varios meses que no se destaca en esta página. Que conste que la propuesta no es mía. Está visto que en esta página ninguna propuesta va a alcanzar los apoyos necesarios son demasiados 54128 en tan solo un año para superar la primera fase. La que más tiene hasta ahora son 24704 no llega ni a la mitad y le falta poco para caducar. Aun así yo soy optimista y tengo esperanza o que los apoyos sirvan por lo menos de protesta.</p>

<p>Esta propuesta es la que tiene más apoyos relacionada con los derechos de los animales, eso no quiere decir que sea la mejor.  Y si creo este debate no es para desprestigiar otras propuestas. Por supuesto que hay que seguir apoyando propuestas en contra del maltrato animal. Pero quiero hacer un llamamiento para apoyar esta porque el 15 de septiembre dejara de recibir apoyos: https://decide.madrid.es/proposals/105-eliminar-los-festejos-taurinos-y-las-subvenciones.  Apoyarla y compartirla, gracias.</p>

<p>Os dejo también aquí la recopilación de propuestas relacionadas con toros: https://decide.madrid.es/proposals/8930-recopilacion-de-propuestas-relativas-a-toros.</p>
";"02/05/2016 14";"238";"172";"66";"23";"3241083764";"7660"
"4606";"Pleno Ordinario 11/05/2016 de Junta Municipal de Fuencarral - El Pardo";"<p>El próximo 11 de mayo tenemos Pleno en la Junta de Fuencarral - El Pardo.</p>

<p>Este es el Orden del Día: </p>

<p>http://www.madrid.es/UnidadesDescentralizadas/FuencarralElPardo/Orden/2016/11mayo2016.pdf</p>

<p>Te invitamos a que eches un vistazo a los diferentes puntos y nos dejes tu opinión en este debate.  </p>

<p> </p>
";"06/05/2016 14";"13";"5";"8";"2";"3264367408";"-115"
"4607";"#TúPreguntas: Marta Gómez, concejala de San Blas-Canillejas y Barajas";"<p>Hola a tod@s,</p>

<p>Soy Marta Gómez Lahoz, y actualmente ocupo el puesto de Concejala Presidenta de los distritos de San Blas Canillejas y de Barajas.</p>

<p>Tengo 49 años, soy licenciada en Matemáticas por la Facultad de Ciencias de la Universidad Autónoma de Madrid y tengo el grado de licenciada en Oceanografía, Climatología y Mecánica de Fluidos por la Facultad de Físicas de la Universidad de Alcalá de Henares.</p>

<p>Hasta el momento en que fui elegida concejala en el Ayuntamiento de Madrid, trabajaba en el Organismo Público Puertos del Estado, en el que ocupaba el puesto de Jefe de Departamento. Durante estos años de experiencia profesional he gestionado numerosos proyectos de Investigación, Desarrollo e Innovación (I+D+I), tanto nacionales como internacionales.</p>

<p>En los últimos años he formado parte activa de todo el tejido social de mi distrito, San Blas-Canillejas, centrando mi actividad en la defensa de los servicios públicos. En ese sentido me incorporé a la Plataforma Contra la Privatización del Canal de Isabel II y formé parte del lanzamiento de la llamada Marea Azul, un movimiento en defensa del agua pública siendo una de las promotoras de la organización de la consulta ciudadana sobre la privatización del Canal de Isabel II.</p>

<p>En febrero de 2014 participé en la fundación del círculo de Podemos de San Blas-Canillejas y a él pertenezco desde entonces.</p>

<p>El próximo <strong>martes 10 de mayo a las 13 h</strong>. estaré en este foro de debate para responder a todas vuestras preguntas y conocer también vuestras inquietudes y propuestas.</p>

<p>Os espero.</p>
";"06/05/2016 14";"48";"36";"12";"58";"3278537904";"1800"
"4608";"Si quieres que repongan un árbol cortado llama al 010 o al 915 298 210";"<p><strong>La vía con más posibilidades para que repongan un árbol cortado es llamar al 010 o al 915 298 210 (atención al ciudadano) e informar de la ubicación exacta</strong>,<strong> calle y número,</strong> <strong>puedes dar los datos de hasta 5 árboles cortados en cada llamada.</strong></p>

<p>Después de mi frustrada experiencia al comunicarme con los responsables de Medio Ambiente del Ayuntamiento de Madrid, así como con el partido gobernante, o de publicarlo e insistir desde esta página Decide.Madrid.es, con el fin de que repusieran un enorme número de árboles de los cuales tenía constancia, he podido constatar que es más fiable dirigirse al 010. Quizás esto se debe a que la notificación pasa directamente a los técnicos, ya que hacerle llegar la petición a los políticos he podido comprobar que es como hablar con la pared, por muy ecologistas que digan ser.</p>

<p>Así que, os animo a que llaméis porque si esto no lo hacemos nosotros mismos nadie lo hará. Si quieres un barrio y una ciudad más verde, colabora llamando. ¡Difunde, por favor!</p>
";"06/05/2016 20";"101";"97";"4";"9";"3287742066";"8931"
"4609";"¿Por que se quiere un Madrid sin rascacielos?";"<p>A raíz de las noticias publicadas sobre la operación chamartín: </p>

<p>http://www.elconfidencial.com/empresas/2016-05-10/carmena-operacion-chamartin-distrito-castellana-norte-madrid-puerta-norte_1197480/</p>

<p>http://www.elconfidencial.com/empresas/2016-05-09/el-ayuntamiento-de-madrid-presenta-su-nueva-operacion-chamartin_1197111/</p>

<p>Vuelvo a comprobar una vez más como desde muchas instancias supuestamente progresistas se intenta paralizar la construcción de este tipo de edificaciones en nuestra ciudad, y de verdad que no lo entiendo. Se escudan en suspuestos pelotazos y especulación urbanistica del pasado, y es cierto que se ha dado. Pero, en un nuevo plan de ordenación urbana que se realiza desde el ayuntamiento. ¿Donde está el pelotazo y la especulación? He leido y escuchado muchas veces que son caros, si es cierto. ¿Pero acaso los promotores de estos edificios no son entidades privadas?</p>

<p>A mi modo de ver las construcciones en altura que se han ejecutado en Madrid se han realizado mal. Se han aislado del resto de la ciudad en en polos con un urbanismo totalmente diferenciado y con apenas conexión con el resto de la ciudad como Azca, o generando espacios artificiales y absurdos como en las cuatro torres. Quizás por esto se ha vilipendiado a estas edificaciones sin llegar a comprender sus ventajas.</p>

<p>Las edificaciones en altura son mas respetuosas con el entorno por varios motivos, menor utilización de suelo, concentración de recursos y población que propician mas eficiencias y economias de escala. Si a esto añadimos la ubicación de estos edificios agrupados y conectados con el resto de la ciudad como se ha hecho tradicionalmente en las ciudades de América y ciertos barrios de Europa, dotamos a la ciudad de centros de alta actividad y vida propiciados por la concentración de población. Lo que a píe de calle implica la creación multitud de comercios y servicios. </p>

<p>Esto en Madrid no se ha hecho así, se decidió asilar estos edificios del resto de la ciudad intercalando espacios meramente estéticos y sin vida. ¿Es tan trasgresivo construir rescacielos a pié de calles con comercios en sus bajo? ¿Necesitamos todos esos miniparques entre esos edificios?</p>

<p>Respecto a la ciudad no solo sería beneficioso desde el punto de vista funcional, sino que a mas edificabilidad y mas metros cuadrados construidos se genera mayor recaudación de impuestos para proporcionar los mismos servicios que a edificaciones convencionales.</p>

<p>Aparte hay que sumar la utilidad estética y de atracción internacional que generan estos edificios.</p>

<p>¿Porqué esa animadversión a los rascacielos en Madrid?</p>
";"11/05/2016 17";"88";"65";"23";"37";"3330074463";"3102"
"4610";"cibeles limpita";"<p>pues eso, que la limpien</p>
";"12/05/2016 13";"55";"45";"10";"0";"3338378594";"2863"
"4611";"buses y metro para bicicletas";"<p>es total mente inutil o a caso tu no andas en bicicleta? para que te quieres ir en bus o metro??</p>
";"12/05/2016 13";"68";"34";"34";"16";"3328391428";"0"
"4612";"#TúPreguntas: Purificación Causapié, concejala portavoz del grupo municipal PSOE";"<p>Estimados amigos y amigas, soy Purificación Causapié, concejala y portavoz del Grupo Municipal Socialista del Ayuntamiento de Madrid.</p>

<p>Soy una firme defensora de la participación ciudadana y de que las administraciones deben ser transparentes para los ciudadanos y ciudadanas. Por eso considero un acierto espacios como este, para que sean un punto de encuentro entre los representantes políticos y la ciudadanía. Las puertas de los ayuntamientos deben estar abiertas para solucionar los problemas de la gente, por eso quedo a vuestra disposición para que me hagáis llegar vuestras inquietudes y preguntas a través de esta entrevista digital y las conteste el próximo <strong>miércoles 18 de mayo a las 13.00 horas.</strong></p>
";"13/05/2016 13";"73";"41";"32";"128";"3346193265";"505"
"4613";"Zonas interbloques en el diatrito de Moratalaz.";"<p> Para cuando firma el Ayuntamiento de Madrid el convenio de recepción de las zonas interbloques del distrito de Moratalaz con la empresa Reyal Urbis. existe ya un acuerdo del Pleno de la Junta del distrito, votada por unanimidad por todos los grupos politicos de esta actual corpopración, ya hace de ello cinco meses.</p>

<p>¿ Como va el proceso ?</p>

<p>¿ Ya se han sentado con Reyal urbis ?</p>

<p>Quiero saber como va la situación.</p>
";"17/05/2016 14";"26";"21";"5";"2";"3385913041";"1292"
"4614";"Un espacio público mejor para quien vive (en) la calle";"<p>Nuestras calles,  plazas y parques son lugares donde pasamos una parte importante de nuestra vida. Son esos espacios donde nos podemos encontrar con los demás y donde podemos aprender a vivir en colectivo.</p>

<p>Las aceras y los espacios verdes de nuestra ciudad pueden ser también los lugares donde vivir nuestra intimidad y donde construir experiencias domésticas; una suerte de gran hogar donde protegernos entre nosotros.</p>

<p>Por estas razones, proponemos poner en común experiencias, ideas y propuestas alrededor de qué podemos hacer para que nuestra ciudad se haga cada vez más amable, inclusiva y capaz de cuidarnos a la vez que nosotros cuidamos de ella.</p>
";"17/05/2016 14";"59";"47";"12";"59";"3390019926";"2788"
"4615";"Carril bici en las calles Francisco Silvela y Joaquín Costa";"<p>El carril bici en las calles de Francisco Silvela (altura de Avda. América) y Joaquín Costa está situado en el carril de la izquierda, carriles como este son un peligro para los ciclistas que en muchas ocasiones no solo nos vemos acosados por los conductores de vehiculos a motor sino que somos adelantados por la derecha sin respetar la distancia de seguridad. ¿No se podría cambiar este carril bici y los que tengan el mismo problema al carril de la derecha junto al carril bus?</p>
";"17/05/2016 15";"73";"57";"16";"10";"3389220212";"3201"
"4616";"Presupuestos participativos CHAMARTIN";"<p>Por qué Chamartín no tiene ni una sola buena propuesta en sus presupuestos participativos. Además justo ahora que estamos con el tema Operación Chamartín- Madrid Puerta Norte tan candente. Es una pena ver como otros distritos tienen cantidad de porpuestas de todos los ámbitos y el mio, como prima la gente mayor que no usa esta web, solamente hay ""chorradas""  o propuestas que van contra el barrio, las menos he de decirlo. He revisado varias veces todas las propuestas que hay para poder participar y no encuentro nada aceptable. Es triste que por la gente que vive aquí no tengamos propuestas normales, aunque visto el caso que este Ayuntamiento y AhoraMadrid ha hecho a muchos de sus votantes y ciudadanos con la chapuza presentada para la prolongación de la Castellana, la estación de Chamartín y la remodelación del nudo norte, me empieza a no extrañar.</p>
";"18/05/2016 16";"32";"19";"13";"4";"3392053062";"356"
"4617";"Comunicar todos los distritos con Cibeles mediante EMT 24horas";"<p>Mi propuesta se basa en cambiar los ""autobuses nocturnos"" por ""líneas 24 horas"", es decir que se mantenga el servicio todo el día, ya que hay muchas zonas de madrid que no estan comunicadas con la zona centro (Cibeles/Alcalá/Sol) mediante EMT. </p>

<p> </p>
";"19/05/2016 09";"69";"55";"14";"5";"3406980355";"3268"
"4618";"Rehabilitacion Comunidades de Propietarios -I HAVE A DREAM";"<p>Me guataria compartir con todos vosotros este debate que si veo tienen aceptación la pasaria a propuesta, pero necesito sentir vuestro parecer a la misma. Soy Administrador de fincas colegiado y sé lo que padecen las comunidades de propietarios cuendo tienen que pedir, y , sobre todo, recibir  una subvención publicada a bombo y platillo por nuestros politicos. Hablo desde la experiencia.</p>

<p>Antes de nada quiero informar que los planes estatales de vivienda nacen del gobierno central y luego pasan a las comunidades autónomas y ayuntamientos. Por ello, enfoco el tema en el plan estatal, pero es válida la propuesta para todos los fondos públicos que se doten tanto de Unión Europea, Estado central,  ministerios, IDAE, Comunidades autónomas y aytuntamientos, diputaciones etc.</p>

<p>Es el momento adecuado pues hay elecciones y los partidos políticos, independiente del que salga elegido, tienen que tener en cuenta lo que os comparto.  Internet hace posible ser activo llegando  a sitios que ni pensamos, por ello, en la idea de hacer las cosas mejor  personas anónimas como yo, podemos aportar ideas. Una interesante relacionada con las Comunidades de Propietarios y la Rehabilitación. No lo dejes pasar, vamos a conseguirlo.</p>

<p>Lo he titulado. I HAVE A DREAM , copiando a Martin Luther King, pues durante estos cuatro años que llevo con el asunto lo he soñado muchas veces.</p>

<p>El fin es el beneficio a la sociedad, que la mayoria viven en Comunidades de Propietarios.</p>

<p>El cambiar la forma de hacer, el mejorar en lo que sabemos que no funciona cómo debiera, el que el Estado Español tomé las riendas y haga que el dinero que dota, no se gaste, no se pierda.</p>

<p>Estamos ante un cambio de paradigma necesario, estamos a puertas del nuevo Plan Estatal de vivienda 2017, debemos unir todo lo que sabemos que para hacer un modelo nuevo que llegue a todos y no sólo a parte.</p>

<p> </p>

<p>Mi mujer, Margarita, dice que no sirve para nada lo que escribo. Lo dice ella, que mira que le di la brasa hasta que se convirtió en mi compañera, jajaja,  pero no busco el conseguirlo, no está en mi mano, sí está el proponer ideas, que se debata y sobre todo aportar a mi País con mi experiencia en este asunto</p>

<p> </p>

<p>Creo que estos puntos, que se pueden desarrollar (me los sé al dedillo y lo defendería ante cualquier público), son los necesarios para hacer el cambio del paradigma.</p>

<p> </p>

<p>A tener en cuenta, para Comunidades de Propietarios:</p>

<p> </p>

<p>1.            Generación fondo de liquidez (hucha) con dotaciones anuales de</p>

<p>fondos europeos y estatales, autonómicos y municipales. El dinero público no se gasta se presta y se devuelve.</p>

<p> </p>

<p>2.            No subvenciones a fondo perdido. Dotar de liquidez por préstamos a las Comunidades de Propietarios.</p>

<p> </p>

<p>3.            Participación activa y directa del Instituto de Crédito Oficial.</p>

<p> </p>

<p>4.            Tipo de interés cero o Euribor.</p>

<p> </p>

<p>5.            Plazo amortización de 5 a 10 años.</p>

<p> </p>

<p>6.            Sin gastos de estudio, apertura etc</p>

<p> </p>

<p>7.            Estudio y reducción del IVA actual.</p>

<p> </p>

<p>8.            Convenios de colaboración con Consejo General de Administradores de Fincas y colegios territoriales, que se encarguen de gestionar las devoluciones de los préstamos a las comunidades de propietarios.</p>

<p> </p>

<p>9.            Desgravación del gasto realizado en la declaración de la renta.</p>

<p> </p>

<p>10.          Obligación de realizar el Informe de Evaluación del Edificio  IEE.</p>

<p> </p>

<p>11.          Habilitar una declaración informativa en la agencia tributaria concreta para las Comunidades de propietarios que se refleje, anualmente los gastos de rehabilitación y las operaciones de IVA por operaciones distintas de la rehabilitación, desde el primer euro, no superior a 3.000.</p>

<p> </p>

<p>12.          Bonificación y ajuste del IBI, que se solicite por la Comunidad y se aplique a cada finca registral, dependiendo del informe del Evaluación del Edificio.</p>

<p> </p>

<p>Hay que involucrar a Ministerio de Hacienda, de Fomento y el ICO. Debe ser algo conjunto en que un ministerio dote las cantidades, otro tenga información de las operaciones que se realizan para evitar el fraude y el ICO para dejarse de trabajar con los bancos privados y, en el caso de las Comunidades, no tener que recurrir a la entidad privada que genera un coste, el dinero es público no privado.</p>

<p> </p>

<p>Si podemos unir estos puntos y estudiarlos entre todos, podremos empezar a rehabilitar.</p>

<p> </p>

<p> </p>

<p>PLAN DE VIVIENDA ESTATAL 2017 ..... I HAVE A DREAM</p>

<p> </p>

<p> </p>
";"19/05/2016 14";"39";"30";"9";"4";"3406357528";"1615"
"4619";"TRANSPARENCIA PRESUPUESTOS PARTICIPATIVOS";"<p>¿POR QUÉ ME SALEN DEBATES EXISTENTES Y ME DEJA EDITAR Y LUEGO NO LO PUBLICAN?</p>

<p>¿POR QUÉ NO SE PUEDEN VER AHORA LAS PROPUESTAS MÁS VALORADAS DE LOS PRESUPUESTOS PARTICIPATIVOS?</p>

<p>¿POR QUÉ NO SE PUEDEN VER LOS VOTOS QUE LLEVA AHORA CADA PROPUESTA?</p>

<p>¿QUÉ CRITERIOS HAN SEGUIDO PARA INCLUIR UNAS PROPUESTAS SÍ Y OTRAS NO?</p>

<p>Gracias</p>
";"19/05/2016 20";"49";"46";"3";"5";"3414027877";"4036"
"4620";"Aparcacoches en restaurantes de lujo";"<p>buenas noches,</p>

<p>como el gobierno actual de Madrid se propone trabajar por y para los ciudadanos ... Quería traer un tema a vuestros debates. </p>

<p>Hay algunas calles de Madrid donde la actividad de los restaurantes de lujo en las mismas hace IMPOSIBLE aparcar a los residentes en un sitio a la hora de comer y cenar. Porque hay unos señores peinando los sitios que se quedan libres y por supuesto gestionándolo con coches en doble fila. </p>

<p> </p>

<p>Este problema es particularmente grave en la calle comandante zorita, donde confluyen 3/4 de estos restaurantes en su cruce con general Perón. </p>

<p>Tanto es así, que la mayoría de las veces cuando vamos a ver a mis suegros, que viven en esta calle, acabamos aparcando en doble fila 3 minutos y solo subiendo a darles un beso. Mientras los clientes de esos restaurantes de la calle pueden estar sentados en su mesa y un señor cuida de su coche mientras DELINQUE dejándolo en doble fila sin ninguna sanción. Creedme, en más de diez años, JAMÁS he visto un policía multar a un coche en doble fila de estos restaurantes. </p>

<p>Es esto justo? Es más importante que los clientes de los restaurantes aparquen que un servicio público decente como es el aparcamiento en la calle? </p>
";"21/05/2016 22";"106";"89";"17";"8";"3435266728";"6045"
"4622";"Proyecto ""Madrid, Zona Norte""";"<p>El próximo día 1 de junio a las 19 horas, en la Junta Municipal de Fuencarral - El Pardo celebramos sesión extraordinaria para informar sobre el proyecto ""Madrid, Puerta Norte"", la propuesta del gobierno municipal para la transformación de la zona norte de la ciudad. Una vez concluída dicha sesión, habrá un turno de intervenciones para el público, de acuerdo con la Instrucción del 1 de abril de 2016 sobre intervenciones de entidades y vecinos. </p>

<p>Mientras tanto, abrimos este hilo de debate para que nos dejes tus comentarios.</p>

<p>Este es el DOSSIER DEL PROYECTO ""MADRID, PUERTA NORTE"": http://ow.ly/d/4Oy1</p>

<p>Os animamos a participar!!</p>

<p> </p>
";"24/05/2016 12";"134";"55";"79";"323";"3454903533";"-985"
"4623";"Corte de la calle López de Hoyos por Fiestas";"<p>Cuál es la razón para cortar durante 10 días la calle López de Hoyos por las fiestas, si nunca se ha hecho y dejar sin parada de bus a muchos vecinos ?</p>
";"25/05/2016 16";"44";"27";"17";"5";"3463515603";"613"
"4624";"Túnel de Sor Ángela de la Cruz";"<p>Desde hace ya más de un año (noviembre 2014) se hicieron obras en eltúnel que une Sor Ángela de la Cruz con Valle de Mena. Con anterioridad la velocidad máxima era de 50Km/h. Después de las obras aparece el luminoso ""pavimento deslizante"" y el límite de velocidad a 30 Km/h.</p>

<p>¿Alguien lo entiende o puede dar razón? Es prácticamente imposible ir a esa velocidad a lo largo de 1620 m.</p>

<p>¿Qué dicen las juntas de distrito sobre esto?</p>
";"25/05/2016 22";"54";"48";"6";"2";"3473671001";"3733"
"4626";"Que nadie se haga el moderado con mi dinero";"<p>El Ayuntamiento de Madrid debe romper los contratos-estafa. Hacerlo es una obligación, no una opción. Encontrar soporte legal es cuestión de voluntad política. Es nuestro dinero el que se está malversando, y votamos a Ahora Madrid para defendernos hasta el final.</p>
";"27/05/2016 10";"120";"108";"12";"1";"3492233550";"8640"
"4627";"Memoria Histórica - a dónde quieren llegar.";"<p>Realmente, la memoria histórica afecta a esta eterna historia de los dos bandos. Habrá y las hay, personas que no quieren que el nombre de Pablo Iglesias corone una Avenida. Pero sinceramente, el gasto que va a conllevar y además ya per se el desastre logístico que supone (mapas, GPS, calles, direcciones postales) el cambio de calles por una absurdez de nuestra ya cansina historia política bipolar, ¿merece tanto la pena? ¿se siente ofendido si aparca en la calle Caídos de la División Azul o Avenida Pablo Iglesias? </p>

<p> </p>

<p>Tantos presupuestos por aprobar con la ciudadanía, tantas cosas que hacer, y mientras proseguimos hablando de chorradas que sólo conllevan un malgasto de dinero, tiempo y una inversión en el odio que se intenta eliminar y que no eliminamos tras 80 años.</p>

<p> </p>
";"27/05/2016 17";"131";"75";"56";"20";"3485261310";"1087"
"4628";"Sustitución de arboles alérgenos de las calles";"<p>Cambiar en la medida de lo posible arboles alergenos como el Platanáceas (Platanus) y Cupressus que son los que más afectan y limpieza de gramineas. Mejoraria la salud de los asmaticos y alérgicos</p>

http://gestiona.madrid.org/spol_web_inter/BusquedaCaptadoresGISAccion.icm
";"27/05/2016 17";"210";"176";"34";"8";"3495439801";"11900"
"4630";"Pobreza";"<p>La pobreza se ha de erradicar, sino se convierte en un monstruo que engulle personas y divide sociedades. Es amoral e indigna para quien la padece, pero más quien la ejecuta. </p>
";"28/05/2016 11";"88";"81";"7";"3";"3501854865";"6811"
"4631";"Monumento a las víctimas del 11M en Atocha";"<p>El monumento en Atocha a las víctimas de los atentados del 11M es una tomadura de pelo en cuanto a que <strong>no tiene nada que ver con el proyecto que ganó el concurso</strong> y que en su parte exterior era infinítamente más bello que el frío cilindro industrial que acabó siendo. Si bien en la parte interior, desconocida para muchos madrileños, se mantiene un ambiente respetuoso y digno, el aspecto del cilindro exterior, rodeado de asfalto negro, resulta desagradable y muy poco inspirador. Tan sólo rodeando el cilindro con algo de vegetación que rompiera la dureza del asfalto, haría de este monumento algo <strong>mucho más humano</strong> y <strong>cercano a la vida</strong>. Unos olivos, unos setos, unas flores... cualquier cosa mejoraría la isla de asfalto negro que en verano se convierte en el lugar más desagradable de la capital.</p>
";"29/05/2016 11";"153";"141";"12";"16";"3514510788";"11888"
"4632";"En Decide Madrid se habla mucho de infraestructuras y poco de actuaciones";"<p>Una crítica que he hecho a las distintas administracioens y gobiernos con el paso del tiempo ha sido que se preocupan mucho de las infraestructuras y poco de los planes de actuación.</p>

<p>Me explico con un ejemplo en el nuestro municipio (aunque es lo mismo en otrsa administraciones), tenemos una Caja Mágica que es la bomba en cuanto a la infraestructura. Sin embargo no solo está infrautilizada, sino que en el barrio en el que está no hay planes efectivos de dinamización del deporte, no hay equipaciones deportivas municipales (ni privadas) para los vecinos (la Caja Mágica no es para los vecinos), excepto unas pequeñas canchas de padel, y fútbol y un frontón (muy insificiente). Este barrio no tiene una biblioteca y el Centro Cultural es un poco triste que solo hace unos cursitos y poco más... Solo el empuje de vecinos hacen que haya algún equipo de fútbol y de baloncesto. Con la centésima parte del coste de la Caja Mágica, se podrían hacer planes de incentivación del deporte en el barrio, sin necesidad de mucha infraestructura, incluso aprovechando instalaciones existentes como los coles, tendría un fin claro y afectaría a mucha más población.</p>

<p>Hay excepciones que, al menos por mi parte, son alabadas, com opudo ser la creación del SAMUR o los servicios asociados a ""Los Mayores Primero"", pero son menos.</p>

<p>El caso es que me meto en Madrid Decide y veo que hay muchas propuestas para la creación de infraestructuras, desde carril bici a centros culturales. Sin embargo lo que creo que es necesario no es tanto ""tener"" esas infraestructuras sno explotar lo que tenemos con programas de utilización, me gustaría que hubiese más debates sobre si se puede hacer un plan global de dinamización del deporte en personas mayores, de inclusión de familias en riesgo de exlusión, de mestizaje de culturas o de iniciación a las artes escénicas para niños.</p>

<p>Igualmente hay algunas propuestas en Madrid Decide sobre servicios (la basura, por ejemplo, parece que nos preocupa mucho), pero igual, son las menos.</p>

<p>Sí, ya sé, la respuesta es que proponga yo algo... Vale, recogido el guante, pero mientras quería sacar esto a debate por si aporta algo.</p>
";"29/05/2016 15";"45";"40";"5";"3";"3510470977";"3111"
"4633";"Transportes públicos y puntualidad laboral.";"<p>Es impensable realizar en Madrid un viaje al trabajo con un horario ajustado a la hora de entrada. Si no se sale de casa con un amplio margen de tiempo se llega tarde. Es indispensable que la Administración Local y Autonómica lleguen a un acuerdo sostenible en horarios y frecuencias de viaje para poder armonizar vida privada y laboral. Metro de Madrid es una catástrofe a fecha de hoy. Gracias.</p>
";"29/05/2016 17";"102";"95";"7";"6";"3515332284";"8196"
"4634";"AVDA DONOSTIARRA ARBOLES";"<p>Porque se estan ropiendo  los arboles en la Avenida Donostiarra?</p>
";"30/05/2016 11";"43";"33";"10";"2";"3515452338";"1765"
"4636";"¿Cuando piensa L1 de metro cumplir con la Ley del Ruido?";"<p>Todavía tenemos humeante la zona de Seseña. Todavía tenemos miles y miles de personas afectadas de cancer por exposición al amianto. Parece ser que el medioambiente no nos importa nada. Sin embargo, pagamos con nuestra salud y la de nuestros hijos la contaminación del aire y el agua. Y no se escapará nadie, de pagar el precio de nuestras acciones.</p>

<p>El ruido afecta a nuestra salud. Nos produce sordera, (ruiditos y pitidos audibles cuando estamos en silencio) e incluso afecta a nuestro estado psicológico y de salud.</p>

<p>La empresa Metro de Madrid, en su L1 nos organiza una serie de ""conciertos de explosiones"" que pensamos -al igual que el humito de los neumáticos- son inofensivos. Dejarán de serlo cuando nuestros niños, ancianos, sus trabajadores o nosotros mismos, nos veamos afectados por los efectos que la exposición a más de 130 dB hace sobre nosotros.</p>

<p>Me refiero a esto</p>

<p>https://www.youtube.com/watch?v=0z8raMLWTxw</p>

<p>El video es auto-explicativo. ¿Es normal esta situación o nos hemos vuelto locos?. ¿Es esta la imagen que queremos dar a nuestros turistas-visitantes de Madrid. Nuestra idea de modernidad? ¿Es sano exponer a niños, bebes, mayores a este tipo de ""conciertos"", o es por acostumbrarles a vivir en la ciudad mas ruidosa de Europa?. ¿Es mejor poner solución al problema, mediante el uso de silenciadores o mejor aumentar el gasto en salud posteriormente? (No se olviden de que siempre, siempre se paga el precio, como en Seseña, como en el asbesto, como en .....).</p>

<p>Me basta, me sobra, con conocer la opinión sobre lo expuesto.</p>

<p>Muchas gracias</p>

<p> </p>

<p> </p>
";"31/05/2016 17";"66";"51";"15";"10";"3529662881";"2781"
"4637";"Polideportivo no tan público calle Alcántara entre Don Ramón de la Cruz y Ayala.";"<p>Hace bastantes años se cedió un solar que antiguamente albergaba unas cocheras de la EMT a BBVA para que construyeran un edificio a cambio de que, a su vez contruyeran un polideportivo municipal y un parking subterráneo para residentes.</p>

<p>En poco tiempo se construyó el edifcio y se comercializaron los apartamentos pero la zona en donde iba a estar el polideportivo seguía siendo un solar. Después de bastante tiempo de protestas el ayuntamiento pavimentó el solar y pintó las plazas de verdes convieriéndo eso en el famosos ""parking de residentes"".</p>

<p>El año pasado vimos como otra empresa privada VIDING CONCESIÓN ALCÁNTARA S.A., comienza la construcción del ""polideportivo"" y el parking para residentes pero también anuncian ""restaurante, parking para abonados al supuesto polideportivo"" etc. y para mí que de municipal sólo tiene el logo y es un nuevo pelotazo como GO FIT ( antiguo polideportivo de Vallhermoso que se demolió para moderniarlo y que lo que hicieron es  pasarlo a manos privadas)</p>

<p>Me da la sensació de que los ciudadanos de Madrid le hemos ""regalado"" un solar a BBVA y luego la concesión de un centro deportivo privado  VIDING y cada vez tenemos menos dotaciones deportivas públicas.</p>

<p> </p>
";"04/06/2016 13";"41";"35";"6";"2";"3568219277";"2475"
"4638";"Mal comportamiento en el autobús y metro de Madrid";"<p>Estoy cansado de soportar a personas que ponen los pies en los asientos del bus o metro, hablan a gritos, ponen la música de sus aparatos lo mas alta que pueden. En resumen un comportamiento inadecuado. Ninguna autoridad toma medidas. Se podrían ponen cartelitos o que la megafonía interior del bus o vagón indicara que evitaran estos comportamientos.</p>
";"05/06/2016 09";"214";"208";"6";"51";"3586490225";"19633"
"4641";"Que llegan aquí propuestas de la gente es clave";"<p>Así podemos abrir la inteligencia Colectiva.</p>
";"06/06/2016 14";"42";"31";"11";"4";"3585898091";"1476"
"4642";"Eliminar el límite de 70 recién puesto en la M30 en tramo a la Avda.Valladolid";"<p>El ayuntamiento se está poniendo las botas, ha bajado la velocidad de una autovía como la M30 en el tramo desde que se sale del tunel hasta la Avda. Valladolid. A mi me han llegado 4 multas y seguro que viene alguna más. La primera es del mes de abril, pero no te la entregan hasta junio para que 'piques' más veces. ¿O es que ni siquiera eso saben hacer bien: sanción y notificación inmediata?</p>

<p>El tema de la velocidad ni le toco, ya el límite de 90 es muy conservador. Algunos dicen que es para reducir la contaminación, pero los expertos no llegan a un acuerdo. Los consumos y emisiones de los coches están optimizados para las velocidades de 90 y 120 Km/h porque son los que se deben publicitar en las descripciones de las características técnicas y se armonizan el par motor, las transmisiones y relaciones de cambio para que a esas velocidades se tenga el mejor rendimiento. Ni que decir tiene que además hace falta conductores que sepan sacar el mejor rendimiento a cada velocidad.</p>

<p>Como en la mayoría de los países tenemos un papá estado hiper-reglamentador que debe tratar a garrotazos a sus hijos/ciudadanos estúpidos que no saben cuidarse a si mismos y por supuesto no saben manejarse ni a sí mismos ni a sus máquinas. No pido que desaparezcan las regulaciones y leyes en general, pido que haya normas razonables y claras y que no se generen los miles de líneas que se generan cada año con nuevas normas y límites y que se añaden a los millones que ya están escritas y que regulan casi cada faceta de nuestra vida.</p>

<p>Por supuesto que hay locos y tarados, pero esos siempre se las apañan para hacer lo que les da la gana, y la gente 'normal' se lleva la mayoría de los palos. Nos convierten en rebaño dirigido a base de varazos. El 'tío de la vara' existe :)</p>
";"06/06/2016 17";"172";"118";"54";"12";"3590045556";"4390"
"4643";"Cuanto tardarán en quejarse del vertedero los futuros compradores de Berrocales";"<p>Parece que en este mes de Junio se va a aprobar el PAU de Los Berrocales para darle continuidad al ensanche de vallecas. Dejando aparte que se han cancelado proyectos más importantescomo Mahou-Calderón o la Operación Chamartín que además de vivienda articulan el corazón de la ciudad, a mi personalmente me ha surgido una pregunta, pregunta que tras ver esta web desde sus inicios estoy convencido que ocurrira. <strong>¿Cuanto tiempo pasará desde que los futuros compradores de una casa nueva en Los Berrocales vengan quejandose de olores y pidiendo el traslado del vertedero a costa del dinero de todos?</strong></p>

<p>En mi opinión no mucho, enseguida tendremos gente que ha comprando a sabiendas un piso con mal olor, quejandose del consistorio, de lo descuidados que están y de lo malisimo para la salud que es vivir alli, eso sí a costa de todos y pensando en revalorizar su inversión.  </p>
";"10/06/2016 13";"47";"29";"18";"3";"3622243032";"678"
"4644";"Fiestas de San Antonio de la Florida bajo control policial";"<p>la verbena de san Antonio de la florida es la más antigua de la ciudad y la primera del año en Madrid. Parece mentira que año tras año estas fiestas sean menospreciadas por el concejal de distrito. Son las fiestas que menor duración tienen frente a las de otros distritos y el programa es también de inferior calidad al de nuestros convecinos.</p>

<p>Son unas fiestas muy de barrio porque dadas las características de la zona, todo el mundo se conoce y la verbena es el espacio ideal de confraternizacion y ayuda a distintos colectivos del barrio como el equipo Ciringanillos, o el Olímpico 64, que con sus chiringuitos consiguen el necesario soporte económico para su actividad.</p>

<p>Cual ha sido mi asombro cuando el pasado sábado, día grande de las fiestas, a las 2.30 de la madrugada nada más acabar la música (cuyos decibelios están tan limitados que solo se oye si estás pegado al altavoz), y cuando la mayoría éramos jóvenes, y padres y madres del barrio con nuestros hij@s disfrutando de la suave temperatura y de la compañía , empiezan a tomar el parque de la bombilla ordas de policías municipales al grito de vayan desalojando, a casa, todos a casa!!!</p>

<p>como somos un barrio Pacífico en 15 minutos era como siNunca  hubiera habido allí una fiesta.</p>

<p>Me parece una actuación policial desproporcionada, inútil y absolutamente de otra época. Parece mentira que un Ayuntamiento de izquierdas lleve a cabo estas medidas de control policial en unas fiestas de barrio sin ningún altercado.</p>

<p>quiero plantear aquí mi total oposición a este nuevo estado policial que nos transporta a una época afortunadamente olvidada, aunque lo que más me duele es que sea precisamente este ayuntamiento quien lo haya promovido.</p>
";"13/06/2016 09";"71";"62";"9";"2";"3659230884";"4628"
"4645";"Centro de Salud en Arganzuela";"<p>Buenas tardes,mi nombre es Daniel y vivo en la calle Alamedilla.Estamos situados al lado de las vias de renfe , que separa el barrio de Vallecas de el barrio de Méndez Álvaro.Somos un barrio más o menos joven ,hay gente con niños,personas mayores,minusválidos,etc.Pedimos un centro de salud en esta zona porque el mas cercano esta casi a 1 km,cuando hay mucha gente que no se puede desplazar.Hemos hecho un estudio y somos mas de 10000 personas afectadas.Queremos que hagais un estudio y creo que no hay mayor necesidad vital que la Sanidad .Muchas gracias,espero apoyo de la ciudadanía.Un abrazo ,hoy por mi mañana por ti.</p>
";"13/06/2016 14";"72";"63";"9";"3";"3661086080";"4725"
"4646";"Calles de peatones cerca la estacion de cercanias de Aravaca";"<p>He escrito muchas cartas a Madrid.es solicitan información sobre mi calle en particular que se cierre al tráfico excepto para ""emergencias y garajes"" sólo para recibir una nota de <strong>Montserrat Rossell Contreras JEFA DEL DEPARTAMENTO DE ORGANIZACIÓN Y CALIDAD</strong> pasar como un asunto de policía, sino la policía se niega a venir para multar a los delincuentes.

¿Alguien sabe lo que puedo hacer para que mi ""calle transitado"" para cerrar la de traffico a excepción de lo que designan los signos""EMERGENCIAS Y GARAJES""? </p>

<p> </p>
";"13/06/2016 17";"25";"9";"16";"0";"3644437759";"-252"
"4647";"Por una transparencia real en los procesos selectivos del Ayuntamiento";"<p>Aprovechando este portal de la Transparencia, solicité al Ayuntamiento que se pusiera a disposición de los ciudadanos la información del número de funcionarios y trabajadores del Ayuntamiento de Madrid que son familia hasta el tercer grado de consaguinidad, indicando la unidad o servicio. Hay servicios y procesos selectivos, bolsas de empleo, etc., en las que este tipo de relaciones condicionan el resultado, máxime cuando en el caso de existir alguna prueba selectiva, esta no se graba (práctica común) o queda a la interpretación y valoración sin un baremo claro. Ya no digo nada de las contrataciones directas.</p>

<p>Ante mi solicitud y con todo mi asombro he recibido esta respuesta del Ayuntamiento de Madrid (AGPCTyGAaccesoinfop@madrid.es)</p>

<p> ""la información por usted solicitada no existe ya que el grado de parentesco (entendemos, que se refiere al grado de parentesco con respecto a otros trabajadores de la misma administración) no es un dato que se requiera ni se solicite a ningún efecto.</p>

<p>Esta comunicación no es recurrible, de acuerdo con lo dispuesto en el apartado cuarto del Acuerdo de 10 de diciembre de 2015 de la Junta de Gobierno de la Ciudad de Madrid por el que se establecen los criterios de gestión interna de las solicitudes de acceso a la información pública (Boletín Oficial del Ayuntamiento de Madrid, de 14 de diciembre de 2015).""</p>

<p>Aprovechando este medio, quería compartir esta situación para ver ¿que opinan?, </p>

<p> </p>

<p> </p>
";"13/06/2016 19";"120";"114";"6";"18";"3667764717";"10260"
"4648";"Escaleras mecánicas y ascensores, en toda la red de metro de Madrid.";"<p>Pienso que una buena forma de invertir el dinero es: poniéndo escaleras mecánicas y ascensores en toda la red de metro de Madrid;para las personas con discapacidad y las personas que llevan coches con niños.</p>
";"14/06/2016 12";"205";"195";"10";"7";"3677015181";"17597"
"4649";"Tarjeta unica BiciMad-Bus-Metro recargable ";"<p>Propongo una tarjeta única para usar de los servicios BiciMad-Bus-Metro con saldo recargable. </p>
";"14/06/2016 17";"245";"232";"13";"11";"3679454065";"20737"
"4650";"Solución global al tráfico en Madrid. Transporte Público al servicio del privado";"<p>El debate complementa la propuesta siguiente: </p>

<p>https://decide.madrid.es/proposals/11760-abono-transporte-ligado-a-impuesto-de-vehiculos-anual</p>

<p>Se trata por tanto de incrementar en una cantidad determinada el impuesto de vehículos (IVTM) y entregar al conductor del vehículo un abono transporte anual. De esta forma a la hora de elegir si hacemos uso de nuestro coche o del transporte público no habrá excusa, el transporte público lo tendremos ya pagado y absolutamente disponible, reduciendo los trayectos en vehículo privado. Con ello, los inmensos beneficios que la disminución de tráfico supone para el medioambiente, la salud pública, la calidad de vida de los peatones, la disminución de ruido, el menor peligro para los ciclistas, la balanza de pagos nacional (por menor consumo de gasolina), se unirá a que aquellos momentos en los que la ruta no esté disponible en transporte público (o por cualquier razón sea preferible el uso del vehículo privado) la circulación será más agil, más amable, con mayor disponibilidad de aparcamiento. </p>

<p>Por otro lado y de forma paralela, el Consorcio de Transportes contará con muchos más recursos con los que mejorar paulatinamente la cantidad, calidad y frecuencia de sus líneas, creando un círculo virtuoso donde cada vez el uso del vehículo privado será menos necesario.</p>

<p>La pregunta que surge es qué incremento en el Impuesto de Vehículos sería más conveniente, para que los conductores sean los principales beneficiados de la propuesta que sin ninguna duda nos beneficiaría muchísimo a todos los madrileños. Mi propuesta inicial es de 150  anuales para la zona A (a sumar al IVTM que a cada coche corresponda) lo que supone un importante descuento sobre el precio de ese título de transporte y un gigantesco aumento en los ingresos anuales del Consorcio de Transportes.</p>

<p>¿Te parece adecuada la propuesta? Comenta por favor tus impresiones y valoraciones.</p>

<p>(Si te parece interesante esta propuesta, apóyala en la sección de propuestas. Muchas Gracias)</p>
";"14/06/2016 18";"70";"55";"15";"15";"3670714339";"3142"
"4651";"Catellana Norte no de cualquier forma";"<p><strong>Castellana norte debe de tener en cuenta:</strong></p>

<ol>
	<li>Solucionar accesos al centro desde el norte (manoteras- las Tablas-Montecarmelo-Fuencarral-Colmenar).</li>
	<li>Plan de transporte con angares de aparcamiento amplios en sitios clave con transporte posterior en metro o tren.</li>
	<li>Poner límite a especulación urbanística.</li>
	<li>Parques y zonas de actividad deportiva, paseos, carril bici....</li>
</ol>

<p>Nota: en varios años de gobierno no se ha hecho nada, tampoco hay por qué plegarse a lo que diga el BBVA. El criterio siempre es el bien común de todos y cada uno.</p>

<p> </p>
";"15/06/2016 11";"72";"45";"27";"1";"3672802215";"1125"
"4652";"Traslado del tranvía Charleroi de Pinar de Chamartín al nuevo museo de la E.M.T.";"<p>Propongo el traslado del tranvía modelo Charleroi II como vehículo histórico que es, desde su ubicación actual en el vestíbulo de la estación de metro de Pinar de Chamartín al museo de vehículos históricos de la E.M.T. recientemente inaugurado en sus instalaciones en el barrio de Fuencarral, no porque el lugar que ocupa sea malo, si no porque creo que se merece estar en otro sitio mucho más acorde con lo que representa.</p>

<p>El vehículo en cuestión, fue puesto en servicio en el año 1.908 y estuvo rodando hasta 1.962 habiendo sido restaurado en varias ocasiones. En 1.971 participó en los actos conmemorativos del centenario del tranvía en nuestra ciudad y el 31 de mayo de 1.972 hizo su último viaje coincidiendo con el último día de servicio de tranvías de la E.M.T. en Madrid. Muy probablemente este modelo o uno de la misma serie, fue utilizado  en las películas Doctor Zhivago de David Lean en 1.965 y en las Bicicletas son para el Verano de Jaime Chavarri en 1.984.</p>

<p>Su aspecto actual obedece a la última restauración que sufrio en los talleres de la empresa CAF (Construcciones y Auxiliar de Ferrocarriles) en sus instalaciones de Zaragoza en 1.995. Como indico en el primer párrafo, está expuesto en Pinar de Chamartín como homenaje a todos los tranvías que circularon en Madrid desde 1.871 hasta 1.972.</p>

<p>Considero que representando lo que representa, siendo un vehículo histórico único y habiendo circulado con los colores de la E.M.T. lo más adecuado y aprovechando que esta empresa acaba de inaugurar su museo con presencia de la alcaldesa, la presidenta de la comunidad y grupos políticos, lo más lógico que esté en dicho museo, por lo que solicito el voto para ello.</p>

<p>Muchas gracias</p>

<p> </p>
";"15/06/2016 21";"49";"28";"21";"4";"3674156793";"400"
"4653";"los árboles se convierten en un peligro para los ciudadanos ";"<p>Hace un mes un árbol en barajas destrozó mi coche.los daños son muy elevados y me lo dieron siniestro.es una vergüenza que este Ayuntamiento se ocupe de chorradas y no se ponga a podar esos árboles que son un peligro para todos los ciudadanos de esta ciudad.quien se va a hacer cargo de mi coche?</p>
";"16/06/2016 09";"113";"63";"50";"14";"3680974144";"724"
"4654";"Recinto canino en calle Dédalo (San Blas-Canillejas)";"<p>Hay 2 solares abandonados, al menos uno podria acondicionarse para espacio seguro con mascotas. Ver ubicación satélite aquí https://www.google.es/maps/place/40%C2%B026'31.7%22N+3%C2%B037'02.9%22W/@40.4421635,-3.6179806,146m/data=!3m1!1e3!4m5!3m4!1s0x0:0x0!8m2!3d40.442138!4d-3.617471</p>
";"17/06/2016 11";"60";"35";"25";"3";"3690972231";"583"
"4656";"Rotondas";"<p>Colocar reflectantes en rotondas. Muchas no se ven de noche y suponen un peligro.</p>
";"22/06/2016 13";"108";"99";"9";"0";"3753443577";"8250"
"4657";"Prohibir la venta puerta a puerta y telefónica.";"<p>¿Porque la venta ambulante está prohibida pero no lo está que puedan abordarte en tu propia casa?</p>

<p>La venta a domicilio, puerta a puerta, a puerta fría o como lo quieran llamar es una violación a la intimidad, igual que la venta telefónica. Nadie tiene derecho a llamar a tu puerta o llamarte por teléfono y tengas que dejar lo que estés haciendo para atender a unos comerciales que no has invitado.</p>

<p>Sólo por esto ya debería de estar prohibido, sin entrar en ciertas acciones en torno a esta práctica que no sé si legales o no, pero que muy lícitas no son.</p>
";"22/06/2016 17";"203";"188";"15";"27";"3758249621";"16021"
"4658";"Trabajos de remodelacion para desempleados";"<p>Propongo que los <strong>trabajos de remodelación e infraestructura</strong> de la Comunicad de Madrid sean contratados por <u>trabajadores en paro</u>, así se da riqueza a las familias y se les ayuda a salir de su situación.</p>

<p>Aunque como condición que se les page un salario justo al trabajo realizado evitando que las empresas privadas paguen salario bajos por trabajar largas jornadas.</p>
";"24/06/2016 13";"119";"114";"5";"5";"3775240882";"10442"
"4659";"MAYOR VISIBILIDAD A PROPUESTAS MÁS APOYADAS,";"<p>Cuando filtro las propuestas siempre me surgen serias dudas en cuanto a la transparencia de los criterios para hacer el ranking de:</p>

<p>- Propuestas más activas. ¿Cual es el criterio para definir una propuesta más activa? Veo propuestas con 12 votos frente a la que propongo que ha recibido 15 votos en el día y no aparece en las primeras páginas de las más activas.</p>

<p>- Propuestas más relevantes ¿Cual es el criterio para definir una propuesta relevante?. Hay propuestas con muy pocos votos que se listan en los primeros puestos como relevantes ¿Por qué?</p>

<p>- Propuestas más apoyadas. Aquí el criterio es claro y objetivo ya que se define en función del número de votos a la propuesta.</p>

<p>Propongo a los arquitectos de la web que revisen la visibilidad de la propuestas más apoyadas de cara a que estas se puedan convertir en propuestas reales y con apoyos sobre la mesa del ayuntamiento. El sistema que hay ahora me parece perverso y no está enfocado a dar visibilidad a las propuestas que poco a poco son apoyadas y se posicionan frente a otras que no tienen apoyos.</p>
";"24/06/2016 21";"93";"87";"6";"3";"3776725773";"7577"
"4660";"Mas zonas para perros";"<p>Necesitamos más zonas habilitadas donde los perros puedan correr sin correa y jugar libremente. De tal forma los perros tendrían lo que necesitan (correr y divertirse) y los usuarios de parques que tengan niños o que teman a los perros estarían más tranquilos. Con poco se podría conseguir mucho.</p>
";"24/06/2016 21";"143";"81";"62";"6";"3766504787";"1076"
"4662";"Enviar una carta a todos los madrileños informando del servicio Decide Madrid";"<p>Enviar una carta a todos los empadronados en Madrid <strong>avisando de la existencia del servicio Decide Madrid</strong> y la importancia de la participación ciudadana. </p>

<p>Enviar además una carta periodicamente en la que se avise de los <strong>plazos de participación</strong> de cada nueva  convocatoria.</p>
";"26/06/2016 02";"201";"168";"33";"23";"3788887379";"11283"
"4663";"Obras en Hermosilla 126 y su cruce con Benito de Castro";"<p>Por un plazo de tiempo prolongado (creo que por el dolor de espalda del jefe de obras y el de sensibilidad sonora por parte de los vecinos del inmueble), parece ser que se ha realizado una gran actuación urbanística para que estacionen irregularmente algunos interesados que no son poseedores de la acreditación de vecino residente en la zona de aparcamiento (reduciendo sus espacios tan limitados por la colonia Iturbe y la escasez de estacionamientos privados, impidiendo la visibilidad de salida a los que tienen ""tan lujo"") Para evitar las obras, alguno se ha dejado los tobillos en el asfalto sin atender (Ni calle ni acera) y puede que la Iglesia Evangélica del Ejército de Salvación, que genera cierta delincuencia en el barrio y no deja acceso al portal a ciertas horas, sea la beneficiaria de tal ""isla de paz"" (los cánticos espirituales también despiertan por las mañanas de un domingo de supuesto descanso) </p>
";"26/06/2016 02";"14";"10";"4";"2";"3776866533";"428"
"4664";"Propuestas rechazadas para USERA";"<p>Lamentablente tengo que informar que después de realizar una propuesta para un centro de pesca en el parque de pradolongo me informan que no se puede realizar porque no es viable mantener con vida una fauna piscicola en el lago, esta claro que no han visto ese lago lleno de peces como yo y eso que antes no habia una depuradora que ahora mantiene una mejor calidad del agua. Se han inventado algo para rechazar la propuesta y no han dejado opción a réplica, de hecho les respondi al email y ni han tenido la deferencia de responder a mi alegato.</p>

<p>Por favor si hay alguien de USERA que vea este debate que diga por favor que han visto como yo a carpas enormes en ese lago y eso que no habia ningun tipo de cuidado, con un minimo manteniemiento se podria mantener una buena poblacion de peces.</p>

<p>Me da a mi que esto es una pantomima y solo van a aprobar lo que los grupo afines al gobierno del ayuntamiento propongan, es lo de siempre pero con otras caras solo harán lo que beneficie a sus amigos al mas puro estilo Pepero.</p>

<p>Que pena de verdad estuve a punto de cambiar de opinion respecto a Ahora Madrid pero son el mismo perro con otro collar.</p>
";"27/06/2016 09";"38";"15";"23";"3";"3780584193";"-315"
"4665";"Accesibilidad de este sistema de participacion";"<p>Entiendo que este sistema de participación es bueno, permitiendo elegir presupuestos, hacer propuestas y hacer debates. Pero, creo que hay un gran problema de accesibilidad, sobre todo para las personas mayores y no tan mayores por la brecha digital que hay. Esto hace que todo este sistema sea un poco menos válido, porque estamos excluyendo a una gran parte de la sociedad. Hay planes en marcha del gobierno pero por lo que he visto mas orientados a formar trabajadores, no tanto para pensionistas. Teniendo en cuenta que tenemos competencia municipal, que medidas podemos proponer para integrar a este perfil de personas en este sistema de participación? Es posible crear algo similar fuera del ámbito general?</p>
";"27/06/2016 11";"53";"45";"8";"6";"3798457789";"3141"
"4666";"posibilidad de votar en contra en los presupuestos participativos";"<p>Buenos días, he estado en la zona de presupuestos participativos y he echado de menos la posibilidad de votar en contra de una propuesta. Creo que cuando finalmente se decida realizar una actuación no solo debe condicionarse por la viabilidad técnica y los votos positivos, no es lo mismo que haya 500 personas a favor de algo sin nadie que se oponga a que haya 500 a favor y 100, 500 o 1000 personas en contra. </p>

<p>Imagino que los votos negativos deberían haber surgido en la zona de propuestas, pero en mi caso no he llegado a tiempo y me incorporo directamente a la zona de presupuestos pasticipativos.</p>

<p> </p>

<p> </p>

<p> </p>

<p> </p>

<p> </p>

<p> </p>

<p> </p>
";"27/06/2016 12";"145";"127";"18";"3";"3803022279";"9546"
"4667";"Limpieza en la playa del madrid rio ";"<p>llevo yendo bastante a la playa del Madrid rio donde los chorros cada vez que nos metemos nos encontramos vasos de plastico , globitos ¿ Podrias un Socorrista vigilante en la zona de baño ?</p>
";"27/06/2016 16";"68";"63";"5";"1";"3803340102";"5373"
"4668";"Los contenedores de reciclaje no son vertederos";"<p>Estoy harta de ver cómo en Rodríguez San Pedro los contenedores de papel y vidrio y sus alrededores se utilizan como vertedero, llenándose se bolsas de basura, mobiliario (hasta un tresillo o un somier han aparecido frente a los contenedores), ropa... incluso en verano algunos restos orgánicos han entrado en descomposición. Creo muy importante una campaña que conciencie de que los contenedores son exclusivamente para depositar los residuos para ellos dispuestos, y recordar las sanciones en que se puede incurrir si se tiran allí cualesquiera de otra índole. Por ejemplo unas pegatinas informativas en los propios contenedores recordando las sanciones y un mayor control policial podrían servir para disuadir a los vecinos poco cívicos que hacen mal uso de estos contenedores.</p>
";"28/06/2016 00";"119";"114";"5";"4";"3809767581";"10442"
"4669";"Pleno Ordinario 28/06/16 Junta Municipal de Villa de Vallecas";"<p>Hoy día 28  tiene lugar el Pleno Ordinario del mes de junio (retrasado por la campaña electoral) en Villa de Vallecas. Puedes consultar el orden del día en el siguiente enlace: https://www.facebook.com/permalink.php?story_fbid=970313739754398&amp;id=819896744796099</p>

<p>Abrimos este debate online para que aportes tus opiniones y comentarios. ¡Gracias!</p>
";"28/06/2016 09";"15";"5";"10";"2";"3791471397";"-166"
"4670";"Creacion de propuestas dentro del mismo distrito al que se pertenece.";"<p>Esta web, da la opcion de crear propuestas, es cierto.Pero no he encontrado opcion de hacer una propuesta en mi distrito. Si vamos a la pestaña de PRESUPUESTOS PARTICIPATIVOS , nos encontramos que las q estan alli, son las que son, sin opcion a dar una NUEVA IDEA. Es algo que dentro de esta misma web podria ampliarse, ya que esta claro que a todos nos gustaria proponer ideas para nuestros distritos y no solo dar votacion de apoyo a lo que existe, sin opcion a decir No apoyo esto...</p>
";"28/06/2016 16";"54";"50";"4";"1";"3812510111";"4259"
"4671";"Punto SOS en Madrid Rio";"<p>Debido a la afluencia  de  personas  en Madrid  Rio unos con niños,con mascotas,en bici,patinando.....se causan grandes conflictos y generan bastantes accidentes.Se podrían poner puntos en el que hubiera Técnicos en Emergencias  para poder solucionar  estos problemas. </p>
";"30/06/2016 17";"86";"79";"7";"3";"3834217499";"6613"
"4672";"PRESUPUESTOS PARTICIPATIVOS";"<p>Buenas tardes</p>

<p>Si ayer ya se acabo el tiempo de votar....a que esperan para sacar la listas de los votos recibidos por cada propuesta, tanto de distrito como de ciudad?</p>

<p>o es que ahora esto se matiza?. Pense que las propuestas que ganaban, ganaban y ya.....</p>

<p>alguien sabe cuando se sabra?. He oido que el 15.07.16.........pero me parece mucho 15 dias para dar la lista</p>

<p>Gracias por contestar y sacarme de dudas</p>
";"01/07/2016 17";"44";"39";"5";"12";"3841428732";"3013"
"4673";"Bajar el precio de alquiler de las pistas de tenis del Canal";"<p>Las instalaciones deportivas del Canal de Isabel II deberian ser públicas y de acceso a todos los bolsillos. Actualmente la empresa que gestiona las pistas de tenis del Canal cobra un importe de una media de 10 euros por la utilización de la pista durante una hora, un precio muy elevado y fuera del alcance de los bolsillos más humildes.</p>
";"04/07/2016 00";"41";"32";"9";"2";"3861078331";"1795"
"4674";"Sustitución mobiliario público ";"<p>Buenos días,</p>

<p> </p>

<p>en en la Avenida Ciudad de Barcelona se están cambiando los pivotes nuevos de los pasos de peatones por otros pivotes nuevos ¿cuál es el motivo de cambiar mobiliario urbano cuan aún está ejerciendo su función?</p>

<p> </p>

<p>gracias por la respuesta.</p>
";"04/07/2016 09";"39";"31";"8";"0";"3864873064";"1828"
"4675";"Pleno Ordinario 06/07/16 Junta Municipal de Puente de Vallecas";"<p>El próximo miércoles 6 de julio  tiene lugar el Pleno Ordinario del mes de julio en Puente de Vallecas. Puedes consultar el orden del día en el siguiente enlace: https://www.facebook.com/permalink.php?story_fbid=1714519758812457&amp;id=1619947368269697</p>

<p>Abrimos este debate online para que aportes tus opiniones y comentarios. ¡Gracias!</p>
";"04/07/2016 12";"10";"4";"6";"4";"3854803491";"-80"
"4676";"NO AL HORARIO EXPERIMENTAL DE RECOGIDA DE BASURAS DE VERANO AL MEDIODIA";"<p>Me dirijo a todos los ciudadanos de Madrid y en especial años de los distritos de Barajas, Ciudad Lineal y Canillejas,  donde como conejillos de indias, nos han impuesto el cambio horario de recogida de basuras, en pleno verano, al mediodía .A parte de la falta de higiene que implica, es increíble la inhumanidad para la gente que lo tiene que recoger tanto porteros, como basureros. Tanto que ofrecen la posibilidad de decidir en Madrid y sin embargo imponen sus criterios (no se en base a que logica). ESTO ES INHUMANO, RETROGRADO Y DICTATORIAL!!!!!</p>
";"04/07/2016 15";"60";"45";"15";"6";"3867894187";"2250"
"4677";"Derogación actual e injusta ""Consumo de bebidas alcholicas en la vía pública""";"<p>Parece que este tema está quedando relegado en estos foros.</p>

<p> </p>
";"05/07/2016 09";"75";"40";"35";"14";"3868690955";"266"
"4678";"Remodelación de Pistas de Tenis Polideportivo Arganzuela ";"<p>Me dirijo a todos los vecinos del Barrio de los Metales, adyacencias y en general vecinos de la Zona Legazpi quienes nos veneficiamos de estas pistas de tenis, las cuales están en muy mal estado y necesitan ser remodeladas. </p>
";"05/07/2016 22";"28";"22";"6";"0";"3878951613";"1257"
"4679";"Debate Estado del Distrito ";"<p>Hoy a las 19 horas celebramos en nuestra Junta Municipal el pleno extraordinario sobre el Estado del Distrito. </p>

<p>http://www.madrid.es/UnidadesDescentralizadas/FuencarralElPardo/Orden/2016/6julio2016extraordinario.pdf</p>

<p>Puedes seguirlo en directo en https://www.youtube.com/watch?v=xJwy5K0sJ4U  y comentarlo al mismo tiempo a través de este hilo. </p>

<p>¡Animaros a participar para intercambiar opiniones!</p>
";"06/07/2016 09";"22";"9";"13";"2";"3871693059";"-163"
"4680";"Reciclado papel y cartón";"<p>Hola, el reciclado del papel y el cartón en los contenedores que los madrileños dejamos al final va a manos de otras personas que lo cogen de esos contenedores para lucrarse con ello. Donde vivo hasta hay una comisaria enfrente y lo hacen sin ninguna impunidad. <u><strong>Basta ya</strong></u>. Con la Policía Municipal, con unos contenedores mas seguros y que pasen a diario a recoger, se arreglaría fácilmente, también con tanta cámara que están colocando en Madrid que enfoquen algunas a esos contenedores. Es dinero que todos los que reciclamos se lo damos indirectamente al Ayuntamiento y otros se lucran con ello. Que lo protejan ya porque si no los madrileños nos dará lo mismo reciclar que no.</p>
";"06/07/2016 14";"82";"80";"2";"9";"3894550868";"7609"
"4681";"Poder votar todos";"<p>El año pasado, las propuestas de los presupuestos participativos de Tetuán no sólo las podían votar los empadronados sino también los que vivían o trabajaban en Madrid.</p>

<p>¿Por qué se nos ha quitado ese derecho si también pagamos nuestros impuestos aquí igual que los empadronados?.</p>

<p>Si podemos proponer ideas para mejorar las ciudad ¿por qué no vamos a poder votarlas?.</p>

<p>Si utilizamos el transporte, las aceras, las carreteras,  también nos interesa todo lo que se pueda mejorar porque al ser también usuarios, también sabemos en qué se puede mejorar y poner nuestro granito de arena para conseguirlo.</p>

<p>Es más, en muchas ocasiones hasta nos preocupamos más que los propios empadronados al ver un desperfecto en la calle y poner un aviso para que vayan a solucionarlo, mientras que ningún madrileño se ha preocupado de ello en años, por eso seguía por arreglar.</p>

<p>Espero que lo consideren y finalmente puedan votar todos para, entre todos, conseguir mejorar la ciudad.</p>

<p> </p>
";"11/07/2016 21";"35";"28";"7";"3";"3939833760";"1680"
"4682";"minimo 54.128 votos";"<p>Me he dado cuenta que para conseguir el mínimo de votos que son 54.128 en un maximo de un año, se necesitan más de 148 votos al día.</p>

<p>Me parece dificil de conseguir ¿qué propuesta consigue eso?.</p>

<p> </p>
";"11/07/2016 22";"57";"49";"8";"19";"3943929782";"3524"
"4685";"Presupuestos participativos invisibles para el ciudadano";"<p>Una excelente idea la de los presupuestos participativos.</p>

<p>Lo que ya ha sido menos excelente ha sido la campaña de difusión de los mismos. Al buzón de mi domicilio ha llegado el bonito folleto que informa de los presupuestos y los plazos cuando quedaba un día para poder votar las propuestas,es decir, el 29 de junio. Sin duda un margen amplísimo parar evaluar las propuestas antes de votarlas. Además he quedado automaticamente excluido de la participación en las anteriores etapas (recogida de propuestas, apoyos,etc) porque el ayuntamiento no ha conseguido que esta información estuviera al alcance de los ciudadanos. Bueno, si, con 4 meses de retraso.</p>

<p>Esto ha sido así sólo en mi distrito (Arganzuela) o ha ocurrido en toda la ciudad? </p>

<p>Se ha llevado a cabo una concienzuda campaña para fomentar la limpieza de Madrid, necesaria y de agradecer. Si todos hemos leído el bando de la alcaldesa en el transporte público y conocemos sus famosos ceniceros, ¿por qué un asunto tan fundamental como los presupuestos participativos ha sido casi invisible para el madrileño? ¿Se ha llevado a cabo alguna acción además del envío de folletos?</p>
";"12/07/2016 17";"56";"48";"8";"3";"3950966531";"3428"
"4686";"Mejorar la limpieza de MAdrid";"<p>Mejorar la limpieza de Madrid, haciendo que los empleados tengan especial cuidado en realizarla (ya que muchas zonas pasan sin limpiarlas, o por encima, más mojando la calle que limpiando) y multar a la gente por incumplir las normas (usar las calles como baños públicos, tirar basuras a la calle, amontonar cajas los comercios a las puertas o fuera de sus locales, tirar colillas al suelo, ...). Un Madrid limpio es cuestión de todos.</p>
";"12/07/2016 18";"179";"177";"2";"13";"3959824136";"17304"
"4687";"Policía Municipal recaudando pero no ayudando";"<p>¿Aparte de para recaudar, para qué sirve la Policía Municipal? Meses de doble fila, de atascos en la puerta de los colegios, de botellones en el parque, motos a escape libre, y un sinfin de irregularidades más en las que no aparecen ni hacen nada. Incluso he tenido que llamarles y no se han dignado a aparecer. Les he puesto quejas y me llaman echando las culpas de un departamento a otro sin asumir el error. Pues hoy los veo en la avenida de Brasilia, justo al colegio Menesiano con un radar. Han señalizado el radar en el carril en el que estaban situados, pero se dedicaban a multar a los que venían de frente al otro lado de la mediana. Más allá de que tengan razón multando a aquellos coches que van a más de 50 (o de 30), echo de menos que tengan la misma pericia a la hora de multar a aquellos que nos llenan de basura los coches y calles con su publicidad (prohibido según la normativa municipal pero apenas perseguido), que acaben con la eterna doble fila en la Avda de Brasilia, Avda Donostiarra, Virgen de Lluc, José del Hierro, Castellana junto a los juzgados, calle Alcalá, etc en los que además de incómodo es peligroso circular. Que dejen tranquilos a los puestos del rastro que se llevan sanciones absurdas por vender fruta mas allá del horario establecido, ya que pueden actuar sin necesidad de sancionar a quién está trabajando (se me ocurren mil maneras). Y en definitiva, que estén para dar servicio, para acudir cuando se les requiere, y no para recaudar escondidos tras una furgoneta como si fueran vulgares rateros.</p>
";"12/07/2016 19";"88";"81";"7";"3";"3955204860";"6811"
"4688";"Limpieza y zonas verdes en barrio Almedrales (Distrito Usera)";"<p>Constato en las últimas semanas que hay un esfuerzo de limpieza y manteninimiento de aceras y jardines, pero me temo, por el tipo de suciedad esparcida por todas partes que hay personas malintencionadas con intereses ilícitos que ensucian aposta boicoteando las políticas municipales. Recomiendo al Ayuntamiento y la Junta del Distrito que controlen y verifiquen esto fotografiando cómo está antes de limpiar y cómo está después. Y que se vigile por la Policía Municipal , porque, repito, no es normal el grado de degradación a que nos someten: basuras, cristales rotos, muebles viejos, etc. lejos de los contenedores.</p>
";"16/07/2016 13";"45";"42";"3";"2";"3990370922";"3640"
"4692";"Re acondicionamiento de la vegetación urbana";"<p>Madrid es una ciudad con carácterísticas propias. ¿Por qué su vegetación no? Como capital europea y ciudad de referencia, creo, que Madrid debe abrir un estudio y un debate acerca de las tipologías de plantas y arbolado de nuestros espacios públicos. En otras ciudades del entorno encontramos variedades que otorgan a sus ciudades identidad, carácter, belleza y que además se adaptan mejor a su clima y condiciones. Creo que es hora de que Madrid tenga también esa identidad, trasladada a sus zonas verdes. (Más aún con los problemas del arbolado actual) Puede parecer un aspecto superfluo, pero ¿Qué sería de Valencia o Sevilla sin sus naranjos o de México sin sus Jacarandas? Es un proyecto sin coste añadido y que progresivamente puede mejorar nuestra ciudad.  </p>
";"19/07/2016 13";"93";"86";"7";"3";"4023389445";"7305"
"4694";"Reabrir el Seu ";"<p>Este complejo deportivo lleva dos años sin canastas los que jugabamos ay nos hemos ido a jugar cerca de prosperidad 2 canchas de baloncesto rockodromo futbol sala </p>
";"19/07/2016 16";"29";"27";"2";"5";"4020223670";"2327"
"4697";"perjuicios que se causan a los vecinos colindantes de las casas en obras";"<p>Al parecer todo el mundo tiene derecho a hacer obras de mejora en sus casas. Bien, pero yo me pregunto ¿dónde se albergan los drechos de los vecinos que sufrimos los ruidos, golpes, polvo y demás inconvenientes y perjuicios de vivir junto a un piso en obras? Me pregunto también si las personas que acometen estas obras, que por lo general no viven en sus casas mientras estas se realizan, por tanto no sufren sus perjuicios, no tendrían que pagar por daños y perjuicios a los vecinos a los que perjudican. Con ese dinero los vecinos podrían alojarse temporalmente en otro lugar mientras los golpes, ruidos, taladros, polvo y demás daños para la vida ordinaria y la salud mental se prolongan.</p>

<p>Si le echo un poco de sentido del humor al tema que me daña y mucho, pues trabajo en casa y vivo con una anciana, lo que me pregunto es ¿por qué hay gente que tiene la manía de comprarse casas que no le gustan? ¿Por qué no se toman la pastilla antes de gastar ese chorro de dinero en molestar a los demás?</p>

<p> </p>

<p>Pues eso, que me gustaría saber si mi Ayuntamiento podría poner alguna solución al respecto.</p>

<p> </p>

<p>Gracias</p>
";"20/07/2016 12";"39";"11";"28";"3";"4011647324";"-479"
"4698";"Limpieza calles marqués de Vadillo ";"<p>No limpian a diario la calle la verdad y colindantes. Pero si pagamos los impuestos </p>

<p> </p>
";"20/07/2016 13";"53";"48";"5";"6";"4030598729";"3894"
"4700";"Urbanizar adelfas (calle barrilero)";"<p>En el distrito de Retiro (Adelfas: calle Barrilero, final de Seco, etc) existe un area sin urbanizar, casi sin aceras, con una limpieza mas que deficiente. En los 6 años que llevo viviendo en la zona no se ha hecho practicamente ninguna actuacion.</p>

<p>reclamo su limpieza, urbanizacion y aprovechar para hacer una zona verde.</p>

<p>en este barrio tambien pagamos impuestos, lo que pasa es que no se reinvierten aqui. Supongo que se destinaran a barrios mas nobles de la capital (Arturo Soria, etc)</p>
";"20/07/2016 21";"22";"18";"4";"0";"4028197133";"1145"
"4701";"Remodelación de los pasos de Cebra en el Barrio de Valverde en Fuencarral";"<p>Llevo esperando 3 Años, 3 Años a que pongan un Paso de Cebra ( ya Solicitado y Aprobado ); en La Calle Santa Ana Baja Número 48. Esto ya es de Cachondeo. Lo Solicite en la Junta Municipal, y fui a preguntar y la Señora Funcionaria, me Derivó a la Calle Albasanz me parece que es donde está el Departamento de la Policía Municipal. No creo que este la Pintura tan Cara; y que pinten de una vez los pasos de Cebra en Fuencarral</p>
";"21/07/2016 00";"28";"25";"3";"0";"4032033727";"1964"
"4702";"¿Es justo el resultado del proceso participativo?";"<p>Al consultar los resultados de los procesos participativos aprobados/consensuados finalizados en junio en Santa Eugenia (Villa de Vallecas) veo con tristeza cómo aparecen unos y otros no.</p>

<p>Sin entrar en la valoración personal que cada uno pueda tener sobre cada una de las propuestas es difícil comprender cómo una propuesta con 280 votos pueda generar un gasto de 500.000 en un carril bici y no se apruebe un paso desde Santa Eugenia al Hospital Infanta Leonor  que a tantas y tantas personas beneficiaría al ahorrar dar un rodeo de 20 minutos andando a una persona joven, cuanto más a personas de más edad; evitaría el trasporte en coche al poder acceder a pie; ahorraría en pérdidas de tiempo personal; etc. Es una reivindicación ya antigua y con varias manifestaciones a sus espaldas.</p>

<p>Si no recuerdo mal, algunas de las propuestas sobre dicho paso al hospital, una decena al menos con distinto título e igual fondo, sobrepasaban los 280 votos del carril bici. Quizá era una propuesta inviable, cosa que he sido incapaz de localizar, pero y ¿por qué sería inviable?</p>

<p>Una de las propuestas Acceso peatonal sin rodeos al Hospital Infanta Leonor  tiene 378 apoyos.</p>

<p>Me he centrado en la propuesta del carril bici pero no se quedan atrás:</p>

<p>Nuevo parque en descampado de Santa Eugenia 300.00 283 votos</p>

<p>Construcción de un rocódromo en Villa de Vallecas 100.000 299 votos</p>

<p>ESPACIO INTER ASOCIATIVO DE VILLA DE VALLECAS 100.000 260 votos</p>

<p>¿No es más importante la salud de los ciudadanos?</p>

<p>¿Sucede lo mismo en otras propuestas? Seguro que sí.</p>

<p> </p>
";"21/07/2016 09";"45";"29";"16";"15";"4031848304";"837"
"4706";"Seguridad ciudadana en Pueblo Nuevo-Ciudad Lineal";"<p> ¿Se esta haciendo algo más que proyectar el cambio de placas de calles,ALGO A NIVEL SEGURIDAD? A que parece demagógica la pregunta?</p>

<p>Pues os invito al maravilloso mundo de que tu casa esté enclavada a escasos metros de discotecas latinas.Éste sábado sin ir más lejos batalla campal con 7 policias heridos y esta madrugada un ciudadano de origen chino ha fallecido apuñalado en el cuello(el autor no se de que nacionalidad es,ni me importa).Mi casa queda a la misma distancia de los dos hechos y de verdad, estoy encantado con que la zona en que vivo esté siempre de rabiosa actualidad, pero mi pregunta, formulada arriba, me gustaría que fuese extendida con la respuesta a qué narices se está haciendo desde las administraciones,empezando por la Junta Municipal.No se puede,administrativamente, tramitar el cierre de un garito reincidente por reyertas? No quiero entrar en un debate sobre inmigración, ya que acaba degenerando en xenofobia o buenismo y cada uno tendrá su visión sobre este asunto,como todo en España,""la cosa va por barrios"".</p>

<p>Pago impuestos para poder andar con tranquilidad por la calle a las 6 de tarde o a las 4 de mañana.A día de hoy aquel que viva en mi barrio no puede decir lo mismo.Sólo se que veo otro barrios evolucionar y el mío degenerar en un ghetto y las palabras como ""integración"" y ""tolerancia"" ya no valen, son huecas, falsas.</p>
";"26/07/2016 09";"50";"50";"0";"7";"4091303776";"5000"
"4707";"Encierro en Madrid.";"<p><strong>Encierro en Madrid,</strong></p>

<p>No, no son los sanfermines.</p>

<p>No, no son desahuciados.</p>

<p>No, no son despedidos por un ere.</p>

<p><strong>No, no es algo habitual.</strong></p>

<p>Madrid es una ciudad activa y los madrileños y madrileñas también. De forma a como en Madrid recibimos las propuestas, quejas y manifestaciones de toda España, este <strong>debate-propuesta </strong>que surge en Madrid y se moviliza desde Madrid quiere llegar a todo el territorio, a todos los ciudadanos, sean o no madrileños.</p>

<p>Tras unas elecciones, los <em>partidos </em>pueden y deben negociar y acordar, pero los <em>ciudadanos, </em>no: Un ciudadano un voto y su recuento es la voluntad ciudadana, del <em>pueblo, </em>que como es lógico, no cambia de un día para otro y por eso ha sido casi la misma en las dos convocatorias y sería también similar en una tercera, salvo que decidiéramos mayoritariamente no votar o revelarnos al margen del sistema, que no contempla esta sinrazón en la que nos están metiendo.</p>

<p><strong>Después de más de seis meses y ahora <strong>durante </strong>un par de semanas, <strong>desde </strong>ya, 26 de julio</strong>, los diputados de la Cámara Baja, representación de la ciudadanía, pueden acordar un Presidente para nombrar un gobierno y gobernar y todos, desarrollar las funciones al completo de una nueva legislatura.</p>

<p>Caso de que en esas dos semanas (ninguna más) no lleguen a un acuerdo en condiciones normales <strong>no habrá terceras elecciones porque:</strong></p>

<p><strong>Encierro en Madrid, es el encierro en el Congreso, en Madrid por ostentar la capitalidad, de los 350 diputados electos (36 por Madrid) y ya acreditados de las Cortes, tras las segundas elecciones. Voluntariamente, en huelga de hambre, se encerrarán en el Congreso hasta alcanzar el propósito para el que han sido elegidos. El encierro finalizará tras la votación con éxito de la investidura del nuevo Presidente.</strong></p>

<p>Los términos y condiciones del encierro (entrada, permanencia, organización, control, contactos, comunicaciones, etc.) los iré añadiendo en siguientes comentarios para así dar lugar a que el debate se ponga en marcha y tener en cuenta las respuestas y comentarios de quienes participen en esta alternativa a una tercera convocatoria. ¡Ojalá no sea necesario!</p>

<p>Por favor, ayudar a hacer llegar este debate a todos, individualmente, colectivos, partidos y cuantos mas mejor. Por supuesto, siempre, todos y todas.</p>
";"26/07/2016 19";"50";"8";"42";"17";"4074754992";"-544"
"4708";"Ocupación de pisos en Usera y Villaverde";"<p>Es muy preocupante, no saber si al volver de vacaciones en estas dos concejalías estará nuestra casa ocupada por otra familia y además, vendida por una mafia, que sin vergüenza habla de ello en la calle, creo hay policía especial en ello, pero siguen sin parece ningún miedo. Agradeceríamos mayor cuidado y seguridad. Gracias</p>
";"28/07/2016 14";"83";"83";"0";"3";"4115357862";"8300"
"4710";"Operación campamento: 2020";"<p>Hola a todos,</p>

<p>Soy un residente de Madrid, aficionado a los debates, al urbanismo y la arquitectura y abro este debate para hablar de la ya conocida Operación Campamento de cara a la paralización total de este proyecto tras la reciente fracasada vente de terrenos al magnate chino.</p>

<p>Acabo de mudarme (casualidades de la vida) a la zona de Aviación Española, y bueno me gustaría por una parte denunciar el estado de abandono de ciertas zonas de Madrid, como el barrio de Las Águilas y abrir un debate a todas las mejores tanto en servicios.</p>

<p>Resumiendo desde mi punto de vista, observo los siguientes problemas en la zona:</p>

<p>-A5 (Exceso de tráfico, contaminación). Urbanización de los barrios al lado de la A5, tiene un tratamiento cómo vía urbana, pero realmente es una autovía, conlleva ruidos para los vecinos y problemas de salud/polución.</p>

<p>-Abandono de espacios: paseos abandonados, basura en la calle, terrenos sin urbanizar, falta de una visión moderna de ciudad. El barrio de Aluche y alrededores tiene un mal diseño.</p>

<p>-Falta de servicios: parece una chorrada, pero antes vivía en el centro de Madrid y tenía de todo, ahora vivo en una zona completamente deprimida en el que faltan servicios como: supermercados, zonas comerciales, parques y demás...</p>

<p>-Transporte insuficiente: la línea 10 de metro está bastante decente, aunque por ejemplo la línea de Cercanías de Móstoles el Soto deja mucho que desear: exceso de paradas, falta de inversión de las estaciones en los últimos ¿30 años? No son accesibles, la frecuencia no es mala pero se incumple siempre.</p>

<p>-Aumento constante de la población: recordemos que es una zona densamente muy poblada: al distrito de Latina, si le sumamos el distrito de Carabanchel (que no tiene Cercanías ni metro directo) y los municipios de Alcorcón, Móstoles, Navalcarnero, etc...etc...Estamos hablando de muchísima gente para sólo una carretera (A5, una línea de Cercanías que funciona mal y sólo te lleva hasta Atocha, y una línea 10 de Metro).</p>

<p>¿Qué propondríais? A mi se me ocurre como prioridad absoluta la mejora del transporte, la creación de zonas verdes, podría incluirse también la creación de servicios, pero lo que no veo viable es la creación de más pisos....Si sumamos toda la gente que vive por la zona estamos hablando:</p>

<p>-Distrito Latina: 234.000 habitantes.</p>

<p>-Distrito Carabanchel: 244.000 habitantes.</p>

<p>-Alcorcón: 170.000</p>

<p>-Móstoles: 205.000</p>

<p>-Villaviciosa de Odón: 26.000</p>

<p>-Arroyomolinos: 25.000</p>

<p>-Navalcarnero: 26.000</p>

<p>Sumando todo tenemos alrededor de 1 millón de personas, eso sin contar Boadilla del Monte y Pozuelo que están completamente detrás de la Casa de Campo. </p>

<p>Desde aquí abro el debate para preguntar a los ciudadanos, ¿qué modelo de ciudad realizaríais para ésta zona?</p>

<p>Saludos y gracias!</p>

<p> </p>

<p>  </p>
";"29/07/2016 14";"30";"28";"2";"9";"4119523862";"2426"
"4711";"Vigilancia en la playa de Madrid rio";"<p>En las fuentes de la playa de Madrid río a los usuarios nos gusta bañar y tomar el sol sin suciedad de globos de agua , bicicletas, sombrillas etc.. </p>
";"02/08/2016 11";"50";"43";"7";"0";"4158156778";"3096"
"4712";"Policía Municipal por los barrios de Madrid a pie";"<p>Policía Municipal por los barrios de Madrid a pie, para su cercanía con la ciudadania, seguridad en las calles, dobles filas, ruidos de terrazas, venta ambulante, etc. En resumen infracciones de todo tipo que los ciudadanos vemos habitualmente andando y no podemos nada mas que verlo y soportarlo con indignación.</p>
";"02/08/2016 12";"94";"89";"5";"1";"4163499308";"7953"
"4714";"Madrid Rio";"<p>Me Gustaria saber que pasa con el Rio Manzanares que lleva varios meses, desde San Antonio de la Florida hasta pasado el puente de Toledo, sin agua, sin caudal y completamente abandonado y lleno de matorrales, y con una vegetación sin podar que invade todo el curso del Rio. Le quita toda la belleza al paisaje y da una sensación de abandono y suciedad, que es especialmente llamativa a su paso por la Rivera del Manzanares (desde el Puente de los Franceses hasta el Puente del Rey). El Puente de Segovia se encuentra en una situación denigrante, las fuentes no funcionan o no estan en marcha el agua esta estancada y desmejora notablemente la zona, al paso por el Vicente Calderon es notable la vegetación que ha crecido, por donde deberia pasar agua, en el Puente de Toledo ocurre tres cuartos de los mismo eso sin hablar de los olores que se provocan en esta época de altas temperaturas y por supuesto la faunia del rio ha desaparecido (Lucios, Carpas y Patos).
Parece increible que una Obra Faraonica en las que nos metio el anterior Alcalde de Madrid, se este despreciando, una vez que se ha gastado el dinero en su arreglo, el Ayuntamiento de Madrid deberia establecer un sistema de mantenimiento, para que lo gastado sirva de algo y no se pierda en estos pocos años que han trascurrido desde que se realizaron las obras de acondicionamiento de Madrid Rio.</p>

<p>Transcurro muy frecuentemente por la zona debido a mi afición a la bicicleta y siento pena por un abandono de una parte de Madrid, de la cual nos deberiamos sentir orgullosos. </p>

<p>Di mi voto al Grupo de Carmena, por que pense que entre otras muchas cosas haria de Madrid una Ciudad Verde, libre de contaminación y de la que sentirme orgullos y espero que en los años que le quedan este Ayuntamiento apueste por estos principios.</p>
";"03/08/2016 13";"55";"49";"6";"8";"4170203206";"3830"
"4715";"Ampliación Cercanías Madrid";"<p>Buenas, comienzo este debate con la idea de proponer un diálogo acerca de zonas en Madrid que creais que es insuficiente la red de cercanías.... ¿Qué lineais propondrías? ¿Nuevas estaciones de tren? ¿Remodelación de algunas actuales? ¿Supresión de estaciones?</p>

<p>Que comience el debate!</p>
";"04/08/2016 10";"52";"50";"2";"9";"4180734179";"4615"
"4716";"Las tiendas de alimentación de los chinos";"<p>Me gustaría que nos planteáramos estos comercios que utilizan la fachada con múltiples pegatinas de productos comerciales ,y cualquier zona,de madrid está inundado de ellos ,que se les exija una imagen,amable y estética </p>
";"04/08/2016 22";"79";"69";"10";"8";"4185024041";"5153"
"4717";"Un parque para la Guindalera";"<p>La Guindalerala es un barrio comprimido entre 4 grandes ejes viarios (M30, Avenida de América, Francisco Silvela y calle Alcalá. Solo dispone de un pequeño parque en su extremo suroeste (Eva Duarte) que comparte con los vecinos de Fuente del Berro y Goya. </p>

<p>Junto a la nueva Avenida de Camilo Jose Cela, proximo al metro Parque de las Avenidas, existe un gran solar urbano que podría convertirse en un magnífico parque arbolado. Supongo que el solar es edificable y si bien utilizar todo el terreno como espacio público (lo cual sería fantástico) pudiera no ser viable, siempre podrían convivir ambos usos dado el tamaño del mismo.</p>

<p>Esta es mi propuesta.</p>
";"06/08/2016 10";"51";"49";"2";"17";"4200592550";"4515"
"4720";"interinos oficial de jardineria";"<p>Para cuándo la contratación de los 35 interinos de oficial de jardinera acordados en la mesa de negociación del pasado 1 de marzo de 2016?</p>
";"08/08/2016 10";"28";"25";"3";"0";"4216475725";"1964"
"4722";"Restricción coches";"<p>Mi propuesta es la siguiente, en muchas avenidas de Madrid puedes ver hasta 5 carriles para coches, más 2 de aparcamiento a cada lado y un carril bus que aparece y desaparece según el tramo. A mayor número de carriles, mayor tráfico y mayor contaminación (obviamente). Los problemas que veo son los siguientes:</p>

<p>-Las dobles filas inhabilitan muchas veces 1 carril de cada lado, con lo cual da igual que haya un carril de circulación, tienes que cambiarte y eso provoca tapones.</p>

<p>-No tiene ningún sentido las calles que van cambiando de 5 a 4 carriles y al girar a otra avenida tienes 2 carriles: tapones y más congestión.</p>

<p>Mi propuesta es fácil: limitar a 3 o 4 carriles el número de las avenidas grandes, ese carril se puede aprovechar para buses, agrandar las aceras o bicicletas. Por ejemplo las calles Rios Rosas, Islas Filipinas, no tiene sentido tener tantos carriles. Salvo la Castellana que es la Avenida por excelencia, el resto de las calles no deberían tener más de 4 carriles.</p>

<p>Para empezar a tener una ciudad habitabley cómoda, vamos a tener que restringir el tráfico a los coches. Yo pdopondría de una manera adicional lo siguiente:</p>

<p>-Peajes en las principales entradas A1, A2, A3, A4, A42, A5 y A6 para entrar en la M30, se podría considerar como una penalización por contaminar. Este peaje sería gratuito para la gente que viva dentro de la almendra central.</p>

<p>-Desgraciadamente pondría zona azul y zona verde entre la M30 y la M40, no tiene sentido que el eje principal de una ciudad como Madrid sea el coche, si no cambiamos el chip, esto va a ser una ciudad insostenible en el tiempo.</p>

<p>-Hacer un estudio barrio a barrio para conocer cuáles de los barrios necesitan la creaión de aparcamientos subterráneos.</p>

<p>-Parkings para bicis en estaciones de Cercanías y estaciones de metro.</p>

<p>-Supresión de aparcamientos en superficie para dotar más espacio al peatón, bicicleta y autobús. Este punto me parece muy interesante, vemos como se crean nuevos barrios tipo las Tablas, sin suficiente transporte público, la gente tira del coche y aparca donde LE DA LA GANA y no pasa nada, las empresas no ofrecen ningún tipo de ventaja adicional, y al final los que perdemos somos  todos los vecinos, los que viven en las Tablas y los que van a las Tablas porque se convierte todo en un gran aparcamiento en superficie como si en vez de un barrio fuera un centro comercial, esto pasa en miles de barrios de Madrid.</p>

<p>-BiciMAD para los distritos que se encuentran entre la M30 y la M40.</p>

<p>-Segundo peaje de la M40 hacia adentro.</p>

<p>-Carriles bus en todas las entradas de Madrid.</p>

<p>-Mejorar la frecuencia de TODAS las líneas de Metro, hacer un estudio de movilidad y eliminar aquellas estaciones que no tienen viajeros.</p>

<p>-Construcción de una línea de Cercanías este-oeste que atraviese la ciudad.</p>

<p>-Mejorar las frecuencias de los trenes.</p>

<p>-Aparcamientos gratuitos para coches eléctricos.</p>

<p>-Supresión de aparcamientos en superficie (coche) y cambiar por aparcamientos para motos.</p>

<p>-Obligar a las empresas de más de 100 empleados a que dispongan de lanzaderas. Esto se hacía hace muchos años en otros sitios de España con muy buena acogida por parte de muchas personas....</p>
";"11/08/2016 09";"63";"38";"25";"16";"4241690202";"784"
"4723";"Ampliación horario aparcamiento regulado SER";"<p>Cuando lo he leído en forma de noticia en un periódico, me he quedado perpleja.</p>

<p>No entiendo la justificación de las administraciones para cobrar a los ciudadanos por aparcar en la calle. </p>

<p>¿Alguien me puede explicar por qué? Bueno, está claro: para que no te multen.</p>

<p>Pero me refiero a una explicación racional, justificada.</p>

<p>Porque si ya pagamos impuesto de circulación, ¿a qué responde ese impuesto del ""aparcamiento regulado""? ¿Qué tipo de servicio se nos hace que justifique el pago de impuestos adicionales? </p>

<p>Y encima, pretenden ampliarlo hasta la medianoche y los fines de semana.</p>

<p>Las Administraciones os estáis equivocando; que el suelo urbano sea público, o responsabilidad del Ayuntamiento, no significa ni implica que seáis literalmente los dueños de la calle, o que tengáis derecho a explotarlo como si fuese un parking público. </p>

<p>La culpa es de los ciudadanos, que os hemos dejado empezar con esto sin rechistar.</p>

<p> </p>

<p>O el Impuesto de Circulación, o Aparcamiento Regulado. Ambas cosas es una incoherencia y un abuso. Y LO SABÉIS...</p>
";"11/08/2016 14";"71";"41";"30";"17";"4242750190";"635"
"4724";"Debate Madrid";"<p>Decide Madrid ha creado una nueva de hacer gobierno pero a mi parecer es insuficiente. Por ello creo que lo que Madrid necesita es una participación más directa de los ciudadanos a modo de debates públicos con la ciudadanía.</p>

<p><strong>¿Cómo se pueden convocar estos debates?</strong></p>

<p>Informando por los medios de comunicación y creando un nuevo proceso al estilo ""procesos sectoriales"" donde la gente pueda ir recopilando las propuestas o preguntas a problemas. Finalizado el debate se hace un análisis para llevar esas propuestas y problemas a debate con la elección de representantes. Se informará al crear cada debate de las fechas y los participantes en el mismo.</p>

<p><strong>¿Donde se podrían realizar los debates?</strong></p>

<p>A elección de la alcaldía, pero un lugar idóneo podría ser la Asamblea de Madrid</p>

<p><strong>¿Quién podría formar parte de los debates?</strong></p>

<p>Los participantes sería representantes de los partidos políticos que tienen sus escaños en Madrid, representantes de la comunidad y del gobierno, y por supuesto una representación de ciudadanos de los distritos de Madrid.</p>

<p><strong>¿Como se va a hacer público cada debate?</strong></p>

<p>La idea es que este debate sea transmitido en abierto, por la televisión publica de Madrid, Telemadrid (que para ello la tenemos) a la vez que pueda ser vista en abierto desde la web del ayuntamiento o desde redes sociales y otros medios. Y que pasada la fecha quede el video de la participación en el deate para que cada persona pueda verlo en cualquier momento.</p>

<p><strong>¿Qué se podría debatir?</strong></p>

<p>Cada debate debería ser sobre una temática concreta, es decir, sobre movilidad, urbanismo, economía, etc. A su vez las propuestas más votadas en la web ""decide madrid"" aparecerán en los debates.</p>

<p><strong>¿Cómo podría ser el sistema de debate?</strong></p>

<p>Los debates podrían tener tres partes:</p>

<ul>
	<li>La primera, una serie de propuestas de cada partido político para solucionar los problemas actuales de la ciudad. En ella se podrán aportar todo tipo de documentación y aportes gráficos.  Posteriormente estas propuestas tendran su comentarios de apoyo o rechazo con los motivos o razonamientos que den los otros partidos. Al acabar el debate, estas propuestas irán directamente a decide madrid con su documentación aportada (como los comentarios de cada fuerza política) para ser valoradas por los ciudanos, eligiendose las más votadas. </li>
	<li>La segunda, se podría ir analizando propuestas del portal ""decide madrid"" (aún no teniendo los apoyos solicitados por la página), por todos los partidos, cada uno comentara su apoyo o su rechazo y finalmente, los representantes políticos harán una votación para llevarlo o no a cabo.</li>
	<li>Finalmente, la parte de distritos.Los representantes de vecinos de cada distrito irían enumerando los problemas, necesidades, mejoras y urgencias de cada distrito. Posteriormente, mostrarían a cada necesidad su propuesta y esto se irá valorandose por cada partido político para su estudio y posterior apoyo, rechazo o mejora, con el compromiso de elaborar una solución.</li>
</ul>

<p><strong>¿Qué se consigue?</strong></p>

<p>El poder reside más en la ciudadanía, ya que muchas propuestas van a ser viables por votaciones ciudadanas. Por otro lado, los representantes políticos van a saber de primera mano los problemas actuales de la ciudad. Además se conseguiría que los ciudadanos vean un trabajo real de la política y un esfuerzo en resolver las necesidades de Madrid.</p>
";"13/08/2016 00";"24";"18";"6";"2";"4258281973";"900"
"4726";"MULTAS PARA CONDUCTAS INCÍVICAS: PISES, EXCREMENTOS DE CANES, ESPUTOS ...";"<p>Hola. Soy una vecina del centro y estoy muy muy harta y muy asqueada de la situación de este barrio. Las calles están sucísimas de basuras, de cacas de perro y de pises de personas. Es asqueroso. De tal manera que si vas a vivir en un exterior tienes que pensarlo dos veces porque </p>

<p>sabes que te va a llegar un bofetón de olor a pises reconcentrados. Me gustaría que se volviera algo raro e inusual lo de que la calle fuera tomada como wc gigante por algunos ciudadanos que piensan que es totalmente normal.</p>

<p>Parece imposible de lograr, pero tb parecía imposible que la gente dejase de fumar en los bares y ya ves. Es algo importante, porque afecta a la salud e higiene de muchas personas. Sé que algunos dirán que es imposible destinar efectivos para este fin, vengan por las calles del centro (Calle del Tesoro, nombre bastante cómico si conoces la calle) y a plena luz del día puedes encontrar a gente haciendo pis. Pero tb en Plaza de España, San Andrés... Respecto a lo de los perros me resulta indignante que haya gente tan sumamente cochina, máxime cuando el ayuntamiento proporciona bolsas. Yo tengo perro y soy la típica rompepalle que si ve que alguien no recoge se lo dice (y más dueños de perros lo hacemos) pq luego nos llevamos los laureles todos y no está bien.</p>

<p>A todos estos comportamientos le sumamos la deficitaria limpieza de las calles y tenemos un cocktail asquerosamente explosivo.</p>

<p>Patrullen, pongan multas POR FAVOR pq si no la gente sigue haciendo el cerdo y vivir así es un asco muy grande. </p>
";"24/08/2016 11";"154";"150";"4";"7";"4385860787";"14220"
"4729";"Piscina municipal para perros.";"<p>Crear una piscina donde lo perros puedan entrar a refrescarse y poder nadar.</p>

<p>¿Cree usted que Madrid debería tener una o varias piscinas donde los perros se puedan refrescar?</p>
";"27/08/2016 11";"142";"30";"112";"8";"4390778916";"-1732"
"4730";"Ponerle una Calle a Vicente Calderón";"<p>Visto que desaparecerá el estadio y el nuevo tendrá un nombre publicitario, propongo una calle en Madrid. </p>

<p>También podemos ver como Santiago Bernabeu tienen una calle y parada de Metro, y habría que darle igualdad a otro equipo de la capital. No supone gasto alguno el poner una calle. O cambiar el nombre de alguna de las Franquistas que hay que suprimir.</p>
";"28/08/2016 11";"73";"39";"34";"0";"4408475064";"267"
"4731";"Rescate de refugiados ----->  rehabilitacion portaareonaves ""PrincipeAsturias"".";"<ol>
	<li>Con todo respeto y desde la declarada ignorancia de un ""habitante del interior"" ajeno al entorno costero, quizá pueda alguien aclarar el <u>estado actual</u> de un gran buque  (véase  https://es.wikipedia.org/wiki/Pr%C3%ADncipe_de_Asturias_%28R-11%29 )  que retirado sin <em>ningún aprovechamiento</em> público ni privado, lanquidece todavía en carena tras haber sido penosamente arrastrado a la grada.</li>
	<li>Sabiendo por otro lado de la encomiable acción de <strong>varias ONGs</strong> y <em>notables</em> particulares, por aliviar la inquietud de <u>migrantes zozobrados</u> durante la precaria travesía acometida en diversos sectores del Mediterráneo, así como de la admirable entrega  -tanto por sus expertos tripulantes como por los variados voluntarios que con ellos se embarcan-  a lo largo de los últimos años.</li>
	<li>Confiando en que la coordinación multilateral desplegada en el sur de Europa vaya más alla de los reducidos medios emplazados por Autoridades y sus <strong>respectivos gobiernos</strong> navegando hoy día, pero al mismo tiempo esperando también que se amplíe a otras instituciones pues convencido no obstante del apoyo que una iniciativa continental llegaría a recibir si fuera a este respecto desde <u>nuestro propio Ayuntamiento</u> lanzada vigorosamente para alcance internacional con formulación consistente y apropiada, es por lo que</li>
	<li>Finalmente y salvo superior criterio, poniendo aquí a disposición de todos una OBVIA consideración sobre los lamentables <em>dispendios de gasto</em> público actualmente ociosos: yo desearía fuese en definitiva <u>elevada al Consejo de Ministros</u> la moción URGENTE para re-equipar y asignar definitivamente en misiones humanitarias el ""nuevo"" portaaeronaves <em><strong>Príncipe de Asturias</strong></em> para que en manos de la <em>Fuerza Guardacostas</em>  -ó equivalente naval de ""altura"", en su caso-  vuelva con su gallarda presencia a otorgarnos días de esplendor, llenando por siempre de orgullo a nuestros hijos y nietos.</li>
	<li>Integrándose activamente en cuantas Flotas multi-misión se desplieguen en el presente y en el futuro, con los ingentes gastos que sin duda devengaría prorrateados entre el conjunto de Estados participantes  (ó a través de la <em>Agc Eur de Sgdd Marítima</em> <em><strong>EMSA</strong></em>), a la vista de las <u>innegables ventajas operativas</u> que proporciona su espaciosa ""Cubierta de Vuelos"" y vista la disparidad de ya obsoletos requerimientos militares que definieron entonces su configuración de combate (frente a las brillantes funcionalidades que hoy su proyección hacia <strong>alta mar</strong> en cambio proporcionaría)  para hacer ahora de su flete otro nuevo <em><strong>Hespérides</strong></em> de variadas utilidades  (véase https://es.wikipedia.org/wiki/Hesp%C3%A9rides_%28A-33%29 )  con que nutrir la ancestral vocación marinera de nuestro País, sin que quepan ya a estas alturas creo acciones dubitativas ninguna por más tiempo en este sentido.</li>
	<li>En fin, rogando por último disculpas al haber quizá a Vds importunado permítanme transmitir a pesar de todo  (en nombre de los ahogados así como de las familias supervivientes, sea cual sea su nacionalidad)  con el ánimo todavía <u>encogido por la tragedia</u> aún EN CURSO día tras día, muchísimas <strong>gracias</strong> de todo corazón al <em>interés prestado</em> de quienes suscriban esta modesta petición. Y a quienes se opongan, también por esa  <em>atención personal</em>  suya al haber dedicado al menos unos instantes en la lectura.  Quédales a todos muy atte suyo,</li>
</ol>

<p> </p>
";"29/08/2016 17";"37";"14";"23";"5";"4413630675";"-340"
"4732";"Soterrar entradas ciudad";"<p>Hola, el otro día se me ocurrieron varias ideas mientras circulaba por Madrid. El problema es el siguiente: todas las entradas a la ciudad no dan más de sí y ampliar el número de carriles no soluciona el problema sino que lo agrava. Aparte de mejorar el transporte público se me ocurrió que se podría hacer lo siguiente:</p>

<p>-Soterrar lo máximo posible, desde que se pasa por ejemplo de la M40, y dejar todo el tráfico de entrada subterráneo. La parte en superficie que ahora son normalmente 6 carriles (3 entrada y 3 salida), los dejaría de la siguiente forma:</p>

<p>-1 carril bici.</p>

<p>-1 carril exclusivo BUS, de esta forma tendríamos una manera rápida y efectiva de acceder siempre a la capital.</p>

<p>-Los otros dos carriles los destinaría a plantar árboles y ampliar aceras: hacer las entradas a la cidad y los barrios periféricos mucho más habitables....</p>

<p>Teniendo en cuenta la cantidad de PAUs y construcciones que se realizan, llevaría a cabo una negociación exigente para llevar a cabo estas reformas....</p>

<p> </p>

<p>¿Cómo lo veis?</p>
";"30/08/2016 11";"48";"34";"14";"11";"4434596433";"1416"
"4733";"Limitar los sueldos de los asesores a dedo igual que los de los políticos";"<p>La limitación salarial de los asesores a dedo (como el hermano de Alberto Garzón) debe ser al menos la misma que la de los políticos electos. Lo contrario es incurrir en la apelación a la confianza típica de los corruptos</p>
";"30/08/2016 18";"112";"111";"1";"7";"4447953942";"10901"
"4734";"Pleno Ordinario 07/09/16 Junta Municipal de Puente de Vallecas";"<p>El próximo miércoles 7 de septiembre tiene lugar el Pleno Ordinario del mes de septiembre en Puente de Vallecas. Puedes consultar el orden del día en el siguiente enlace: https://www.facebook.com/permalink.php?story_fbid=1740032059594560&amp;id=1619947368269697</p>

<p>Abrimos este debate online para que aportes tus opiniones y comentarios. ¡Gracias!</p>
";"05/09/2016 13";"9";"6";"3";"2";"4489283008";"200"
"4735";"Tráfico, atascos, soluciones";"<p>Buenos días, </p>

<p>He vivido y he trabajado en varias zonas de Madrid y veo que hay problemas severos de congestión en todas las carreteras durante aproximadamente 2 horas a la ida y 2 horas a la vuelta, provocando contaminación, congestión y problemas graves de transporte.</p>

<p>Abro este debate para tener centralizado en un sitio como mejorar la ciudad y la comunidad de Madrid en términos de atascos. Se me ocurre proponer soluciones a corto plazo (C), a medio plazo (M) y a largo plazo (L)</p>

<p>Gracias por vuestra colaboración!</p>
";"07/09/2016 09";"35";"33";"2";"10";"4518507420";"2922"
"4736";"Ocupación de pisos en carabanchel";"<p>Me gustaría que alguien de algún gobierno después de informar a la comisaria se les diera permiso para poder desalojar a la cantidad de personas que se están metiendo en los pisos en la zona de Carabanchel, enganchando la luz que luego tienen que pagar jubilados de más de 75 años con una pensión mínima así como la convivencia que no respetan a ningún nivel. Se les da calle y piso y no se ataja el problema. ¿Que se puede hacer al respecto?.</p>
";"10/09/2016 15";"61";"59";"2";"0";"4553328961";"5513"
"4741";"Limitación a 30 km/h en calles de un sólo carril";"<p><strong>Se propone una <u>limitación de velocidad a 30 km/h</u> en todas las calles de un sólo carril dentro de la M-30</strong>, sin necesidad de indicarlo en el propio carril ""pintado"". Motivos:</p>

<ul>
	<li>En calles con un sólo carril los peatones tendemos a cruzar ""por cualquier lado"" y la velocidad es un factor que incide tanto en el riesgo de accidente como en la severidad de las consecuencias. Estas calles suelen tener aparcamiento a ambos lados lo que limita la visibilidad de los niños (mayor riesgo)</li>
	<li>Actualmente están en funcionamiento con éxito los carriles compartidos con ciclistas con limitación a 30 km/h, muy adecuados para el uso de bicis</li>
</ul>

<p><strong>DGT</strong> ya realizó una propuesta en este sentido: http://www.20minutos.es/noticia/2511385/0/dgt-propone/circular-30km/caminar-calles-ciudades/</p>

<p>En función de la experiencia podría irse ampliando a otras zonas.</p>
";"16/09/2016 19";"86";"40";"46";"14";"4595630790";"-279"
"4742";"me siento abandonada por el ayuntamiento.";"<p>Soy una vecina del distrito de Arganzuela. Desde hace años tengo problemas con gente que se dedica a beber, orinar, dormir y demas en la calle donde vivo, C/ Tortosa (Pasaje). Ya no se donde acudir pues he hablado con el 010 y no me han dado solucion, la policia se pasa por aqui y tampoco hace nada....y ya no se donde acudir o que mas hacer. Tengo paciencia pero ya se me esta agotando y me siento totalmente abandonada por aquellos que deberian ayudarme. Por favor si alguien sabe alguna manera o sitio para acudir y solucionen este problema, estaria muy agradecida.</p>
";"19/09/2016 11";"79";"76";"3";"6";"4642975422";"7022"
"4743";"Nuevo trazado Cercanías Madrid-Alcobendas";"<p>Actualmente la zona norte de Madrid está muy colapsada, si observamos aparte de la cagada de la líena 10 con su correspondencia inútil en 3 olivos, si vemos el trazado de la línea que comunica con Alcobendas, observamos que da mucha vuelta.</p>

<p>Propongo crear una línea adicional que una Chamartín-&gt;Las Tablas-&gt;La Moraleja-&gt;Alcobendas.</p>

<p>Actualmente todas las empresas se instalan en la zona de Las Tablas/Sanchinarro (zona que no tiene estación de Cercanías) y en la zona de la A1 cerca de la Moraleja.</p>

<p>De esta manera dotaríamos a la zona de la A1 de dos líneas de Cercanías y descongestionariamos bastante la zona norte de Madrid.</p>

<p>No tiene ningún sentido la vuelta que se da por Cantoblanco, Comillas, Valdelasfuentes.....</p>
";"19/09/2016 17";"40";"34";"6";"2";"4639744384";"2380"
"4744";"Aunar propuestas";"<p>Esto es más una consulta que un debate, puesto que no encontré dónde hacerla. Veo que las propuestas sobre los bienes de la iglesia, las multas a dueños de animales por no recoger excrementos y el tema taurino se repiten una y otra vez de forma separada. ¿no tiene esta página un administrador/a que aune las propuestas? es una forma muy poco eficiente de conseguir apoyos, cuando deberían aunarse se dividen.</p>
";"20/09/2016 12";"38";"32";"6";"5";"4647291202";"2189"
"4749";"Creacion de un interurbano Ciudad Lineal-Aranjuez ";"<p>Los vecinos de Ciudad Lineal necesitamos un acceso a las ciudades de fuera del centro de madrid por que desde Ciudad Lineal es complicado ir a fuera con transporte publico:</p>

<p>Los Interurbanos de Ciudad Lineal:Solo van hacia Coslada que no esta tan lejos</p>

<p>La lejania de las estaciones de Cercanias:Para ir a Atocha hay que coger un autobus y andar,para ir a Nuevos Ministerios el metro...</p>

<p>Propongo debatir:</p>

<p>Añadir un interurbano hacia Aranjuez o un autobus hacia Atocha o Nuevos Ministerios en el Intercambiador de Ciudad Lineal que para algo esta</p>
";"25/09/2016 19";"34";"26";"8";"1";"4697810758";"1376"
"4750";"Tráfico zona norte de Madrid";"<p>El tráfico en la zona norte de Madrid va de mal en peor. Hace años las oficinas se situaban en el eje Castellana o centro de la ciudad, ahora progresivamente se está moviendo todo a Alcobendas, zona de las Tablas, etc...</p>

<p>Desde la llegada de la ciudad de Telefónica y ahora la ciudad de BBVA, la zona es insostenible, la hora punta dura alrededor de 2 horas a la ida y 2 horas a la vuelta.</p>

<p>Necesitamos soluciones ya, tanto para los que quieren seguir viajando en coche, como para los que vamos en transporte público. </p>

<p>O hacemos algo a corto plazo o llegará un día que la gente no pueda llegar ni a su trabajo.</p>

<p>¿Qué se os ocurre?</p>
";"28/09/2016 10";"61";"55";"6";"3";"4729726014";"4418"
"4751";"Incentivar a personas para que usen el transporte público";"<p>Muchas personas se quejan del tráfico, pero siguen circulando a todas partes en coche, hay que cambiar esta mentalidad ""madrileña"" de ir en coche a todos lados, necesitamos medidas que impulsen a dejar el coche en tu garaje y moverte en transporte público. ¿Qué se os ocurre?</p>

<p>-A mi se me ocurre que con un justificante del abono anual, no se pague el impuesto de circulación de los coches...</p>

<p>-Construccion de aparcamientos subterráneos en barrios con problemas para aparcar, serían de pago gestionado por el Ayuntamiento, en caso de pagar el abono mensual, descuentos en la cuota de tu garaje, con esta medida, consigues más espacio en superficie, quitas coches y fomentas a que la gente lo deje en su plaza y vaya en t.publico.</p>

<p> </p>
";"28/09/2016 10";"98";"87";"11";"7";"4731252656";"6746"
"4753";"Renovación de las fachadas en Madrid Río y alrededores.";"<p>Dar un Paseo por Madrid Río es realmente un placer, pero es cierto que las fachadas de los edificios aleñados, muestran una arquitectura caduca, y energéticamente poco sostenible. Por ello propongo un plan renove para la zona en cuestión y los barrios cercanos.</p>

<p>Este plan renove ya se intentó hace unos años, con el descontento vecinal por su alto coste. Por ello, una asamblea entre ayuntamiento, vecinos y el colegio de arquitectos de Madrid sería en mi opinión una buena solución para intentar relanzar un proyecto más realista.</p>
";"30/09/2016 13";"68";"50";"18";"2";"4746559616";"2352"
"4754";"Que baje el precio del abono transporte para todos";"<p>No solamente los jóvenes y los jubilados viajan en transporte público, si quieren liberar la ciudad de atascos...bajen el bono transporte para todos.</p>
";"02/10/2016 14";"160";"142";"18";"2";"4774476836";"11005"
"4755";"MÁS O MENOS";"Este es uno de los proyectos presentados para la Remodelación de Plaza España, puedes participar en el proceso y votar el que más te guste en http://decide.madrid.es/proceso/plaza-espana";"03/10/2016 22";"0";"0";"0";"2";"4769341717";"1"
"4756";"PARKIN";"Este es uno de los proyectos presentados para la Remodelación de Plaza España, puedes participar en el proceso y votar el que más te guste en http://decide.madrid.es/proceso/plaza-espana";"03/10/2016 22";"0";"0";"0";"3";"4769341728";"1"
"4757";"Mi rincón favorito de Madrid";"Este es uno de los proyectos presentados para la Remodelación de Plaza España, puedes participar en el proceso y votar el que más te guste en http://decide.madrid.es/proceso/plaza-espana";"03/10/2016 22";"0";"0";"0";"1";"4769341731";"1"
"4758";"Espacio España";"Este es uno de los proyectos presentados para la Remodelación de Plaza España, puedes participar en el proceso y votar el que más te guste en http://decide.madrid.es/proceso/plaza-espana";"03/10/2016 22";"0";"0";"0";"7";"4770803015";"1"
"4759";"La pluma es la lengua del alma";"Este es uno de los proyectos presentados para la Remodelación de Plaza España, puedes participar en el proceso y votar el que más te guste en http://decide.madrid.es/proceso/plaza-espana";"03/10/2016 22";"0";"0";"0";"6";"4770133550";"1"
"4760";"CONECTOR URBANO PLAZA ESPAÑA";"Este es uno de los proyectos presentados para la Remodelación de Plaza España, puedes participar en el proceso y votar el que más te guste en http://decide.madrid.es/proceso/plaza-espana";"03/10/2016 22";"0";"0";"0";"1";"4769341741";"1"
"4761";"117....142";"Este es uno de los proyectos presentados para la Remodelación de Plaza España, puedes participar en el proceso y votar el que más te guste en http://decide.madrid.es/proceso/plaza-espana";"03/10/2016 22";"0";"0";"0";"9";"4771894470";"1"
"4762";"Baile a orillas del Manzanares";"Este es uno de los proyectos presentados para la Remodelación de Plaza España, puedes participar en el proceso y votar el que más te guste en http://decide.madrid.es/proceso/plaza-espana";"03/10/2016 22";"0";"0";"0";"5";"4769341748";"1"
"4763";"Sentiré su frescor en mis plantas";"Este es uno de los proyectos presentados para la Remodelación de Plaza España, puedes participar en el proceso y votar el que más te guste en http://decide.madrid.es/proceso/plaza-espana";"03/10/2016 22";"0";"0";"0";"7";"4770803032";"1"
"4764";"UN PASEO POR LA CORNISA";"Este es uno de los proyectos presentados para la Remodelación de Plaza España, puedes participar en el proceso y votar el que más te guste en http://decide.madrid.es/proceso/plaza-espana";"03/10/2016 22";"0";"0";"0";"1";"4769341757";"1"
"4765";"QUIERO ACORDARME";"Este es uno de los proyectos presentados para la Remodelación de Plaza España, puedes participar en el proceso y votar el que más te guste en http://decide.madrid.es/proceso/plaza-espana";"03/10/2016 22";"0";"0";"0";"3";"4769341760";"1"
"4766";"MADRID AIRE";"Este es uno de los proyectos presentados para la Remodelación de Plaza España, puedes participar en el proceso y votar el que más te guste en http://decide.madrid.es/proceso/plaza-espana";"03/10/2016 22";"0";"0";"0";"0";"4769341763";"1"
"4767";"Descubriendo Plaza de España";"Este es uno de los proyectos presentados para la Remodelación de Plaza España, puedes participar en el proceso y votar el que más te guste en http://decide.madrid.es/proceso/plaza-espana";"03/10/2016 22";"0";"0";"0";"0";"4769341766";"1"
"4768";"DirdamMadrid";"Este es uno de los proyectos presentados para la Remodelación de Plaza España, puedes participar en el proceso y votar el que más te guste en http://decide.madrid.es/proceso/plaza-espana";"03/10/2016 22";"0";"0";"0";"2";"4769341770";"1"
"4769";"Alla donde se cruzan los caminos";"Este es uno de los proyectos presentados para la Remodelación de Plaza España, puedes participar en el proceso y votar el que más te guste en http://decide.madrid.es/proceso/plaza-espana";"03/10/2016 22";"0";"0";"0";"3";"4769341773";"1"
"4770";"NADA CORRE PEDALEA";"Este es uno de los proyectos presentados para la Remodelación de Plaza España, puedes participar en el proceso y votar el que más te guste en http://decide.madrid.es/proceso/plaza-espana";"03/10/2016 22";"0";"0";"0";"2";"4769341776";"1"
"4771";"El sueño de Cervantes";"Este es uno de los proyectos presentados para la Remodelación de Plaza España, puedes participar en el proceso y votar el que más te guste en http://decide.madrid.es/proceso/plaza-espana";"03/10/2016 22";"0";"0";"0";"6";"4770133592";"1"
"4772";"ESplaza";"Este es uno de los proyectos presentados para la Remodelación de Plaza España, puedes participar en el proceso y votar el que más te guste en http://decide.madrid.es/proceso/plaza-espana";"03/10/2016 22";"0";"0";"0";"1";"4769341782";"1"
"4773";"En un lugar de Madrid";"Este es uno de los proyectos presentados para la Remodelación de Plaza España, puedes participar en el proceso y votar el que más te guste en http://decide.madrid.es/proceso/plaza-espana";"03/10/2016 22";"0";"0";"0";"4";"4769341785";"1"
"4774";"CodigoAbierto";"Este es uno de los proyectos presentados para la Remodelación de Plaza España, puedes participar en el proceso y votar el que más te guste en http://decide.madrid.es/proceso/plaza-espana";"03/10/2016 22";"0";"0";"0";"0";"4769341788";"1"
"4775";"CampoCampo";"Este es uno de los proyectos presentados para la Remodelación de Plaza España, puedes participar en el proceso y votar el que más te guste en http://decide.madrid.es/proceso/plaza-espana";"03/10/2016 22";"0";"0";"0";"0";"4769341791";"1"
"4776";"El diablo cojuelo";"Este es uno de los proyectos presentados para la Remodelación de Plaza España, puedes participar en el proceso y votar el que más te guste en http://decide.madrid.es/proceso/plaza-espana";"03/10/2016 22";"0";"0";"0";"0";"4769341795";"1"
"4777";"Metamorfosis del girasol";"Este es uno de los proyectos presentados para la Remodelación de Plaza España, puedes participar en el proceso y votar el que más te guste en http://decide.madrid.es/proceso/plaza-espana";"03/10/2016 22";"0";"0";"0";"3";"4769341798";"1"
"4778";"De este a oeste";"Este es uno de los proyectos presentados para la Remodelación de Plaza España, puedes participar en el proceso y votar el que más te guste en http://decide.madrid.es/proceso/plaza-espana";"03/10/2016 22";"0";"0";"0";"11";"4772766029";"1"
"4779";"Corredor ecologico";"Este es uno de los proyectos presentados para la Remodelación de Plaza España, puedes participar en el proceso y votar el que más te guste en http://decide.madrid.es/proceso/plaza-espana";"03/10/2016 22";"0";"0";"0";"0";"4769341805";"1"
"4780";"Welcome mother Nature, good bye Mr Ford";"Este es uno de los proyectos presentados para la Remodelación de Plaza España, puedes participar en el proceso y votar el que más te guste en http://decide.madrid.es/proceso/plaza-espana";"03/10/2016 22";"0";"0";"0";"5";"4769341809";"1"
"4781";"PLAZA DE ESPAÑA 2017";"Este es uno de los proyectos presentados para la Remodelación de Plaza España, puedes participar en el proceso y votar el que más te guste en http://decide.madrid.es/proceso/plaza-espana";"03/10/2016 22";"0";"0";"0";"0";"4769341812";"1"
"4782";"Ñ-AGORA";"Este es uno de los proyectos presentados para la Remodelación de Plaza España, puedes participar en el proceso y votar el que más te guste en http://decide.madrid.es/proceso/plaza-espana";"03/10/2016 22";"0";"0";"0";"1";"4769341815";"1"
"4783";"OASIS24H";"Este es uno de los proyectos presentados para la Remodelación de Plaza España, puedes participar en el proceso y votar el que más te guste en http://decide.madrid.es/proceso/plaza-espana";"03/10/2016 22";"0";"0";"0";"1";"4769341819";"1"
"4784";"Madrid wild";"Este es uno de los proyectos presentados para la Remodelación de Plaza España, puedes participar en el proceso y votar el que más te guste en http://decide.madrid.es/proceso/plaza-espana";"03/10/2016 22";"0";"0";"0";"0";"4769341822";"1"
"4785";"PlazaSdeespaña";"Este es uno de los proyectos presentados para la Remodelación de Plaza España, puedes participar en el proceso y votar el que más te guste en http://decide.madrid.es/proceso/plaza-espana";"03/10/2016 22";"0";"0";"0";"1";"4769341825";"1"
"4786";"Dentro";"Este es uno de los proyectos presentados para la Remodelación de Plaza España, puedes participar en el proceso y votar el que más te guste en http://decide.madrid.es/proceso/plaza-espana";"03/10/2016 22";"0";"0";"0";"6";"4770133640";"1"
"4787";"CON MESURA";"Este es uno de los proyectos presentados para la Remodelación de Plaza España, puedes participar en el proceso y votar el que más te guste en http://decide.madrid.es/proceso/plaza-espana";"03/10/2016 22";"0";"0";"0";"2";"4769341831";"1"
"4788";"EN BUSCA DE DULCINEA";"Este es uno de los proyectos presentados para la Remodelación de Plaza España, puedes participar en el proceso y votar el que más te guste en http://decide.madrid.es/proceso/plaza-espana";"03/10/2016 22";"0";"0";"0";"1";"4769341835";"1"
"4789";"Luces de Bohemia - Madrid Cornisa";"Este es uno de los proyectos presentados para la Remodelación de Plaza España, puedes participar en el proceso y votar el que más te guste en http://decide.madrid.es/proceso/plaza-espana";"03/10/2016 22";"0";"0";"0";"4";"4769341838";"1"
"4790";"De una plaza concéntrica a un caleidoscopio de oportunidades";"Este es uno de los proyectos presentados para la Remodelación de Plaza España, puedes participar en el proceso y votar el que más te guste en http://decide.madrid.es/proceso/plaza-espana";"03/10/2016 22";"0";"0";"0";"1";"4769341842";"1"
"4791";"Cambio de Onda";"Este es uno de los proyectos presentados para la Remodelación de Plaza España, puedes participar en el proceso y votar el que más te guste en http://decide.madrid.es/proceso/plaza-espana";"03/10/2016 22";"0";"0";"0";"0";"4769341845";"1"
"4792";"La respuesta está en el 58";"Este es uno de los proyectos presentados para la Remodelación de Plaza España, puedes participar en el proceso y votar el que más te guste en http://decide.madrid.es/proceso/plaza-espana";"03/10/2016 22";"0";"0";"0";"4";"4769341848";"1"
"4793";"En un lugar de la cornisa";"Este es uno de los proyectos presentados para la Remodelación de Plaza España, puedes participar en el proceso y votar el que más te guste en http://decide.madrid.es/proceso/plaza-espana";"03/10/2016 22";"0";"0";"0";"3";"4769341853";"1"
"4794";"Continuidad de los parques";"Este es uno de los proyectos presentados para la Remodelación de Plaza España, puedes participar en el proceso y votar el que más te guste en http://decide.madrid.es/proceso/plaza-espana";"03/10/2016 22";"0";"0";"0";"2";"4769341856";"1"
"4795";"Vamos de ronda";"Este es uno de los proyectos presentados para la Remodelación de Plaza España, puedes participar en el proceso y votar el que más te guste en http://decide.madrid.es/proceso/plaza-espana";"03/10/2016 22";"0";"0";"0";"0";"4769341859";"1"
"4796";"MADRID EM-PLAZA";"Este es uno de los proyectos presentados para la Remodelación de Plaza España, puedes participar en el proceso y votar el que más te guste en http://decide.madrid.es/proceso/plaza-espana";"03/10/2016 22";"0";"0";"0";"1";"4769341862";"1"
"4797";"230306";"Este es uno de los proyectos presentados para la Remodelación de Plaza España, puedes participar en el proceso y votar el que más te guste en http://decide.madrid.es/proceso/plaza-espana";"03/10/2016 22";"0";"0";"0";"14";"4773813445";"1"
"4798";"Redibujando la plaza";"Este es uno de los proyectos presentados para la Remodelación de Plaza España, puedes participar en el proceso y votar el que más te guste en http://decide.madrid.es/proceso/plaza-espana";"03/10/2016 22";"0";"0";"0";"1";"4769341868";"1"
"4799";"TOPOFILIA";"Este es uno de los proyectos presentados para la Remodelación de Plaza España, puedes participar en el proceso y votar el que más te guste en http://decide.madrid.es/proceso/plaza-espana";"03/10/2016 22";"0";"0";"0";"2";"4769341871";"1"
"4800";"Imprescindible, necesario, deseable";"Este es uno de los proyectos presentados para la Remodelación de Plaza España, puedes participar en el proceso y votar el que más te guste en http://decide.madrid.es/proceso/plaza-espana";"03/10/2016 22";"0";"0";"0";"8";"4771383074";"1"
"4801";"3 plazas, 2 paseos, 1 gran parque";"Este es uno de los proyectos presentados para la Remodelación de Plaza España, puedes participar en el proceso y votar el que más te guste en http://decide.madrid.es/proceso/plaza-espana";"03/10/2016 22";"0";"0";"0";"0";"4769341877";"1"
"4802";"Oz  ";"Este es uno de los proyectos presentados para la Remodelación de Plaza España, puedes participar en el proceso y votar el que más te guste en http://decide.madrid.es/proceso/plaza-espana";"03/10/2016 22";"0";"0";"0";"1";"4769341880";"1"
"4803";"ENCUENTRO";"Este es uno de los proyectos presentados para la Remodelación de Plaza España, puedes participar en el proceso y votar el que más te guste en http://decide.madrid.es/proceso/plaza-espana";"03/10/2016 22";"0";"0";"0";"2";"4769341883";"1"
"4804";"Generando fluorescencia con molinos ";"Este es uno de los proyectos presentados para la Remodelación de Plaza España, puedes participar en el proceso y votar el que más te guste en http://decide.madrid.es/proceso/plaza-espana";"03/10/2016 22";"0";"0";"0";"4";"4769341886";"1"
"4805";"UN REFLEJO DE LA ESPAÑA RURAL";"Este es uno de los proyectos presentados para la Remodelación de Plaza España, puedes participar en el proceso y votar el que más te guste en http://decide.madrid.es/proceso/plaza-espana";"03/10/2016 22";"0";"0";"0";"4";"4769341889";"1"
"4806";"SuperSuperficie TermosSocial";"Este es uno de los proyectos presentados para la Remodelación de Plaza España, puedes participar en el proceso y votar el que más te guste en http://decide.madrid.es/proceso/plaza-espana";"03/10/2016 22";"0";"0";"0";"0";"4769341892";"1"
"4807";"DESCUBRE MADRID";"Este es uno de los proyectos presentados para la Remodelación de Plaza España, puedes participar en el proceso y votar el que más te guste en http://decide.madrid.es/proceso/plaza-espana";"03/10/2016 22";"0";"0";"0";"1";"4769341895";"1"
"4808";"VERDECOMÚN";"Este es uno de los proyectos presentados para la Remodelación de Plaza España, puedes participar en el proceso y votar el que más te guste en http://decide.madrid.es/proceso/plaza-espana";"03/10/2016 22";"0";"0";"0";"0";"4769341899";"1"
"4809";"Ecotono urbano";"Este es uno de los proyectos presentados para la Remodelación de Plaza España, puedes participar en el proceso y votar el que más te guste en http://decide.madrid.es/proceso/plaza-espana";"03/10/2016 22";"0";"0";"0";"1";"4769341902";"1"
"4810";"LA PIEL QUE HABITO";"Este es uno de los proyectos presentados para la Remodelación de Plaza España, puedes participar en el proceso y votar el que más te guste en http://decide.madrid.es/proceso/plaza-espana";"03/10/2016 22";"0";"0";"0";"1";"4769341905";"1"
"4811";"Entreplazas.Plaza España";"Este es uno de los proyectos presentados para la Remodelación de Plaza España, puedes participar en el proceso y votar el que más te guste en http://decide.madrid.es/proceso/plaza-espana";"03/10/2016 22";"0";"0";"0";"3";"4769341908";"1"
"4812";"Abracadabra";"Este es uno de los proyectos presentados para la Remodelación de Plaza España, puedes participar en el proceso y votar el que más te guste en http://decide.madrid.es/proceso/plaza-espana";"03/10/2016 22";"0";"0";"0";"2";"4769341911";"1"
"4813";"Pradera urbana";"Este es uno de los proyectos presentados para la Remodelación de Plaza España, puedes participar en el proceso y votar el que más te guste en http://decide.madrid.es/proceso/plaza-espana";"03/10/2016 22";"0";"0";"0";"8";"4771383114";"1"
"4814";"Archipielago";"Este es uno de los proyectos presentados para la Remodelación de Plaza España, puedes participar en el proceso y votar el que más te guste en http://decide.madrid.es/proceso/plaza-espana";"03/10/2016 22";"0";"0";"0";"4";"4769341918";"1"
"4815";"Flow";"Este es uno de los proyectos presentados para la Remodelación de Plaza España, puedes participar en el proceso y votar el que más te guste en http://decide.madrid.es/proceso/plaza-espana";"03/10/2016 22";"0";"0";"0";"7";"4770803202";"1"
"4816";"EN UN LUGAR DE MADRID";"Este es uno de los proyectos presentados para la Remodelación de Plaza España, puedes participar en el proceso y votar el que más te guste en http://decide.madrid.es/proceso/plaza-espana";"03/10/2016 22";"0";"0";"0";"1";"4769341925";"1"
"4817";"1968 diluir los límites, evitar las discontinuidades y más verde";"Este es uno de los proyectos presentados para la Remodelación de Plaza España, puedes participar en el proceso y votar el que más te guste en http://decide.madrid.es/proceso/plaza-espana";"03/10/2016 22";"0";"0";"0";"1";"4769341928";"1"
"4818";"MejorANDO x Pza España";"Este es uno de los proyectos presentados para la Remodelación de Plaza España, puedes participar en el proceso y votar el que más te guste en http://decide.madrid.es/proceso/plaza-espana";"03/10/2016 22";"0";"0";"0";"10";"4772352231";"1"
"4819";"RE-VERDE CON CAUSA";"Este es uno de los proyectos presentados para la Remodelación de Plaza España, puedes participar en el proceso y votar el que más te guste en http://decide.madrid.es/proceso/plaza-espana";"03/10/2016 22";"0";"0";"0";"3";"4769341934";"1"
"4820";"ECO2Madrid";"Este es uno de los proyectos presentados para la Remodelación de Plaza España, puedes participar en el proceso y votar el que más te guste en http://decide.madrid.es/proceso/plaza-espana";"03/10/2016 22";"0";"0";"0";"1";"4769341938";"1"
"4821";"THE LONG LINE";"Este es uno de los proyectos presentados para la Remodelación de Plaza España, puedes participar en el proceso y votar el que más te guste en http://decide.madrid.es/proceso/plaza-espana";"03/10/2016 22";"0";"0";"0";"9";"4771894666";"1"
"4822";"El ojo de Horus";"Este es uno de los proyectos presentados para la Remodelación de Plaza España, puedes participar en el proceso y votar el que más te guste en http://decide.madrid.es/proceso/plaza-espana";"03/10/2016 22";"0";"0";"0";"6";"4770133756";"1"
"4823";"ME VA MADRID";"Este es uno de los proyectos presentados para la Remodelación de Plaza España, puedes participar en el proceso y votar el que más te guste en http://decide.madrid.es/proceso/plaza-espana";"03/10/2016 22";"0";"0";"0";"0";"4769341947";"1"
"4824";"THE FOOL ON THE HILL";"Este es uno de los proyectos presentados para la Remodelación de Plaza España, puedes participar en el proceso y votar el que más te guste en http://decide.madrid.es/proceso/plaza-espana";"03/10/2016 22";"0";"0";"0";"9";"4771894675";"1"
"4826";"Cielo y agua";"Este es uno de los proyectos presentados para la Remodelación de Plaza España, puedes participar en el proceso y votar el que más te guste en http://decide.madrid.es/proceso/plaza-espana";"06/10/2016 12";"0";"0";"0";"1";"4795048508";"1"
"4827";"El paseo de la cornisa";"Este es uno de los proyectos presentados para la Remodelación de Plaza España, puedes participar en el proceso y votar el que más te guste en http://decide.madrid.es/proceso/plaza-espana";"06/10/2016 12";"0";"0";"0";"0";"4795048517";"1"
"4829";"Zona para perros en zona Centro";"<p>Vivo en la zona de Callao y me gustaía que ahora que se tiene pensado remodelar Plaza España, el Ayuntamiento considere el habilitar un espacio para los perretes, no para que se caguen y el dueño no lo recoja, me refiero para que jueguen. Cada vez hay más gente que tiene perro y tenemos derecho a tener una zona habilitada para ellos.</p>
";"07/10/2016 17";"62";"35";"27";"11";"4813028556";"451"
"4830";"Supuesto boicot a Bicimad";"<p>Soy usuaria de Bicimad desde Junio 2005. Desde entonces, mi relación con la ciudad de Madrid ha mejorado en un 500% porque en un momento puedo desplazarme a mi destino, con la enorme satisfacción de que no sólo me estoy haciendo bien a mí haciendo ejercicio, sino también reduciendo contaminación.</p>

<p>Desde hace una semana he observado un número alto de bicis de Bicimad abandonadas, las estaciones de cerca del Retiro han sido absolutamente vandalizadas y las bicicletas dañadas visiblemente, y las terminales no funcionan. En seguida me ha parecido un boicot salvaje. </p>

<p>Un amigo me ha comentado que quizá pueda ser porque el Ayuntamiento de Madrid se ha hecho cargo del servicio y ya no lo lleva la empresa que lo llevaba antes.</p>

<p>Si es cierto, propondría que el Ayuntamiento de Madrid redactara una nota de prensa para que los usuarios sepamos que sabe que se están vandalizando estaciones y bicicletas y que se reestablecerá un servicio normal lo antes posible. También puede informarnos a través de los correos electrónicos.</p>

<p>Nunca antes he estado tan orgullosa de mi ciudad. Vamos a hacer todo lo posible por rescatar Bicimad y que los vándalos que quieren boicotear ese servicio no triunfen. Este Madrid es responsabilidad de todos. Vamos a cuidarlo.</p>

<p>Gracias por leer.</p>
";"08/10/2016 21";"30";"17";"13";"2";"4822700026";"226"
"4831";"¿participación ciudadana?";"<p>¿A esto se le considera participación ciudadana?.</p>

<p>Si el Ayuntamiento de Madrid quiere realmente que participemos, que copie los modelos de los paises nórdicos o Suiza.</p>

<p>Esto solo tiene de participativo el nombre.</p>

<p> </p>
";"09/10/2016 19";"49";"37";"12";"15";"4839424936";"1887"
"4834";"¿Estan boicoteando a la emisora de radio del Ayuntamiento del 88.6 de FM?";"<p>posible boicot a la emisora de radio del Ayuntamiento</p>
";"10/10/2016 11";"27";"4";"23";"4";"4832615692";"-281"
"4839";"Sobre los procesos participativos";"<p>Hola a tod@s,</p>

<p>Sobre el proceso votaciones para la remodelación de la Plaza de España, en mi opinión es un error someter a votación tantísimas propuestas. Uno se siente abrumado e incapaz de valorarlas todas seriamente. Por no hablar que, aparte del aspecto visual, imagino que habrá otras muchas cosas a considerar de las que no somos conscientes los que no sabemos de urbanismo.</p>

<p>Por ello quería proponer que este tipo de votaciones pasen primero una criba mucho mayor por parte de expertos en urbanismo del Ayuntamiento, y que se voten entre la ciudadanía una cantidad mucho menor, no sé si 3, 5 ó 10. pero desde luego no todas las que hay ahora.</p>

<p>Creo seriamente que tantas opciones es una barrera para muchos, que limita la participación y la valoración seria de cada propuesta.</p>

<p>Saludos,</p>

<p>Miguel</p>
";"14/10/2016 14";"52";"47";"5";"8";"4891078547";"3796"
"4840";"Reducción de impuestos a las empresas familiares.";"<p>Hola a todos, soy nuevo aqui y es mi primera propuesta. Que creo que es muy importante ya que es la que genera la mayoria de trabajo en nuestra ciudad.</p>

<p>Mi propuesta consiste en reduccion de impuestos para empresas familiares, las llamadas PYMES.</p>

<p>Esta demostrado que la bonificacion (a la contratacion indefinida/temporal, a creación de nuevas empresas....) no da resultado,  a consecuencia que es un periodo de tiempo,  se acaba y la contratacion de los trabajadores no la puedes mantener por tanto tienes que despedirlos.</p>

<p>Hay muchos modelos de impuestos sin tener que modificar toda la estructura y fomentar que las pequeñas empresas se hagan grandes.</p>
";"14/10/2016 19";"66";"50";"16";"0";"4889711821";"2575"
"4841";"Remodelación proyectos Plaza de España";"<p>Me parece una locura enviar a los ciudadanos 70 diseños para que den su opinión al respecto. Vivimos en una democracia representativa y no asamblearia. Revisar 72 diseños supongo que tienen la posibilidad de dar entretenimiento a la enorme cantidad de parados que, lamentablemente, tenemos pero sigue siendo algo no viable desde el punto de vista normal. Así, a base de preguntar, gobierno yo que no soy político. Además, hay otras muchas actuaciones, más transcendentes de las que no se nos consulta nada. Incomprensible la pregunta</p>
";"17/10/2016 10";"130";"103";"27";"68";"4920192773";"6021"
"4843";"Mayores en actividad.";"<p>Hay un colectivo de mayores que como yo han trabajado toda su vida y que se encuentran en perfectas condiciones fisicas. Pues bien.Como se ve Madrid está     llena de baches,aceras rotas, suciedad, árboles que se caen o no exiten, obras que se ejecutan y no retiran los desechos.Si las empresas que llevan todos estos temas no hacen caso. Pues. SªCarmena aprobeche este pontecial.Seguro que hay algunas de estas personas que con una pequeña remuneración le harian a usted un infome diario del estado de su distrito. Remuneración que usted podria cargar a la cuenta de estas concesionarias. Ahí lo dejo.</p>
";"20/10/2016 13";"41";"33";"8";"5";"4947026819";"2012"
"4845";"¿Continua el PP gobernando en Madrid?";"<p>Ha pasado más  de un año desde que Dña. Manuela Carmena gobierna el Ayuntamiento, pero en lo que se refiere a la limpieza de los barrios populares continua el mismo desastre, no sé  cuál será el motivo, pero invito a la señora alcaldesa a darse un paseo, sin avisar, por Usera,  Moratalaz, San Blas.....observo carteles  de concienciación para no ensuciar nuestra ciudad, la mayoría en el Barrio de Salamanca, por cierto. Nuestra ciudad tiene que estar limpia y que los ciudadanos estén orgullosos de ella, de tal modo que el marrano que la ensucie sea aseada su conducta por todos los ciudadanos. Pero lo siento, y me decepciona porque tenía muchas esperanzas en este ayuntamiento de progreso Madrid está asqueroso de sucio. Lo mismo ocurre con la recogida de basuras se hacen a horas inexplicables, cuando se hace,  porque los contenedores, además de estar sucísimos, están desbordados. Nos esforzamos en reciclar los ciudadanos  y luego está por el suelo porque en  los contenedores ya no cabe y no los recogen.</p>

<p>Otro tema es el transporte público no pueden pretender que no se coja el vehículo  privado cuando llegas a una parada de autobús  e indica que el próximo llegará  con más de 18 o 20 minutos, luego van dos juntos, y , lo siento señores no es por el tráfico, porque da igual que sea en hora punta. Pasa lo mismo en el metro, frecuencias en hora punta de 7 u 8 minutos es una vergüenza. Somos trabajadores, cuyo tiempo parece no valer nada. Además de ser muy caro, una familia que viva en Usera o Vallecas o La Elipa  etc., de cuatro miembros que quieran ir al Retiro (que digo yo que tienen derecho a disfrutar de él ) les cuesta más de 9,60 euros, eso en este país de sueldos miserables es una vergüenza .  Mucha decepción siento, muchas ilusiones rotas, los que vivimos en barrios humildes seguimos abandonados. En mi día a día no ha acabado el gobierno del PP en el ayuntamiento  de Madrid, quizás otros tengan otra percepción, pero yo sólo siento tristeza porque estamos abocados a un desastre de los gobiernos progresistas municipales, al menos en Madrid.</p>
";"22/10/2016 10";"60";"39";"21";"26";"4963656888";"1170"
"4847";"Pregunta 1 sobre la nueva ordenanza de licencias de obras y apertura de locales";"<p><strong>¿Considera necesario realizar una nueva regulación para facilitar y simplificar las obras en viviendas, o la modificación y apertura de locales comerciales o empresariales?</strong></p><p>Este debate pertenece a la Consulta previa sobre la regulación de la concesión de licencias urbanísticas para la realización de obras y la apertura de locales comerciales o empresariales.</p><p>Más información en https://decide.madrid.es/proceso/licencias-urbanisticas</p>";"25/10/2016 08";"564";"506";"58";"161";"5007684745";"40192"
"4848";"Pregunta 2 sobre la nueva ordenanza de licencias de obras y apertura de locales";"<p><strong>¿Está de acuerdo en ampliar el número de actuaciones que pueden tramitarse mediante declaración responsable y comunicación previa, y limitar así la exigencia de licencia urbanística?</strong></p><p>Este debate pertenece a la Consulta previa sobre la regulación de la concesión de licencias urbanísticas para la realización de obras y la apertura de locales comerciales o empresariales.</p><p>Más información en https://decide.madrid.es/proceso/licencias-urbanisticas</p>";"25/10/2016 08";"372";"222";"150";"73";"4995344257";"4296"
"4849";"Pregunta 3 sobre la nueva ordenanza de licencias de obras y apertura de locales";"<p><strong>¿En el ámbito de las autorizaciones urbanísticas, es partidario de que se modifique el papel que juegan las empresas privadas acreditadas (ECU) para que también puedan facilitar las gestiones en las obras que realicen los particulares en sus viviendas u otras actuaciones similares?</strong></p><p>Este debate pertenece a la Consulta previa sobre la regulación de la concesión de licencias urbanísticas para la realización de obras y la apertura de locales comerciales o empresariales.</p><p>Más información en https://decide.madrid.es/proceso/licencias-urbanisticas</p>";"25/10/2016 08";"527";"399";"128";"141";"5002542966";"20517"
"4850";"Pregunta 4 sobre la nueva ordenanza de licencias de obras y apertura de locales";"<p><strong>¿Estaría dispuesto a tramitar de forma electrónica todas sus solicitudes de licencias, declaraciones responsables y comunicaciones previas?</strong></p><p>Este debate pertenece a la Consulta previa sobre la regulación de la concesión de licencias urbanísticas para la realización de obras y la apertura de locales comerciales o empresariales.</p><p>Más información en https://decide.madrid.es/proceso/licencias-urbanisticas</p>";"25/10/2016 08";"519";"485";"34";"76";"5008482131";"42145"
"4851";"Pregunta 5 sobre la nueva ordenanza de licencias de obras y apertura de locales";"<p><strong>¿Qué medidas podría adoptar el Ayuntamiento de Madrid para facilitar y agilizar la autorización para la  realización de obras y la apertura de locales comerciales o empresariales?</strong></p><p>Este debate pertenece a la Consulta previa sobre la regulación de la concesión de licencias urbanísticas para la realización de obras y la apertura de locales comerciales o empresariales.</p><p>Más información en https://decide.madrid.es/proceso/licencias-urbanisticas</p>";"25/10/2016 08";"165";"145";"20";"110";"5002854143";"10984"
"4852";"Opinión ciudadana en el concurso Plaza España";"<p>El Ayuntamiento propone la participación ciudadana en la definición de las actuaciones para la reforma de la Plaza de España (https://decide.madrid.es/debates/4416-reforma-de-la-plaza-de-espana.) y se confecciona un pliego de condiciones en el que se presentan como VINCULANTES varios puntos sacados de la opinión de los ciudadanos.</p>

<p>Cuando se presentan los proyectos participantes para que podamos votar al que queramos, vemos con estupor cómo muchos proyectos INCUMPLEN claramente el pliego de condiciones en lo que respecta a varios de los puntos decididos por los ciudadanos.</p>

<p>¿Por qué, a dos días de la finalización del período del voto ciudadano, se puede seguir votando a esos proyectos? ¿Por qué no se ha actuado al respecto con suficiente antelación a la finalización del período de votación? ¿Qué ocurre con los votos de quienes hayan votado a propuestas que puedan ser apartadas con posterioridad?</p>
";"26/10/2016 14";"74";"64";"10";"15";"5011304293";"4670"
"4854";"vigilancia policial en los barrios con el fin de acabar con la delincuencia.";"<p>Fomentar aun mas la igilancia policial en los barrios con el fin de acabar con la delincuencia de hurtos, robos, posesion de armas, drogas y terrorismo. Todos queremos una sociedad mejor.</p>
";"27/10/2016 13";"94";"90";"4";"0";"5024333808";"8234"
"4857";"¿De quien depende Madrid Salud?";"<p>Alguien me puede aclarar de quien depende Madrid Salud. ¿Del Ayuntamiento? ¿De la Autonomía de Madrid? ¿Del gobierno central?</p>

<p>¿el gerente de madrid es un cargo político o administrativo? ¿A quien tiene por encima dicho gerente?</p>

<p>¿quien lo colocó En el cargo?</p>

<p>son unas cuantas preguntas que os lanzo. Si podéis aportar enlace para complementar vuestro aporte mejor.</p>
";"28/10/2016 18";"15";"12";"3";"4";"5025728649";"720"
"4859";"Gestión Municipal";"<p>Igual que el programa municipal ""Decide Madrid"" que promueve la participación ciudadana y la transparencia, debería crearse el programa ""Soluciona Madrid"" que promueva la buena gestión municipal.</p>

<p>Si algo es el Ayuntamiento es un Órgano gestor, por tanto es básico que responda de su gestión.</p>

<p>Los ciudadanos además de participar democráticamente, también queremos que el Ayuntamiento sea eficiente en los servicios, queremos por ejemplo que cuando llamemos al 010 u otro teléfono municipal no nos tengan esperando un rato para luego no informar de nada, que cuando solicitemos algo nos lo resuelvan rápido, que cuando avisamos de un desperfecto en la vía pública se arregle rápido, que las calles estén limpias, etc.</p>

<p>Igual que el Ayuntamiento multa y sanciona a los ciudadanos, el ciudadano debería ser indemnizado de oficio por el Ayuntamiento cuando éste no cumpla con su obligación en un tiempo razonable.</p>
";"01/11/2016 21";"33";"28";"5";"0";"5070985365";"1951"
"4860";"Ayuntamiento incompetente en temas contaminacion";"<p>El actual Ayuntamiento ganó unas elecciones prometiendo, si recuerdo bien, que iba a mejorar (como mínimo) la contaminación en Madrid.

A principios del verano del 2015 hubo un episodio de alta contaminación y mucho decir que si iban a prohibir la circulación por números pares/impares pero no hicieron nada y los madrileños ""nos tragamos"" (y algunos murieron gracias a ella) dicha contaminación.

Desde entonces hemos seguido sufriendo una contaminación relativamente alta pero nada se ha hecho para impedir la entrada de los coches en la ciudad de Madrid. 

Ni siquiera se ha empezado a construir algo tan obvio como algún parking disuasorio ni se ha aumentado el precio del aparcamiento en la calle ni se han restringido las zonas de aparcamiento en la calle para no-residentes fuera de una zona muy pequeñita en los alrededores de la Puerta del Sol o algo así.

Aún menos se ha hecho una campaña de concienciación de los no-residentes sobre la necesidad de que hagan algo tan solidario y elemental como es el entrar por transporte público en la ciudad, como así hacen la mayoría de los ciudadanos de la Unión Europea. La mejora/aumento de los carriles para bicicletas ha sido mínima.  

La mejora/aumento de los carriles para autobuses/taxis ha sido mínima.  La mejora del transporte público (autobuses) en la ciudad tanto en cantidad como en calidad (autobuses eléctricos, por ejemplo, u autobuses no-contaminantes) también ha sido mínima.

Ni siquiera se han instalado paneles informativos en las paradas de autobuses sobre el tiempo de espera de los autobuses.   Paneles que existen en otras ciudades de Europa en todas las paradas.   Pero aquí, donde los mayores, digamos, de 40 años utilizamos poco o mal nuestros móviles, pretendemos que tenemos una población experta en nuevas técnicas y que no tenemos más que averiguar la información usando nuestros móviles.   El turista que se fastidie y nosotros, si nos hemos dejado el móvil en casa pues que nos fastidiemos también.

Eso sí :  el Ayuntamiento nos ha declarado en varias ocasiones que están estudiando fórmulas para mejorar la contaminación.  Ha pasado un año y medio, pero por lo visto siguen estudiando.

Este verano ha habido nuevos episodios de contaminación pero siempre el resultado concreto ha sido que no se ha tomado ninguna medida.   Es que limitar la velocidad en las entradas de Madrid, cuando sabemos que una buena parte de los automovilistas no lo respeta y que las multas por ello finalmente no se cobran o no se ponen es en alguna medida ""tomarnos el pelo"" a los residentes en la ciudad.  

No puedo menos de preguntarme,  sin ánimo de ofender claro está,  si es que la intención de ganar,  eventualmente,  unas futuras elecciones a la presidencia de la Autonomía importan más que la salud de los residentes en la ciudad.  Como la gasolina está barata y no se ha hecho nada (o poquísimo que viene a ser lo mismo) por mejorar el transporte público  ""dentro""  de la ciudad ..   pues quizás los temas de salud que son individuales y por ello se notan poco (como mucho alguna reseña estadística de vez en cuando) tienen, insisto, poca o ninguna importancia.</p>

<p>Y hemos así llegado al actual episodio de alta contaminación de este puente de fin de octubre.

¿Y qué nos cuenta el Ayuntamiento?  Pues que una vez más no se hará nada: iban a impedir la circulación, dijeron.  Iban a impedir la circulación, repitieron.  Pero nada.   Una vez más, nada.  Eso sí, a los pobrecitos que se fueron de puente no se les va a molestar con una medida el día de su vuelta del puente.  Entretanto los que no nos fuimos de puente pues a seguir respirando y a seguir, por consiguiente, acelerando eventualmente la hora de nuestro fallecimiento (varios cientos o miles al año). 

Se va a activar el ""protocolo"", no se activa el ""protocolo"" :  a mi me espanta cada vez que oigo la palabra ""protocolo"".  Y cada vez que algún representante oficial la menciona suelo salir corriendo pues ya sé que no es más que un modo discreto de decir que no sólo no se resolverá el problema en cuestión sino que aún menos se utilizará un ápice de imaginación para intentar resolverlo.

Efectivamente, a la vista de lo que constatamos en la práctica, efectivamente tenemos un Ayuntamiento muy preocupado por el tema de la contaminación..  Tan ocupado que es evidente que el estado de salud y la eventualidad de muerte anticipada por contaminación de unos cuantos residentes en la ciudad importa poco.  Juzgo por los hechos.

Es que los intereses de los no-residentes en la ciudad aquellos que escogieron tener pisos/casas más amplios, piscinas, espacios al aire libre, etc.,  por la visto,  importan más al Ayuntamiento de la ciudad que los intereses  (para empezar nuestra salud y para continuar la importancia de vivir en una ciudad con un nivel de circulación razonable)  de nosotros, residentes, es decir, sus eventuales votantes (actuales y/o futuros).</p>

<p>Resumiendo :  salimos de un Ayuntamiento del PP y entramos en un Ayuntamiento de Ahora Madrid.  ¿Algún cambio?     Respuesta obvia:   ¡ninguno!</p>

<p> </p>
";"02/11/2016 04";"65";"41";"24";"27";"5071364467";"1072"
"4863";"Alianza para el Gobierno Abierto";"<p>El pasado mes de abril la Ciudad de Madrid fue seleccionada para formar parte del Programa piloto para gobiernos subnacionales de la Alianza para el Gobierno Abierto. Esta organización compuesta por gobiernos y sociedad civil, ayuda a que los gobiernos desarrollen medidas relevantes y específicas para avanzar en la participación y la transparencia, y certifica el cumplimiento de las mismas por medio de evaluadores independientes. En el contexto de este programa la Ciudad de Madrid debe plantear 5 compromisos para desarrollar el Gobierno Abierto durante el próximo año. Estos compromisos y su nivel de cumplimiento serán evaluados por la Alianza en 2018.</p><p>Participa hasta el <strong>20 de noviembre</strong> en https://decide.madrid.es/proceso/alianza-gobierno-abierto</p>";"04/11/2016 11";"45";"33";"12";"12";"5095575001";"1539"
"4865";"Pregunta 1 sobre la Ordenanza de subvenciones";"<p><strong>¿Considera necesario modificar la actual ordenanza general de subvenciones para simplificar y reducir cargas administrativas?</strong></p><p>Este debate pertenece a la consulta pública para modificar la regulación del sistema de subvenciones, simplificando la tramitación y reduciendo las cargas administrativas.</p><p>Más información en https://decide.madrid.es/proceso/ordenanza-subvenciones.</p><p><strong>Pregunta 2</strong></p><p>https://decide.madrid.es/debates/4866-pregunta-2-sobre-la-ordenanza-de-subvenciones</p><p><strong>Pregunta 3</strong></p><p>https://decide.madrid.es/debates/4867-pregunta-3-sobre-la-ordenanza-de-subvenciones</p><p><strong>Pregunta 4</strong></p><p>https://decide.madrid.es/debates/4868-pregunta-4-sobre-la-ordenanza-de-subvenciones</p><p><strong>Pregunta 5</strong></p><p>https://decide.madrid.es/debates/4869-pregunta-5-sobre-la-ordenanza-de-subvenciones</p><p><strong>Pregunta 6</strong></p><p>https://decide.madrid.es/debates/4870-pregunta-6-sobre-la-ordenanza-de-subvenciones</p>";"08/11/2016 08";"349";"296";"53";"50";"5144309294";"20609"
"4866";"Pregunta 2 sobre la Ordenanza de subvenciones";"<p><strong>¿Está de acuerdo con limitar la obligación de depositar garantías antes de recibir una subvención?</strong></p><p>Este debate pertenece a la consulta pública para modificar la regulación del sistema de subvenciones, simplificando la tramitación y reduciendo las cargas administrativas.</p><p>Más información en https://decide.madrid.es/proceso/ordenanza-subvenciones.</p><p><strong>Pregunta 1</strong></p><p>https://decide.madrid.es/debates/4865-pregunta-1-sobre-la-ordenanza-de-subvenciones</p><p><strong>Pregunta 3</strong></p><p>https://decide.madrid.es/debates/4867-pregunta-3-sobre-la-ordenanza-de-subvenciones</p><p><strong>Pregunta 4</strong></p><p>https://decide.madrid.es/debates/4868-pregunta-4-sobre-la-ordenanza-de-subvenciones</p><p><strong>Pregunta 5</strong></p><p>https://decide.madrid.es/debates/4869-pregunta-5-sobre-la-ordenanza-de-subvenciones</p><p><strong>Pregunta 6</strong></p><p>https://decide.madrid.es/debates/4870-pregunta-6-sobre-la-ordenanza-de-subvenciones</p>";"08/11/2016 08";"306";"230";"76";"27";"5140475395";"11575"
"4867";"Pregunta 3 sobre la Ordenanza de subvenciones";"<p><strong>¿Cree necesario, a la vista de la singularidad de la materia, introducir un régimen específico para las subvenciones de cooperación internacional al desarrollo y de acción humanitaria?</strong></p><p>Este debate pertenece a la consulta pública para modificar la regulación del sistema de subvenciones, simplificando la tramitación y reduciendo las cargas administrativas.</p><p>Más información en https://decide.madrid.es/proceso/ordenanza-subvenciones.</p><p><strong>Pregunta 1</strong></p><p>https://decide.madrid.es/debates/4865-pregunta-1-sobre-la-ordenanza-de-subvenciones</p><p><strong>Pregunta 2</strong></p><p>https://decide.madrid.es/debates/4866-pregunta-2-sobre-la-ordenanza-de-subvenciones</p><p><strong>Pregunta 4</strong></p><p>https://decide.madrid.es/debates/4868-pregunta-4-sobre-la-ordenanza-de-subvenciones</p><p><strong>Pregunta 5</strong></p><p>https://decide.madrid.es/debates/4869-pregunta-5-sobre-la-ordenanza-de-subvenciones</p><p><strong>Pregunta 6</strong></p><p>https://decide.madrid.es/debates/4870-pregunta-6-sobre-la-ordenanza-de-subvenciones</p>";"08/11/2016 08";"277";"201";"76";"38";"5139383253";"9070"
"4868";"Pregunta 4 sobre la Ordenanza de subvenciones";"<p><strong>¿Considera necesario simplificar el procedimiento para justificar la correcta ejecución de las subvenciones?</strong></p><p>Este debate pertenece a la consulta pública para modificar la regulación del sistema de subvenciones, simplificando la tramitación y reduciendo las cargas administrativas.</p><p>Más información en https://decide.madrid.es/proceso/ordenanza-subvenciones.</p><p><strong>Pregunta 1</strong></p><p>https://decide.madrid.es/debates/4865-pregunta-1-sobre-la-ordenanza-de-subvenciones</p><p><strong>Pregunta 2</strong></p><p>https://decide.madrid.es/debates/4866-pregunta-2-sobre-la-ordenanza-de-subvenciones</p><p><strong>Pregunta 3</strong></p><p>https://decide.madrid.es/debates/4867-pregunta-3-sobre-la-ordenanza-de-subvenciones</p><p><strong>Pregunta 5</strong></p><p>https://decide.madrid.es/debates/4869-pregunta-5-sobre-la-ordenanza-de-subvenciones</p><p><strong>Pregunta 6</strong></p><p>https://decide.madrid.es/debates/4870-pregunta-6-sobre-la-ordenanza-de-subvenciones</p>";"08/11/2016 08";"296";"238";"58";"25";"5142128975";"14472"
"4869";"Pregunta 5 sobre la Ordenanza de subvenciones";"<p><strong>¿Le parece adecuado limitar o modular la publicación convocatorias de subvenciones en los meses de verano?</strong></p><p>Este debate pertenece a la consulta pública para modificar la regulación del sistema de subvenciones, simplificando la tramitación y reduciendo las cargas administrativas.</p><p>Más información en https://decide.madrid.es/proceso/ordenanza-subvenciones.</p><p><strong>Pregunta 1</strong></p><p>https://decide.madrid.es/debates/4865-pregunta-1-sobre-la-ordenanza-de-subvenciones</p><p><strong>Pregunta 2</strong></p><p>https://decide.madrid.es/debates/4866-pregunta-2-sobre-la-ordenanza-de-subvenciones</p><p><strong>Pregunta 3</strong></p><p>https://decide.madrid.es/debates/4867-pregunta-3-sobre-la-ordenanza-de-subvenciones</p><p><strong>Pregunta 4</strong></p><p>https://decide.madrid.es/debates/4868-pregunta-4-sobre-la-ordenanza-de-subvenciones</p><p><strong>Pregunta 6</strong></p><p>https://decide.madrid.es/debates/4870-pregunta-6-sobre-la-ordenanza-de-subvenciones</p>";"08/11/2016 08";"275";"190";"85";"20";"5137992950";"7254"
"4870";"Pregunta 6 sobre la Ordenanza de subvenciones";"<p><strong>¿Qué medidas podría adoptar el Ayuntamiento de Madrid para que sea más sencillo solicitar una subvención?</strong></p><p>Este debate pertenece a la consulta pública para modificar la regulación del sistema de subvenciones, simplificando la tramitación y reduciendo las cargas administrativas.</p><p>Más información en https://decide.madrid.es/proceso/ordenanza-subvenciones.</p><p><strong>Pregunta 1</strong></p><p>https://decide.madrid.es/debates/4865-pregunta-1-sobre-la-ordenanza-de-subvenciones</p><p><strong>Pregunta 2</strong></p><p>https://decide.madrid.es/debates/4866-pregunta-2-sobre-la-ordenanza-de-subvenciones</p><p><strong>Pregunta 3</strong></p><p>https://decide.madrid.es/debates/4867-pregunta-3-sobre-la-ordenanza-de-subvenciones</p><p><strong>Pregunta 4</strong></p><p>https://decide.madrid.es/debates/4868-pregunta-4-sobre-la-ordenanza-de-subvenciones</p><p><strong>Pregunta 5</strong></p><p>https://decide.madrid.es/debates/4869-pregunta-5-sobre-la-ordenanza-de-subvenciones</p>";"08/11/2016 08";"156";"138";"18";"62";"5142776731";"10615"
"4873";"¿Debe renunciar Pablo Soto ahora, o cuando fracase su última predicción?";"<p>Menos de 8.000 madrileños votaron en la farsa^H^H^Hse ""participativa"". Y de las 5 propuestas seleccionadas, solo 2 eran las preferidas de ese minúsculo grupo (recordemos que el corte para aprobar una propuesta ciudadana es de 27.064 apoyos necesarios).</p>

<p>Claro, ahora nos enteramos que esta fase era solamente para ""arquitectos y urbanistas"". Pero no nos preocupemos, en la votación final participaran al menos ¡100.000 personas! Creo que es un buen momento para dar un paso al costado.</p>

<p> </p>
";"11/11/2016 19";"47";"31";"16";"20";"5167227636";"989"
"4874";"Decide Madrid=Farsa participativa";"<p>De las 5 propuestas seleccionadas por el Ayuntamiento para remodelar la Plaza de España, solamente 2 fueron las que han seleccionado los ciudadanos. ¿Dónde está la elegida por los ciudadanos en 2º. lugar?</p>

<p>Por lo menos podrían haber cogido las seleccionadas por los ciudadanos en primer y segundo lugar, no la 25º.</p>

<p>Esto es una farsa participativa.</p>

<p> </p>
";"11/11/2016 20";"74";"50";"24";"17";"5169231241";"1756"
"4876";"Protocolo real: Tala de árbol-Sustitución por otro";"<p>Últimamente estamos asistiendo a la <strong>tala masiva de árboles en todo Madrid</strong>, en Carabanchel está siendo muy visible. Los motivos se presuponen fundados, ya sea por enfermedad del ejemplar, riesgo... Lo que no parece fundado es que incluso árboles cortados al inicio de la legislatura municipal <strong>no han sido restituidos</strong>, lo que denota un mal planteamiento medioambiental en la ciudad.</p>

<p>Podríamos incluso ir más allá pues hay otros árboles que llevan años cortados y sin restituir, pero que parecen que no merecen atención por ser ""herencia recibida"", ese pretexto político tan manido para no asumir funciones y que tanto se usa por todas las fuerzas políticas en nuestro cainita país.</p>

<p>Es bastante inexplicable que esto suceda en Madrid, cuando uno de los partidos de la coalición gobernante es el partido ecologista Equo, una propuesta cuya influencia ha demostrado ser cada vez más menguante, inexistente o simplemente ineficaz a la vista de los problemas medioambientales que siguen generándose en la capital.</p>

<p>Queremos una ciudad verde, en la que se pueda respirar, y dónde los árboles juegan un papel clave. <strong>No queremos más excusas</strong>, ni el ""y tú más"". Apliquen un protocolo real: <strong>Si cortan un árbol, REPÓNGANLO</strong>. <strong>No queremos discursos, queremos hechos</strong>.</p>
";"12/11/2016 22";"151";"145";"6";"8";"5190515355";"13347"
"4877";"Debate sobre la propuesta 2015-09-199 ""Madrid -- 100% Sostenible""";"<p>Invitamos a debatir sobre la próxima propuesta que pasará a votación: https://decide.madrid.es/proposals/199-madrid-100-sostenible</p>

<p>Puedes consultar toda la información sobre el proceso en https://decide.madrid.es/vota</p>
";"15/11/2016 17";"49";"35";"14";"1";"5207252823";"1500"
"4878";"Debate sobre la propuesta 2015-09-9 ""Billete único para el transporte público""";"<p>Invitamos a debatir sobre la próxima propuesta que pasará a votación: https://decide.madrid.es/proposals/9-billete-unico-para-el-transporte-publico</p>

<p>Puedes consultar toda la información sobre el proceso en https://decide.madrid.es/vota</p>

<p> </p>
";"15/11/2016 17";"164";"156";"8";"14";"5218503589";"14078"
"4879";"Mupis";"<p>El Ayuntamiento está sustituyendo los 2.000 mupis (Mueble Urbano para la Presentación de Información) de la ciudad. Deberíamos preguntarnos cuál es el coste y la utilidad de estos muebles (excluyo los servicios, obviamente necesarios).</p>

<p>En cuanto a lo primero, el Ayuntamiento afirma que tienen un coste cero, ya que se financian por explotación publicitaria. Sin embargo, eso se refiere únicamente a su valor monetario pero no al coste que tiene para el medioambiente. ¿Cuánto contamina fabricar 2.000 mupis nuevos y retirar los antiguos? (Y eso si queremos creernos que los antiguos realmente se van a reciclar...)</p>

<p>En cuanto a su utilidad, nos dicen que algunos disponen de wifi, bluetooth y depósito para recogida de pilas. Pero todo eso se podría instalar en las paradas de autobus, que ya hay por toda la ciudad.</p>

<p>Para mí está claro cuál es el fin último y primordial de los mupis: servir de soporte publicitario. Por eso los nuevos contenedores para vidrio son mucho más grandes que los habituales que hay en todas las calles, para poder ofrecer un mayor espacio a la publicidad. Es decir, una vez más, entregamos el espacio público al consumismo por unos pocos euros. Vale, digamos que al Ayuntamiento le vienen muy bien 13 millones de euros anuales y que esto revertirá en beneficio de todos. Entonces, ¿dónde ponemos el límite? Si tan necesarios son esos 13 millones de euros, ¿por qué no instalamos 20.000 mupis en lugar de sólo 2.000 y así sacamos 130 millones? Supongamos que una empresa propone al Ayuntamiento, a cambio de una suma fabulosa, instalar alrededor de la Cibeles un faldón de pantallas led con publicidad. Probablemente a la mayoría nos parecería un horror, incluso aunque supusiera un ingreso estupendo para las arcas municipales. Ahora imaginemos que esa empresa, a cambio de la publicidad y tocando sabiamente nuestra fibra sensiblera de cara a las navidades, financia la construcción de un albergue para mil refugiados sirios. Quizá entonces no nos parecería tan mal. Así que ahí está la duda: ¿dónde ponemos el límite?</p>

<p>Hay una famosa anécdota, atribuida a distintos personajes: un caballero pregunta a una señorita si se acostaría con él por un millón de dólares. Por supuesto, responde ella. ¿Y por un dólar? , aventura él. ¡¿Por un dólar?! ¡¿Pero qué se cree usted que soy?! Lo que usted es ya ha quedado claro, ahora estamos negociando el precio.</p>

<p>Pues eso, ya está claro lo que somos, ahora estamos debatiendo por cuántos euros vendemos las calles de nuestra ciudad a las empresas instaladoras de mupis.</p>
";"15/11/2016 22";"67";"48";"19";"9";"5210466243";"2077"
"4880";"Pregunta 1 sobre el Plan de calidad del aire";"<p><strong>¿Considera usted que restringir el acceso de vehículos privados a ciertas zonas de su distrito puede mejorar la contaminación, el nivel de ruido y mejorar en general la calidad del espacio público?</strong></p><p><strong>Por favor, indique su distrito y en qué zonas.</strong></p><p>Este debate pertenece al Diálogo Con los Barrios, dentro del proceso de elaboración del borrador de Plan de Calidad de Aire y Cambio Climático del Ayuntamiento de Madrid.</p><p>Más información en https://decide.madrid.es/docs/procesos/dossier_plan_de_calidad_de_aire_y_cambio_climatico.pdf</p>";"16/11/2016 12";"2156";"1864";"292";"756";"5234068791";"135909"
"4881";"Pregunta 2 sobre el Plan de calidad del aire";"<p><strong>¿Considera usted que en su distrito sería adecuado mejorar el espacio peatonal construyendo aceras más anchas y facilitando el cruce de calzadas para los peatones?</strong></p><p><strong>Por favor, no olvide indicarnos cuál es su distrito.</strong></p><p>Este debate pertenece al Diálogo Con los Barrios, dentro del proceso de elaboración del borrador de Plan de Calidad de Aire y Cambio Climático del Ayuntamiento de Madrid.</p><p>Más información en https://decide.madrid.es/docs/procesos/dossier_plan_de_calidad_de_aire_y_cambio_climatico.pdf</p>";"16/11/2016 12";"1232";"996";"236";"410";"5229800501";"61441"
"4882";"Pregunta 3 sobre el Plan de calidad del aire";"<p><strong>¿Cree usted que para mejorar la movilidad peatonal en los barrios de su distrito sería positivo limitar a 30 km/h la velocidad de circulación de los vehículos?</strong></p><p><strong>Por favor, no olvide indicarnos cuál es su distrito.</strong></p><p>Este debate pertenece al Diálogo Con los Barrios, dentro del proceso de elaboración del borrador de Plan de Calidad de Aire y Cambio Climático del Ayuntamiento de Madrid.</p><p>Más información en https://decide.madrid.es/docs/procesos/dossier_plan_de_calidad_de_aire_y_cambio_climatico.pdf</p>";"16/11/2016 12";"1048";"537";"511";"340";"5216497989";"1332"
"4883";"Pregunta 4 sobre el Plan de calidad del aire";"<p><strong>Creemos que la movilidad en bicicleta, además de beneficios para el propio usuario, tiene un efecto importante en la mejora de la circulación y de la movilidad en general. ¿Considera usted que en su barrio o distrito se pueden tomar medidas concretas que fomenten y faciliten un mayor uso de la bicicleta como medio de transporte? ¿Puede indicar algunas?</strong></p><p>Este debate pertenece al Diálogo Con los Barrios, dentro del proceso de elaboración del borrador de Plan de Calidad de Aire y Cambio Climático del Ayuntamiento de Madrid.</p><p>Más información en https://decide.madrid.es/docs/procesos/dossier_plan_de_calidad_de_aire_y_cambio_climatico.pdf</p>";"16/11/2016 12";"1208";"1035";"173";"713";"5231976023";"73855"
"4884";"Pregunta 5 sobre el Plan de calidad del aire";"<p><strong>¿Considera que en su barrio o distrito la dotación de transporte público es adecuada a sus necesidades?</strong></p><p><strong>Por favor, no olvide indicarnos cuál es su distrito.</strong></p><p>Este debate pertenece al Diálogo Con los Barrios, dentro del proceso de elaboración del borrador de Plan de Calidad de Aire y Cambio Climático del Ayuntamiento de Madrid.</p><p>Más información en https://decide.madrid.es/docs/procesos/dossier_plan_de_calidad_de_aire_y_cambio_climatico.pdf</p>";"16/11/2016 12";"835";"483";"352";"447";"5220310845";"7577"
"4885";"Pregunta 6 sobre el Plan de calidad del aire";"<p><strong>¿Qué mejoras o medidas propondría para incentivar el uso del transporte público?</strong></p><p><strong>Por favor, no olvide indicarnos cuál es su distrito.</strong></p><p>Este debate pertenece al Diálogo Con los Barrios, dentro del proceso de elaboración del borrador de Plan de Calidad de Aire y Cambio Climático del Ayuntamiento de Madrid.</p><p>Más información en https://decide.madrid.es/docs/procesos/dossier_plan_de_calidad_de_aire_y_cambio_climatico.pdf</p>";"16/11/2016 12";"488";"467";"21";"648";"5232464089";"42680"
"4886";"Pregunta 7 sobre el Plan de calidad del aire";"<p><strong>Teniendo en cuenta que los carriles bus mejoran la velocidad comercial, frecuencia y por tanto la calidad del servicio ¿considera usted que en su barrio o distrito la red de carriles bus es adecuada?</strong></p><p><strong>Por favor, no olvide indicarnos cuál es su distrito.</strong></p><p>Este debate pertenece al Diálogo Con los Barrios, dentro del proceso de elaboración del borrador de Plan de Calidad de Aire y Cambio Climático del Ayuntamiento de Madrid.</p><p>Más información en https://decide.madrid.es/docs/procesos/dossier_plan_de_calidad_de_aire_y_cambio_climatico.pdf</p>";"16/11/2016 12";"479";"239";"240";"206";"5214442389";"-49"
"4887";"Pregunta 8 sobre el Plan de calidad del aire";"<p><strong>Indique en que calles o vías propondría la extensión de los carriles bus.</strong></p><p><strong>Por favor, no olvide indicarnos cuál es su distrito.</strong></p><p>Este debate pertenece al Diálogo Con los Barrios, dentro del proceso de elaboración del borrador de Plan de Calidad de Aire y Cambio Climático del Ayuntamiento de Madrid.</p><p>Más información en https://decide.madrid.es/docs/procesos/dossier_plan_de_calidad_de_aire_y_cambio_climatico.pdf</p>";"16/11/2016 12";"173";"139";"34";"165";"5223668361";"8436"
"4888";"Pregunta 9 sobre el Plan de calidad del aire";"<p><strong>¿Considera usted que la implantación en su barrio o distrito de un sistema de regulación del estacionamiento en las calles, sin coste para los residentes, mejoraría el problema del estacionamiento y redundaría en la mejora de la movilidad peatonal?</strong></p><p><strong>Por favor, no olvide indicarnos cuál es su distrito.</strong></p><p>Este debate pertenece al Diálogo Con los Barrios, dentro del proceso de elaboración del borrador de Plan de Calidad de Aire y Cambio Climático del Ayuntamiento de Madrid.</p><p>Más información en https://decide.madrid.es/docs/procesos/dossier_plan_de_calidad_de_aire_y_cambio_climatico.pdf</p>";"16/11/2016 12";"564";"350";"214";"326";"5221002725";"8439"
"4889";"Pregunta 10 sobre el Plan de calidad del aire";"<p><strong>¿Considera que la renovación de las flotas de vehículos de la EMT, así como de los vehículos utilizados para la distribución urbana de mercancías, los taxis y resto de flotas, puede ayudar a mejorar el problema de la contaminación en su barrio y distrito y por tanto en el resto de la ciudad?</strong></p><p><strong>Por favor, no olvide indicarnos cuál es su distrito.</strong></p><p>Este debate pertenece al Diálogo Con los Barrios, dentro del proceso de elaboración del borrador de Plan de Calidad de Aire y Cambio Climático del Ayuntamiento de Madrid.</p><p>Más información en https://decide.madrid.es/docs/procesos/dossier_plan_de_calidad_de_aire_y_cambio_climatico.pdf</p>";"16/11/2016 12";"901";"843";"58";"301";"5233304857";"73446"
"4890";"Pregunta 11 sobre el Plan de calidad del aire";"<p><strong>¿Cree usted que en su barrio o distrito hay suficiente número de reservas de estacionamiento para carga y descarga de los vehículos encargados de la distribución urbana de mercancías? ¿Puede identificar algunas calles en la que considere que la necesidad es mayor?</strong></p><p><strong>Por favor, no olvide indicarnos cuál es su distrito.</strong></p><p>Este debate pertenece al Diálogo Con los Barrios, dentro del proceso de elaboración del borrador de Plan de Calidad de Aire y Cambio Climático del Ayuntamiento de Madrid.</p><p>Más información en https://decide.madrid.es/docs/procesos/dossier_plan_de_calidad_de_aire_y_cambio_climatico.pdf</p>";"16/11/2016 12";"345";"239";"106";"146";"5221641509";"9213"
"4891";"Pregunta 12 sobre el Plan de calidad del aire";"<p><strong>Si dispusiera en su entorno habitual (domicilio, trabajo, etc) de una red suficiente de puntos de  recarga de vehículos eléctricos y tuviera que renovar su vehículo ¿se plantearía usted la adquisición de un vehículo eléctrico?</strong></p><p><strong>Por favor, no olvide indicarnos cuál es su distrito.</strong></p><p>Este debate pertenece al Diálogo Con los Barrios, dentro del proceso de elaboración del borrador de Plan de Calidad de Aire y Cambio Climático del Ayuntamiento de Madrid.</p><p>Más información en https://decide.madrid.es/docs/procesos/dossier_plan_de_calidad_de_aire_y_cambio_climatico.pdf</p>";"16/11/2016 12";"863";"751";"112";"441";"5231048496";"55607"
"4892";"Pregunta 13 sobre el Plan de calidad del aire";"<p><strong>El borrador del Plan de Calidad del Aire y Cambio Climático propone una medida que supone la creación de un área central de acceso restringido al vehículo privado cuyo alcance y extensión es prácticamente coincidente con la del distrito Centro.  Esta nueva área permitirá el acceso a los residentes, a los servicios públicos y vehículos de servicio a los residentes, vehículos de distribución urbana de mercancías y cualquier vehículo particular que acceda para aparcar en alguno de los aparcamientos públicos subterráneos existentes en el área. ¿Considera usted que esta medida tendrá un efecto positivo sobre la calidad del aire de la ciudad y en consecuencia en su distrito?</strong></p><p><strong>Por favor, no olvide indicarnos cuál es su distrito.</strong></p><p>Este debate pertenece al Diálogo Con los Barrios, dentro del proceso de elaboración del borrador de Plan de Calidad de Aire y Cambio Climático del Ayuntamiento de Madrid.</p><p>Más información en https://decide.madrid.es/docs/procesos/dossier_plan_de_calidad_de_aire_y_cambio_climatico.pdf</p>";"16/11/2016 12";"905";"778";"127";"386";"5230723023";"55964"
"4893";"Pregunta 14 sobre el Plan de calidad del aire";"<p><strong>¿Qué acciones propone usted que debería poner en marcha el Ayuntamiento de Madrid en la lucha contra la contaminación?</strong></p><p>Este debate pertenece al Diálogo Con los Barrios, dentro del proceso de elaboración del borrador de Plan de Calidad de Aire y Cambio Climático del Ayuntamiento de Madrid.</p><p>Más información en https://decide.madrid.es/docs/procesos/dossier_plan_de_calidad_de_aire_y_cambio_climatico.pdf</p>";"16/11/2016 12";"371";"342";"29";"776";"5231034040";"28853"
"4894";"Prohibir la circulación de vehículos de 5 plazas con una sola persona.";"<p>Sin más que decir, 1 tonelada de hierro contaminante transportando 1 persona! no más!! transporte público o bicicleta!</p>
";"17/11/2016 10";"154";"54";"100";"25";"5208783533";"-1612"
"4896";"¿Supresión de la publicidad en el Paseo del Prado?";"<p>El Ayuntamiento ha llenado el Paseo del Prado de soportes publicitarios para promocionar los museos del Paseo de las Artes. </p>

<p>Creo que esa publicidad puede ser ilegal pues, aunque cultural, destroza visualmente el Paseo dell Prado, declarado Bien de Interés Cultural y por lo tanto protegido de la publicidad, además de también protegido por la Ordenanza  Reguladora de la Publicidad Exterior de 2009.</p>

<p>El debate se centra en que si para promocionar a los museos hay que ignorar y destrozar el Paseo del Prado.</p>
";"19/11/2016 10";"72";"24";"48";"3";"5230046713";"-800"
"4897";"Reconocimiento de la figura de ciclista";"<p>Antes, el montar en bicicleta era cosa de críos, pero ha ido evolucionando para pasar a considerarse deporte y, en forma general como distracción o recreo. </p>

<p>Y ahora, socialmente y en muchos casos alentados por la propia Administración, se nos trata de imponer como medio normal de transporte, sustituyendo al automóvil, de lo que ya vamos teniendo cierta experiencia.</p>

<p>Todo ello sin acondicionamiento adecuado por donde circular, salvo en ciertos lugares, escasos y mal diseñados muchas veces.</p>

<p>Además, al no existir normativa reguladora general y conocida por todos, provoca que estemos en conflicto los propios ciclistas, los automovilistas y los peatones.</p>

<p>Se está dando el caso de que haya ciclistas que montan en las aceras, doblen esquinas con velocidad, adelanten por detrás sin avisar a los peatones, rozándoles, sin respetar distancia alguna. </p>

<p>No digamos el serpenteo que hacen en los pasos de peatones, el no respetar las luces de paso en semáforos, la forma de circular en las carreteras, el quiero y no puedo en solitario de subir cuestas empinadas reteniendo kilométricamente vehículos a motor detrás.</p>

<p>Y puestos a no entender, no se explica que no se les haya pedido aún unos conocimientos básicos de las normas generales de circulación por las vías públicas, el que no tengan un carnet de circulación y que no se les quite puntos por mala práctica.</p>
";"20/11/2016 13";"80";"46";"34";"15";"5253012946";"690"
"4899";"Pregunta 1 sobre la Ordenanza Reguladora de la denominación y Rotulación de Vías";"<p><strong>¿Considera conveniente la modificación de la Ordenanza para adaptarla a la normativa vigente en materia de Memoria Histórica?</strong></p><p>Este debate pertenece al proceso de Consulta pública modificación Ordenanza Reguladora de la denominación y Rotulación de Vías, Espacios Urbanos.</p><p>Más información en https://decide.madrid.es/proceso/rotulacion-vias</p>";"24/11/2016 00";"119";"75";"44";"21";"5290421319";"1953"
"4900";"Pregunta 2 sobre la Ordenanza Reguladora de la denominación y Rotulación de Vías";"<p><strong>¿Considera necesario modificar el procedimiento para la asignación o cambio de denominación de nombres de calles, edificios y espacios públicos?</strong></p><p>Este debate pertenece al proceso de Consulta pública modificación Ordenanza Reguladora de la denominación y Rotulación de Vías, Espacios Urbanos.</p><p>Más información en https://decide.madrid.es/proceso/rotulacion-vias</p>";"24/11/2016 00";"92";"45";"47";"41";"5284821043";"-97"
"4901";"Pregunta 3 sobre la Ordenanza Reguladora de la denominación y Rotulación de Vías";"<p><strong>¿Considera adecuado dar participación a los Distritos en este procedimiento?</strong></p><p>Este debate pertenece al proceso de Consulta pública modificación Ordenanza Reguladora de la denominación y Rotulación de Vías, Espacios Urbanos.</p><p>Más información en https://decide.madrid.es/proceso/rotulacion-vias</p>";"24/11/2016 00";"93";"65";"28";"7";"5291624334";"2586"
"4902";"Comisaría de policía en Sanchinarro, Las Tablas o Valdebebas";"<p>Desde hace unos años vivo en Sanchinarro. He vivido una persecución policial de un coche que acaba estrellado bajo mi ventana, la policía persiguiendo por los tejados a unos narcos/camellos, una mujer muerta en un contenerdor etc, pero al ser casos aislados no me lo tomé en serio, pensé, ""una simple casualidad"".</p>

<p>Desde hace ya varios meses no paro de oir de personas que les han robado, locales en los que han entrado etc, pero el colmo es cuando en la guardería de mi hija, que también tiene tienda, entran a robar con los niños dentro jugando, o cuando roban en los coches de las madres o padres que van a dejar a sus hijos a la guardería. </p>

<p>Yo creo que ya basta con la broma de vivir en un barrio donde vive mas gente que en la mayoría de ciudades de España y que no exista policía que nos proteja. Este barrio se está convirtiendo en el parque de atracciones para ladrones de poca monta que ven impunes sus actos al no haber presencia policial, y por supuesto por la falta de una comisaría que nos ofrezca cierta seguridad.</p>

<p>Espero que alguna vez triunfe la lógica y hagamos las cosas con sentido común y no sentido económico.</p>

<p>Atentamente un ciudadano y padre preocupado</p>
";"24/11/2016 10";"118";"110";"8";"7";"5303557091";"9508"
"4903";"Restricción a el transporte privado.";"<p>Prohibir la entrada en la almendra central de la ciudad a vehículos con un solo viajero. Fomentaremos así compartir vehículos y evitaremos atascos. O fomentaremos mas el transporte público.</p>
";"25/11/2016 10";"126";"72";"54";"7";"5302274323";"1028"
"4905";"Circulacion:  Nuevas ideas";"<p>Si queremos empezar a resolver el problema circulatorio y sus consecuencias en las ciudades hemos de aplicar nuevas ideas.</p>

<p>Para empezar sería:  Comprometer a los empresarios respecto a sus empleados y a sus clientes.</p>

<p>El tiempo que destina el empleado en ir y volver de su residencia al trabajo ha de computarse dentro de su jornada laboral. Con ello terminaremos consiguiendo sean mínimos los desplazamientos, bien por iniciativas patronales a surgir, bien por las del asalariado.</p>

<p>También, que para ir a trabajar siempre se usen medios colectivos (transporte público o fletado por la empresa, nunca particular o vehículo tipo privado de empresa con o sin chófer), además de poder hacerlo andando, bicicleta, etc.  Con ello reduciremos considerablemente la circulación general.</p>

<p>Respecto a los clientes, toda empresa que tenga un aforo de público a determinar, ha de contar con cercanos medios de transporte público y/ o plazas de garaje para clientes, según el caso.</p>

<p>Y como es una idea, en embrión, la expongo a criterio general, para  comentario, desarrollo, y fructificación.</p>
";"26/11/2016 12";"46";"37";"9";"46";"5318807391";"2252"
"4907";"La circulación y otra forma de verla";"<p>Narrándolo de forma objetiva y general, hace sesenta años en Madrid las viviendas eran en régimen de arrendadas, con alquileres congelados, se vivía cerca de donde se trabajaba, muchas empresas la proporcionaban a sus asalariados, las mujeres no trabajaban fuera de casa y hacían la compra en establecimiento del mismo barrio.</p>

<p>Por estas circunstancias, generalmente se iba andando al trabajo y, como mucho, en uno de los escasos transportes públicos entonces existente, y, por costumbre, los esparcimientos domingueros y demás días festivos se hacían andando.</p>

<p>Los críos jugaban en la calle, había personas que sacaban la silla a la calle en las anochecidas veraniegas, la ciudad era pequeña, estando limitada por pueblos, asentamientos ilegales, arrabales, huertas y despoblados, pero no hacía falta ir lejos para andar entre tierras, que por doquier había solares por los que se hacían caminos de atajo. </p>

<p>Desde entonces, libremente y sin pensar en después, hemos ido entre todos marcando diferencias con estas formas y ahora nos encontramos con resultados no apetecidos: contaminación atmosférica, saturación de vehículos a motor, cantidades inmensas en gastos de combustibles (beneficiando a sus productores y a los recaudadores de impuestos), una gran suma de horas perdidas en ir y venir, falta de espacio en calles.</p>

<p>También, las empresas que antes dotaban de vivienda a sus empleados se las han vendido y, como otras, se han desplazando lejos, con el consiguiente problema que crean a sus trabajadores.</p>

<p>Nos hemos expandido uniéndonos a pueblos y arrabales, desapareciendo huertas y campos de alrededor, al tiempo que llenábamos los solares internos, creciendo, apilados, hacia lo alto.</p>

<p>Lentamente, pero de forma efectiva, los espacios abiertos para el paseo y esparcimiento en forma de bulevares, sean el de Reina Victoria, o el de Paseo Ronda, e incluso lo que conocemos como Paseo de la  Castellana, Recoletos o Arturo Soria, los hemos llenado de coches, igual que otras vías que se crearon de ensanche, como la calle Atocha, la Gran Vía, etc.  </p>

<p>Las consecuencias ya las sabemos todos y no hace falta relatarlas.</p>

<p>Así pues, o nos lo tomamos en serio y reconsideramos nuestra forma de vivir, trabajar y desplazarnos, o seguimos igual mejor dicho: caminando cada día a peor.</p>
";"29/11/2016 11";"32";"21";"11";"2";"5342090635";"656"
"4908";"Dejar opcional la CITA previa en todos los Organismos de Madrid";"<p>Hola, me presento como ciudadano que diariamente se pasa por todos los organismos publicos en la comunidad de madrid, me encuentro todos los dias con desatenciones a mayores, extrangeros y trabajadores...  porque el punto de informacion es un vigilante de seguridad muy quemado por cierto porque no le pagan para informar, se queja hasta el punto que le molesta dar un folleto con el telefono de cita previa, la gente se va desatendida y es muy complicado para diversos colectivos recibir atencion, mi ejemplo es que pasen por una oficina de agencia tributaria o seguridad social a pedir un certificado de estar al corriente de pago; ¿A ver que pasa? </p>

<p>Hay que acabar con la desidia de los funcionarios y con la burocracia que cada vez son mas y nosotros estamos peor atendidos.</p>

<p> </p>
";"02/12/2016 14";"47";"35";"12";"2";"5376579918";"1712"
"4909";"ACCESIBILIDAD EN PARADAS DE METRO Y CERCANIAS DE HOSPITALES";"<p>Es increible que cuando llegas al Hospital de La Paz o al Ramon y Cajal (en Metro o Cercanias, respectivamente) no haya ascensores cuando, por definicion, es un lugar al que llegan personas mayores, personas con movilidad reducida, sillas de ruedas, sillas de bebe, etc. Ademas, ambas estaciones cuentan con espacio de sobra para ponerlos.</p>
";"03/12/2016 21";"90";"88";"2";"2";"5398197385";"8408"
"4910";"Renovar tarjeta de transporte público en autobuses";"<p>Siempre pasa; Subes al autobús y cuando pasas tu tarjeta de transporte público resulta que ha caducado ese mismo día. La solución actual es bajarse del autobus y acudir a una parada de metro para renovarla o pagar un billete de autobús. Un lío. Deberíamos poder renovar la tarjeta de transporte público en el mismo autobús porque es lógico que si das un servicio sea al completo.</p>
";"05/12/2016 11";"109";"98";"11";"8";"5412598536";"7822"
"4913";"Servicio Remunerado de Limpieza de la Ciudadanía";"<p>He creado una propuesta nueva que espero contar con vuestro apoyo. Lleva el mismo título de este debate. La idea es ayudar a la gente y apoyar al Ayuntamiento, en el servicio de limpieza que va tan mal. Os pido que seais proactivos y que lo apoyeis. El sistema se puede perfeccionar con vuestro aporte. De lo que se trata es que cada ciudadano que vive en su barrio pueda colaborar con el servicio de limpieza de su propia calle, recibiendo una remuneración por parte del Ayuntamiento. En la propuesta lo explico. Muchas gracias.</p>
";"07/12/2016 13";"52";"33";"19";"1";"5423490091";"888"
"4917";"Futuro del Metro de Madrid";"<p>Me gustaría abrir un hilo acerca del Metro de Madrid y las futuras inversiones que hay que realizar, soy consciente que es competencia de la Comunidad de Madrid, pero nos afecta a todos en nuestro día a día, y el Ayuntamiento de Carmena tiene la obligación en cierta medida de ""presionar"" por el interés de sus ciudadanos. Mucho se habla de contaminación, de movilidad, pero el transporte sigue estando lejos de ser un transporte que funcione de una manera efectiva en una ciudad tan extensa como Madrid.</p>

<p>Mis propuestas son las siguientes:</p>

<p>- Eliminar el nudo de 3 Olivos. Soy consciente de la dificultad ya que de 3 Olivos hacia Alcobendas tenemos una longitud de andén y hacia abajo tenemos otra. Todas las mañanas hay hacinamientos y la estación está colapsada por un mal diseño. Tres Olivos es zona A y Ronda de la Comunicación también. Además con todo el trabajo que hay en el eje Castellana, Las Tablas, Alcobendas, es necesario impulsar el transporte público</p>

<p>- Hacer la línea 11 útil par alguien: tanto por el norte como por el Sur. Debería conectarse al Metrosur y por el norte a algún sitio que no sea Plaza Elíptica, muchas propuestas hay acerca de ésta línea, pero ahora mismo es completamente inútil.</p>

<p>- Extender la Línea 5 de Alameda de Osuna a Barajas.</p>

<p>-Ampliación de la línea 8 de Nuevos Ministerios a Moncloa (pasando por Canal).</p>

<p> </p>

<p>Y luego a medio plazo, Madrid pide una segunda circular a gritos y ver si las líneas se pueden hacer express, no es eficiente moverte de una punta a otra con tanta parada intermedia.</p>

<p>También la conexión entre Metro-Cercanías la veo floja o inexistente, muy pocas estaciones interconectan las dos redes, así como la red de Cercanías que lleva muuuuchos años sin tener una inversión en condiciones. </p>

<p> </p>
";"13/12/2016 10";"55";"54";"1";"7";"5491696633";"5203"
"4919";"Los anuncios de prostitutas en los parabrisas de los coches al lado de colegios ";"<p>Soy un vecino de Puerta del Angel (Distrito La Latina) y cada día despues de ir a recoger a mis hijos al colegio veo una y otra vez tarjetas con publidad de protitutas incluyendo foros explicitas en el parabrisas de los coches o tirados en las aceras, es una autentica verguenza la impunidad con la que estas mafias reparten la publicidad por mi barrio sin que el ayuntamiento haga nada por remediarlo.</p>

<p>Aunque todos los grupos del Pleno del Ayuntamiento de Madrid aprobaron por unanimidad la propuesta del PSOE para que se prohíba la distribución de anuncios de prostitutas que se colocan principalmente en los parabrisas de los coches con multas de hasta 3.000  la realidad es que se ha incrementado notablemente la publicidad de este tipo de servicios incluso cerca de colegios.</p>

<p>Me gustaría que el ayuntamiento nos diese información sobre el numero de multas que han aplicado desde que se aprobo la medida en Noviembre de 2015</p>

<p>Es lamentable ver como nuestros politicos se limitan a aplicar una ley en el pleno, cuando su obligación es asegurarse de que esta ley se cumple. Una vez más las mafias de la prostitución se mofan de nuestros politicos y demuestran que están por encima de la ley.</p>

<p>No es un tema de partidos políticos puesto que en este caso hubo unanimidad a la propuesta de prohibir esta practica, queda por tanto demostrado que son igual de incapaces todos los partidos: AHORA MADRID, PSOE; PP Y CIUDADANOS.</p>

<p>ESPERO QUE DENTRO DE TODOS LOS PARTIDOS HAYA ALGÚN POLITICO RESPONSABLE QUE PRESIONE PARA QUE SE CUMPLE LA LEY Y SE CASTIGUEN ESTAS PRACTICAS Y POR FAVOR QUE NOS INFORMEN SOBRE EL NUMERO DE MULTAS DESDE LA APROBACION DE ESTA MEDIDA.</p>

<p> </p>

<p> </p>

<p> </p>

<p> </p>
";"14/12/2016 10";"143";"135";"8";"5";"5504595337";"11989"
"4920";"En la valoración de las propuestas no todo es cosa de número, si no de necesidad";"<p>Creo que todas las propuestas no se pueden mirar sólo desde el punto de vista del número de votos, en casos en los que el asunto es de salud pública o necesidad, creo que esos deberian de hacerse directamente.</p>

<p>Para ello algunos responsables del ayuntamiento tendran que tomarse el trabajo de leerlos todos y clasificarlos.</p>

<p>Por una parte los de salud pública o necesidad, por otra agrupar los temas comunes, porque si hay 27 de más fuentes, deberián de ir juntos. A mi de otro modo me parece chapucero y populista.</p>

<p> ¿qué pensais? </p>

<p>buen día a todas y todos</p>
";"14/12/2016 11";"30";"27";"3";"6";"5497930154";"2160"
"4921";"Lineas transversales de transporte";"<p>Uno de los problemas que veo que tiene Madrid es que sólo existe transporte público que o bien rodea la capital (L6), Cercanías C1, C10, C3, C7, incluso a nivel de carretera M30, M40. Con lo cual los transportes transversales son largos o inexistentes.</p>

<p>No existen líneas este-oeste, noreste-noroeste, sudeste-suroeste, y si existen cumplen 1 de estas dos condiciones:</p>

<p>-Muchas paradas en metro, con lo cual al final tu tiempo duplica el del tiempo en coche.</p>

<p>-Todo pasa por el eje Chamartín-&gt;Nuevos Ministerios-&gt;Atocha, que está completamente colapsado.</p>

<p>Voy a poner dos ejemplos para ilustrar lo que comento:</p>

<p>-Escenario 1: Una persona que vive cerca de Valdebernardo va a trabajar a Moncloa. 26 minutos en coche, en transporte público 44 minutos. L9 hasta Sainz de Baranda y L6 hasta Moncloa. <strong>Relacion tiempo transporte publico/coche 1,69</strong></p>

<p>-Escenario 2: Persona que vive en Aluche va a trabajar a Puente de Vallecas. 16 minutos en coche. 40 minutos en transporte público: C5 hasta Atocha y L1 hasta Puente de Vallecas. <strong>Relacion tiempo transporte publico/coche 2,5</strong></p>

<p>-Escenario 3: Persona que vive en Barrio del Pilar, va a trabajar a Suanzes. 20 minutos en coche, 52 min en transporte público. L7 hasta Pueblo Nuevo y después L5.<strong>Relacion tiempo transporte publico/coche 2,6</strong></p>

<p>-Escenario 4: Persona que vive en Aravaca va a trabajar a Las Tablas. 20 minutos en coche, 46 minutos en transporte público. <strong>Relacion tiempo transporte publico/coche 2,3</strong></p>

<p>Si extrapolamos a municipios de alrededor podemos poner los siguientes ejemplos todavía más escandalosos. </p>

<p>-Escenario 5: Persona que vive en Móstoles va a trabajar a Alcobendas. 40 minutos en coche. 1:30h en transporte público. L12 hasta Getafe Centro y después Cercanías. <strong>Relacion tiempo transporte publico/coche 2,25</strong></p>

<p>-Escenario 6: Persona que vive en Pinto va a trabajar a Barajas. 29 minutos en coche. 1:40h en transporte publico. Cercanías hasta N.Ministerios y L8 hasta Barajas. <strong>Relacion tiempo transporte publico/coche 3,44</strong></p>

<p>-Escenario 7: Persona que vive en San Fernando de Henares va a trabajar a Ciudad Universitaria. 30 minutos en coche, 1:12h en transporte publico: L6 + L7. <strong>Relacion tiempo transporte publico/coche 2,4</strong></p>

<p>-Escenario 8: Persona que vive en Carabanchel va a trabajar a Tres Cantos. 34 minutos en coche, 1:23h en transporte público. <strong>Relacion tiempo transporte publico/coche 2,44</strong></p>

<p><strong>RESUMEN</strong></p>

<p>Haciendo una media ponderativa entre los trayectos propuestos con anterioridad tenemos una media de 2,45, esto es que para un trayecto de 20 minutos en coche tardamos 49 minutos en transporte público.</p>

<p>Como vemos el transporte público deja mucho que desear y desde mi humilde punto de vista está sobrevalorado, si que tiene buena cobertura pero las conexiones son lentas y para moverte a distancias medias es bastante ineficiente.</p>

<p><strong>¿Qué medidas se os ocurren? ¿Qué propondríais si vosotros fuerais parte del Ayuntamiento?</strong></p>

<p> </p>
";"15/12/2016 11";"72";"71";"1";"3";"5513571755";"6902"
"4922";"Sobre Alepo";"<p>He leido esta noticia: http://www.publico.es/espana/madrid-apaga-iluminacion-cibeles-y.html</p>

<p>Alepo ha ido a mejor. No entiendo el porqué de esta iniciativa. Los terroristas y los ¿Moderados? Han sido expulsados de esa ciudad. ¿O es que vamos con DAESH, Al-Nusra y toda esa chusma?</p>
";"16/12/2016 09";"20";"10";"10";"7";"5505336285";"0"
"4924";"Plaza de España";"<p>Ya no hace falta destrozarla,  ya lo habéis hecho con la feria navideña que habéis montado.</p>
";"18/12/2016 17";"77";"34";"43";"15";"5524543158";"-397"
"4928";"Anillo M30-M40";"<p>Me gustaría hablar del anillo que existe entre la M30 y la M40, multitud de barrios son siempre penalizados por su localización: ocio, trabajo, infraestructuras, parques, obras, reformas, etc, etc...</p>

<p>Estoy completamente de acuerdo en descentralizar Madrid y despejar el ""centro"" que se está convirtiendo en insostenible...</p>

<p>¿Qué medidas propondríais? ¿Infraestructuras? ¿Planes de dinamización de los barrios? ¿BICIMad? ¿Protocolo contaminación?</p>

<p>Salu2!</p>
";"27/12/2016 16";"53";"44";"9";"6";"5630084292";"2905"
"4929";"Adjudicaciones a dedo en rastros de madrid";"<p>Adjudicaciones a dedo en rastros de Madrid. Cuando por normativas es por sorteo</p>
";"29/12/2016 01";"36";"14";"22";"0";"5627347852";"-311"
"4930";"Adjudicaciones a dedo en rastros de madrid";"<p>Adjudicaciones a dedo en rastros de Madrid. Cuando por normativas es por sorteo</p>
";"29/12/2016 01";"38";"10";"28";"0";"5627567203";"-473"
"4931";"Contaminación y estelas de aviones.";"<p>Durante mas de 7 dias consecutivos antes de la famosa boina o ""anticiclon"" todos hemos podido ver aunque no quisieramos , el bombardeo de estelas de aviones en el cielo. Cualquiera puede poner en un calendario los dias de mayor afluencia de estelas de aviones suben en los dias posteriores los indices de contaminción y ni se habla del tema ....
Tampoco se puede mirar en ningun sitio los niveles de metales en sangre de la poblacion, ni en el medio ambiente, 
 </p>
";"29/12/2016 14";"53";"18";"35";"6";"5632194790";"-577"
"4932";"Restricciones de tráfico por la alta contaminación por NO2";"<p>En la última semana de diciembre de 2016, el Ayuntamiento de Madrid ha aplicado medidas contra los episodios de alta contaminación por NO2 en determinados días (a partir de 180 µg/m³ se consideran niveles tóxicos para la salud).</p>

<p>Algunas medidas son restricciones de aparcamiento, limitaciones de velocidad en la M-30 y la circulación del 50% de los vehículos.</p>

<p>El dióxido de nitrógeno (NO2) es un contaminante atmosférico consecuencia del tráfico, determinadas industrias y calefacciones de carbón (en desuso actualmente). El NO2 es peligroso para la salud, entre otros, porque puede irritar los pulmones y disminuir la función pulmonar, así como disminuir la resistencia a infecciones respiratorias.</p>

<p><strong>¿Qué te parecen estas medidas?</strong></p>

<p>Te facilitamos más información para poder opinar:</p>

<ul>
	<li>Noticia sobre las restricciones de tráfico del 29/12/2016 https://goo.gl/OpzrrG</li>
	<li>Recomendaciones y alternativas de transporte http://diario.madrid.es/?p=6610</li>
	<li>Información y recomendaciones frente a los altos niveles de NO2: http://madridsalud.es/?p=16369</li>
</ul>
";"29/12/2016 16";"184";"149";"35";"31";"5654083831";"9231"
"4933";"Volver a la esencia del folleto de Navidad";"<p>El Ayuntamiento de Madrid ha presentado este año un folleto de navidad distinto con el formato de los que se hacían los años anteriores.</p>

<p>El folleto es muy cutre y no es llamativo:</p>

<ul>
	<li>La portada no presenta ninguna imagen o fotografía. Solo tiene un color de fondo rosa. Las letras de la portada no son las apropiadas.</li>
	<li>El tamaño de las letras no es el adecuado para un folleto.</li>
	<li>Solo presenta dos tipos de colores: rosa y verde. Debería tener varios y más llamativo.</li>
	<li>Apenas hay imágenes y además son muy pequeñas. Para poner imágenes que no se ven y solo tienen color verde o rosa mejor no ponerlas.</li>
	<li>Los diferentes apartados no tienen decoración, solo el nombre del apartado y el color rosa y verde.</li>
	<li>En un programa los pasatiempos y tonterías de dibujos sobran.</li>
	<li>En la contraportada no es el lugar adecuado para poner en letras grandes que el folleto está impreso con tintas recicladas. Se deberían poner en el interior del folleto y en letra más pequeña.</li>
	<li>La presentación o saludo de la alcaldesa podía ser más llamativo y no tan pequeño.</li>
</ul>

<p>En resumen, el diseño del folleto es horrendo y no es el apropiado para un folleto de navidad.</p>

<p>Un folleto de navidad tendría que ser llamativo y atractivo, justo lo contrario al de este año. Lo que pretende es informar y atraer a los ciudadanos para que vayan a las actividades y se informen bien. Al ponerlo bonito con buenas y grandes imágenes, buena letra y diseño a la gente seguro que le apetece ir con más ganas.</p>

<p>Me parece muy bien que el ayuntamiento lo imprima de forma ecológica y cuide el medio ambiente con tintas recicladas y con menos páginas, pero creo que no impide para que no se puedan poner grandes imágenes y un diseño mejor. Una cosa es cuidar el medio ambiente y otra muy distinta es ser austero y no preocuparse lo más mínimo por hacer el diseño del folleto.</p>

<p>Ya que el ayuntamiento se preocupa por realizar un buen programa de actividades y espectáculos, lo que tenemos que hacer es difundirlo de la mejor manera posible y una de ellas es mediante un buen folleto de navidad.</p>

<p>Yo por mi parte, pido que el año que viene volvamos a tener un folleto de navidad decente y atractivo que llame la atención a los ciudadanos.</p>

<p>Por eso, abro este debate para que cada uno de su opinión al respecto.</p>
";"29/12/2016 23";"46";"19";"27";"1";"5636309337";"-330"
"4934";"Revisar rutas transporte público puntos inconexos";"<p>Buenas noches, </p>

<p>Dada la situación de restricciones de tráfico el Ayuntamiento debería revisar ciertas rutas de transporte público entre ciertos barrios. Pongo mi ejemplo. </p>

<p>Vivo en Montecarmelo y trabajo en Clara del Rey (10 mins andando desde Avenida de America). Si voy en coche al trabajo tardo 10 minutos por trayecto, si quiero ir en transporte público 1 hora 10 minutos y dos o tres transbordos por trayecto, si no os lo creeis mirad google maps. </p>

<p>Si queremos que se use el transporte público habría que revisar puntos inconexos aún estando muy cerca.  </p>

<p>Seguro que hay muchos más ejemplos de este tipo de rutas chungas que podemos decirle al ayuntamiento.</p>

<p>Un saludo a todos</p>
";"29/12/2016 23";"90";"85";"5";"4";"5658261420";"7555"
"4935";"cita previa para inscribir recién nacidos ";"<p>Recientemente intentaba pedir cita previa para inscribir a mi recién nacido bebe. Resulta que la cita mas cercana estaba cercana al mes por lo cual decidimos ir directamente a una oficina de la seguridad social. El funcionario no aceptó atendernos sin cita y dijo q teníamos 90 dias para inscribir al bebé y supongo que para solicitar la prestación por maternidad y-o paternidad. Realizando una rápida mirada a la oficina se veía bastante pocos ciudadanos en espera y no había realmente una congestión que justificará no atendernos o que las citas sean tan demoradas, teniendo en cuenta además que la oficina solo atiende de 9 a 14 horas. Es justificable esto, como es posible que tarde tanto un tramite cuando no hay realmente una alta demanda de citas? Cuantas citas atenderán por dia? Podemos buscar una solución a esto?</p>
";"30/12/2016 01";"65";"55";"10";"0";"5654938723";"3807"
"4937";"Barrios con peor transporte publico ";"<p>¿Cuáles son las zonas peores comunicadas de Madrid? ¿Qué consideras que necesita un ciudadano para tener un transporte público decente? ¿Metro, bus, tren, tranvía, bici, nada? ¿Qué es para ti importante como ciudadano de Madrid? </p>

<p>Debate abierto para saber cuales son las necesidades de la gente y mejorar el transporte público, que es muy necesario....</p>
";"02/01/2017 11";"66";"50";"16";"22";"5687510509";"2575"
"4940";"Regulación del alquiler de vivienda para uso vacacional";"<p>Buenos días,</p>

<p>Me gustaría sugerirles mi opinión sobre la necesidad de controlar el uso de pisos para alojamiento turístico, ya que está perjudicando seriamente la disponibilidad de vivienda para alquiler como residencia habitual y provocando nuevamente una burbuja del alquiler de viviendas en las zonas mas céntricas de nuestra ciudad (Dentro de la M30). Creo que se deberían tomar iniciativas como las que ya se han tomado en otras ciudades (New York, Barcelona, etc) y limitar los supuestos en los que las viviendas pueden ser ofrecidas como alojamiento turístico a aquellas en las que el propietario figure como empadronado en la misma o que se alquile alguna de sus habitaciones. De lo contrario, se contribuye a que los inversores centren su atención en esta lucrativa actividad que está provocando un ya evidente exodo de la problación nativa al extraradio de las ciudades y una subida generalizada del coste de la vida para los realmente importantes, los madrileños.</p>

<p>Se ha llegado a un punto en el que se hace necesaria la regulación de la actividad de sitios como Airbnb, Homelidays, etc,  cuya idea original como economía colaborativa era muy interesante pero que como todo ha sido pervertida para pasar a ser en gran parte una muestra más de especulación salvaje.</p>

<p>Muchas gracias y un saludo</p>

<p> </p>
";"05/01/2017 09";"124";"90";"34";"19";"5717511060";"4064"
"4943";"Pregunta 1 sobre nuevo barrio en el distrito de Villa de Vallecas";"<p><strong>¿Consideras conveniente que el PAU de Vallecas se configure como un barrio independiente denominado ""Ensanche de Vallecas""?</strong></p><p>Este debate pertenece a la Consulta previa sobre la creación de un nuevo barrio en el distrito de Villa de Vallecas.</p><p>Más información en https://decide.madrid.es/proceso/distrito-villa-de-vallecas</p>";"09/01/2017 00";"554";"477";"77";"159";"5763332978";"34440"
"4944";"Pregunta 2 sobre nuevo barrio en el distrito de Villa de Vallecas";"<p><strong>¿Crees necesaria la participación de los propios Distritos en el proceso de decisión sobre la creación o modificación de sus barrios?</strong></p><p>Este debate pertenece a la Consulta previa sobre la creación de un nuevo barrio en el distrito de Villa de Vallecas.</p><p>Más información en https://decide.madrid.es/proceso/distrito-villa-de-vallecas</p>";"09/01/2017 00";"302";"260";"42";"24";"5760709042";"18768"
"4946";"Autoescuelas: enseñanza de como reducir las emisiones en vehículos";"<p>Aunque se trata de un problema nacional, propongo que se incluyan en el temario para obtención de carnet de conducir técnicas de conducción para reducir el nivel de contaminantes producidos por su vehículo. Un estudio de la Escuela de Ingenieros Industriales de Madrid indica que el nivel de contaminantes NOx y de CO, emitidos por los vehículos a motor, casi se cuadruplican si la conducción es ""agresiva"" o ""deportiva"". Si la conducción es más tranquila y moderada, evitando acelerones y frenazos frecuentes, las emisiones son mucho menores. Además el consumo de combustible va a ser menor, con el consiguiente ahorro económico para el conductor.</p>

<p>Esto es educación para los futuros conductores, por lo que su impacto a medio plazo puede ser muy beneficioso. Entiendo que esta propuesta se puede trasladar desde el Ayuntamiento a la Dirección General de Tráfico.</p>
";"11/01/2017 12";"124";"102";"22";"3";"5781315432";"6580"
"4947";"Instalaciones deportivas en el barrio de Chamberi.";"<p>Como habitante de este barrio tengo una queja sobre las escasisimas instalaciones deportivas existentes en el mismo.</p>

<p>Como es posible que casi siempre tengamos que irnos a otros barrios, generalmente perifericos, para poder jugar a diferentes deportes de equipo por total masificacion de las escasas instalaciones polideportivas de este barrio?.</p>

<p>Por no hablar de la chapuza/pelotazo que represento Canal.</p>

<p>Propongo que se habiliten mas instalaciones polideportivas en este barrio ante el colapso de las escasas ya existentes.</p>

<p> </p>
";"17/01/2017 13";"114";"96";"18";"4";"5842064810";"6568"
"4948";"Votar sin conocimiento";"<p>Ha gastado papel para que los madrileños decidamos por el ayuntamiento tres decisiones que les corresponden a ellos... con ello se lavan las manos si a alguien no le gusta el resultado.</p>

<p>porque no se vota que pasa con la limpieza? votemos tambien las medidas de regulacion de la contaminacion que se han puesto en marcha estas navidades...la educacion en madrid, las becas comedor...en fin...hay millones de cosas que podemos votar la ciudadania...Asi que con eso no necesitamos personas que nos representen...pongan un ordenador. Con encuestas y votaciones y se decide lo que diga la mayoria! Nos ahorramos sus sueldos!</p>
";"17/01/2017 14";"189";"38";"151";"17";"5821958069";"-2271"
"4949";"Tarifa plana para personas con discapacidad ";"<p>¿Qué me pueden decir de la noticia publicada hace casi un año de que Madrid aprobará una tarifa plana de 20 euros en el transporte para personas con discapacidad. La Asamblea de Madrid dará luz verde a una Proposición No de Ley (PNL) para la creación de una tarifa plana para personas con discapacidad cuyo coste será como máximo de 20 euros al mes. Sujeta a criterios de renta de no superar tres veces el IPREM?

 </p>
";"17/01/2017 14";"171";"155";"16";"13";"5845952888";"12599"
"4950";"Regulacion del uso de petardos";"<p>Se que este tema va a causar mucha controversia, pero creo que es importante que se trate.</p>

<p> </p>

<p>En mi barrio desde Octubre hasta la primera semana de Enero se pueden oir petardos a diario. Durante 2 meses y medio hemos tenido dias enteros en los que a lo mejor en una hora podias oir 15 o 20 petardos, descansando algo por las mañanas y por las noches, pero tampoco mucho. Los animales domesticos lo pasan fatal, pero es que la gente que trabaja en turnos de noche a partir de las 16 de la tarde ya no pueden dormir, los bebes y los ancianos tambien sufren sobresaltos constantes y es insufrible. Parece que los regalan con las pipas de la cantidad y continuidad con la que los lanzan. Yo entendía que en Nochebuena y en Nochevieja hubiera un rato, pero es que en el Ensanche de Vallecas son 3 meses insufribles. Y ademas se que es solo aqui, porque en casa de familiares que viven en otras zonas esto no ocurre, no oyes un petardo fuera de las fiestas de Navidad.</p>

<p>Creo que deberia de haber algun tipo de regulacion que prohibiera la venta de petardos o su uso, segun potencia y fechas. No es normal que en los chinos del barrio los compren por puñados y que los tiren a 2 manzanas y aun te llegue como si lo estuvieran tirando debajo de tu balcon. Cuando ya los tiran debajo de tu casa, durante un par de horas, te dan ganas de coger a los que lo tiran, pegarles los petardos con pegamento a la mano y encenderlos todos a la vez.</p>

<p> </p>

<p> </p>
";"17/01/2017 17";"361";"326";"35";"14";"5849953017";"26278"
"4951";"JARDINERÍA AMABLE, SILENCIOSA, SIN RUIDOS, NUBES DE POLVO, CONTAMINANTES";"<p>Reclamo para mi ciudad, una jardinería amable, silenciosa, sin ruidosas sopladoras que levantan inmensas nubes de polvo y que dejan a su paso un atronador y desagradable ruido. Abogo por una jardinería respetuosa con personas, animales y plantas, que mejore nuestro entorno y nuestra calidad de vida, y no al contrario. La productividad nunca debe romper la calma de nuestros parques, ni llenarlos de humo, contaminantes, y ruidos desagradables. La jardinería debe preservar nuestra relación con la naturaleza de manera amable. Prefiero las escobas jardineras a los motores de las sopladoras, prefiero los alcorques de toda la vida hechos con azada, y no esas masas artificiales que se han puesto de moda y que axfisian a los árboles. Aducen que son porosas, pero todos sabemos que con el tiempo, la suciedad las hace impermeables, y los árboles enferman. Me gustaría que hubiera más frutales en nuestra ciudad, más permacultura y menos plaguicidas, ingenieros agrónomos que se toman la molestia de estudiar y conocer la infraestructura urbana para no cometer el error de poner especies con frutos muy tóxicos delante de la puerta de una escuela pública. No estoy en contra de la modernización de la jardinería siempre y cuando sea respetuosa. Existen motores de hidrógeno, eléctricos silenciosos, no contaminantes. Pido que se valore un nuevo modelo de hacer las cosas en una jardineria a la altura de nuestra ciudad.</p>
";"17/01/2017 18";"141";"127";"14";"10";"5846770484";"10178"
"4952";"Plaza de España ¿ UN PASEO POR LA CORNISA o WELCOME MOTHER NATURE...?";"<p>El Jurado del Concurso para la Remodelación de la Plaza de España ha seleccionado 2 Proyectos bien distintos: Proyecto Y: UN PASEO POR LA CORNISA y Proyecto X: Welcome mother Nature, good bye Mr Ford. El presupuesto-coste del irreverente y ambicioso Welcome mother...,  se eleva al triple del más sostenible y respetuoso Paseo por la Cornisa.</p>

<p>Aunque hay debates parciales en la presentación de cada Proyecto, parece necesario tener un lugar donde los ciudadanos e incluso los proyectistas elegidos o eliminados, podamos debatir en un espacio único sobre las bondades o no de ambas propuestas</p>
";"17/01/2017 19";"151";"128";"23";"31";"5846037434";"8900"
"4954";"M-Río: Calzada compartida, un peligro basado en una utopía, pero tiene solución";"<p>Los que conocemos y usamos el parque lineal denominado M-Río, en mi caso de forma diaria, somos conscientes de los peligros continuos que significa la existencia de una calzada única para peatones, corredores tradicionales y no tradicionesles (corredores que portan un carrito de bebé por delante de ellos mismos...), patinadores, ciclistas y otas ""especies"" de usuarios. Hasta aquí muy bien. Es un dominio público y como tal, salvo norma en contrario, todos tenemos derecho a su uso.</p>

<p>El problema-peligro está es su falta de regulación de uso, y para explicarme debo empezar diciendo que soy ciclista de hábito diario.</p>

<p>Empiezo:</p>

<p>01.-De entrada, el diseño realizado por un importante, joven y entusiasta equipo de arquitectos madrileño, no tuvo jamás encuenta la realidad del diseño de la calzada de dicho parque lineal.</p>

<p>¿Que quiero decir?.</p>

<p>Pues sencillamente que si <strong>(a)</strong>la disposición general transversal (a lo ancho) de dicha calzada es:</p>

<p><strong><em><u>(terrizo-con vegetación)</u> + <u>(calzada de unos 6 metros) </u>+ <u>(terrizo-con vegetación)</u></em></strong></p>

<p>y que <strong>(b)</strong>la calzada como tal, no presenta señalización vial sobre la misma (sobre la calzada propiamente dicha) para definir áreas de los distintos usos ""reales"", como el peatonal, ciclista, deportista pedestre y otros usos (como por ejemplo hacer un corro de niños sentados en el suelo jugando con sus muñecos ocupando media calzada o más... y otros usos, que no ha lugar), junto con <strong>(c)</strong>la amplísima carga de uso (usuarios de dicho parque linal), y para terminar <strong>(d)</strong>la falta de un mínimo <u>sentido común</u> -alguien podría decir, falta de civismo- para el uso de dicho parque lineal, y en concreto del vial (la calzada) y sus terrios, el resultado es el siguiente:</p>

<p><strong>(i)Terrizos laterales</strong> sin practicamente uso, cuando representan, como promedio, los 2/3 de la sección transvensal de dicho parque lineal (salvo en zona de juegos).</p>

<p><strong>(ii)Calzada</strong> con continuos incidentes entre ciclistas (respetuosos e irrespetuosos con el resto de usuarios), peatones que no guardan una zona de avance (que no recuerdan que el uso es compartido con otros tipos de usos y se permiten los giros repentinos, la ocupación atodo lo ancho de la repetida calzada, etc... pero no estan en campo libre), paseantes de canes (malos paseantes, ya que dejan la correa con más metros de holgura de la que se espera en esta calzada), y demás ""equivocados"" usos de la calzada.</p>

<p>Diría mucho más sobre este tema, pero no quiero cansar al lector, pero si paso a proponer soluciones para que los lectores opinen, y que se pueda decidir, con sentido común y práctico</p>
";"18/01/2017 10";"176";"157";"19";"23";"5853940952";"12310"
"4955";"Regular comisiones Agencias Inmobiliarias";"<p>Imagino que como inquilino o arrendatario todos hemos sufrido la situación en el que, por el mero hecho de que llamas preguntando por una vivienda, la agencia inmobiliaria te solicita un mes de alquiler por el simple hecho de darte algún dato complementario al del anuncio o enseñarte el inmueble. <strong>En nuestra opinión este servicio se le está prestando al arrendador que es el que ha constratado los servicios de la agencia y se beneficia de ellos y nunca al arrendatario</strong>cuyo beneficio obtenido por la agencia no justifica en ningún caso el importe cobrado (Mínimo una mensualidad).</p>

<p><strong>Solicitamos que se acabe con esta practica abusiva con los arrendatarios y que se regule un sector</strong> que ha sido y sigue siendo el origen de muchos abusos e irregularidades</p>
";"18/01/2017 10";"214";"185";"29";"24";"5854064596";"13485"
"4956";"parque para perros en valdebernardo ";"<p>En el parque lineal de Valdebernardo, justo el que esta siguiendo la M40 en la zona norte de dicho parque concretamente casi enfrente de Ladera de los Almendros 22-24. hay una explanada de tamaño medio.  La misma no es utilizada por las personas.  Seria un sitio estupendo para con una valla crear un parque para perros, parte de ella ya esta limitada por seto.  Tiene agua, pues hay una fuente, y luz pues hay varias farolas, así como algun arbol para la epoca de verano. Entiendo que el espacio es suficiente para que nuestras mascotas puedan correr y  disfrutar, así no se molestaria a los que no les gustan los perros y no abria accidentes con los que van con las bicis a todo meter por el paseo.  No seria necesario ponerles nada mas, asi podriamos tenr un sitio para ellos, sin que el coste de realización de dicha adptación fuese excesivo.</p>
";"18/01/2017 16";"92";"64";"28";"0";"5848080418";"2504"
"4957";"Eliminación del parquímetro en todo Madrid.";"<p>Ya se paga un impuesto de circulación para eso.</p>
";"19/01/2017 12";"400";"233";"167";"15";"5856304877";"3844"
"4959";"¿Qué se va a hacer con la piscina del Parque Móvil?";"<p>Fui socio durante casi una década del Parque Móvil. Siempre estuvo la sospecha de que algún día se cerrarían las instalaciones. En junio de 2014, si mal no recuerdo, cerraron las puertas. Pensé que inmediatamente se harían obras, se derrumbaría o se haría algo. Pero nada, ese espacio sigue igual, con un frontón resquebrajado y unas instalaciones cerradas que daban un servicio al barrio. Además de ser un recinto histórico, por ser el de la primera piscina cubierta de Madrid.</p>

<p>¿Qué va a ser de este inmueble? Vamos camino de cumplir el tercer año y no veo ningún avance y ninguna explicación.</p>

<p>Gracias.</p>
";"19/01/2017 15";"45";"35";"10";"3";"5858005894";"1944"
"4960";"BONO SESIONES DEPORTE POLIDEPORTIVO MADRID SIN  CADUCIDAD";"<p>Ahora mismo (o al menos hace unos meses)..., el bono de 10 sesiones para los polideportivos de Madrid, el cuál te da acceso a los gimnasios o a las piscinas caduca de un año para otro si no vas a renovarlo hasta ciertas fechas. No le veo sentido que te hagan ir hasta el polideportivo a renovarlo de un año para otro..., además ni siquiera puedes hacerlo online. </p>
";"19/01/2017 17";"195";"170";"25";"7";"5866614161";"12641"
"4961";"Construcción de Túnel en la Calle Gran Vía";"<p>Debido a la idea por parte del Ayuntamiento, la cual creo que salio de esta página web, considero una GRAN IDEA, la construcción de un tunel que pueda comunicar la parte de la Calle de Alcalá con Plaza de España, ya que la Calle Gran Vía es una de las arterias principales de Madrid, y cortandola, se creará una gran concentración de tráfico, en el caso de que peatonicen esta calle.</p>
";"19/01/2017 18";"217";"114";"103";"8";"5854010987";"577"
"4962";"Ofertas de trabajo con el sueldo especificado";"<p>Somos muchos los que buscamos u ojeamos ofertas de trabajo. Al igual que las empresas piden con detalle todos los méritos y requisitos que necesitamos para poder acceder a ese deseado puesto de trabajo, deberíamos exigir que especificaran claramente el dato del sueldo que ofrecen, puesto que estoy harta de ver ofertas de trabajo con ""sueldo a convenir"" o ""sueldo según valía"". </p>

<p>El salario es uno de los datos más relevantes que debería incluir cualquier oferta de trabajo, así como el horario laboral o el tipo de jornada y de contrato, pero que frecuentemente no se detalla, lo que crea una situación de ""angustia"" puesto que las condiciones del trabajo están incompletas. </p>

<p>Debería ser obligatorio especificar en cada oferta de trabajo, horario y sueldo completo. No pueden ocultar información tan importante y necesaria. Se les olvida muchas veces que la gente trabaja por dinero, no por amor al arte.</p>

<p> </p>

<p> </p>
";"19/01/2017 19";"186";"174";"12";"1";"5869057419";"15154"
"4963";"no seamos egoistas pensemos en lo demás";"<p>no seamos egoistas con el coche, pensemos en los transeuntes, todos lo somos en cualquir momento. tenemos poco tiempo, ¿porque no lo utilizamos para sentirnos mas solidarios ? seriamos mas felices.gracias por su atención.</p>
";"19/01/2017 22";"65";"45";"20";"3";"5859729030";"1730"
"4964";"Madrid: una ciudad sucia";"<p>Hola a todos, </p>

<p>revisando las propuestas del Ayuntamiento, la mayoría me parecen positivas aunque un lazo bonito que distrae uno de las tareas clave a solucionar: señora Alcadesa, no me creo que no lo vea. Toda mi familia vive fuera de Madrid, por mi vida profesional he viajado y he hecho amigos en muy diversos países: todos cuando vienen a Madrid coinciden en lo mismo: esta cada vez más sucia!!!</p>

<p>Por supuesto parte de esta situación es responsabilidad de todos nosotros. Le puedo decir calles concretas en las que los vecinos tiran todas las noches residuos orgánicos, ropa, papel, muebles... Es una vergüenza y una falta de civismo absoluta. </p>

<p>Sin embargo, le puedo enseñar fotografías de cómo se acumulan los residuos en los puntos de recogida, día tras día... </p>

<p>Limpieza llama a limpieza, si estamos ante una ciudad limpia, como ocurre con muchas ciudades de Europa, es probable que nos lo pensemos dos veces de no agacharnos a recoger el papel que se nos ha caído. Estoy agotada de llamar la atención a los que tiran colillas y papeles. Una sola no puede con todo.</p>

<p>Sra Alcadesa está muy bien que nos deslumbren con obras para remodelar la Plaza de España (es humano querer dejar un legado construido a base de ladrillos, ya le dio por eso a los Egipcios en época de Ramses) pero si esas obras a los pocos años están llenas de porquería su legado se cubrirá de un bonito manto de eso mismo....porquería.</p>

<p>Es como disimular que uno es limpio poniéndose litros de perfume cuando lleva días sin que le roce una gota de agua. </p>

<p>Tómeselo en serio DE VERDAD, no gaste nuestro dinero en marquesinas absurdas que nos digan que seamos buenos ...usted y yo sabemos que eso no cambia nada.</p>

<p>Qué hacer? Educación y mano dura a partes iguales. Condenemos socialmente a los tiran colillas, papeles,no recogen las cacas de sus perros (yo tengo perro y aún no me han salido granos por limpiar su caca). Desde el colegio.... es responsabilidad de todos que nuestra ciudad no dé vergüenza ajena!! </p>

<p>Por supuesto a aquellos que no lo respetan multas económicas y trabajo social: días de trabajo limpiando las calles según su falta, con notificación a su puesto de trabajo (condena social). </p>

<p>Pero también, esfuerzo por su parte: más inversión en la limpieza de las calles!!</p>

<p>No es fácil pero algo tenemos que hacer. Lucha contra la famosa boina cuando no se da cuenta de la porqueria que le rodea. </p>

<p>Haga algo ya. Gracias.</p>

<p> </p>

<p> </p>

<p> </p>

<p> </p>
";"20/01/2017 21";"185";"163";"22";"13";"5878615123";"12423"
"4965";"Cada palo que aguante su vela";"<p>Cada palo que aguante su vela y los señores que tienen que decidir para el Proyecto de, o para un Madrid mas limpio son los cargos electos . Los ciudadanos ya fuimos citados a las urnas. Ahora que se impliquen ,que se mojen,que estudien y que no se anden con las pijadas de enviar sobres a los ciudadanos pq los que tienen que acatar responsabilidades son vds no el ciudadanito que  bastante tiene con pagarles para sólo lucir palmito. Así que no tiren balones fuera y siéntense a estudiar y asesorarse de los buenos profesionales y no de los  q hablan mucho y no entienden de nada. Eso sin mencionar el tiempo y gasto de papel a los 2 millones de madrileños que lo archivarán directamente en la P........</p>

<p>Que brillante idea señor Planchuelo</p>

<p> </p>

<p> </p>
";"20/01/2017 22";"122";"26";"96";"22";"5855244706";"-1491"
"4967";"Coches en doble fila";"<p>Somos muchos vecinos de la zona de Chamberí, que tenemos que soportar en algunas calles como Ponzano o Alonso Cano, sobre todo jueves y viernes, coches en doble fila en la puerta de los bares. Y pasa por todo Madrid.</p>

<p><strong>En ocasiones se ve a coches policía patrullar sin hacer nada.</strong></p>

<p>Cuando vas en autobús, no puede pasar, y todos los usuarios de transporte público hemos de esperar a que el ilustre ciudadano de turno quite el coche, para que finalmente de la vuelta a la manzana y lo deje en el mismo sitio donde estaba, para que el siguiente autobús 15 minutos despues vuelva a tener el mismo problema.</p>

<p>Además de este perjuicio están los ruidos de los cláxones, y atascos que provoca.</p>

<p>Pedimos que se tomen acciones ya.</p>
";"22/01/2017 20";"141";"130";"11";"10";"5898052628";"10971"
"4968";"ACABAR CON LA MUTILACION DE LOS ARBOLES";"<p>Que la empresa que se dedica a podar los arboles de Madrid no se limite a dejarlos en ""cuatro palos"" sino que sean personas tituladas y formadas en la poda de los distintos arboles. Da pena ver como dejan los pobres arboles mutilados. Sabiendo que lo hacen asi para ahorrarse la poda todos los años. esto generaria mas puestos de trabajo ya que hay muchas personas tituladas en poda que estan en el paro sin mucho futuro....</p>
";"22/01/2017 21";"168";"154";"14";"4";"5899152658";"12833"
"4970";"Promocionar edificios de nueva obra de estilos más clásicos";"<p>Ver que todos los nuevos edificios de Madrid responden al mismo estilo arquitectónico moderno de colores blancos, metálicos y enormes cristaleras, desanima a la hora de pasear por el centro de nuestra ciudad. Estaría bien que futuros edificios en la zona centro se construyeran pensando un poco más en la estética general de los barrios en los que se contruyen, ya sean barrocos, herrerianos, modernistas o neoclásicos. La concenciación estética en la ciudad debería aumentar un poco más si queremos que nuestra ciudad siga siendo tan agradable como siempre lo ha sido.</p>
";"24/01/2017 09";"133";"119";"14";"11";"5912609272";"9394"
"4971";"accesibilidad hospital clinico san carlos";"<p>es imposible hacer una salida de metro en el hospital clinico san carlos???</p>

<p>el corte ingles, sin ir mas lejos, tiene mejores accesos publicos</p>

<p> </p>

<p> </p>
";"24/01/2017 09";"109";"101";"8";"4";"5912727499";"8617"
"4972";"Papeleras de colores";"<p>Salgo del trabajo, del entrenamiento, de las clases de alemán o del aula de ebanistería, y me entra hambre. O sed. Para saciarlo, compro algún comestible -o alguna bebida- que, por cuestiones de higiene, está envasado. Retiro el envoltorio y ¿qué hago con él? Cívicamente, y por supuesto, lo tiro a la papelera; que este Madrid con una suciedad tan repentinamente patente no admite ya más basura. Entiendo que igual que yo, tropecientos habitantes -y visitantes- tiran diariamente sus correspondientes tropecientos envases a las papeleras, que no pueden distinguir las pobres entre plásticos, material orgánico o escupitajos (aunque supongo que este último entra dentro del anterior). Propongo remodelar, cambiar, actualizar, mejorar, optimizar o el verbo más proactivo que se nos ocurra estos precarios recipientes, para que sean capaces de separar, al menos, lo ""amarillo"" de todo lo demás. No creo que sea un procedimiento demasiado costoso y, si su gestión es realizable, contribuiría a pasar del Madrid gris que hemos heredado a uno más verde, utilizando la socorrida referencia cromática. </p>

<p>Abro esta cuestión como debate, principalmente porque se trata de una idea poco madurada -que se me acaba de ocurrir, vaya- y porque, antes de presentarlo como propuesta o incluso parte de los Presupuestos, podríamos depurarlo un poco entre todos en este espacio de voces que también es nuestro.</p>

<p>Animaos a participar! :)</p>
";"24/01/2017 13";"82";"66";"16";"3";"5909831264";"4024"
"4973";"Limpieza y colillas en las calles";"<p>Creo que ha sido muy buena iniciativa la de concienciar a la gente de que no tire sus colillas al suelo mediante carteles por las calles, sin embargo también creo importante que se mejoren los servicios de liempieza,  ya que muchas de las veces que ando por la calle me da grima ver el suelo tal y como está. La principal culpa la tenemos quienes lo ensuaciamos, pero eso no quita para que, ya que se paga, que se mantengan limpias las calles, como en otras muchas ciudades europeas.</p>
";"24/01/2017 16";"137";"126";"11";"21";"5916285590";"10576"
"4974";"BICIMAD en ALTO EXTREMADURA";"<p>De ésta manera se conectaría la Casa Campo y sus pabellones con Madrid Río y el centro de Madrid.</p>

<p>El Paseo Extremadura en una de las entradas a la capital mas usadas por los madrileños, que bicimad tenga una estación aquí serviría de aliciente para iniciar la ruta desde aqui, hacia cualquier destino de madrid centro.</p>

<p>Si queremos reducir la contaminacion en Madrid y modernizar el barrio, apoyemos la instalación de nuevas estaciones de bicimad en los barrios aledaños a la almendra central.</p>
";"25/01/2017 00";"98";"87";"11";"3";"5917203002";"6746"
"4976";"VOTACIONES CON POCA INFORMACION";"<p>hola, me llega una carta a casa en la que en 4 lineas me explican unas propuestas pintandolas muy bonitas, sin mas informacion que datos genericos.</p>

<p>no indican lo que nos pueden costar, como lo van a hacer, que partidas se destinan para ello...</p>

<p>Increible que nos pregunten por un Proyecto para PLAZA DE ESPAÑA ¡¡¡ </p>

<p>Hemos votado en elecciones para que Expertos en el tema decidan lo mejor para Madrid, no Nosotros Ciudadanos que no sabemos que proyecto sera mas rentable para la ciudad, generara menos trafico, mas puestos de trabajo... </p>

<p>En fin, es mi opinion, me parece increible que en una cartita de 4 lineas decidamos lo que  nos ""Venden"" de manera muy bonita, como Mejor para nosotros. Sin mas datos... luego nos quejaremos de costes, impuestos, trafico, incomodidades, pero...</p>

<p>Como lo elegimos nosotros... no hay opcion.</p>

<p>gracias</p>
";"25/01/2017 13";"77";"54";"23";"25";"5917032817";"2174"
"4977";"Eliminar Presupuestos Ciudadnos, facilitar la participación no vinculante";"<p>Gracias al sobre que recibí ayer para que diera mi opinión sobre si deben salir adelante dos propuestas ciudadanas accedo a esta web y me entero de que hay ni más ni menos 100 millones de euros de presupuestos para que los ciudadanos elijan qué se quiere hacer con ellos, un 66% más que el año pasado.</p>

<p>Estoy profundamente indignada ¿Por qué existe esta bolsa a repartir en lo que decidan los ciudadanos? ¿No tiene el ayuntamiento el suficiente criterio como para determinar en qué es necesario invertirlos? ¿Por qué es mejor lo que opinen unos cuantos ciudadanos que el criterio de los políticos a quienes hemos votado y de los expertos que trabajan con ellos? ¿Este dinero es complementario al presupuesto necesario para la correcta gestión de la ciudad? En caso afirmativo, ¿por qué hemos tenido que pagar 100 millones de euros de impuestos adicionales?</p>

<p>Se me ocurren 100 millones de iniciativas a las que el ayuntamiento puede destinar este dinero no obstante creo que los ciudadanos individuales no tenemos capacidad para determinar cuál es la mejor manera de asignarlos.</p>

<p>Me parece muy positivo fomentar el debate y escuchar la opinión de los ciudadanos, de ahí a que la opinión de los ciudadanos sea vinculante hay un abismo. Para poder determinar si un proyecto es necesario para la ciudad hay que tener en cuenta muchas más cosas que las que se envían en la carta de participación. Es necesario saber cuánto cuesta, de dónde saldrá el dinero para financiarlo,  qué iniciativas se quedarán sin presupuesto por asignarlo a ésta, si está en línea con los planes del ayuntamiento y de la estrategia para la ciudad, si puede tener impacto negativo para algún colectivo, qué implicaciones tiene, qué mantenimiento requiere y por lo tanto será necesario presupuesto en años posteriores Temas que la ciudadanía carece de tiempo y conocimiento para poder evaluar.</p>

<p>Por otra parte y por curiosidad reviso los presupuestos ciudadanos de 2016, y veo que en mi barrio se han decidido varios proyectos en base a la opinión de 1500 personas, apenas un 1% de la población del barrio, y las iniciativas que se han aceptado contaban con el apoyo de entre 134 y 311 personas ¿Son estas iniciativas mejores para la ciudad de Madrid en general que las que pudiera haber propuesto el ayuntamiento? ¿Son más prioritarias las iniciativas más votadas que otras que nadie ha escrito o que el título de la propuesta no era lo suficientemente atractivo? ¿La plaza A necesitaba arreglo más urgente que la plaza B o es que nadie ha abierto una propuesta sobre la plaza B, o no se ha leído? Sinceramente, los ciudadanos no tenemos tiempo de estar todo el día leyendo debates y propuestas, y votando si deben hacerse o no.</p>

<p>Sé que, de haber comentarios a mi debate, serán mayoritariamente negativos porque en general las personas que acceden a esta web son las que están a favor del proceso y no las que están en contra o no lo conocen. Por este mismo motivo creo que la opinión de los ciudadanos no debe ser vinculante.</p>
";"25/01/2017 15";"58";"14";"44";"5";"5903287643";"-724"
"4980";"Metro o Cercanías hasta Mejorada del Campo";"<p>Extensión del Metro o Cercanías hasta Mejorada del Campo desde San Fernando o Vicálvaro.  Años y años siendo un reclamo para un municipio de 23000 habitantes que depende de Autobuses mal gestionados por la compañía Etasa junto a otros municipios adyacentes a quien también facilitaría dicha ampliación, ya que estando realmente cerca de Madrid tenemos una Red de Carreteras muy limitada dependiendo de la R-3 la gran mayoría de veces.</p>
";"26/01/2017 09";"73";"52";"21";"4";"5925058837";"2208"
"4981";"Ocupación de espacio público";"<p>Estamos dando por sentado y así se viene haciendo, que para ciertas actividades, como puestos de lotería, de periódicos y demás, por un precio establecido, se ocupe aceras en detrimento de los viandantes. En los últimos tiempos se ha incrementado, diríamos fomentado, el hacerlo con sillas y mesas, cerrándolo con paredes y techo, lo que anula la posibilidad de paso a los peatones y, el espacio entre ellos y el establecimieniento  es entorpecido con el tránsito de camareros con bandejas, aunque hay que agradecer el olorcillo que regalan. Por todo ello, se me ocurre, que igual que un bar, restaurante, mesón o demás se llame, que tiene la posibilidad de aumentar su espacio físico sin tener que comprar o alquilar local alguno, siplemente sacando sus ensereres a la calle, el resto de ciudadanos deberíamos tener la misma posibilidad de ampliar la vivienda en caso necesario, por ejemplo si viene un familiar de visita o la suegra a convivir. En estos casos, podríamos contar con montar nuestra tienda de campaña enfrente del portal y asunto resuelto. Eso sí, pagando el canon correspondiente, claro, para dar ejemplo de legalidad. ¿Apoyarías si se hiciese propuesta formal?</p>
";"27/01/2017 14";"53";"24";"29";"13";"5924625066";"-226"
"4982";"¿Madrid DF?";"<p>Con la llegada de la democracia se volvieron a recuperar las autonomías de Cataluña, Euskadi y Galicia. Por ende, el resto del territorio se desglosó en otras tantas comunidades autónomas. Se produjeron casos como el de Ávila que quería pertenecer a Madrid y el de Almería que no quería pertenecer a Andalucia. Pero hubo un caso llamativo....nadie quería Madrid.</p>

<p>Madrid siempre ha pertenecido a Castilla La Nueva, pero cuando se plantearon trocear Murcia para quitarles Albacete e incluirla en la nueva Castilla, resulta que, la nueva autonomía no quería a Madrid, ya que les iban restar importancia por el peso de Madrid. Así pués, se decidió crear a Madrid como comunidad autónoma como si fuera una región diferente a Castilla.</p>

<p>Ahora con la crisis territorial que tenemos, el PSOE saca a relucir en su programa electoral, la creación de Estados Federados. Nos convertiríamos así, como en Alemania o Mexico en una federación de territorios. En este sentido cabe preguntarse si las 17 comunidades autónomas se convertirían en un Estado. Tendríamos lo absurdo de ver La Rioja como un Estado, a Murcia como otro Estado, y lo más rídiculo aún, a Madrid como Estado, como si hubieramos sido alguna vez Reino (a diferencia de Asturias o Navarra que sí lo fueron).</p>

<p>Por tanto tiene sentido, la idea que ya manejaron los políticos en la Transición, de convertir a Madrid en un Distrito Federal, y dejar el resto de la provincia de Madrid integrada en Castilla La Mancha.</p>

<p>Madrid va creciendo paulatinamente y su corona metropolitana también. Es necesario pensar en el Madrid dentro de 50 años y hacer políticas con vistas a un futuro.</p>

<p>Dejo para este debate la pregunta de si es conveniente la absorción de todo el cinturón metropolitano de Madrid, ampliando Madrid hasta la futura M60 y crear para todo ese único término municipal, 26 Distritos Federados con autogobierno pero integrados en la ciudad de Madrid.</p>

<p>Se podrían crear Distritos de unos 250.000 habitantes, pudiendo ser por ejemplo:</p>

<p>DF1 - Centro, Arganzuela, Retiro, Chamberí               DF14 - Coslada, San Fernando</p>

<p>DF2 - Tetuan, Chamartín, Salamanca                         DF15 - Moratalaz, Vicálvaro</p>

<p>DF3 - Ciudad Lineal, Hortaleza                                    DF16 - Puente y Villa de Vallecas</p>

<p>DF4 - Fuencarral El Pardo                                           DF17 - Usera, Villaverde</p>

<p>DF5 - Moncloa Aravaca                                               DF18 - Carabanchel, La Latina</p>

<p>DF6 - Barajas, Paracuellos                                          DF19 - Pozuelo</p>

<p>DF7 - San Blas Canillejas                                            DF20 - Las Rozas, Majadahonda</p>

<p>DF8 - Boadilla                                                              DF21 - Villaviciosa</p>

<p>DF9 - Alcorcón                                                             DF22 - Leganés</p>

<p>DF10 - Getafe                                                              DF23 - Móstoles</p>

<p>DF11 - Fuenlabrada, Humanes                                    DF24 - Parla</p>

<p>DF12 - Pinto, Valdemoro                                              DF25 - Rivas, Arganda</p>

<p>DF13 - Torrejón                                                            DF26 - Alcalá</p>

<p>El resto de ciudades y pueblos quedaría dentro de la provincia de Madrid integrados dentro del Estado Federado de Castilla La Mancha.</p>

<p>Madrid DF queda sometido a un gobierno emanado del Gobierno de España sin relación con ningún Estado Federal, siendo una isla en competencias territoriales. El Presidente del Gobierno designa al Alcalde, que podrá ser impuesto por el Gobierno de la Nación o bien junto con las Elecciones Generales.</p>

<p>El funcionamiento de un Madrid DF, sería una única ciudad con un gobierno central y con distritos con una amplia autonomía propia. A nivel nacional o internacional la federación de distritos actuaría como una única ciudad, y ya dentro de la convivencia de la ciudad, cada distrito tiene su propio estatuto de funcionamiento.</p>

<p>Espero comentarios. ¿Como veis el futuro de Madrid?</p>
";"28/01/2017 00";"63";"11";"52";"7";"5927341921";"-715"
"4984";"Aparcamiento para residentes en barrio Trafalgar (Chamberí)";"<p>Existen muy pocas plazas verdes para residentes en el barrio de Trafalgar. Encima, muchas de ellas quedan periodicamente ocupadas por contenedores de obras, sacos de escombros, motocicletas de concesionarios o talleres adyacentes que no deberían estacionar en ellas, o vados que llevan años sin utilizarse. En la Glorieta Alvarez de Castro existe espacio suficiente para habilitar más plazas verdes en el centro, que de hecho son ocupadas por la gente de fuera del barrio todos los fines de semana. Además, las grandes avenidas que delimitan el barrio (Santa Engracia, Bravo Murillo, Jose Abascal) son todas zona azul, por lo que realmente son pocas las opciones para la gente residente. Necesitamos soluciones, o al menos que no nos quiten las pocas plazas verdes que ya tenemos. </p>
";"29/01/2017 01";"49";"42";"7";"3";"5954510057";"3000"
"4986";"Por seguridad NO a las motos en las aceras. Devolvamos las aceras a los peatones";"<p>Cada día las aceras de nuestra ciudad se están volviendo más agresivas e intransitables para su destinatario natural: el peatón; especialmente para las personas con alguna discapacidad. No solamente tenemos que salvar el exceso de ""mobiliario urbano"" (soportes para anunios comerciales, kioskos, farolas, bancos, papeleras, mesas y sillas de bares,etc) sino que día a día nos vemos invadidos y puesta en riesgo nuestra seguridad por los cientos de motos que circulan y aparcan a su libre albedrío sin que ni se respeten las ordenanzas municipales alr especto ni haya intervención policial que evite los riesgos para el peatón y pueda sentirse seguro en su espacio natural. Y todo ello con total impunidad.</p>

<p>Si ya cuesta entender que las ordenanzas permitan que las motos puedan utilizar las aceras para su aparcamiento quitando el espacio a los peatones,  no es admisible que lo hagan con la actual impunidad un uso caótico y un abuso en su utilización sin considerar ni respetar en absoluto el poco derecho al respecto que las ordenanzas municapales reservan para los peatones. Por toda la ciudad se ven motos aparcadas como y donde quieren, circulando incluso por la acera, pero no para recorrer el mínimo espacio para su aparcamiento y apeados los conductores de la moto sino recorriendo el trayecto que sea y, por supuesto, montados en el vehículo recorriendo todo el espacio que quieran y poniendo en riesgo a los peatones. Personalmente he sufrido el toque de alguna moto circulando por las aceras y no he sido arrollado porque yo lo he evitado no el motorista. Y no hablemos de los motoristas que usan los pasos de peatones o recorren cientos de metros por las aceras para realizar sus cambios de sentido. ¿Y qué hace la policióa municipal al repecto? No lo sé, yo no la he visto actuar cuando ha pasado por delante de decenas de motos mal aparcadas. Yo no les he visto imponer sanciones. ¿han retirado las grúas municipales las motos aparcadas indebidamente? Y el Ayuntamiento no sé para donde mirará, pero desde luego no en dirección a las motos dueñas de la ciudad.</p>

<p>Y todo ello GRATIS. Los reyes de la ciudad, los motoristas, están exentos de pagar lo que el resto de conductores tienen que soportar. ¿Por qué un motorista no tiene que pagar por aparcar y un vehículo de 4 ruedas sí? ¿Qué clase de privilegio se supone es innato al motorista? Ellos no tienen ningún problema en encontrar aparcamiento (tienen cientos, miles de metros de acera) ni tienen que molestarse en dar vueltas y vueltas hasta encontrar hueco ni preocuparse de que tienen un tiempo limitado para aparcar. Ellos son los privilegiados, los reyes que pueden (y hacen) lo que quieren. El resto de ciudadanos ya pagamos sus privilegios y ponen nuestras vidas en riesgo porque el Ayuntamiento así se lo permite.</p>

<p>RECUPEREMOS LAS ACERAS PARA LOS PEATONES. LOS VEHÍCULOS A LA CALZADA.</p>
";"01/02/2017 12";"214";"137";"77";"16";"5987378114";"3841"
"4987";"Espacio público junto al Centro Médico de Canillejas";"<ul>
	<li>En Canillejas al principio de la calle Boltaña intersección con Nicolasa Gómez encontramos dos espacios públicos que inicialmente fueron pensados para niños (tienen dos mobiliarios de paques infantiles) y que por el incivismo ciudadano, se ha convertido en el arenero de los perrros del barrio, siendo un espacio insalubre e inutilizable. Provoca suciedad, malos olores y da verdadero asco pasar por allí Solicito que el espacio sea reacondicionado como parque infantil vallado, para la correcta utilización del espacio que en su momentó se ideó a tal fin, y si esto no fuera posible, eliminar el arenero donde están orinando y defecando los perros (como a los dueños no se les sanciona...).</li>
</ul>
";"01/02/2017 17";"41";"37";"4";"1";"5991592919";"2978"
"4988";"Erratas en los proyectos finalistas";"<p>Soy yo, hay un error entre las puntuaciones y lois proyestos presentados como finalistas. ¿¿??</p>
";"01/02/2017 18";"17";"15";"2";"2";"5988201063";"1147"
"4989";"Porque un pasaje único ";"<p>En vez de un pasaje único deberían es bajar el bono con una zona única como el bono joven por todo la comunidad si de verdad quieren que se usen menos coches y eleven la calidad de vida</p>
";"01/02/2017 22";"49";"39";"10";"1";"5991633750";"2308"
"4991";"Eliminación de esta Web.";"<p>Dejemos de tirar el dinero a la basura. ¿Cuanto cuesta el mantenimiento de esta web?. Podrian dar el dinero a jóvenes emprendedores con webs mucho más útiles.</p>
";"03/02/2017 18";"223";"30";"193";"14";"5994934557";"-2192"
"4992";"Céntimo de Transporte";"<p>Céntimo de Transporte.</p>

<p>Para llegar a la gratuidad del transporte público ( financiación que exima del pago de billetes para la libre circulación de personas en el transporte público urbano), se podría instaurar el Céntimo de Transporte.</p>

<p>Según estimaciones del gobierno, entre 2002 y 2011, se recaudaron por el impuesto del  Céntimo Sanitario ( ya eliminado)...13.000 millones de euros!. Unos 1.500 millones al año : CUATRO MILLONES DE EUROS DIARIOS!.</p>

<p>El coste de explotación diario de toda la red de Metro de Madrid asciende a 287.323 ...¡Seguro que salen las cuentas!!!!.</p>

<p>Se trata de penalizar el uso del transporte privado, contaminante, en la ciudad a favor del transporte público. Usar el coche sólo para desplazamientos fuera del casco urbano. Es así de sencillo. Si quieres usar un coche contaminante en la ciudad para tu uso individual, has de ser consciente que tienes que pagar por ello para favorecer un uso más racional.</p>

<p>Penalizar entre 2 y 4 céntimos por litro, dependiendo si es gasolina o gasóleo, cubriría los gastos del Metro en la Comunidad de Madrid,...al parecer.</p>

<p>Propongo que se realice un estudio sobre los beneficios de ésta medida para alcanzar la gratuidad y libre circulación en el transporte público y concienciar, al menos cargándoles con la financiación, a los que consideran que ser ciudadano responsable, depende del nivel de ingresos, cuando en realidad, a más ingresos, menos responsabilidad social.</p>

<p>Por un transporte público, eficaz y eficiente: Vota para el  Céntimo de Transporte!.</p>

<p>Gracias.</p>

<p> </p>
";"04/02/2017 02";"51";"33";"18";"16";"6009807697";"970"
"4993";"La plaza de la Remonta para los peatones: limpia y sin hoyos";"<p>Los vecinos del barrio de Tetuan tenemos la ""gran suerte"" de contar con un especio grande con terrazas de bares y juegos infantiles, una plaza donde los niños pueden jugar, con un instituto en la propia plaza, donde los estudiantes salen en el recreo allí y un lugar del pensionista. Justo al lado de ese instituto hay una comisaría. Todo en orden si no fuera por los hoyos del suelo, la suciedad de la plaza y columpios ocasionada principalemente por tres problemas importantes:</p>

<p>1.- De forma periódica (he contado cada 15 minutos, pasa uno) la atrviesan furgonetas grandes, incluso caminones (ambos suministran a las cafeterías de la plaza) y de forma casi constante, coches de policía que aparcan en la puerta de la comisaría. Esto provoca un suelo lleno de agujeros generados por los vehículos rodados, suciedad y el correspondiente susto cuando se te escapa el crio con la bici derecho hacia el vehículo. Porque no todos van a velocidad moderada... y encima te sueltan que ""tengas más cuidado con tu hijo"".</p>

<p>2.- Siempre hay un grupo de personas desfavorecidas, algunas duermen allí, detrás de los comlumpios, que cuando están fuera de razón y no hay niños, orinan en los columpios (""ideal"" para un entorno infantil) además de las hordas de palomas que circulan por ahí.</p>

<p>3.- La plaza no se limpia, no se friega. Pasan camiones y furgonetas las que quieras, menos las que limpian las calles.... chicles y manchas negras de tiempos inmemorables... Cacas de perros de dueños incívicos...</p>

<p>Soluciones: Limpieza de la plaza en profundidad, prohibir la circulación de vehículos rodados (incluidos coches oficiales, entiendo las ambulancias pero lo demás...), arreglar los hoyos, no con parches que se levantan sino de verdad, ayudar a las personas indigentes que están allí para mostrarles otros lugares donde desarrollar su vida, sería genial que salieran de ese vicio pero no siempre es posible, pero todos debemos convivir (colocarse y orinar en otras zonas no infantiles sería lo mínimo). La plaza es enorme, cabe un sitio para perros.</p>

<p>Gracias por esta oportunidad, en gobiernos anteriores había escrito varias cartas al concejal de urbanismo pero creo que estarán en la basura...</p>

<p>Amparo Escribano.</p>
";"04/02/2017 08";"66";"63";"3";"5";"6021062394";"5727"
"4996";"PASOS DE CEBRA EN SANTA EUGENIA";"<p>Me gustaría saber el motivo de la creación de los pasos de cebra nuevos en la Avenida de Santa Eugenia. No veo mucho sentido, lo poco o mucho, que se hayan gastado en los mismos, cuando lo importante, bajo mi punto de vista, en este barrio, sería el paso al Hospital INFANTA LEONOR. A esto he de añadir, el peligro que puede ser, los pasos creados justo en la entrada al barrio desde la A3.</p>
";"05/02/2017 13";"28";"24";"4";"1";"6027252466";"1714"
"4997";"Tramo peatonal en metro Alfonso XIII";"<p>¿Qué ventajas ha reportado transformar en peatonal el tramo. de no más de 30 metros, que transcurre entre las calles de López de Hoyos y Clara del Rey, justo en la salida del metro de Alfonso XIII?</p>

<p>Al haber peatonalizado ese tramo, los vehículos que descendían por López de Hoyos y giraban allí para ir a Clara del Rey, han de continuar por López de Hoyos donde hay dos semáforos, lo que supone un gasto adicional de combustible aparte la contaminación adicional que se produce al alargar el recorrido.</p>

<p>Por otra parte el tramo que se ha peatonalizado no aporta ningún beneficio aparente, salvo que puedan colocarse terrazas por parte de alguno de los bares / restaurantes que se encuentran próximos al mismo. </p>
";"06/02/2017 13";"31";"12";"19";"9";"6023186698";"-270"
"4998";"IBI por lechugas!";"<p>IBI por lechugas!.</p>

<p>Llevo tiempo intentado promover los huertos y/o cubiertas vegetales en los edificios (http://huertosdealtura.blogspot.com.es/ ) y la pega, en toda y cada una de las comunidades de vecinos, a parte de su condición de Comunidad de Vecinos, que ya cuesta encontrar mayorías en los acuerdos, es el coste, que consideran innecesario para mejorar la calidad de vida, tanto suya cómo del resto de los ciudadanos.  1 m² de cobertura vegetal genera la cantidad de óxigeno que necesita una persona durante un año!.</p>

<p>Apoyar estas iniciativas por la administración sería casi obligatorio, pero, mientras tanto, ahí va nuestra propuesta:</p>

<p>Eximir del pago del IBI durante un periodo de 5/10 años, a aquellas viviendas que instalen un huerto en las azoteas y así financiar su instalación.</p>

<p>¡IBI por lechugas, tomates, zanahorias, berenjenas..!</p>

<p>Aprovechad ahora, que además ha subido el Catastro!!! y las verduras!!!.</p>
";"06/02/2017 14";"64";"49";"15";"10";"6038511330";"2603"
"4999";"Hurgadores de basura; hurgar contenedores.";"<p>Al inicio de la crisis, allá por 2008, me pareció empezar ver más hurgadores de basura que nunca antes. Ahora que tal vez han cambiado un poco los tiempos tengo la impresión de que continúan los mismos. Es pavoroso, y supongo que lo que menos importa es que la tapa naranja quede abierta o la basura minuciosamente extendida. Yo a veces les hablo y les ayudo a que como poco dejen la tapa cerrada; por la lluvia, por el sol, por las moscas. Ignoro si esos nuevos millones de turistas que ahora venimos teniendo los habrán visto y fotografiado con sus carrillos, sus ropas, su vara de hurgar. Perdón si a alguien le ha parecido frívolo -porque lo que no importa es el cubo:  importa esa Persona- y gracias por leerme.</p>
";"07/02/2017 08";"39";"23";"16";"10";"6039690055";"412"
"5000";"¿Sirve de algo votar?";"<p>En el Informe de Competencia que se puede leer al final de la propuesta Madrid 100% sostenible se lee El Ayuntamiento de Madrid puede intentar llevar a cabo la mayoría de las iniciativas, aunque probablemente no todas sean ejecutables a nivel municipal.</p>

<p>En el de la propuesta Billete único para el transporte público se lee: el Ayuntamiento de Madrid tiene una competencia compartida en la puesta en práctica de la propuesta, pudiendo impulsar la misma dentro del Consorcio Regional de Transportes Públicos Regulares de Madrid, aunque la decisión final será adoptada por un órgano colegiado al que el Ayuntamiento de Madrid pertenece, pero en el que no ostenta la mayoría</p>

<p>Es decir, aunque salga SI, parece que el Ayuntamiento, en el primer caso, sólo ""puede intentar"", y en el segundo caso directamente no puede.</p>
";"08/02/2017 13";"51";"44";"7";"29";"6060260547";"3192"
"5002";"SOY PENSIONISTA Y ESTOY EN CONTRA DEL CAPITAL QUE REQUERIRÁ LA OBRA DE PZ ESPAÑA";"<p>El capital que se va a desmebolsar es esencial para poder resolver muchos problemas sociales, como solventar que muchas familias con sueldos pauperrimos consigan terminar dignamente cada mes. También se podrían construir más alberges y casas de comidas sociales, cenrto de día ocupacionales para personas de la tercera edad. </p>

<p>Prioridad a las personas que lo pasan mal antes que realizar obras de restructuración. </p>

<p> </p>
";"08/02/2017 20";"73";"44";"29";"9";"6056453024";"904"
"5003";"Subrogación de personal ¡YA!";"<p>Hola a todos!</p>

<p>Soy un trabajador de uno de los seis Viveros de Empresas que tiene el Ayuntamiento de Madrid y que gestiona su Dirección General de Comercio y Emprendimiento. Se trata de una serie de centros que están gestionados por empresas privadas. Recientemente han salido los pliegos para elegir a las nuevas empresas adjudicatarias tanto para el personal administrativo, de seguridad y de limpieza. Hasta ahí todo correcto. </p>

<p>Sin embargo, es una injusticia que el personal de limpieza y de seguridad, gane la empresa que gane, tiene su puesto de trabajo asegurado porque en su caso se contempla la subrogación del personal y en el caso del equipo administrativo nos tengamos que ir al SEPE en cuanto gane otra empresa que no sea la nuestra ya que el personal que gestiona el Vivero no tiene futuro dentro de la empresa.</p>

<p>Nos sentimos totalmente abandonados por ambas partes. No trabajamos para nuestra empresa (aunque ésta nos paga las nóminas) y aunque trabajamos para el Ayuntamiento no nos sentimos parte de ellos, (lo cual repercute en el clima laboral) no somos funcionarios ni personal laboral. Estamos en un limbo y no sabemos a quién acudir.</p>

<p>Si no soy yo que por lo menos puedan disfrutar de subrogación los siguientes. </p>
";"08/02/2017 21";"41";"32";"9";"1";"6059999242";"1795"
"5004";"Pregunta 1 sobre Línea Madrid";"<p><strong>Consideras suficientemente completa y actualizada la información que ofrece Línea Madrid a través de sus diferentes canales: telefónico -010-, presencial, a través de las oficinas de atención a la ciudadanía OAC, telemático a través de www.madrid.es y la cuenta de Twitter @lineamadrid?</strong></p><p>Este debate pertenece a la Consulta previa sobre la atención a la ciudadanía de Línea Madrid.</p><p>Más información en https://decide.madrid.es/proceso/linea-madrid</p>";"09/02/2017 11";"97";"69";"28";"73";"6068447572";"2916"
"5005";"Pregunta 2 sobre Línea Madrid";"<p><strong>A la hora de realizar trámites y gestiones a través de los diferentes canales de atención de Línea Madrid ¿has recibido la información suficiente para resolver tus dudas y problemas?</strong></p><p>Este debate pertenece a la Consulta previa sobre la atención a la ciudadanía de Línea Madrid.</p><p>Más información en https://decide.madrid.es/proceso/linea-madrid</p>";"09/02/2017 11";"91";"62";"29";"61";"6067275478";"2248"
"5006";"Pregunta 3 sobre Línea Madrid";"<p><strong>¿Qué mejoras propondrías para que la atención presencial, telefónica o telemática fuera aún más accesible?</strong></p><p>Este debate pertenece a la Consulta previa sobre la atención a la ciudadanía de Línea Madrid.</p><p>Más información en https://decide.madrid.es/proceso/linea-madrid</p>";"09/02/2017 11";"48";"39";"9";"68";"6069374676";"2437"
"5007";"Pregunta 4 sobre Línea Madrid";"<p><strong>Respecto a la actividad web de Línea Madrid y en sus redes sociales ¿Qué otros servicios, informaciones o canales de participación te gustaría que se ofrecieran o cuáles crees que deberían mejorar?</strong></p><p>Este debate pertenece a la Consulta previa sobre la atención a la ciudadanía de Línea Madrid.</p><p>Más información en https://decide.madrid.es/proceso/linea-madrid</p>";"09/02/2017 11";"42";"28";"14";"20";"6064107500";"933"
"5008";"ENTENDER LAS DIFERENCIAS ENTRE LOS PROYECTOS ""X"" E ""Y"" PARA PLAZA DE ESPAÑA";"<p>ANTES QUE NADA QUIERO AGRADECER AL AYUNTAMIENTO EL PASO HISTORICO QUE SUPONE PERMITIR A LOS VECINOS DE MADRID VOTAR POR LOS PROYECTOS QUE NOS AFECTAN.</p>

<p>QUIERO COMPARTIR QUE DESDE QUE RECIBI LA CARTA AMARILLA HE SONDEADO A TODA LA GENTE QUE CONOZCO Y QUE QUIERE VOTAR SI ALGUNO ES CAPAZ DE EXPLICARME LAS DIFERENCIAS ESENCIALES ENTRE EL PROYECTO ""X"" Y EL ""Y"". NADIE ES CAPAZ. MUCHOS QUEREMOS VOTAR Y DESEAMOS LEER 5 LINEAS QUE NOS PERMITAN HACERNOS UNA IDEA MAS CLARA DE LA SITUACION. ALGUNO COMPARTÍS NUESTRA INQUIETUD?</p>
";"09/02/2017 18";"62";"56";"6";"10";"6073469789";"4516"
"5009";"Alcaldesa Irresponsable";"<p>Nada estimada alcaldesa</p>

<p>Parece que no tiene nada más que hacer aparte de gastarse los cada vez más altos impuestos con los que pago su sueldo y el de sus camaradas del Ayuntamiento. Su decisión de hacer votar a los ciudadanos las medidas que debe tomar el Gobierno Municipal son de un nivel de IRRESPONSABILIDAD jamás visto en mi vida. Señora mía, el sistema funciona de la siguiente manera: nosotros votamos una vez cada cuatro años y durante ese período uds toman las decisiones que, a su parecer, sean más adecuadas para los ciudadanos. A los 4 años o antes, si lo han hecho rematadamente mal, rendirán cuentas de nuevo en las urnas antes sus contribuyentes y pagadores de sus sueldos, dietas y demas guateques que montan a nuestra costa. Con esta nueva y socialmente tan bien vista opción de ""supuesta participación ciudadana"", lo que Ud y los suyos se asegura es que nadie podrá echarles nada en cara, ya que todas las medidas que se tomen serán por culpa de los que las votaron(y los que no lo hicieron). Estoy deseando ver el porcentaje de participación, por edades y Distritos por cierto. Esto no debería ser válido si no alcanza un nivel, al menos similar al de las votaciiones municipales. Ya sé que Ud cree que estamos tan ociosos como para votar todos los días las ideas de los iluminados de su Gobierno. La próxima vez espero que , en primer lugar, me dé la opción de gastar mis Impuestos en semejantes campañas, cartas a domicilio, publicidad en farolas y autobuses, página web...un disparate similar financiado por el de siempre, el tonto del pueblo manipulado... Absolutamente lamentable, irresponsable y un gasto indecente.</p>

<p>Mi voto, absolutamente NO a todas sus iniciativas.</p>

<p>La mía, tome Ud las decisiones y asuma las consecuencias de las mismas, o mejor aun, deje paso a los más jóvenes que están deseando desarrollarse profesionalmente.</p>

<p>Saludos</p>
";"09/02/2017 21";"155";"33";"122";"12";"6055096996";"-1894"
"5010";"Pregunta 1 sobre la nueva Ordenanza de Movilidad";"<p><strong>¿Consideras adecuado mantener el vigente texto de la Ordenanza de Movilidad, la reformarías o aprobarías una nueva?</strong></p><p>Este debate pertenece a la Consulta previa sobre la nueva Ordenanza de Movilidad.</p><p>Más información en https://decide.madrid.es/proceso/nueva-ordenanza-movilidad.</p>";"10/02/2017 11";"224";"166";"58";"151";"6081896233";"8003"
"5011";"Pregunta 2 sobre la nueva Ordenanza de Movilidad";"<p><strong>¿Estás de acuerdo en que se dé prioridad al transporte público colectivo sobre el individual privado? Si así fuera, ¿qué medidas propondrías?</strong></p><p>Este debate pertenece a la Consulta previa sobre la nueva Ordenanza de Movilidad.</p><p>Más información en https://decide.madrid.es/proceso/nueva-ordenanza-movilidad.</p>";"10/02/2017 11";"520";"446";"74";"232";"6088165906";"31906"
"5012";"Pregunta 3 sobre la nueva Ordenanza de Movilidad";"<p><strong>¿Qué medidas propondrías para incrementar la seguridad vial y mejorar el respeto entre los distintos medios de transporte?</strong></p><p>Este debate pertenece a la Consulta previa sobre la nueva Ordenanza de Movilidad.</p><p>Más información en https://decide.madrid.es/proceso/nueva-ordenanza-movilidad.</p>";"10/02/2017 11";"117";"100";"17";"138";"6083409891";"7094"
"5013";"Pregunta 4 sobre la nueva Ordenanza de Movilidad";"<p><strong>¿Qué medidas propondrías para mejorar el uso de los aparcamientos municipales de residentes, rotacionales (de uso público), mixtos y disuasorios?</strong></p><p>Este debate pertenece a la Consulta previa sobre la nueva Ordenanza de Movilidad.</p><p>Más información en https://decide.madrid.es/proceso/nueva-ordenanza-movilidad.</p>";"10/02/2017 11";"87";"67";"20";"59";"6079487137";"3619"
"5014";"Pregunta 5 sobre la nueva Ordenanza de Movilidad";"<p><strong>¿Crees que la Administración debería potenciar la movilidad peatonal y ciclista? Si así fuera, ¿cómo las fomentarías?</strong></p><p>Este debate pertenece a la Consulta previa sobre la nueva Ordenanza de Movilidad.</p><p>Más información en https://decide.madrid.es/proceso/nueva-ordenanza-movilidad.</p>";"10/02/2017 11";"368";"312";"56";"150";"6086482570";"21704"
"5015";"Pregunta 6 sobre la nueva Ordenanza de Movilidad";"<p><strong>¿Consideras oportuno que el Ayuntamiento de Madrid promueva el uso de vehículos poco contaminantes y la instalación de puntos de recarga de energías limpias (eléctrica, gas...)?</strong></p><p>Este debate pertenece a la Consulta previa sobre la nueva Ordenanza de Movilidad.</p><p>Más información en https://decide.madrid.es/proceso/nueva-ordenanza-movilidad.</p>";"10/02/2017 11";"426";"384";"42";"87";"6088510178";"30828"
"5016";"Pregunta 7 sobre la nueva Ordenanza de Movilidad";"<p><strong>¿Por dónde consideras que deberían circular los aparatos de movilidad personal como patinetes y patinetes eléctricos: por la calzada, la acera o los carriles reservados? ¿Debería limitarse su uso en determinadas zonas de la ciudad?</strong></p><p>Este debate pertenece a la Consulta previa sobre la nueva Ordenanza de Movilidad.</p><p>Más información en https://decide.madrid.es/proceso/nueva-ordenanza-movilidad.</p>";"10/02/2017 11";"161";"128";"33";"201";"6083189738";"7552"
"5017";"¿Está bien que Ahora Madrid abra debates?";"<p>Ahora Madrid suele abrir un montón de debates de una tacada, por ejemplo, hoy 10 de febrero, uno para cada una de las preguntas sobre la nueva Ordenanza de Movilidad y sobre Línea Madrid. Esto hace que copen los primeros puestos de la lista tanto si ordenas por Nuevos o por Más activos hoy. Por supuesto que puedes irte abajo del todo y buscar en la siguiente página, pero estoy seguro de que aquí pasa como en Google, que la mayoría no pasa de la primera página. Eso hace que otros debates de particulares enseguida bajen hacia abajo en la lista y ya sabemos que esta página es un monstruo de fagocitar debates y propuestas, que acaban perdidos en las profundidades internáuticas.</p>

<p>¿No podría ser que se limitara de alguna manera el número de debates que puede abrir un usuario por día, especialmente si es un partido político que ya tiene otros medios de relacionarse con los ciudadanos?</p>
";"10/02/2017 13";"193";"168";"25";"14";"6084913846";"12447"
"5019";"Los conductores-también son peatones";"<p>Tambien soy conductor abitual,pero me saca de mis casillas,conductores,que cuando estas llegando a un</p>

<p>ceda el paso,y disminulles la velocidad,por divisar un peatón,que esta dispuesto a cruzar,como el de atras,ho bien </p>

<p>se cambia al otro carril,con intención de adelantarte,ho te mete un ""pitazo"",convencido de que el tiene razón....</p>
";"11/02/2017 15";"39";"19";"20";"7";"6076672690";"-48"
"5020";"Votaciones por internet";"<p>No se puede votar por Internet las propuestas de Decide Madrid.</p>

<p>No lo entiendo. He estado siguiendo varios debates y cuando llega la hora de las votaciones, resulta que no se puede votar a través de la página. Resulta que tengo que irme a una mesa de votación.</p>

<p>Se supone que nos hemos registrado y han realizado algun tipo de comprobación. Existen bases de datos y multiples sistemas para evitar fraudes. ¿por que no los utilizan?.</p>

<p>Es una lastima porque seguro que hay muchos mas ciudadanos que como yo no van a votar en los procesos solo porque no vamos a acercarnos a una mesa. </p>

<p>Una cosa es aprovechar una tarde de sabado, despues de acostar a los niños, y ponerse al día de los debates. Otra muy distinta es utilizar el poco tiempo libre del que disponemos para ir a una mesa de votacion.</p>

<p>¿O es que solo quieren que voten los desocupados, parados y demas?</p>
";"11/02/2017 18";"82";"54";"28";"52";"6089179381";"1712"
"5022";" ¿Consideráis justo pagar por estacionar en Hospital 12 de Octubre?";"<p>Siendo usuario y teniendo como adjudicado el Hospital 12 de Octubre, me gustaría abrir el presente debate. El estado de dicho Hospital (aún siendo unos de los hospitales de referencia de España) es lamentable, paredes destrozadas, ascensores de época, asientos hechos polvo, falta de personal sanitario, servicio de limpieza mínimo......., que conste que sé que es competencia de la Comunidad de Madrid y al ser público, eso nos perjudica gobernando el PP.</p>

<p>Bien, ¿pero que me dicen de los estacionamientos?, entiendo que se instalaran parkings de pago (seguro que alguna empresa familiar se benefició) ahora, ¿por qué no se asfalta y rehabilita el gratuito que intentamos usar los madrileños que tenemos adjudicados dicho hospital? éste presenta grandes charcos, desniveles, boquetes, grietas, barrizales, etc, si a todo ésto añadimos la presencia de ""gorrilas"" los cuales si no les entregas 2 te arañan el vehículo o te pinchan los neumáticos, tenemos el caldo de cultivo perfecto para que algún día tengamos una desgracia. Hay que exigir el mismo trato para todos lo madrileños, les invito a comprobar otros hospitales públicos como el de Puerta de Hierro, comparen y vean, es ahí donde se percibe las diferencias en inversión respecto al nivel económico de sus habitantes.</p>
";"11/02/2017 21";"157";"59";"98";"15";"6073369596";"-1465"
"5023";"Mejora de Barrios ¿Hay vida más allá de la M-30?";"<p>Durante los último años se han hecho muchas mejoras en los barrios centricos de Madrid.</p>

<p> </p>

<p>Tengo un dílema. ¿Por qué siempre las inversiones de mejoría de barrios se centran en la zona centro Valgame la redundancia?</p>

<p>Igual que se ha elaborado un plan de mejora del la zona de universidad el famoso plan Tribal del triangulo ballesta, Madrid Río, el proyecto plaza de España. </p>

<p> </p>

<p>¿Qué ocurre con los barrios? por que no se fomentan los negocios locales en barrios de Madrid.</p>

<p> </p>

<p>Creo que la mejora de los barrios y la creación de más actividades como food tracks o mercados efimeros en barrios como ciudad lineal o barrio de la concepción, además de mejorar sus plazas y negocios locales, mejoraría muchisimo la ciudad , no solo ir haciendo que el centro mejore y se impulse, está muy bien y está claro que todos los turistas van allí y es una carta de presentación al mundo.</p>

<p>¿no creen que podría mejorar la imagen de Madrid si barrios aledaños al centro desmotrarán ser tan cosmopolitan e interesantes como el centro? </p>

<p> </p>

<p> </p>

<p>¿Qué ocurre con los barrios más allá de la M-30? </p>

<p> </p>

<p> </p>

<p> </p>
";"14/02/2017 09";"188";"174";"14";"5";"6124998752";"14808"
"5024";"ESTACIONAMIENTO VEHÍCULOS LOCALES COMERCIALES";"<p>Muchos comercios disponemos de nuestros vehiculos particulares para poder desplazarnos al puesto de trabajo (local comercial) Es muy complicado el poder estacionar en las distintas zonas Verdes y azules, ya que el pedriodo máximo y sus tarifas son excesivas. El motivo de utilizar nuestros vehículos es porque vivimos lejos y/o no tenemos otra posibilidad de desplazarnos que no sea nuestro propio transporte privado. Me gustaría que se pudiera poner en marcha una nueva normativa para que podamos estacionar los vehículos de los que trabajamos en locales comerciales a una tarifa fija al mes sin limitación de horario. Actualmente existe una tarifa para vehículos comerciales, pero solo es aplicable a 5 horas al día. Y el resto de horas?.</p>
";"14/02/2017 12";"44";"13";"31";"9";"6101857641";"-531"
"5025";"Instituto Público Arganzuela-Planetario";"<p>El barrio de Arganzuela-Planetario es relativamente nuevo, se han construido muchas viviendas remplazando un barrio industrial de talleres. Por ello se han acomodado muchas familias con hijos que tienen necesidades educativas.</p>

<p>Estas necesidades educativas han sido satisfechas con retraso. Se creo el Colegio Publico Tirso de Molina después de un gran debate. Ahora se necesita con urgencia un Instituto para dar continuidad a la educación de los alumnos de este colegio. Parece que hay aprobado el proyecto de creación de un nuevo instituto en el barrio pero hay mucha desinformación o ausencia de ella.</p>

<p>Me gustaría que las personas que tuvieran más información, la compartan para porder hacer más presión a la Comunidad de Madrid o Ayuntamiento y agilizar los trámites.</p>

<p>Gracias</p>

<p> </p>
";"14/02/2017 12";"78";"74";"4";"2";"6123346209";"6641"
"5026";"Union de barajas y valdebebas por pasarela o puente";"<p>Los vecinos de barajas tenemos un maravilloso nuevo parque muy cercano, en valdebebas, y hay que hacer toda una excursion para llegar a el.</p>

<p>No hay forma logica de llegar em bicicleta, ni caminando desde barajas al parque Felipe VI. Seria muy importante un puente para cruzar en coche incluso, o ya ni que decir una linea de bus que conecte barajas con valdebebas y san chinarro.</p>

<p>Creo que como minimo es necesario construir una pasarela con carril bici para que podamos llegar hasta el parque y disfrutarlo.</p>
";"14/02/2017 15";"137";"132";"5";"3";"6127047088";"12236"
"5027";"Nueva linea de la E.M.T.";"<p>Acabo de leer la ""Página del Distrito"", (portada, y página 8) correspondiente al de Vicálvaro, y editada por Comunicaciones y Servicios, S.L., que nuestro querido Ayuntamiento, ha creado e inaugurado una nueva línea de autobuses de la E.M.T., uniéndo ""Puerta de Arganda"" (Viválvaro), con la Cañada Real. Pués bién: Ante éste hecho, yo no veo de Justicia por parte del Ayuntamiento, dicha concesión, máxime cuándo los vecinos de los barrios de San Blas,- Las Rosas,- Canillejas,- Las Musas, (que cuadruplica, quiuntuplica o sextuplica la población de la Cañada Real), venimos Rogando muy encarecidamente desde hace ya muchos años al susodicho Ayuntamiento, una linea de autobús de la E.M.T., que una dichos barrios con el Hospital Ramón y Cajal, por ser de Justicia. Y yo, me pregunto: ¿Esque tienen más derechos los que ""piden por pedir"", que los que pedimos por verdadera necesidad?.</p>

<p>¿Esque tienen más y mayores privilegios los que ""trapichean"" con ciertas sustancias y los de otras etnias, que el resto de población?.</p>

<p>S no es así, que me lo expliquen.Justicia e igualdad para todos </p>

<p> </p>
";"14/02/2017 16";"29";"18";"11";"4";"6112825076";"434"
"5028";"¿Por qué el carril-bici de la calle Alcalá no termina directamente en el Retiro?";"<p>Todas las mañanas y todas las tardes circulo en mi bici por la calle Alcalá en el tramo entre la Puerta de Alcalá y la Plaza de Cibeles y me pregunto por qué no está conectado el carril bici de esta calle con el Parque del Retiro, que a su vez, está conectado con el carril bici de la calle O'Donnell.</p>

<p>La consecuencia de no estar hecha la unión (aunque fuera con un rebajamiento de la acera que está justo en la puerta del parque de El Retiro, con una señalización preferente para bicis en la propia plaza, etc) es que infinidad de bicicletas circulan por la acera de la plaza de la Independencia (Pueta de Alcalá)</p>

<p>¿Por qué no se mejora la conexión entre estos dos puntos?</p>

<p> </p>

<p> </p>
";"14/02/2017 17";"169";"156";"13";"1";"6127604311";"13200"
"5029";"Sustitución de la arena de los columpios por suelo de goma o caucho.";"<p>Los suelos de arena, hormigón o asfalto son peligrosos por las heridas que te dejan al caer o ser susceptibles de que los niños se metan en la boca arena.</p>

<p>En cambio los de caucho o goma ayudan a amortiguar las caídas, son más limpios, no se dejan charcos y se secan antes.</p>

<p>Propongo la sustición de los suelos en las zonas infantiles de columpios o zonas de ocio.</p>
";"14/02/2017 19";"167";"126";"41";"7";"6123014022";"6413"
"5030";"Carteles de la guia botanica del parque de Berlin";"<p>Los carteles de la guía botanica del parque de berlín estan hechos una porquería. Victimas de salvajismo y la mala educación están pintados la mayoría, deteriorados por el tiempo los demás. La desidia del ayuntamiento ha sido la puntilla. Propongo que se arregle y se mejore la exposición y la explicación de las plantas y árboles del parque. No debe de ser muy caro y harían un gran favor a los vecinos. Tambien se pudiera hacer alguna guía con un naturista que explicara la flora del parque tanto para niños, como para jovenes y adultos.</p>
";"14/02/2017 22";"63";"60";"3";"2";"6126411901";"5428"
"5031";"¿Es mejor una carta o una propuesta?";"<p>Supongamos que escribo una carta al Ayuntamiento pidiendo, no sé, por ejemplo que en mi calle pongan árboles. Esa carta llega a un concejal al cual le parece una petición oportuna. La aprueba y se plantan los árboles.</p>

<p>Pero imaginemos que, en lugar de escribir, hubiera decidido abrir una Propuesta en esta página. Como mi calle es pequeñita y nadie la conoce, mi propuesta no la vota casi nadie, así que no sale y mi calle se queda sin árboles.</p>

<p>Entonces, ¿es mejor escribir una carta o hacer una propuesta?</p>

<p>A algunas personas les parece que el 1% de la población es demasiado poco para decidir si algo se hace, pero ¿y las cosas que se hacen porque un solo ciudadano las ha pedido por carta y un responsable municipal ha decidido llevarla a cabo?</p>

<p>A ver si me ayudáis con este dilema que tengo. Gracias.</p>
";"15/02/2017 00";"23";"17";"6";"28";"6120195926";"813"
"5032";"Por qué los monitores de los andenes del metro tienen volumen?";"<p>Personalmente me parece una molestia completamente innecesaria, por muchísimos motivos. Tengamos en cuenta que el sentido del oído no se puede ""cerrar"" como el de la vista. Es decir, yo puedo elegir (hasta cierto punto) si me fijo en un mensaje y lo leo. Después de hacerlo, si así lo he decidido, dejo de mirar y listo. No sucede así con el sonido. Siempre está ahí, aunque no lo desees. Puse reclamaciones a metro y me respondieron que de esa manera los invidentes están en igualdad de condiciones. Como si los invidentes no tuvieran cosas más importantes en las que fijarse cuando están en un andén.</p>

<p>Uno de los principales inconvenientes del sonido de los monitores es que se nos imponen informaciones sin que (por lo dicho anteriormente) se nos dé derecho a elegir si queremos recibirlas o no. Escribí una carta a la entonces defensora del pueblo para informarla de esa vulneración del artículo 20.1 d de la Constitución Española, en el que se consagra mi derecho a dar o RECIBIR información libremente. No le pareció suficiente para darme la razón.</p>

<p>Por ello pido vuestro apoyo para ver si entre todos podamos acabar con el sonido de los monitores del metro, que yo creo que en realidad no le gusta a nadie. Ustedes dirán</p>
";"15/02/2017 03";"91";"69";"22";"12";"6124915236";"3563"
"5033";"quien decide cuantos apoyos necesita cada propuesta?";"<p>por cada propuesta que hacemos exxiste un baremo desconocido que nos marca cuantos apoyos se necesitan para sacarla a votacion,pero......quien se encarga de decidir esa cifra de apoyos??,no me parece que sea un a maquina pero seria bueno saber en que se basa quien decide esto pues por propuestas de subvenciones o fondos sociales se requieren tantos apoyos que parece que estemos pidiendo que se construya un muro entorno a Madrid con fronteras o algo asi,en cambio si lo que se propone es que quiten el nombre de un general o una estatua,la cosa cambia sustancialmente,acaso no es mas importante la ayuda social que remodelar una plaza sin problemas actuales??, acaso ayudar a madrileños con serios problemas en sus correspondientes economias es menos importante que cambiar el nombre de una calle o su numeracion??</p>
";"15/02/2017 14";"43";"33";"10";"13";"6127501201";"1765"
"5034";"ArteFacto";"<p>¿Me podría alguien informar dónde se ha consultado a los vecinos, según Rita Maestre, sobre el proyecto ArteFacto, en concreto de Valdebebas?</p>
";"15/02/2017 20";"53";"40";"13";"6";"6129917147";"2037"
"5035";"Atascos en Alberto Aguilera con Blasco de Garay";"<p>No hay un solo día en que la esquina de Alberto Aguilera con Blasco de Garay. Los conductores que van de San Bernardo hacia Arguelles se quedan en medio del cruce por los atascos de los semaforos y cuando se les pone verde a los que suben por BG se encuentran con el paso bloqueado formando mayor atasco, contaminación acústica y enfado colectivo. Regulando mejor los semaforos o con lineas amarillas para que se dieran cuenta, quiza no se armarian estos lios. </p>
";"16/02/2017 01";"36";"31";"5";"4";"6133441389";"2238"
"5036";"Madrid no es ciudad para bicis y Carmena está de acuerdo";"<p>Que Madrid no es ciudad para bicis lo han tenido claro todos los gobiernos municipales anteriores. No es problema de las cuestas, que se superan dentro del carril bici yendo a tu ritmo, no es problema del clima que es de hecho uno de los mejores de Europa al tener pocas lluvias y nada de hielo. El problema está en que los alcaldes siempre han priorizado e invertido en el coche y cuando las costuras de las calles han llegado a su límite han invertido en transporte público que en todo caso también contamina y consume cientos de millones de impuestos ya que todos los billetes están subvencionados porque el precio del billete no cubre los costes. </p>

<p>En estas ha llegado Ahora Madrid al Ayuntamiento y se habló de crear una serie de ejes estratégicos para moverse en carril bici por Madrid separados de los coches, que circulan en dichos ejes a velocidades asesinas. </p>

<p>Ha pasado un año  y medio de gobierno y ¿donde están los proyectos?. Al final Ana Botella con BiciMad y los carriles a 30 ha hecho más por la bici que Carmena. </p>

<p>¿Ha sucumbido Ahora Madrid al lobby automovilístico?, ¿será que Madrid no es ciudad para bicis? o ¿será que los madrileños no son de bici?. </p>
";"16/02/2017 10";"125";"71";"54";"40";"6133075330";"965"
"5037";" No al uso de herbicidas y talas  en el parque del Retiro ";"<p>No puedo entender que en un parque como el Retiro se esté usando herbicidas en los bordes de los viales. Una contaminación innecesaria tanto para las plantas como árboles y muy perjudicial para pajaros, perros y todo tipo de ser viviente. La tala masiva de árboles que dicen estar ""enfermos"" ( tan solo por tener señales por el paso del tiempo y su mal trato dado durante muchos años por las empresas encargadas de su mantenimiento.) Arboles que no volveran a crecer con las condiciones medioambientales de hoy en dia. Menos excavadoras y más  jardineria realizada por profesionales no por empresas de construcción.</p>
";"16/02/2017 11";"122";"103";"19";"1";"6141648511";"7091"
"5038";"Punto de Bicimad en plaza de Diego de León y Avenida de América";"<p>Hola,</p>

<p> </p>

<p>Creo que el barrio de la Guindalera carece de un punto cercano de Bicimad, estaría bien uno en el intercambiador o en la plaza de Diego de León</p>
";"16/02/2017 12";"80";"67";"13";"2";"6140188474";"4522"
"5039";"¿que coste tiene cada proyecto finalista de la Plaza España?";"<p>Tengo que votar, y no tengo ese detale para hacerlo. Segun mi opiión la inforación encontrada en multiples sitos no es completa (ni en la web del ayto. encontre ese dato) pues la verdad es que ninguno de los dos proyectos me convence como para votarlos. Asique cada cual debe decidir segun su criterio. Por lo que entonces valoro la economia local, es decir que no gastemos mucho los madrileños.</p>

<p>¿alquien me puede decir que coste tiene los dos proyectos finalistas?</p>

<p> </p>
";"16/02/2017 15";"90";"76";"14";"13";"6142312524";"5235"
"5040";"Exposición Universal en Madrid";"<p>Madrid necesita crecer económicamente para ofrecer estabilidad y bienestar a sus ciudadanos.</p>

<p>Eso se consigue atrayendo inversores que generen trabajo, servicios, ocio y cultura.</p>

<p>La red de polígonos industriales debe ser potenciada bajo una dirección política coordinada con la Comunidad Autónoma de Madrid para atraer empresas, áreas de servicio, comerciales y de ocio, que generen riqueza.</p>

<p>Pero hay otra forma de atraer inversores, y es, hacer de Madrid, un foco de atención internacional. Ya lo intentamos con las olimpiadas, pero el fracaso de no conseguirlo, nos debe hacer más fuertes para plantearnos otro reto a nivel internacional.</p>

<p>Propongo a debatir, la presentación de la candidatura de Madrid para una Exposición Universal temática, que nos pongan a nivel internacional, durante 6 meses, en el foco de la noticia de la vanguardia, la innovación y el turismo.</p>

<p>Es una forma de aglomerar lo último de la tecnología mundial junto con el conocimiento de las culturas mundiales. Es la oportunidad de promoción de nuestro país y de nuestra ciudad con el objetivo de atraer más turismo e inversores.</p>

<p>La idea es poder crear una Exposición Universal Registrada en el Oficina Internacional de Exposiciones (BIE) para que Madrid se incorpore al catálogo de ciudades expositoras.</p>

<p>La finalidad de la Expo, es dejar un legado para la posteridad en forma de arte, icono, de cualquier estructura o edificio que en el futuro represente a Madrid inequívocamente, como lo es la Torre Eiffel en París. La mayoría de las estructuras construidas son temporales y se desmontán tras su finalización. Algunos recintos expositores, se han convertido en parques o han tenido otro uso.</p>

<p>La idea es crear una Expo en la zona de Los Cerros, actualmente un montículo sin urbanizar, con un planeamiento urbano totalmente parado. Las ventajas son la utilización de este espacio sin uso y las vistas magníficas de la zona este (Madrid, Coslada, Rivas, Mejorada, Torrejón, Paracuellos). Tras el uso se puede a volver a replantear el urbanismo proyectado adaptado a las parcelas libres dejadas por los pabellones.</p>

<p>Madrid y su área metropolitana tienen casi 6 millones de habitantes, lo que la hace el tercer núcleo urbano más importante de Europa. Una gran ciudad necesita un gran proyecto que la impulse, siempre, desde la cordura de la viabilidad económica del proyecto.</p>

<p>Os dejo este tema para el debate. ¿Queréis una Expo para Madrid?</p>

<p> </p>
";"16/02/2017 23";"109";"78";"31";"3";"6142229476";"3363"
"5041";"Votación Plaza España";"<p>En el proceso de votación se da la opción de votar sí o no a todas las opciones menos a una.</p>

<p>En este proceso se nos pide votar el proyecto X o Y para modificar la Plaza de España. En otras palabras, el Ayuntamiento ha decidido modificar la Plaza sí o sí y nos pide nuestra opinión. No nos deja decidir si queremos modificar la Plaza o no. Quiere disfrazar su decisión en algo que todos debemos votar y si no votamos es que no nos interesa y tuvimos nuestra oportunidad para hacerlo. He visto esto mismo en países con regímenes totalitarios que quieren imponer sus decisiones disfrazándolas en una opinión popular y una falsa democracia.</p>

<p>Si se pide mi opinión quiero que se me de la opción de votar NO como el resto de propuestas.</p>

<p>En mi opinión la Plaza está bien como esta, transito por ella y hay un gran espacio peatonal que permite moverse a ciudadanos y turistas sin problemas. No debemos gastar el dinero en este proyecto cuando hay otras cosas importantes que hacer.</p>

<p>Existe una intención clara de hacer peatonal la Gran Vía y este es un primer paso que se quiere camuflar en una votación ciudadana.</p>

<p>Mi voto es en blanco ya que si no no puedo votar el resto de propuestas.</p>

<p>Creo que es lógico invalidar esta votación. En cualquier referéndum se pide decidir SÍ o NO y si votas SÍ te dan la opción de decidir qué proyecto deseas el X o Y. Lo normal hubiera sido esto y no lo que se ha hecho.</p>

<p>Por otro lado, hasta el momento de la votación yo no me enterado de que ha habido un montón de proyectos de remodelación de la plaza y qué proyectos había. Pero lo que me ha quedado muy claro es que en ningún momento se ha propuesto no hacerlo o debatido porque hay que hacerlo.</p>
";"17/02/2017 13";"38";"22";"16";"2";"6140845790";"347"
"5042";"REMODELACIÓN PLAZA DE ESPAÑA";"<p>Aunque agradezco al Ayuntamiento que por primera vez hayan permitido la participación ciudadana directa para decidir sobre como queremos que sea Madrid, quizás por eso, por ser la primera vez, considero que no se han hecho bien algunas cosas, en concreto la votación sobre la remodelación de la Plaza de España. No me parece bien que en la presentación de las dos propuestas finalistas no aparezca el coste de las mismas en un lugar destacado, pues para conocerlo hay que irse a las últimas páginas de la memoria final de cada una de ellas, lo que a mi juicio incumple la normativa de la Comunidad de Madrid y del propio Ayuntamiento en lo que a publicidad de los precios se refiere y al sentido común. Casi nadie compraría un artículo, aunque sea de pequeño importe, sin conocer el precio y mucho menos uno con un coste tan elevado como en este caso.</p>

<p>Me temo que muchos ciudadanos habrán votado guiados únicamente por las fotos y los videos, pensando que el coste de ambos proyectos sería similar, cuando no es así, ya que el X cuesta más del doble que el Y, si es que en éste los precios incluyen el IVA, pues aunque no lo dicen expresamente, se supone que están obligados a incluirlo.</p>

<p>Por otra parte, en el proyecto X se modifica la ubicación y creo que, aunque mínimamente, el monumento a Cervantes, sin que eso tampoco figure en un lugar destacado para conocimiento de los votantes. Además, considero que el Ayuntamiento no lo debería haber permitido, ya que dicho monumento está protegido por Patrimonio y dudo que hayan dado su permiso y en mi humilde opinión, de hacerse, se perdería una de las imágenes icónicas de Madrid, con dicho monumento y el Edificio España detrás.</p>

<p>No tengo relación ni interés alguno con el proyecto Y, y aunque sea ya un poco tarde, solicito al Ayuntamiento que aplace la adjudicación del proyecto y repita las votaciones obligando a los proyectos a cumplir unos mínimos en la información facilitada y a que el Ayuntamiento haga de forma transparente un comparativo con esos requisitos mínimos. De no hacerlo, es posible que alguien impugne la adjudicación en base a dichas irregularidades y si lo consigue, supondría un pésimo comienzo para una excelente idea.</p>
";"17/02/2017 14";"99";"66";"33";"27";"6147311867";"2200"
"5043";"Aumentar el tiempo para peatones en los semáforos de Prado-Recoletos-Castellana";"<p>En los ciclos de los semáforos del eje Prado-Recoletos-Castellana, el tiempo dedicado a los peatones es insuficiente para cruzar la avenida en un solo ciclo. Es muy frecuente ver a personas jóvenes que cruzan corriendo para conseguirlo, lo cual resulta un poco ridículo e incluso algo peligroso, para ellos y para otras personas con las que pueden tropezarse. Las personas algo mayores ni lo intentan y tienen que esperar un segundo ciclo en alguno de los setos intermedios. El problema desaparecería aumentando solo unos pocos segundos el tiempo para peatones en cada ciclo.</p>
";"17/02/2017 18";"96";"76";"20";"0";"6152153464";"4433"
"5044";"Para cuándo operación asfalto entre Aluche y Lucero?";"<p>Es increíble que aún pasado un año de la gestión del actual gobierno de Carmena, nadie se ha puesto manos a la obra, nunca mejor dicho...Para operación asfalto entre Aluche y Lucero, los baches son cráteres sin exagerar, nadie se hace cargo de un problema que conlleva un posible reventón de rueda y pone en peligro la seguridad de tod@s...</p>

<p> </p>
";"17/02/2017 22";"49";"43";"6";"5";"6153665187";"3246"
"5045";"DAR UNA VIDA DE RECORRIDO SUPERIOR A 1 AÑO A LAS PROPUESTAS.";"<p>Puesto que el ritmo de votaciones a lo largo de este último año ha sido muy lento ya que casi no se ha producido participación suficiente para recoger esos 27.064 votos (1% del censo) que se requieren para que las propuestas sean valorada por el Ayuntamiento y pasen a fase de votaciones por la ciudadanía, quisiera proponer el debate de dar una vida superior de 1 año a las propuestas para que éstas tengan la posibilidad de recoger más votos y mostrar su verdadera valía.</p>
";"18/02/2017 12";"65";"55";"10";"3";"6159808990";"3807"
"5046";"Falta de iluminación y mal estado de aceras";"<p>Desde hace unos meses, he observado una falta de iluminación en las zonas por las cuales paso todos o casi todos los días, llame al 010 y trate de exponer este problema, problema que durante este mes han ido a mas con las lluvias, ya que la falta de iluminación se ha sumado a zonas de la calzada con bordillos levantados que hacen que los peatones se lleven todo el barro/arena de los parques o zonas con árboles y arbustos ya que la acera está llena de esto. Quiero exponer que esto no solo es un problema para la seguridad de los peatones por el peligro de resbalarse con los charcos debido al mal estado de la acera y de los pasos de peatones afectando también a personas con movilidad reducida e incluso coches por el desgaste del asfalto, si no también una falta de seguridad para estos mismos debido a la falta o escasa luz en muchas zonas, en mi caso este problema se presenta a lo largo de Arturo Soria, Avenida de burgos pero también por lo que he podido ver afecta a zonas cercanas a la puerta de Alcalá. No entiendo cómo se puede pretender mejorar una ciudad añadiendo cosas nuevas, cuando las que hay ni se mejoran, ni se cuidan ... creo que lo primero es arreglar lo que hay, respecto a los temas de iluminación creo que es algo que no debería darse en ningún barrio ya que no es algo de una farola</p>
";"18/02/2017 17";"72";"71";"1";"3";"6166102665";"6902"
"5047";"¿Porque no poder acceder por cualquier puerta a los autobuses?";"<p>Yo me pregunto, porqué no es posible acceder al autobús por cualquiera de sus puertas. Desde hace muchos años lo he visto en la mayoría de los paises de Europa, esto agilizaría mucho más la Subida y bajada de viajeros, y con el debido respeto, no tener que estar esperando porque a la persona de turno no le lee el abono, desde dentro del bolso. Si la justificación que van a dar, es controlar si pagan o no, para eso están los supervisores y así mismo los conductores ni se fijan, al igual que demasiado tienen con conducir.</p>
";"19/02/2017 01";"80";"36";"44";"10";"6147539524";"-360"
"5048";"Estación de metro en Paseo de la Dirección";"<p>Los vecinos del Paseo de la Dirección, en el límite entre los barrios de Tetúan y Fuencarral-El Pardo, asistimos desde hace años a unas obras de dragados interminables. Uno de los temas que más nos preocupa es la comunicación de la zona porque con tan pocos autobuses (49, 177, 42) con unas frecuencias de paso que dejan mucho que desear, no es posible explicarse cómo es que no se previó el diseño de una nueva estación de metro que comunicara con algunas de las líneas de metro ""más cercanas"" (1, 7, 9) , que tanta falta nos hace. El punto idóneo habría sido Paseo de la Dirección con Capitán Blanco Argibay por encontarse en las inmediaciones, pero a fin de cuentas parece que ha sido más conveniente alargar la línea 9 hasta Paco de Lucía y hacer del Paseo de la Dirección un laberinto inútil que, en un sentido tiene tres inmensos carriles vacíos de coches, y en el otro, una callejuela estrecha donde no hay espacio ni para aparcamiento.</p>
";"19/02/2017 01";"39";"34";"5";"4";"6164058820";"2528"
"5049";"Administrativos del Grupo Municipal del PP";"<p>En la relación actualizada en enero de 2016 aparecen en la relación de puestos eventuales 6 administrativos del Grupo Municipal del PP y 4 Jefes de Secretaría, más una vacante.</p>

<p>¿Se trata de un error de la hoja de cálculo?</p>

<p>Si es cierto, cada jefe/a de secretaría tiene 1,5 subordinados y cuando se cubra la vacante 1,2. Si el trabajo de un jefe/a de secretaría es coordinar el trabajo de los administrativos, poco trabajo tienen en este caso...</p>

<p>¿Existe una explicación administrativa para esta situación?</p>

<p>Antonio Pérez</p>

<p> </p>

<p> </p>

<p> </p>

<p> </p>
";"19/02/2017 11";"19";"8";"11";"1";"6153328409";"-126"
"5050";"Restricción a  vehículos particulares en fin de semana Paseo de Ruperto Chapí";"<p>A pesar de que la circulación en fines de semana en el <strong><em>Paseo Ruperto Chapi</em></strong> (desde Moncloa al Puente de Los Franceses) está permitida <strong>solo para el transporte publico, y vehiculos de servicio público</strong>, cualquier persona que vaya a esta zona del <em><strong>Parque del Oeste</strong></em> puede ver como constantemente circulan coches particulares, la mayoria a bastante velocidad. A pesar de que la Policia Municipal coloca una valla donde se lee claramente la prohibición. </p>

<p>Si bien la vía no es peatonal, ya que circulan autobuses con cierta frecuencia, cualquiera que quiera montar en bicicleta, skate, patines, con cierta tranquilidad, solo o con niños, tiene que estar constantemente esquivando estos coches. Hay que agregar, que quien va a esa zona a buscar algo de calma y silencio, alejandosé un poco del trafico intenso, sufre las consecuencias de la contravención de estos conductores, con la contaminación acústica. Esta medida, implementada en su día como una forma de protección de los espacios verdes, se incumple sistematicamente, sin consecuencias para los contraventores.</p>

<p>La pregunta es: <strong>Porqué no se aumenta el control sobre los vehículos que bajan desde <em>Moncloa</em> y toman el <em>Paseo de Ruperto Chapí</em> a pesar de ver la valla con la restricción?</strong></p>
";"19/02/2017 17";"28";"18";"10";"1";"6163790727";"514"
"5051";"Mejora de parques en el barrio las Águilas";"<p>Los parques del barrio las Águilas estan en muy mal estado, necesitan invertir en ellos. </p>

<p>En el barrio viven muchos niños, la arena del parque, juegos nuevos creativos, suelo</p>

<p>de goma, pintar.</p>
";"19/02/2017 20";"43";"40";"3";"2";"6173713356";"3441"
"5052";"Reutilización y valorización en los puntos limpios";"<p>La Ley de la comunidad de Madrid sobre Residuos (L5/2003, 20 marzo), en su artículo 1 define el objeto de la ley: (...) fomentando, su reducción, su reutilización, reciclado y otras formas de valorización(...)</p>

<p>Es por ello que quisiera abrír este debate en el que se discuta la posibilidad, de dar un mayor uso de los puntos limpios, no como meros recepcionistas de residuos para después tratarlos si no como un punto de encuentro en el que se pueda reutilizar, o valorizar muchos desechos que en principio no se hace.</p>

<p>Por ejemplo, con todos los restos de poda, se puede por un lado, hacer compost  para abonar los parques públicos y no tener que comprar abonos como hace el Ayto cada año o, si sobrase tambien los ciudadanos tiene posibilidad de llevarse unos kg para sus macetas de su vivienda. Estos sería bueno que se hiciese en cada unos de los parques.</p>

<p>Los restos de Leña producto de las podas, puedan ser usado por multitud de chimeneas de leñas domesticas que existen y como en otros municipios el Ayto favorece su recogida y gestión.</p>

<p>Algunos reaparaciones domésticas se podrian solucionar tambien con alguna pieza que se encuentre en los puntos limpios.</p>

<p>Para evitar el negocio, se debería llevar un registro de las personas que hacen uso del servicio</p>

<p> </p>
";"20/02/2017 09";"60";"58";"2";"1";"6181384943";"5413"
"5053";"Estilo musical Fiestas de Primavera Hortaleza 2017 POP";"<p>¿Quieres que una de las actuaciones estelares de las Fiestas de Primavera Hortaleza 2017 sea de estilo musical <strong>POP</strong>?</p>
";"20/02/2017 16";"134";"87";"47";"2";"6177859066";"2597"
"5054";"Estilo musical Fiestas de Primavera Hortaleza 2017 ROCK";"<p>¿Quieres que una de las actuaciones estelares de las Fiestas de Primavera  Hortaleza 2017 sea el estilo musical <strong>ROCK</strong>?</p>

<p> </p>
";"20/02/2017 17";"221";"183";"38";"32";"6185661527";"12006"
"5055";"Estilo musical Fiestas de Primavera Hortaleza 2017 INDIE";"<p>¿Quieres que una de las actuaciones estelares de las Fiestas de Primavera Hortaleza 2017 sea de estilo musical <strong>INDIE</strong>?</p>
";"20/02/2017 17";"123";"50";"73";"1";"6161983819";"-934"
"5056";"Estilo musical Fiestas de Primavera Hortaleza 2017 RAP";"<p>¿Quieres que una de las actuaciones estelares de las Fiestas de Primavera Hortaleza 2017 sea de estilo musical <strong>RAP</strong>?</p>
";"20/02/2017 17";"112";"32";"80";"2";"6162692047";"-1371"
"5057";"Estilo musical Fiestas de Primavera Hortaleza 2017 MESTIZAJE";"<p>¿Quieres que una de las actuaciones estelares de las Fiestas de Primavera Hortaleza 2017 sea de estilo musical <strong>MESTIZAJE</strong>?</p>
";"20/02/2017 17";"107";"31";"76";"4";"6162687074";"-1303"
"5058";"Municipios sin cercanías";"<p>Viendo el mapa de Cercanías y las poblaciones de muchos municipios, me sorprende que muchos municipios se encuentren sin tren. Mi debate es acerca de cómo interconectaríais estos municipios tanto con la red de Cercanías como con la red de Metro. Ampliaría el tren a los siguientes municipios:</p>

<p>-Rivas Vaciamadrid. 80483.</p>

<p>-Arganda. 55307</p>

<p>-Boadilla del Monte. 47856</p>

<p>-Villaviciosa de Odón. 26911</p>

<p>-Villanueva de la Cañada. 18827</p>

<p>-San Agustín de Guadalix. 12953</p>

<p>-Brunete. 10188</p>

<p>-Algete. 20102</p>

<p>-Paracuellos del Jarama. 21178</p>

<p>Según estos datos me llama la atención como Boadilla, Rivas y Arganda no tienen Cercanías, me gustaría saber tambien cuales son los criterios que se siguen para impulsar el tren a unas zonas y no a otras. ¿Deseos ocultos como vender pisos, tipo la Teneria II? ¿Porqué existen municipios con poblaciones como El Escorial (15000) con tren y otras como Rivas (80000) que no disponen del mismo? ¿Sería factible llevar el tren a zonas nuevas de Madrid como El Ensanche de Vallecas, Paracuellos, las Tablas o el PAU de Carabanchel?</p>
";"21/02/2017 02";"34";"27";"7";"3";"6181783870";"1588"
"5059";"Prohibición publicidad en lunas de coches.";"<p>Si queremos volver a tener el Madrid limpio de hace muchos años, habrá que empezar por evitar aspectos que la ensucien. Cada día al coger el coche me encuentro con 3 ó 4 panfletos en el parabrisas, manilla de la puerta..., aunque yo lo tiro a la papelera de turno, no todo el mundo hace lo mismo, con lo cual propongo prohibir ese tipo de publicidad, a parte de no tocar el tema que dicha publicidad suele ir orientada a un público mayor de edad, y me hace poca gracia que mis hijos tengan que verla.</p>
";"21/02/2017 12";"176";"168";"8";"6";"6196681921";"15272"
"5060";"Polideportivo en Barajas";"<p>Se esta empezando la <strong>construcción</strong> un Polideportivo nuevo en Barajas, concretamente en el espacio que da a la M11. Inicialmente era zona verde y ahora, de repente, van a construir un polideportivo.<strong> Zona verde</strong> que esta repleta de pajaros de miles de especies y esta contrucción significa que se tendrán que ir de ahi y esto supone un deterioro del medioambiente. Tanto que el Ayuntamiento de Podemos definde este tipo de ataques medioambientales.... por qué ahora hace esto??????</p>

<p>Gracias.</p>
";"21/02/2017 13";"28";"19";"9";"0";"6182813386";"678"
"5061";"Exámen para dueño y perro de ppp entrenados";"<p>Me encantan los pitbulls y entiendo que no son agresivos de nacimiento, aún así opino que no está mal la legislación contra PPP(perros potencialmente peligrosos), por que no es lo mismo maleducar a un chihuahua que a un pitbull, ya que estamos hablando de un perro MUY POTENTE que como algún inconsciente lo enseñe a ser agresivo, el perro pasaría a ser muy peligroso, cabe decir que esto es así con cualquier raza, a cualquier perro le puedes enseñar a atacar y a ser agresivo, no solo a los ppp.</p>

<p>También es verdad que somos muchos los que nos esforzamos hasta el límite por hacer de nuestro pitbull (o cualquier ppp) el mejor perro del mundo, que no haría daño ni a un gorrión, y duele el no poder pasearle como al resto.</p>

<p>Es por esto que propongo que se organice exámenes/pruebas a los dueños y a los perros, pagados por el dueño, que evaluen si ese perro con ese dueño supone una amenaza para lo sociedad, pruebas psicológicas, de estrés, de sorpresa, etc... todo lo necesario para asegurarse de que ese perro es inofensivo y de que el dueño conoce cómo actuar con su perro. Luego ya se pueden poner renovaciones anuales o lo que sea.</p>

<p>Estoy seguro de que a muchos nos encantaría que nos dieran la oportunidad de probar que no es el perro el peligroso, sino el dueño el que lo hace así.</p>
";"21/02/2017 15";"93";"90";"3";"14";"6195668338";"8419"
"5062";"Solo votaciones electrónicas";"<p>Creo que tendría sentido eliminar todo el papel que sea posible de las votaciones, ya que ahorraríamos en:</p>

<p>- Coste económico de imprimir, repartir y destruir las papeletas.</p>

<p>- Coste de personal y tiempo de contar las papeletas</p>

<p>- Coste medioambiental de las papeletas</p>

<p>Con instalar equipos en las oficinas de votación, donde cada votante se registra en esta web y vota (con la ayuda y un modo de validación inmediato). O en su defecto usa su DNI/DNI electrónico como identificación directa (sin registro) para la votación</p>

<p>Cada votación menos gente tendría que desplazarse a un centro de votación, ya que una vez registrados y familiarizados votarían en sus domicilios, con lo que menos voluntarios serian necesarios.</p>

<p>Ademas se tendrían los resultados de forma inmediata.</p>
";"21/02/2017 15";"97";"62";"35";"21";"6186545991";"1725"
"5063";"Estancamiento del agua en ciudad de los ángeles";"<p>Hace más de un año que di el último parte a la junta del distrito de villaverde, en el barrio de ciudad de los angeles, por el motivo del estancamiento de agua que se producen en los aparcamientos sitados al final de la Calle Hermandad de Donantes de Sangre. Desde hace años, las raices de los árboles han provocado el abultamiento del asfalto imposibilitando la salida del agua de los aparcamientos. Se imaginarán que cuando llueve el nivel del agua alcanza la altura de los tobillos durante días, se sube a la acera, hasta que termina filtrándose por el suelo y evaporándose. Son en total una veintena de huecos de aparcamiento que quedan inservibles durante días. Si a esto le sumamos las hojas de los árboles, que estas navidades cubrían todo hasta el hecho de no verse el agua, la basura (evidentemente los barrenderos no lo limpian porque no pueden entrar), y el mal olor la situación es totalmente tercermundista. </p>

<p>A mí me gustaría que me aconsejaran qué puedo hacer para que nos arreglen esto. Aquí vivimos más de 150 familias que tenemos derecho a vivir de una forma digna. </p>

<p>Esto ha salido en la televisión, en Telemadrid, pero por lo visto les da igual...</p>

<p> </p>

<p>Gracias</p>
";"22/02/2017 00";"27";"25";"2";"0";"6193147696";"2129"
"5064";"MAYOR INFORMACIÓN EN LAS PAPELETAS PARA LA DECISIÓN DE LAS PROPUESTAS DEL AYTO";"<p>Debido a las propuestas que se están lanzando, y como seguirá siendo así, propongo que en las papeletas pongan la información necesaria para poder votar con conocimiento de causa.</p>

<p>Considero que esto es algo MUY NECESARIO.</p>
";"22/02/2017 11";"55";"46";"9";"4";"6198336513";"3094"
"5065";"Propuesta de un nuevo modelo de lotería para la ciudad";"<p>Abro este debate sobre la necesidad de un nuevo modelo de lotería para la ciudad, cuyo concepto sería radicalmente diferente a la lotería actual. Si en el debate este proyecto no es capaz de reunir al menos el 80% de apoyos, consideraría que la ciudad no está preparada para este nuevo modelo de lotería y por lo tanto, no lo subiría a modo de propuesta.  A continuación expongo mi argumentación sobre la importacia de implementar este nuevo concepto de lotería:</p>

<p><strong> Una lotería basada en el no-derroche </strong>   </p>

<p> La lotería propuesta, llamemosla Lotería Futura, es un invento social,  como lo ha sido la seguridad social, la sanidad universal o la educación pública, la prestación por desempleo, o en un futuro próximo la renta básica universal e incondicional.</p>

<p><strong>    Una lotería cualitativa</strong>  </p>

<p>De la lotería cuantitativa actual a la lotería cualitativa futura.  Una es acumulativa y la otra es expansiva.  Mientras el agraciado de la lotería del pasado se replegaba sobre sí mismo, en la lotería del futuro despliega sus potencias sobre la sociedad. La lotería futura es una nueva infraestructura, y a la larga afectará a nuestro pensamiento y mirada sobre el mundo.      </p>

<p><strong>El boleto inclusivo</strong></p>

<p> Hay diferentes maneras de conseguir un boleto de la lotería futura. El más sorprendente es aquel en el que, por el solo hecho de ser ciudadano, cualquiera juega: ""Todo el mundo juega, aunque no quiera""  La lotería es un reflejo del modelo de sociedad en la que se vive. Por el hecho de existir, participamos en la vida social, estamos jugando. En la lotería propuesta, ocurre exactamente lo mismo. Por el simple hecho de ser ciudadano, adquieres un boleto. Nadie tiene que ir a comprarlo, se le es asignado al nacer. Si usted es agraciado con algún premio, la administración de lotería se encargará de comunicárselo.  </p>

<p>Pero también hay otras formas de adquirir la fortuna de la lotería futura. Por ejemplo; al realizar cualquier actividad orientada al bien común, desde plantar un árbol,  barrer las calles, o donar libros a la biblioteca, por ejemplo. Al participar en la mejora de lo común, se entra en juego inmediatamente. Todos entramos en juego, nadie es excluido.  </p>

<p> Como cualquier otra lotería, el boleto de la lotería futura también puede comprarse.</p>

<p><strong>Premios</strong></p>

<p>Los premios son el reflejo del tipo de sociedad que se desea. El premio no es cuantitativo, sino cualitativo. Es un premio que permite desarrollar las potencias latentes del individuo, y que más tarde acabarán revertiendo también en el conjunto de la sociedad. De hecho, el premio consiste en múltiples premios para el agraciado. No hay segundos ni terceros premios.  </p>

<p><strong>El premio podría consistir en: </strong></p>

<p>-<em><strong> Una renta incondicional mensual suficiente, no inferior al umbral de la pobreza,</strong></em>  Con el fin, si lo desea el agraciado, de obtener tiempo libre mediante el cual sacar a la luz sus potencialidades. Este ingreso será compatible con otras rentas siempre y cuando no superen en cuantía el premio. Ya hemos dicho que este premio no es acumulativo.</p>

<p><strong><em>- Un piso en usufructo.</em></strong>  La sociedad permite al agraciado el uso de un piso que no puede enajenarse ni alquilarse, y que pasará de nuevo a la sociedad tras el fallecimiento del agraciado. En él , el agraciado podrá relajarse, olvidarse de hipotecas o rentas de alquiler. Esta tranquilidad permitirá al beneficiario trabajar creativamente, estudiar, prepararse, sacar lo mejor que hay en él. Le ayudará a obtener más tiempo, más tiempo libre si lo desea. Volvemos a comentarlo, este es un piso que no podrá acumularse. Es un piso de uso. Si ya tiene uno, deberá elegir. Recuerdo que este premio no es para tener más, sino para ser más.</p>

<p><strong><em>- Acceso al transporte</em></strong>  Abono transporte anual intermodal para toda la vida, autobús, metro, tren, e incluye una cantidad limitada de viajes anuales en taxi, así como una bicicleta o patinete, a elegir por el agraciado. No sólo supondrá un sustancial ahorro energético y medioambiental, sino que a la larga evitará alguna de las enfermedades derivadas de la vida moderna. </p>

<p><strong><em>- Acceso a museos y exposiciones</em></strong> Tarifa plana para todos los museos, teatros y exposiciones del gran Mandril, incluido el museo de cera.</p>

<p><em><strong>- Acceso al saber</strong></em>  Matricula y cuotas mensuales gratuita para todo tipo de enseñanzas o cursos, de cualquier índole, que decida realizar a lo largo de su vida el agraciado, eso, o al menos un descuento del 98%.</p>

<p><strong><em>- Comida garantizada </em></strong>Menú del día garantizado. Ya no estará forzado a la compra a diaria o a cocinar con desgana. Dispondrá de más tiempo libre para sus cosas. Cosas que más tarde podremos todos disfrutarlas.</p>

<p><strong><em>- Posibilidad de un viaje anual cada siete años </em></strong> Se iniciaría así, por fin, la posibilidad de comenzar a viajar de verdad, en vez de practicar el turismo insostenible de masas. En un viaje así seguro que es posible conocer a las gentes del país, hablar su idioma, e integrarse. Por fin uno se vuelve viajero y regresa diferente, con nuevos saberes que puede compartir con sus conciudadanos. creo que este tipo de premio, mejora la calidad estética del viajero, y su deplorable aspecto de invasor neocolonial.</p>

<p>La propuesta completa se puede encontrar en http://dominguet.blogspot.com.es/2017/01/propuesta-para-un-nuevo-modelo-de.html</p>
";"22/02/2017 20";"52";"15";"37";"35";"6184710220";"-634"
"5066";"QUE LOS CONTROLADORES DEL S.E.R. APORTEN FOTOGRAFÍAS PARA EVITAR ERRORES";"<p>Me han multado por una infracción grave de aparcamiento en un lugar y una fecha que nunca he estado. Según me han dicho no tengo manera fehaciente de demostrar que mi vehículo estaba en otro lugar salvo que aporte un ticket de un parking con lectura de matrículas o similar. </p>

<p>Se me plantea el dilema de recurrir y perder la bonificación del 50% o pagar sin rechistar. Porque si el controlador de la S.E.R. se ratifica, y al parecer lo hacen sin mirar siquiera el boletín recurrido, me tocará pagar los 200 euros indicados para esa infracción.</p>

<p>En mi opinión no debería ser yo el que ha de demostrar mi inocencia sino el acusador el que debería aportar pruebas de mi culpabilidad.</p>

<p>Abogo y pido apoyos para que los controladores de la S.E.R. hagan fotografías de los vehículos infractores para evitar errores.</p>

<p>Saludos.</p>
";"23/02/2017 10";"141";"134";"7";"10";"6214682679";"12069"
"5068";"Queremos una Estatua del General Millán Astray en el Consistorio";"<p>El General Millán Astray fue un militar muy vinculado a la Capital de España. Aquí fundó el Barrio de La Legión Española en 1924 donde se instalaron familias muy humildes y trabajadoras. Gracias a la Creación de La Legión Española en 1920, miles y miles de jóvenes madrileños de las capas sociales más desfavorecidas consiguieron evitar ir a Africa como soldados forzosos a morir. El General Millán Astray consiguió parar las sacas de presos republicanos al comienzo de la Guerra Civil en ciudades como Salamanca. Durante la dura posguerra, el General se volcó en la ayuda asistencial de los barrios más humildes de Madrid, como el de ""Las Latas"" en Vallecas. El sí que iba a esos barrios a dar de comer a los necesitados y no como Manuela Carmena o Paca Sauquillo que van allí a hacerse la foto y luego se van a disfrutar de sus lujosas vidas de ""la izquierda del caviar"". Finalmente todo lo que se dice sobre el enfrentamiento con Unamuno es pura mentira.  http://gaceta.es/noticias/mentira-enfrentamiento-unamuno-millan-astray-salamanca-24022017-1747</p>

<p>Por eso, en agradecimiento y desagravio, proponemos que se erija una estatua del General enfrente del nuevo Consistorio de Madrid</p>
";"26/02/2017 11";"246";"126";"120";"57";"6231638790";"307"
"5071";"Acabar con la democracia participativa. ¿1,1 millones de euros?";"<p>Ha quedado más que claro que la democracia participativa es una estafa a los ciudadanos y solo debemos usarla una vez más para acabar con ella.</p>

<p>Hechos:</p>

<p>- Cuesta un dinero que no podemos permitirnos.</p>

<p>- Es un método descarado para que los políticos no asuman responsabilidades y se las traspasen a los ciudadanos (que no cobramos por ello, encima pagamos).</p>

<p>- Es una farsa, el truco del trilero de la bolita, ya que solo se nos pregunta por asuntos que no tienen relevancia (parques), que el ente que pregunta no puede llevar a cabo (billete único) o que, como he dicho, el político de turno no tiene los arrestos para realizarlo bajo su responsabilidad.</p>

<p>- No se nos pregunta por temas que los políticos tienen muy claros (como los impuestos que pagamos) o que saben que no podrán solucionar ( como la limpieza de la ciudad). ¿A que no veremos una consulta sobre si queremos pagar el IBI?.</p>

<p>- Es un fracaso participativo. Cualquier consulta con menos del 50% de apoyo por parte del total de votantes deja de ser ""ciudadana"" y se convierte en selectiva. Y en estas consultas han votado un 8% de madrileños.</p>

<p>- Las preguntas tienen una elevada carga demagógica y absurda. ¿Quiere que Madrid sea una ciudad sostenible?....Por favor...esperemos que la siguiente no sea ¿Quiere que la gente sea feliz en Madrid?....¿Quiere que se acaben las guerras en el mundo?... No preguntes si Madrid tiene que ser sostenible, HAZ de Madrid una ciudad sostenible.</p>

<p>- Y esta la repito porque me parece muy importante. Es un gasto desorbitado y absurdo. ¿Cuantas cosas útiles se podrían hacer con 1.100.000 ?. A cuanta gente se podría ayudar si en vez de esto de la farsa de la democracia participativa, nuestros políticos del ayuntamiento hicieran su trabajo, que no es otro que el tomar decisiones. ¿Acaso no les votamos para que hicieran eso?</p>

<p>Opiniones:</p>

<p>- Y en este caso encima el Ayuntamiento usa para la realización de la consulta a una empresa muy vinculada a Podemos...¿existió concurso?.</p>
";"28/02/2017 08";"139";"39";"100";"16";"6238729276";"-1711"
"5072";"El General Millán Astray y Terreros";"<p>Queremos una estatuta del General D.José Millán Astray y Terreros en ek consistorio de Madrid.</p>

<p>Es una figura Legendaria en la historia de España y la cual dejó gran solidaridad por donde pasó durante el transcurso de su vida.</p>

<p>VIVA MILLÀN ASTRAY!!!</p>
";"28/02/2017 18";"104";"29";"75";"5";"6243599489";"-1282"
"5074";"FACILIDAD PARA ENCONTRAR PISO Y/O HABITACIONES CON ANIMALES";"<p>Me parece indignante por no decir más cosas que más del 80% de los pisos que hay en alquiler no admiten animales, su excusa es simple, destrozan cosas. </p>

<p>Creo que en un sociedad que nos creemos libres de prejuicios, que nos encantan ver vídeos de gatitos y perritos, dónde en cada familia, incluso alguna vez en nuestras vídas hemos tenido mascota, se nos prohíba vivir con los seres que más amamos, y que los tilden de salvajes.</p>

<p>Yo tengo mascota, aunque para mí son mi familia, y son más limpios (los gatos se pasan el día aseándose, los perros se bañan...), más educados con las visitas, amables que toda mi familia y caseros que me he encontrado en mi vida.</p>

<p>Ellos saben dónde deben hacer sus necesidades, saben que no deben romper las cosas y hacer ruido, son animales si, pero educados, cosa que no puedo decir de la mayoría de personas que veo a diario, maleducados, groseros, ensuciando las calles, los baños públicos, gritan... </p>

<p>Se perfectamente que si mi mascota rompe algo yo debo repararlo o pagarlo, pero prohibirnos vivir con ellos muchas veces implica que otras personas en circunstancias límite abandonen a sus mascotas (no pretendo defender el abandono, pero SÍ QUE ES CIERTO QUE ES UNA DE LAS CAUSAS).</p>

<p>Por eso pido que se nos facilite alguna ley, reforma, para poder vivir tranquilamente con los seres que amamos.</p>
";"28/02/2017 23";"75";"30";"45";"2";"6245580404";"-600"
"5075";"Abono transporte jubilados menores de 65 años";"<p>Las personas que estamos jubiladas, anticipadamente por obligación, no tenemos prácticamente ninguna ventaja</p>
";"01/03/2017 14";"99";"74";"25";"3";"6269120863";"3662"
"5076";"Madrid Río por la m-30 zona norte";"<p>Continuar con el soterramiento de la m-30 y Madrid Río por la zona norte</p>
";"01/03/2017 23";"84";"67";"17";"1";"6273775949";"3988"
"5077";"Carriles bici útiles";"<p>Favorecer el transporte en bici por Madrid con carriles bici que permitan desplazarse de forma rápida y segura. </p>
";"01/03/2017 23";"107";"89";"18";"2";"6275680626";"5905"
"5078";"Las motos aparcadas en zona SER que paguen su tasa por ocupar sitio de coches";"<p>Las motos que aparcan muchas veces con la pillería para reservar sitio en zona verde, deberían pagar tasa de aparcamiento ya que estan quitando el espacio de los que pagan su tasa anual, bastante es que al ensanchar las esquinas en vez de poner bancos para las personas que tienen movilidad reducia se llenan de motos y lo único que se consigue es otra dificultad añadida a los transeuntes.</p>
";"03/03/2017 12";"113";"83";"30";"9";"6288539013";"3892"
"5079";"https://decide.madrid.es/proposals/16776-rehabilitacion-de-vista-alegre-ya";"<p>Donde estan las Asociaciones de Vecinos de Carabanchel? Es ahora!!! Devuelvan de una vez -Ayuntamiento de Madrid y Comunidad de Madrid- el parque historico de aVista Alegre a los habitantes de la ciudad.</p>
";"03/03/2017 16";"25";"21";"4";"1";"6287860299";"1428"
"5081";" PONER PUNTO BICIMAD EN MARQUES DE VADILLO";"<p>Apesar de la cercania con Madrid Rio, en la plaza de  Marques de vadillo no hay un punto de Bicimad, lo que dificulta a los vecinos de esa zona a utilizar ese servicio.   </p>
";"04/03/2017 11";"57";"43";"14";"3";"6296264691";"2187"
"5083";"Pregunta 1 sobre la conservación y rehabilitación de edificios";"<p><strong>¿Consideras que las inversiones en conservación de los edificios suponen una mejora de su calidad y de las condiciones de confort y habitabilidad?</strong></p><p>Este debate pertenece a la Consulta previa sobre la conservación y rehabilitación de edificios.</p><p>Más información en https://decide.madrid.es/proceso/conservacion-rehabilitacion-edificios</p>";"06/03/2017 00";"229";"220";"9";"27";"6322937687";"20270"
"5084";"Pregunta 2 sobre la conservación y rehabilitación de edificios";"<p><strong>¿Compartes la idea de que la falta de conservación de los edificios afecta a la seguridad del conjunto de los ciudadanos?</strong></p><p>Este debate pertenece a la Consulta previa sobre la conservación y rehabilitación de edificios.</p><p>Más información en https://decide.madrid.es/proceso/conservacion-rehabilitacion-edificios</p>";"06/03/2017 00";"188";"178";"10";"14";"6321636584";"15906"
"5085";"Pregunta 3 sobre la conservación y rehabilitación de edificios";"<p><strong>¿Sabes que el deber de conservación de los edificios corresponde a sus propietarios?</strong></p><p>Este debate pertenece a la Consulta previa sobre la conservación y rehabilitación de edificios.</p><p>Más información en https://decide.madrid.es/proceso/conservacion-rehabilitacion-edificios</p>";"06/03/2017 00";"161";"135";"26";"18";"6317756577";"9139"
"5086";"Pregunta 4 sobre la conservación y rehabilitación de edificios";"<p><strong>¿Consideras que el sistema de concienciación, anticipación y disciplina y realización de obras de conservación derivadas de la Inspección Técnica de los Edificios (ITE) ha funcionado eficazmente?</strong></p><p>Este debate pertenece a la Consulta previa sobre la conservación y rehabilitación de edificios.</p><p>Más información en https://decide.madrid.es/proceso/conservacion-rehabilitacion-edificios</p>";"06/03/2017 00";"102";"18";"84";"17";"6296834088";"-1164"
"5087";"Pregunta 5 sobre la conservación y rehabilitación de edificios";"<p><strong>¿Estás de acuerdo con ampliar las comprobaciones de la Inspección Técnica de los Edificios (ITE) con pruebas y ensayos con el fin de asegurar la seguridad de todos aunque suponga un aumento de su coste?</strong></p><p>Este debate pertenece a la Consulta previa sobre la conservación y rehabilitación de edificios.</p><p>Más información en https://decide.madrid.es/proceso/conservacion-rehabilitacion-edificios</p>";"06/03/2017 00";"135";"114";"21";"16";"6317300029";"7853"
"5088";"Pregunta 6 sobre la conservación y rehabilitación de edificios";"<p><strong>La ley obliga a la instalación de medidas de accesibilidad en los edificios (colocación de ascensores, rampas, etc.), ¿ves viable lograr un consenso entre los vecinos de tu edificio para lograrlo? ¿cuánto estarías dispuesto a invertir para mejorar la accesibilidad de tu vivienda?</strong></p><p>Este debate pertenece a la Consulta previa sobre la conservación y rehabilitación de edificios.</p><p>Más información en https://decide.madrid.es/proceso/conservacion-rehabilitacion-edificios</p>";"06/03/2017 00";"102";"66";"36";"20";"6310595332";"1941"
"5089";"Pregunta 7 sobre la conservación y rehabilitación de edificios";"<p><strong>¿Crees que el estado de conservación de las fachadas de los edificios afecta a la imagen de tu ciudad?</strong></p><p>Este debate pertenece a la Consulta previa sobre la conservación y rehabilitación de edificios.</p><p>Más información en https://decide.madrid.es/proceso/conservacion-rehabilitacion-edificios</p>";"06/03/2017 00";"189";"183";"6";"31";"6322415479";"17138"
"5090";"Pregunta 8 sobre la conservación y rehabilitación de edificios";"<p><strong>¿Tienes otras sugerencias para la mejora de la ordenanza?</strong></p><p>Este debate pertenece a la Consulta previa sobre la conservación y rehabilitación de edificios.</p><p>Más información en https://decide.madrid.es/proceso/conservacion-rehabilitacion-edificios</p>";"06/03/2017 00";"30";"15";"15";"38";"6305776052";"0"
"5091";"Exigir a las electricas dueñas de torretas electricas en vía pública soterrarlas";"<p>Existen una gran cantidad de torretas eléctricas en la vía pública, en parques, aceras, muchas de ellas impiden el paso como puede ser en Ciudad Lineal, además del afeamiento que produce en la ciudad.</p>

<p>La ley del Suelo de la Comunidad de Madrid, expone que las instalaciones u obras hechas sin licencia no prescriben nunca si estan situados en espaciós públcios o zonas verdes. Por ello es facil requerir a los titulares de las torretas, que éstas sean soterradas con la preceptiva licencia municipal de cala.</p>

<p>El debate es hasta cuando el Ayuntamiento no va a exigir que se soterren las lineas electricas, no entiendo que teniendo toda la normativa de nuestro lado se deje de ejercer ese derecho, máxime con los grandes beneficios que tienen las eléctricas.</p>

<p> </p>
";"06/03/2017 13";"101";"97";"4";"3";"6325154136";"8931"
"5093";"Procesionarias";"<p>Como dueña de perros toda mi vida, en ésta época del año todos los que tenemos perros lo pasamos muy mal, llega un momento que no puedes pasear por las calles de la Colonia Virgen de la Esperanza (Canillas) ¿no hay una forma de poder exterminar los capullos de los pinos antes de que eclosionen? he preguntado a los jardineros de la colonia y me han dicho que es cosa del Ayuntamiento?</p>
";"07/03/2017 10";"66";"61";"5";"3";"6331181106";"5175"
"5095";"¡¡¡¡Usa tranporte público!!!! ";"<p>Como se puede promover el transporte público y al mismo tiempo estropearlo.</p>

<p>Siempre he creído que mejorándolo la gente puede optar por él pero en el Ayuntamiento y Comunidad deben pensar todo lo contrario.</p>

<p>La frecuencia del metro lleva muchos años siendo un desastre aunque sí tengo que decir que en los últimos meses ha mejorado disminuyendo el tiempo de espera entre tren y tren pero ahora esta enfermedad se le ha contagiado a líneas de autobuses de la EMT que funcionaban bien y que han dejado de hacerlo. </p>

<p>En el caso que expongo no sé si es debido a la rivalidad existente entre los gobiernos que gestionan la Comunidad y el Ayuntamiento o a que este último ha decidido ahorrar eliminando servicio de un autobús que funcionaba estupendamente. Desde el verano pasado el 115 que tenía una frecuencia de 5 minutos (a veces menos) entre autobuses ha pasado a no bajar de 10 minutos en muchas ocasiones supera los 20. Se agrava todo esto con el cierre de la línea 8 por obras lo que hace que el transito de clientes sea mayor. </p>

<p>Igual el ayuntamiento ha pensado que es una forma de reducir servicio asociándolo a otro estado del transporte y así cuando se abra el metro todos diremos ¡Que bien! aunque las condiciones sigan siendo nefastas pero compartidas con menos gente pues ya hay mucha que irá en Metro.</p>

<p>¿Es normal que en el intercambiador de Avenida de America haya esperando una cola de gente que llena el autobus y espere 5 minutos para arrancar?. Esto no lo he visto nunca en los muchos años que hago uso de él.</p>

<p>En paradas coincidentes con el 114 antes veía pasar alguno o niguno de estos y ahora hay días que veo pasar hasta 3 autobuses 114.</p>

<p>Mucha campaña de peatonalización del Centro y desde luego gestionando así el transporte vamos a morir en el intento cada vez que queramos acercarnos sin un vehículo privado.</p>

<p> </p>
";"07/03/2017 21";"100";"90";"10";"1";"6336605692";"7200"
"5097";"Numero de votaciones necesarias";"Es exagerado conseguir 27,064 votos en un año para que una propuesta llegue a tenerse en cuenta...son 2,255 al mes ...o 75 votos al dia...POR FAVOR ADMINISTRADORES LEAN ESTO.

<p>Puedo entender que este portal esté casi empezando pero de momento no veo ningun otro sitio donde dirigirme a los administradores del portal. En el mes de abril van a desaparecer 7 propuestas de las 10 mas votadas por superar el año de su creacion. A dia de hoy la mas votada lleva 7720 votos. En cosa de 1 mes ninguna de estas propuestas veran la luz ya que no llegaran a los 27,064 votos ni por asomo...Entonces yo me pregunto ¿para que sirve este portal?...No sabemos cuanta gente hay registrada y de esa gente registrada no sabemos cuantos son activos y cuantos se han conectado una sola vez y no lo han vuelto a hacer nunca mas...Vuelvo a preguntarme ¿para que sirve esto?¿para que crear una propuesta que nunca vera la luz?¿para que ver propuestas buenas y malas si nunca se tendran en cuenta?...Voy a tomar una determinacion y es que si no recibo aqui o en otro sitio donde pueda verlo todo el mundo alguna contestacion en este sentido por parte de los administradores me negare a colaborar con este portal desapareciendo totalmente. SI QUIEREN CONSERVAR ESTE PORTAL MAS VALE QUE LO CUIDEN.</p>
";"10/03/2017 04";"91";"87";"4";"12";"6360848110";"7935"
"5098";"cancelar autoescuelas";"<p>Son un monopolio y carísimas.</p>
";"10/03/2017 12";"52";"19";"33";"0";"6341230276";"-511"
"5099";"Mejorar el ratio bibliotecas/población";"<p>Hola, he decidido investigar acerca de las bibliotecas que exiten en Madrid, ya que me parece que no hay una cantidad suficiente para todos los que vivimos en la ciudad. Recordemos que hay que fomentar la cultura y el estudio y muchas de las actuales bibliotecas están obsoletas y no están actualizadas para ser parte de una ciudad moderna que debería ser Madrid.</p>

<p>A continuación, aparecen la demogafía por distritos y el número de bibliotecas. </p>

<p> </p>

<p>01. Centro 132.644 (6) 02. Arganzuela 151.520 (1) 03. Retiro 118.559 (1) 04. Salamanca 143.244 (1) 05. Chamartín 142.610 (2) 06. Tetuán 152.545 (2) 07. Chamberí 137.532 (0) 08. Fuencarral-El Pardo 235.482 (1) 09. Moncloa-Aravaca 116.689 (0) 10. Latina 234.015 (2) 11. Carabanchel 242.000 (2) 12. Usera 134.015 (1) 13. Puente de Vallecas 227.195 (3) 14. Moratalaz 94.607 (1) 15. Ciudad Lineal 212.431 (3) 16. Hortaleza 177.738 (1) 17. Villaverde 141.442 (0) 18. Villa de Vallecas 102.140 (1) 19. Vicálvaro 69.800 (2) 20. San Blas-Canillejas 153.411 (3) 21. Barajas 46.264 (1)</p>

<p> </p>

<p>Total Bibliotecas municipales= 34. Poblacion de Madrid (aprox)= 3.157.000.</p>

<p>Como veis, según el ratio, tenemos a biblioteca aproximadamente por cada 92000 habitantes (aprox). Con lo cual tenemos distritos que aprueban y distritos que suspenden.</p>

<p>-APROBADOS: Centro, Chamartín, Tetuán, Puente de Vallecas, Moratalaz, Ciudad Lineal, Vicálvaro, San Blas-Canillejas y Barajas.</p>

<p>-SUSPENSOS: Arganzuela (1/151000), Retiro (1/118000), Salamanca (1/143000), Chamberí (0), Fuencarral-El Pardo (1/235000), Moncloa-Aravaca (0), Latina (1/117000), Carabanchel (1/121000), Usera (1/134000), Hortaleza (1/177000), Villaverde (0), Villa de Vallecas (1/102000)</p>

<p>Con lo cual por orden de prioridad, se encontrarían la creación de bibliotecas municipales en los distritos que no tienen (de mayor a menor población) y posteriormente las que itnene un ratio inferior a la media de la ciudad:</p>

<p>1. Villaverde. </p>

<p>2. Chamberí.</p>

<p>3. Moncloa-Aravaca.</p>

<p>4. Fuencarral-El Pardo (1/235000).</p>

<p>5. Hortaleza (1/177000).</p>

<p>6. Arganzuela (1/151000).</p>

<p>7. Salamanca (1/143000)</p>

<p>8. Usera (1/134000)</p>

<p>9. Carabanchel (1/121000)</p>

<p>10. Retiro (1/118000)</p>

<p>11. Latina (1/117000)</p>

<p>12. Villa de Vallecas (1/102000)</p>

<p>Muchas veces no se trata del número, sino del estado, abro este debate para ver qué soluciones propondríais. Cualquier sugerencia es bienvenida.</p>

<p>Gracias.</p>
";"10/03/2017 12";"85";"81";"4";"10";"6363808448";"7337"
"5100";"Sexista e ilegal: Madrid oferta plazas públicas con preferencia por sexos";"<p>http://ccaa.elpais.com/ccaa/2017/03/10/madrid/1489143219_287482.html</p>
";"10/03/2017 19";"58";"25";"33";"4";"6344640546";"-344"
"5101";"Metro express y EMT";"<p>Me parece un derroche que una infraestructura tan cara, tenga unas velocidades medias ridículas.</p>

<p>https://ecomovilidad.net/madrid/a-que-velocidad-va-el-transporte-publico/</p>

<p>Creo que todo el mundo debería pensar que interesa más:</p>

<p>Tener dos transportes que se solapan y que se hacen competencia ( EMT y metro) porque ambos son lentos para distancias de más de 5km(medias) y ambos tienen mucha""capacidad de servicio"" (paradas a poca distancia)</p>

<p>O tener un transporte para media distancia y otro para corta distancia, aparte del cercanías...De media-larga distancia</p>

<p> </p>

<p>Aquí están recogidas mis ideas....Pero quizá en este debate puedan ustedes rebatirlas, comentarlas o mejorarlas:</p>

<p>https://decide.madrid.es/proposals/17326-metro-express-y-autobuses</p>
";"11/03/2017 14";"83";"80";"3";"7";"6374873024";"7421"
"5102";"Cómo conseguir sacar adelante una propuesta ciudadana";"<p>Simplemente echando un vistazo rápido por las diferentes propuestas ciudadanas te das cuenta de que resulta prácticamente imposible sacar adelante alguna de ellas. Disponemos de un medio para solicitar mejoras, pero son tantas que los apoyos están muy divididos. Yo por ejemplo he entrado para proponer o apoyar una propuesta relacionada con la limpieza de Madrid y el cuidado de las zonas verdes y hay cientos. La mayoría de las personas que hacen propuestas las focalizan en su barrio y creo que ese es el principal problema. Sería todo más sencillo si consiguiéramos agruparlas ¿no? Hay propuestas para problemáticas específicas de un barrio, pero hay otras como el tema limpieza y cuidado de las zonas verdes, que afecta a todo Madrid. Con una sola propuesta bastaría y sería mucho más sencillo invitar a la gente a entrar un votar. Tenemos la herramienta pero no la utilizamos correctamente y eso lo saben....</p>
";"13/03/2017 12";"54";"49";"5";"4";"6390533362";"3992"
"5104";"Propongo que se amplíe el carril bici hasta Pinar de Chamartin ";"<p>Propongo que se amplíe el carril bici hasta Pinar de Chamartin y que llegue alli bici Madrid</p>
";"14/03/2017 09";"86";"67";"19";"1";"6397497931";"3739"
"5105";"Aparcamiento para Residentes Prosperidad";"<p>Buenos días,</p>

<p>Como vecina del barrio de Prosperidad estoy indignada con las obras que el Ayuntamiento está llevando acabo de ampliación de las esquinas de las aceras. En la mayoría de las esquinas de las aceras del barrio están haciendo unas ""plazas"" (esquinas tres veces más grandes que el ancho de la acera) sin ningún sentido que no sea otro que el de quitar numerosas plazas de aparcamiento para los residentes ya que en las aceras de zona azul no se está produciendo esta ampliando. Acado de leer las declaraciones de la portavoz del Gobierno municipal, Rita Maestre en relación a las obras de la calle Santa Engraciá diciendo que las plazas de aparcamiento para residentes que se quiten por la ampliación de las aceras y el carril bici en esa zona se reubicarán......en Prosperidad llevan tiempo haciendo la ampliación de las esquinas de las aceras y ni una sóla plaza de aparcamiento para residentes que se ha quitado por estas obras se ha reubicado en ningún sitio así que agradecería que dejaran de tomarnos el pelo diciendo lo que se creen que queremos escuchar y empezaran a ser coherentes con lo que dicen y hacen. Ya está bien que tengamos que pagar un impuesto de circulación y nos limiten o entorpezcan la circulación cada vez más por Madrid y que paguemos la zona Ser para residentes pero no tengamos plaza para poder estacionar. Además en el barrio hay númerosas obras que llevan acabo más necesarias como arreglar muchas de las acras que están en un estado lamentable o el asfaltado de calles que parecen más caminos que otra cosa (como lamento que no se puedan subir fotos para poder ilustrar esto).</p>

<p>Dejen de jugar con nuestros impuestos y relicen una gestión apropiada de los mismos.</p>

<p> </p>

<p>Muchas gracias</p>

<p> </p>
";"14/03/2017 12";"34";"24";"10";"5";"6393931737";"988"
"5107";"Tomar opiniones directas en la calle sobre las necesidades en los distritos";"<p>Puede ser bueno tomar de vez en cuando opiniones en la calle, No todas las personas tienen acceso a internet o están acostumbradas a hacer estas cosas por estos medios. Pero es muy importante conocer la opinión de las personas que están en la calle. Se podrían conocer muchas situaciones.</p>
";"15/03/2017 07";"56";"50";"6";"2";"6408413290";"3928"
"5108";"Me gustaria saber que opinais sobre el estado de una zona de mi barrio.";"<p>Por favor leer esta propuesta y luego opinar. muchas gracias </p>

<p>https://decide.madrid.es/presupuestos/presupuestos-participativos-2017/proyecto/1731</p>

<p> </p>
";"15/03/2017 13";"19";"14";"5";"0";"6403251282";"663"
"5109";"Sacos de obra ";"<p>Todos los días es un infierno aparcar en los barrios de la capital, ya sea por la carencia de plazas, las zonas de color, cargas y descargas, etc.</p>

<p> </p>

<p>Pero lo que más dificil lo hacen son los sacos de obra y contenedores de obra, ambos elementos ocupan en muchas ocasiones no una sino dos potenciales plazas de aparcamiento. Y muchas veces permanecen en la calle durante varios días hasta su retirada. Por ello ruego al ayuntamiento de Madrid que proceda de la siguiente manera.</p>

<p> </p>

<p>Sacos de obra, todos los sacos de obra han de ser retirados de la calle todos los días antes de las 18:00, hora en la que la mayor parte de las personas vuelven a casa y asi se habiliten muchas plazas de aparcamiento, y no se podrán volver a colocar hasta el día siguiente por la mañana, de igualmanera de los fines de semana se deberán recoger todos los sacos los sabados antes de las 14:00 y no se podrán volver a colocar hasta el lunes por la mañana. De lo contrario se multará a la empresa propietaria del saco. </p>

<p>Contenedores de obra, todos los contenedores de obra se han de dejar de forma que solo ocupen una plaza de aparcamiento, si el aparcamientos es bateria, se tendrá que dejar el contenedor de forma que solo ocupe una plaza, de lo contrario se multará a la empresa propietaria del contenedor. De igual manera se han de retirar todos los contenedores de obra antes del sabado a las 14:00 de la tarde, de forma que ese espacio pueda ser utilizado para aparcar, no pudiendose dejar el contendor otra vez en la calle hasta el lunes por la mañana.</p>

<p>Creo que esta medida será beneficiosa porque:</p>

<p>1º Reduce el tiempo de aparcamiento, reduciendo el tiempo de emisiones de co2 de los tubos de escape de los coches.</p>

<p>2º Ayuda a mantener más limpia la ciudad dado que no hay tanta basura y escombros en las calles.</p>

<p>3º Mejorará el humor de los conductores porque facilitará el aparcamiento.</p>

<p> </p>
";"15/03/2017 21";"53";"46";"7";"4";"6413143605";"3384"
"5110";"Zonas de carga y descarga";"<p>Las calles de Madrid están llenas de zonas de carga y descarga, sin utilizar la mayor parte del tiempo y que impiden el aparcamiento al resto de vehiculos. Esto ocurre en todos los barrios de Madrid sin excepción.</p>

<p> </p>

<p>Por ello ruego que:</p>

<p>1º Se revisen todos los puntos de carga y descarga, en la calle Cristobal Bordiu entre el numero 1 y el numero 7 hay tres puntos de carga y descarga, uno de 8 a 14 horas, y dos de 8 a 19 horas. En un espacio de siete bloques apenas hay espacio de aparcamiento, sin contar con los vados y los parkines, y la unica empresa que le podría interesar tener tanto espacio de carga y descarga es el carrefour que cerro hace tiempo y que ahora se mete la mercancia por Rios Rosas. Por ello sería bueno revisar todos los puntos y los que no tengan sentido eliminarlos.</p>

<p>2º Por otro lado no tienen sentido los horarios de carga y descarga, desde las 8 a las 19 horas es un plazo demasiado largo más cuando además se alarga a sabados de 8 a 14. Por ello ruego que se reduzca el horario de carga y descarga de 10 a 14 y los sabados de 10 a 14, de esta forma haremos de Madrid un espacio de convivencia más sencillo.</p>
";"15/03/2017 21";"66";"50";"16";"3";"6410984522";"2575"
"5111";"Mala utilización del plural";"<p>En numerosos organismos públicos se utiliza el plural mediante el uso de las formas masculina y femenina, en vez de emplear el plural genérico. Esto es una incorrección lingüística de acuerdo con la RAE (ver http://www.rae.es/consultas/los-ciudadanos-y-las-ciudadanas-los-ninos-y-las-ninas) y si bien puedo entender que una persona de la calle no hable con propiedad o incluso que lo haga mal por ideología, me parece que los organismos públicos deben respetar la lengua.</p>
";"15/03/2017 22";"87";"72";"15";"7";"6414449401";"4717"
"5112";"Obras en Calle Omega ";"<p>Actualmente se están llevando  a cabo obras de adecuación y remodelación en la calle Omega (en su parte inicial) consistentes en ensanchamiento de la acera y cambio de pavimento. Es descorazonador y al vez una falta de respeto hacia los trabajadores que  allí ejercen y a los vecinos que lo sufren que cada noche con el fin de la jornada de trabajo siguen aparcando coches en la acera, que en esos días está siendo repavimentada. Todo esto indigna mucho más cuando existe posibilidad de aparcamiento a menos de 200metros de dichas aceras. Mi preocupación es si en el  momento que  las obras finalicen no habrá ningún mecanismo, acción, iniciativa para concienciar a estos vecinos que esta forma de aparcar el vehículo propio no es la adecuada para una ciudad  como es Madrid. </p>
";"16/03/2017 09";"9";"3";"6";"0";"6402579959";"-100"
"5113";"En Polideportivos a las Escuelas deportivas de Convenio, limitar acaparamiento";"<p>Desde hace unos años, en muchas instalaciones, las Escuelas deportivas de varias disciplinas, como futbol, voley, etc. Han ido haciendose dueños de la instalación, haciendo uso de jaulas, vestuarios, etc. Ademas de hacerse con incluso el uso, cuando quieren de salas de musculación, pistas, y el resto de usuarios, y clubes de barrio, que algunos estan inscritos como Entidades ciudadanas, sean tratados como  de segunda clase. El problema, es que los directores de las instalaciones, priorizan a que es mejor que tener una escuela de convenio, que hace pagar a los niños/as, hasta 600 ó 700 euros, en vez de clubes de barrio, que están por debajo de esa cantidad, incluso la mitad lo que tienen que abonar los jovenes, ya que sus integrantes lo hacen  de forma forma altruista, no como las escuelas de convenio, que es mas negocio, que promoción del deporte. Esta causa es de que cada vez se inscriban menos equipos en ligas municipales, federadas, etc, de cualquier disciplina.</p>

<p>Solo hay que pedir que se trate por igual en las instalaciones, a todos sean escuelas de convenio, clubes de barrio ó usuarios.</p>
";"16/03/2017 15";"27";"24";"3";"0";"6418653932";"1866"
"5114";"Zona Las Tablas-Montecarmelo ";"<p>Quisiera proponer algunos temas de mejora para esta zona que no he visto en las propuestas de voto:</p>

<p>- Habilitar la estación de tren de Fuencarral que ahora mismo da miedo en cuento se hace de noche. Pavimentarla e iluminarla para que se pudiera acceder a ella normalemente como cualquier estación - Mayor limpieza del barrio. Habilitar papeleras y fuentes en el carril bici que funcionen.</p>

<p>- Estudiar las vías de entrada y salida en coche de estos barrios porque en hora punto se producen cuellos de botella que sólo salir de alguno de ellos supone perder más de media hora. </p>
";"16/03/2017 21";"31";"25";"6";"0";"6419695502";"1532"
"5115";"Madrid Olímpico";"<p>Crear una comisión que analice las posibilidades olímpicas para Madrid.</p>

<p> </p>

<p>Después de tres intentos fallidos por ser ciudad olímpica, Madrid, debe reconsiderar la posibilidad de presentarse como ciudad candidata para unos Juegos Olímpicos. En estos tres intentos, se ha debido aprender de los errores cometidos, tanto por la candidatura, como por el desconocimiento del procedimiento elector del COI y de las relaciones públicas con los miembros y evaluadores del COI.</p>

<p>El mundo está interconectado, y es fundamental conocer la afinidad de Madrid con el mundo anglosajón, los países latinoamericanos y el continente asiático. Si no se dispone de dicha información, sin tener los apoyos necesarios y sin crear la confianza suficiente, es imposible garantizar una victoria en el proceso elector del COI.</p>

<p>Propongo a debatir, la creación de una Comisión investigadora que determine en cada momento, la idoneidad de la presentación de la candidatura de Madrid a unos Juegos Olímpicos. Esta comisión deberá estudiar y analizar:</p>

<ol>
	<li>La <strong>Marca </strong><strong>MADRID</strong> como generadora de confianza a nivel económico y de estabilidad política.</li>
	<li>La <strong>Marca </strong><strong>ESPAÑA</strong> como generadora de país en crecimiento y con estabilidad política.</li>
	<li>La <strong>situación </strong>del país a nivel <strong>económico </strong>y <strong>político</strong>. Apoyos de los grupos políticos, apoyos de los ciudadanos y de los gobiernos regionales.</li>
	<li>La <strong>situación </strong>de la ciudad de Madrid, en cuanto a <strong>deuda</strong>, balanza de pagos, <strong>déficit</strong>, inversiones previstas, índices económicos, etc.</li>
	<li>Estudio del <strong>COI </strong>en cuanto a la composición de sus miembros</li>
	<li>Estudio del <strong>mundo anglosajón </strong>en cuanto apoyos a determinados países, confianza que tengan en nuestra candidatura, etc.</li>
	<li>Estudio de los <strong>apoyos latinoamericanos </strong>en cuanto a número de países comprometidos con nuestra oferta.</li>
	<li>La <strong>influencia </strong>del continente <strong>asiático</strong>, en espacial China, en cuanto a la influencia de oriente hacia nuestro país.</li>
	<li>
<strong>Análisis </strong>de las <strong>candidaturas </strong>que se presenten y su potencial, teniendo en cuenta el peso del país a nivel mundial, las circunstancias políticas y económicas y el periodo que dicho país no ha recibido unos juegos olímpicos.</li>
	<li>
<strong>Rotación </strong>de <strong>candidaturas </strong>entre continentes y las posibilidades de elección.</li>
</ol>

<p>Pero el potencial de Madrid como ciudad olímpica pueda ser el terminar el proyecto olímpico Madrid 2020 con la finalidad de sacar rentabilidad económica como negocio.</p>

<p>Por un lado, al terminar un proyecto olímpico al completo, significa que la siguiente vez que nos presentemos, el coste de adaptar las infraestructuras es mínimo, y es una ventaja competitiva con el resto de candidaturas.</p>

<p>Por otro, para obtener un beneficio económico, entendiendo cada recinto deportivo, y demás infraestructura deportiva como negocio a arrendar hasta la fecha de unas futuras Olimpiadas. Así tenemos las siguientes infraestructuras deportivas y su potencial uso lucrativo:</p>

<ol>
	<li>
<strong>Estadio Olímpico </strong>-&gt; Usufructo por parte del Ayuntamiento para competiciones deportivas previo convenio con el Atlético Club de Fútbol.</li>
	<li>
<strong>Centro de Natación </strong>-&gt; Arrendamiento al Consejo Superior de Deportes como sede de entrenamientos de alta competición. Propuesta para los Mundiales de Natación de 2025. Arrendamiento de las oficinas al Atlético Club de Fútbol</li>
	<li>
<strong>Villa Olímpica </strong>-&gt; Ejecución de los apartamentos para arrendarlas con cláusula en contrato que deberán ser desalojadas en caso de celebración olímpica.</li>
	<li>
<strong>Canal de Remo </strong>-&gt; Ejecución del canal de remo en el Manzanares y arrendarlo al Consejo Superior de los Deportes para el entrenamiento de élite del piragüismo. En épocas no olímpicas arrendarlo a particulares para entrenamiento de remo.</li>
	<li>
<strong>Otros </strong>centros deportivos -&gt; Sacar rédito mediante el alquiler al CSD o entidades privadas.</li>
</ol>

<p>Según estimaciones atendiendo a los candidatos que se han presentado y han caído en anteriores ediciones, sí como, las nuevas ciudades que puedan presentarse, se presupone que las condiciones idóneas para la presentación de una candidatura, estará en la década de los años 40, habiendo conseguido ya los Juegos, ciudades como París, Berlín, Toronto y alguna ciudad africana (Ciudad del Cabo, Durban) o musulmana (Estambul, Doha) siendo estas ciudades principales rivales a batir. Solo entonces Madrid tendrá opciones.</p>
";"16/03/2017 22";"102";"33";"69";"5";"6404734355";"-1164"
"5116";"¿Es el Comisionado de la Memoria Histórica un órgano objetivo e independiente?";"<p>Doña Paca Sauquillo, presidenta del Comisionado de la Memoria Histórica del Ayuntamiento de Madrid, y este Comisionado han condenado al General Millán Astray a los infiernos y le quitarán su calle de la Capital de España.</p>

<p>Hemos localizado una entrevista que le realizó un canal local de Madrid justo un día después de su nombramiento como Purgadora oficial de Madrid y en sus respuestas evidencia que ya ha sentenciado a Millán Astray y que todo lo del Comisionado es un paripé más donde unos pocos listillos de la Memoria Histórica se van a forrar del esfuerzo de los españoles.</p>

<p>Te invitamos a ver esta entrevista en el enlace siguiente youtube a partir del minuto 11</p>

<p>https://www.youtube.com/watch?v=9z3LuCL3cco&amp;t=1570s</p>

<p>También puedes participar en cuestionario de preguntas que hemos preparado a raíz de dicha entrevista. Es un TEST de trabajo cooperativo llamado de Verdad Histórica donde los madrileños podrán despertar su espíritu crítico en relación al papel de la señora Sauquillo en el Comisionado que preside y del resto del Comisionado, respondiendo a las preguntas que se plantean a lo largo de su entrevista ante sus reveladoras y sorprendentes afirmaciones.</p>

<p>Para ello deberás pinchar en el enlace Edpuzzle que viene a continuación. Es requisito para participar en este test el tener una cuenta de Gmail (en Google), entrar por la vía de estudiante (student) e introducir el código (code) berehoo (sin las comillas).</p>

<p>https://edpuzzle.com/join/berehoo</p>

<p>Edpuzzle es una aplicación estándar de Google que permite experiencias como ésta.</p>

<p>Las contestaciones serán monitorizadas y se efectuará un análisis de las recibidas que será enviado tanto a la Señora Sauquillo como a la Alcaldesa de Madrid, en un ejercicio de transparencia que ellas mismas no practican.</p>

<p>Participa en este debate abierto en DECIDE MADRID.</p>

<p> </p>
";"17/03/2017 13";"66";"22";"44";"7";"6411468500";"-733"
"5117";"Atenciones  sociales";"<p>Creo que con la crisis actual donde se debe incidir en en las ayudas sociales y los debates de carriles bici, en una cieudad de tanta cuesta, ahora creo no son oportunos. Gastemos el dinero en atenciones sociales a los necesitados, desahuciados, parados, etc. y  no nos perdamos en debates superfluos. </p>

<p>Si este gobierno municipal es el adaliz de lo social dediquese a eso no a tirar el dinero en isletas que no son utiles, ej. Mar de Cristal.</p>
";"18/03/2017 12";"51";"41";"10";"3";"6437877207";"2492"
"5118";"Problema: ""competición"" entre barrios en los presupuestos participativos";"<p>Me gusta la idea de presupuestos participativos pero he visto que en la parte de distritos se compite entre barrios por un mismo presupuesto, de forma que si ganan las propuestas de un barrio, porque tiene mayor numero de votos, pierden las del otro barrio, con menor numero de vecinos. Me gustaria que no fuera asi, porque entonces es cuestion del ""nuestro barrio contra el de al lado..."", que va en contra del objetivo de decidir entre todos.</p>

<p>¿como se podria corregir esto?</p>
";"19/03/2017 08";"47";"30";"17";"10";"6441688472";"829"
"5119";"Paremos los pies a Carmena";"<p>Exijamos que se respete el resultado del referéndum en Hortaleza, exijamos que nadie imponga su voluntad sobre la de los ciudadanos, sobre la democracia. Que ningún parque en Madrid lleve el nombre de nuestro infame rey.</p>
";"22/03/2017 08";"164";"34";"130";"13";"6459635144";"-1990"
"5120";"¿Crees que Valdebebas y Rejas necesitan otro tipo de dotaciones y no ARTEFACTOS?";"<p>si crees que el ARTEFACTO no soluciona los problemas dotaciionales de esos barrios</p>

<p>si crees que el ARTEFACTO no se debería ni plantear antes de que esos barrios cuenten con colegios y centros deportivos </p>

<p>Si crees que condenar a los residentes de los ARTEFACTOS a la utilización de un vehículo para todo, cuando sus ocupantes no tendrán recursos para vehículos privados, es un sinsentido</p>

<p>si crees que no parece lógico que un gobierno municipal, que presume de promover la participación ciudadana, haga caso omiso a miles de vecinos que se oponen a la construcción de los ARTEFACTOS</p>

<p>Si crees que los problemas de esos barrios se agravan con la construcción de estos ARTEFACTOS</p>

<p>Si crees que edificaciones similares, como el Ruedo de la M30, (más grande pero con idéntica filosofía) no trajo nada bueno ni a los vecinos ni  a los ocupantes, entonces:</p>

<p>vota mano arriba para que el gobierno municipal recapacite y se de cuenta de que están empeñados en construir algo sin apoyos. No es coherente con el tipo de política que promueven, y eso sólo nos puede llevar a pensar mal, a pensar en intereses ocultos que no comprendemos el 100% de los vecinos de Rejas y Valdebebas.</p>

<p> </p>

<p> </p>
";"23/03/2017 01";"77";"59";"18";"4";"6483334598";"3141"
"5121";"Eliminar Aereoclub  Cuatrovientos. Aviones a pocos metros de viviendas.  ";"<p>Creo que hasta que no haya una desgracia esto seguirá igual. No es la primera ni la última vez que ha habido un problema con avionetas que han caido en la zona del PAU de Carabanchel. Cuando se estaba construyendo dicho PAU, ya se estrello una, no hace tanto cayó otra en la zona de aterrizaje.  Hay viviendas a menos de 500 metros de donde aterrizan los aviones.</p>

<p>Ya se propuso llevar dicho aereopuerto a El Alamo. ¿Hasta cuando?</p>
";"23/03/2017 11";"90";"26";"64";"3";"6470628883";"-1097"
"5122";"¿Van a participar los ciudadanos en la regulación publicitaria? ¿Por qué?";"<p>La publicidad forma parte de nuestra vida. No se puede elegir no verla; varias asociaciones trabajan por una publicidad responsable. Por qué no contar con sus sugerencias...</p>
";"23/03/2017 16";"31";"17";"14";"5";"6480593904";"164"
"5123";"Para cuando la nueva ley de vehículos eléctricos ";"<p>Somos muchos los que estamos esperando a que salga la nueva ley de movilidad sobres los vehiculos y patinetes elécticos para comprarnos uno. A la espera de la ley que ya tenia que haber sido aprobada, no podemos comprar nada, ya que luego puede que no podamos darle el uso para el cual fue comprado</p>
";"23/03/2017 17";"90";"84";"6";"9";"6495674157";"7280"
"5124";"Reactivar ""Madrid Activa""";"<p>El programa ""Madrid activa"" ha muerto y era una estupenda idea para disfrutar de espectáculo de calidad en Madrid para todos los públicos. Con la llegada de Ahora Madrid, el plan Madrid activa ha muerto y los madrleños no podemos disfrutar de la programacion de calidad que había con este plan. Los padres ya no tenemos Centro culturales a los que llevar a nuestro hijos. El plan de Madrid Activa que realizó Ahora Madrid ha sido un fiasco. Con un contenido que de puro participativo ha sido grotesco. Reactiven Madrid Activa como estaba no todo lo que habia antes era malo. Han demostrado ser igual que todos , aniquilando todo lo que habia antes fuese bueno o malo.</p>
";"24/03/2017 14";"45";"37";"8";"0";"6498493484";"2384"
"5125";"Parque Eugenia de Montijo";"<p>Para cuando la rehabilitacion del parque que destrozo Gallardon </p>
";"24/03/2017 15";"40";"31";"9";"1";"6497320831";"1705"
"5126";"ASFALTAR EL BARRIO";"<p>PROPONGO EL ASFALTADO DE LAS CALLES DEL  DISTRITO DE FUENCARRAL EL PARDO.  </p>

<p>TODAS LAS CALLES ESTÁN LLENAS DE BACHES Y NO ENTIENDO POR QUÉ ASFALTAN PEQUEÑOS TROZOS QUE, EN POCOS DÍAS, VUELVEN A ABRIR NUEVAMENTE, LLENANDOLO TODO DE ZANJAS Y AGUJEROS OTRA VEZ.</p>

<p>POR FAVOR, ASFALTEN Y DÉJENLO DECENTE DE UNA VEZ.</p>

<p> </p>

<p> </p>

<p> </p>
";"24/03/2017 17";"55";"45";"10";"1";"6500182855";"2863"
"5127";"Creación de puestos de trabajo para la limpieza de Madrid";"<p>Al igual que existen vigilantes ""de la hora"" de aparcamiento aporto la idea de contratar personal de limpieza ciudadana, aporto este tema a debate. En Madrid, en todos sus barrios, se necesita mas limpieza y aunque no sea recaudatorio el aplicar multas a los ciudadanos que atentan a la salud publica arrojando basura a las calles no estaria mal comenzar a pensar en crear cuadrillas de limpieza con lo que el paro en la ciudad disminuiria y la educación de limpieza ciudadana comenzaria en base a las calles limpias. </p>
";"24/03/2017 21";"155";"147";"8";"5";"6509759803";"13182"
"5128";"TRABAJAR POR COBRAR LAS  AYUDAS EN BIEN DE LA COMUNIDAD. ";"<p>ME PARECE MUY BIEN QUE SE AYUDE A LA GENTE QUE NO TIENE EMPLEO, YO TAMBIEN LO HE SUFRIDO.</p>

<p>ESTO VA POR LOS QUE NO QUIEREN TRABAJAR Y POR LOS QUE QUIEREN TRABAJAR, YA QUE LOS QUE QUIEREN TRABAJAR SE SIENTEN UTILES Y MAS FELICES.</p>

<p>PROPONGO QUE PARA COBRAR UN SUBSIDIO O AYUDA DEL ESTADO SE HAGAN TRABAJOS SOCIALES, CONSIDERO QUE HAY MUCHAS COSAS POR HACER: PARQUES SUCIOS, HOSPITALES SUCIOS, ENFERMOS SOLOS, ANCIANOS DEPENDIENTES Y SOLOS, Y UN SIN FIN DE LABORES QUE TODOS AQUELLOS QUE COBRAN ALGUNA AYUDA PUEDEN DESEMPEÑAR.</p>

<p>EL TENER TODAS LAS HORAS DEL DIA LIBRES Y COBRANDO, AUNQUE SEA POCO A FIN DE MES, ESTA AYUDANDO A DEFRAUDAR, HA HACER TRABAJOS EN ""B"" Y EN DEFINITIVA A QUE ESTE PAIS NO PROSPERE.</p>

<p>CONSIDERO QUE CON ESTO DE LA CRISIS Y LAS AYUDAS HAY MUCHA GENTE QUE NO QUIERE TRABAJAR PORQUE ENTRE LAS AYUDAS QUE COBRAN Y LAS CHAPUZAS EN ""B"" HACEN SU APAÑO, MUCHAS VECES GANANDO MAS DINERO QUE LOS QUE ESTAMOS TRABAJANDO, SIN APORTAR A QUE EL PAIS SUBA Y PORSUPUESTO SIN PAGAR IMPUESTOS.</p>

<p>AYUDAS SÍ PERO CURRANDOSELAS.</p>

<p>ESPERO NO MOLESTAR A NADIE Y CONCIENCIAR QUE ASI NO PODEMOS SEGIR.</p>

<p> </p>

<p>SALUDOS</p>
";"25/03/2017 14";"73";"63";"10";"7";"6511437302";"4573"
"5129";"Carril Bici";"<p>Propongo que se renueve todo el carril bici, y que llegue a todos los barrios de Madrid. </p>

<p> </p>
";"25/03/2017 19";"123";"93";"30";"4";"6512373134";"4763"
"5130";"Centro Comercial";"<p><strong>Centro Comercial en Calle Alcala.</strong></p>

<p>Al lado de los autobuses ALSA y del Hotel, cerca de Suanzes, existe un terreno bien grande sin utilizar, no seria mejor que en vez de hacer edificios, se hiciera un centro comercial o un polideportivo, si queremos podemos derribar el de Alcalá norte y hacer un nuevo Alcalá Norte en eses terreno.</p>
";"25/03/2017 19";"31";"13";"18";"4";"6496032982";"-209"
"5131";"En busqueda del orden en este caos";"<p>Soy un visitante asiduo a esta página, y cada ve que entro me resulta más decepcionante. Aquí cada uno mira porque mejoren su barrio, hay muchisimas propuestas que escapan a las competencias del Ayuntamiento, hay muchas propuestas repetidas, en definitiva, hay muchisimo desorden, que provoca que esta página resulte un absoluto fracaso. </p>

<p>Mientras tanto, el Ayuntamiento va aprobando normativas y leyes (como no podría ser de otra forma), sobre las cuales los ciudadanos no podemos opinar y nos gustaría, esto me parece un completo contrasentido. Es como si tuviésemos esta página para desahogarnos, simular que tenemos margen de actuación, sentirnos involucrados en el devenir de nuestra ciudad, pero en el fondo fuese una herramienta perfectamente inútil y las medidas que se aplican en la ciudad las sigue tomando el gobierno de la ciudad, al margen de los ciudadanos, así ha sido y así será. </p>

<p>Me gustaría cambiar esto. Creo que el rumbo que ha tomado esta página hasta ahora ha demostrado ser un fracaso por eso propongo que:</p>

<p>SEA EL EQUIPO DE GOBIERNO EL QUE REALIZA LAS PROPUESTAS. SE HACE UNA PROPUESTA CON 8 O 10 VARIACIONES, Y LOS CIUDADANOS VOTAMOS SI NOS GUSTA LA PROPUESTA EN SU CONJUNTO, Y DENTRO DE ELLA QUE VARIACIONES NOS GUSTAN MÁS; O SI RECHAZAMOS LA PROPUESTA EN SU CONJUNTO. MAS APROBADOS QUE SUSPENSOS, LA PROPUESTA SALE ADELANTE, LO CONTRARIO, LA PROPUESTA NO SE LLEVA ACABO. FIN.</p>

<p>Si quieren mantener esta página para tomar ideas acerca de que proponer me parece bien, pero a cualquier otro efecto esta página resultará inútil. Creo que así podríamos comenzar ha sentirnos realmente realizados en lo que a construir ciudad se refiere.</p>

<p>Y como para muestra, un botón, aquí dejo la que para mi gusto podría ser la primera propuesta:</p>

<p>AMPLIACIÓN DE HORARIOS DE LA ZONA SER:</p>

<p>Está de acuerdo con que se amplien los horarios de la zona ser. (Este es el conjunto de la propuesta, aquí se vota si o no)</p>

<p>Si ha votado si:</p>

<p>· Desde las 8 hasta las 21 los laborales.</p>

<p>·Desde las 7 hasta las 21 los laborales.</p>

<p>·Desde las 6 hasta las 21 los laborales.</p>

<p>·Desde las 9 hasta las 22 los laborales.</p>

<p>·Desde las 9 hasta las 23 los laborales.</p>

<p>·Desde las 9 hasta las 24 los laborales.</p>

<p>·Computar el sabado como un día laboral más.</p>

<p>·Computar los domingos y festivos como un día laboral más.</p>

<p>·Desde las 9 hasta las 14 los domingos y festivos.</p>

<p>(aquí quienes hayan votado si pueden elegir que variaciones les gustan más, pudiendo elegir más de una, de forma que ambas se solapen entre sí).</p>

<p> </p>
";"26/03/2017 14";"58";"52";"6";"6";"6521075550";"4124"
"5132";"Badenes en carril bici";"<p>Se deberian poner badenes en la cuesta que une Madrid Rio con el parque Manzanares ya que los Indurains madrileños van a altisimas velocidades y hay muchas broncas y accidentes</p>
";"26/03/2017 22";"89";"63";"26";"0";"6520598693";"2619"
"5133";"Pregunta 1 sobre la ordenanza de la publicidad exterior";"<p><strong>¿Cómo calificarías la gestión actual de solicitudes de instalación de los soportes publicitarios/ identificativos regulados en la Ordenanza Reguladora de la Publicidad Exterior?</strong></p><p>Este debate pertenece al trámite de consulta pública sobre la modificación de la ordenanza reguladora de la publicidad exterior.</p><p>Más información en https://decide.madrid.es/proceso/ordenanza-publicidad-exterior</p>";"27/03/2017 00";"54";"14";"40";"21";"6505836705";"-674"
"5134";"Pregunta 2 sobre la ordenanza de la publicidad exterior";"<p><strong>¿Consideras necesaria la modificación de regulación actual de la publicidad exterior contenida en la Ordenanza? En caso afirmativo explica brevemente los motivos.</strong></p><p>Este debate pertenece al trámite de consulta pública sobre la modificación de la ordenanza reguladora de la publicidad exterior.</p><p>Más información en https://decide.madrid.es/proceso/ordenanza-publicidad-exterior</p>";"27/03/2017 00";"75";"63";"12";"31";"6524999093";"4284"
"5135";"Pregunta 3 sobre la ordenanza de la publicidad exterior";"<p><strong>¿Estás de acuerdo con la necesidad de introducir una regulación de la instalación de pantallas digitales en establecimientos? Manifieste su conformidad o no con la instalación de las mismas.</strong></p><p>Este debate pertenece al trámite de consulta pública sobre la modificación de la ordenanza reguladora de la publicidad exterior.</p><p>Más información en https://decide.madrid.es/proceso/ordenanza-publicidad-exterior</p>";"27/03/2017 00";"83";"62";"21";"22";"6522611349";"3062"
"5136";"Pregunta 4 sobre la ordenanza de la publicidad exterior";"<p><strong>¿Calificarías de excesiva la utilización del espacio público para la realización de acciones promocionales publicitarias?</strong></p><p>Este debate pertenece al trámite de consulta pública sobre la modificación de la ordenanza reguladora de la publicidad exterior.</p><p>Más información en https://decide.madrid.es/proceso/ordenanza-publicidad-exterior</p>";"27/03/2017 00";"106";"88";"18";"27";"6525762539";"5811"
"5137";"¿La ciudad que quieres?";"<p>Hoy he pasado junto a las obras de los jardines del Arquitecto Ribera y he comprobado cómo, aun estando a escasos metros del Museo de Historia de Madrid, se están equipando con farolas básicas y funcionales, sin que se haya tenido en cuenta el espacio en que se ubican, singular y situado en pleno casco histórico. No hay más que visitar el museo contiguo para ver el catálogo de farolas clásicas de Madrid y que podrían haberse elegido en su lugar.</p>

<p>Dicho esto, desde aquí le invito a la gente a mirar y al Ayuntamiento a que establezca una comisión independiente de paisajistas que informen sobre este y otros proyectos importantes que pueden tener un calado en la estética de nuestra ciudad. Un equivalente a lo que debería haber sido la inoperante Comisión para la Protección del Patrimonio Histórico, que tenga voz y voto en las reformas de espacios urbanos como la Plaza España o la misma plaza Barceló.</p>

<p>La funcionalidad no es antes que la estética de nuestra ciudad, ni todo vale a la hora de equipar un lugar público.</p>

<p>Apoya la propuesta en: https://decide.madrid.es/proposals/18115-crear-una-comision-de-paisaje-urbano</p>
";"28/03/2017 19";"40";"35";"5";"2";"6541138652";"2625"
"5138";"Unificación tarjeta transporte público";"<p>En Rence Cercanías ya está en uso la tarjeta  de recarga, que funciona por proximidad, y no se necesitan tickets en papel.</p>

<p>Metro de Madrid anuncia que en breve también pondrá este método y diremos adiós al papel; como ya lo hemos hecho con los taquiller@s.</p>

<p>Mi pregunta es ¿no podrían poner una misma tarjeta para ambos transportes?  Y no tener que llevar la cartera llena de tarjetas.</p>
";"31/03/2017 14";"178";"172";"6";"0";"6577454242";"16040"
"5140";"Pregunta 1 sobre nuevos barrios en el distrito de Vicálvaro";"<p><strong>¿Consideras conveniente la configuración del Distrito de Vicálvaro con los barrios de Casco Histórico de Vicálvaro, Valdebernardo, Valderrivas y El Cañaveral?</strong></p><p>Este debate pertenece a la Consulta previa sobre la conveniencia de crear nuevos barrios en el Distrito de Vicálvaro.</p><p>Más información en https://decide.madrid.es/proceso/distrito-vicalvaro</p>";"03/04/2017 00";"136";"113";"23";"19";"6596519733";"7477"
"5141";"Pregunta 2 sobre nuevos barrios en el distrito de Vicálvaro";"<p><strong>¿Crees necesaria la participación de los propios Distritos en el proceso de decisión sobre la creación o modificación de sus barrios?</strong></p><p>Este debate pertenece a la Consulta previa sobre la conveniencia de crear nuevos barrios en el Distrito de Vicálvaro.</p><p>Más información en https://decide.madrid.es/proceso/distrito-vicalvaro</p>";"03/04/2017 00";"123";"110";"13";"11";"6597934463";"8674"
"5142";"Pregunta 1 sobre la denominación del barrio San Ándres Distrito de Villaverde";"<p><strong>¿Consideras conveniente la  denominación de Barrio de ""Villaverde Alto, Casco Histórico de Villaverde""?</strong></p><p>Este debate pertenece a la conveniencia de cambiar la denominación del ""Barrio San Andrés"" por el de ""Villaverde Alto, Casco Histórico de Villaverde"", en el Distrito de Villaverde.</p><p>Más información en https://decide.madrid.es/proceso/distrito-villaverde</p>";"03/04/2017 00";"51";"33";"18";"6";"6587966814";"970"
"5143";"Pregunta 2 sobre la denominación del barrio San Ándres Distrito de Villaverde";"<p><strong>¿Crees necesaria la participación de los propios Distritos en el proceso de decisión sobre la creación, modificación o cambio de denominación de sus barrios?</strong></p><p>Este debate pertenece a la conveniencia de cambiar la denominación del ""Barrio San Andrés"" por el de ""Villaverde Alto, Casco Histórico de Villaverde"", en el Distrito de Villaverde.</p><p>Más información en https://decide.madrid.es/proceso/distrito-villaverde</p>";"03/04/2017 00";"52";"41";"11";"2";"6591758243";"2365"
"5144";"Plan de educación ambiental";"<p>Es una vergüenza el estado de suciedad de las calles.</p>

<p>Vivo en Tres Olivos y es lamentable la cantidad de latas, bolsas de snacks,etc que se ven por el suelo. Como padres todos debemos educar a nuestros hijos para que tiren la basura en papeleras, pero también hay que hacer una fuerte labor de concienciación en colegios. Al final, es un coste que revierte en beneficio de todos porque a largo plazo ahorrará dinero en gastos de limpieza.</p>

<p>Además, debería verse reforzado con multas ejemplarizantes por parte de los agentes. Hay mucho celo por multar en zonas SER pero nulo por amonestar a los incivicos que contaminan nuestras calles</p>
";"09/04/2017 15";"152";"149";"3";"4";"6667831187";"14311"
"5145";"No tenéis derecho a pagar una deuda ilegítima!";"<p>Rita Maestre asume en una entrevista estar amortizando deuda ilegítima, es decir: pagando con dinero público, recaudado a la fuerza, una deuda que no debería pagarse. No os elegimos para eso!</p>

<p>http://www.elboletin.com/noticia/147858/nacional/estamos-amortizando-deuda-ilegitima.html</p>
";"10/04/2017 12";"80";"40";"40";"2";"6655354436";"0"
"5148";"Alerta:  INTRUSION !!   ----->   esta URL está siendo hackeada.";"<p>Por tercera vez en los últimos diez días se vienen ""interponiendo"" diversos <strong>scripts</strong> en cada acceso de los Usuarios, que se disponen a efectuar  (inadvertidos de su oculta presencia)  mientras ven impotentes <em>a algo arrastrarse</em> bajo sus mismas narices cuando les EXAMINA su disco y memorias mientras se les <u>ralentiza el inicio</u> de la transacción.</p>

<p>Está muy bien que el Consistorio de otras ciudades  (en Francia, p.e. París)  nos hayan seguido igualmente adoptando también sus <em><strong>políticas de participación</strong></em> mediante la implantación de Foros equivalentes.  Pero bajo ningún concepto estamos aquí dispuestos a tolerar que se nos ""cuele"" el largo brazo de  WEBORAMA.FR  investigándonos a los Madrileños durante nuestra participación privada, desde el país vecino.</p>

<p>Y no es el único <strong>sniffer</strong> que los Administradores han dejado ""colarse"" esta Semana Santa:  otro miserable gusano como es  SIZMEK  (de Austin, Texas)  también agarra la oportunidad de <u>recoger su cosecha</u> con datos privados en nuestras plataformas ""cliente"" aquí en <em>Decide.Madrid.es</em> desde nuestros propios Equipos servidores... por no hablar del <u>análisis de transacciones</u> que se ha introducido  -bajo código abierto-  con la herramienta  PIWIK  sin avisarnos tampoco en absoluto del propósito y alcance que persiguen las Métricas extraídas mediante dicha ""utilidad"" técnica.</p>

<p><u>Es francamente intolerable</u> que hayamos estado  (hasta ahora)  confiando en la tutela del <strong>Web-Master</strong> para finalmente descubrir ahora que nos han venido dejando  -literalmente-  con ""el culo al aire"" todos estos meses sin inmutarse lo más minimo.  Y eso, que ya se han tenido numerosos VICIOS internos que sobrellevar para no zaherir la participación cordial de los Vecinos menos <em>avezados</em> sin cortapisas  (p.e. la auto-votación de los Comentarios propios aún sigue sin estar vetada, dando ""exitosos"" resultados de <em>falsa aprobación</em> para <em>cierto Interviniente</em> a todas luces exagerados).</p>

<p>Hastiado como estoy, y profundamente decepcionado con este descubrimiento, no volveré a participar mientras no compruebe  PUBLICAS EXPLICACIONES  desde el grupo de administradores a este particular respecto.  Hasta entonces, para todos un saludo amistoso con mi gratitud sincera por su agradable compañía.</p>

<p>MchGrcs</p>

<p> </p>
";"16/04/2017 22";"23";"14";"9";"1";"6723833818";"304"
"5149";"debate sobre la creación de espacios legales para los graffiteros";"<p>Creo que se deberían crear espacios legales para que los graffiteros hagan lo que quieran en ellos ya que el graffiti se extiende más y a pesar de que las medidas de seguridad han sido reforzadas los grafiteros grafitean muy entrada la noche lo que hace difícil que se les pueda pillar otra cosa también es que cuando la policía se encuentra a uno de estos le persiguen y esto hace que vayan por vías de metro autopistas etc... Gracias por vuestra atención un cordial saludo</p>
";"17/04/2017 18";"159";"114";"45";"2";"6740771259";"4947"
"5150";"Ideas para el equipo de gobierno: proyecto Vital Quartier de París";"<p>Se trata de un proyecto de revitalización urbana destinado a favorecer la conservación y el desarrollo de los comercios de proximidad en barrios donde los mismos se encuentran amenazados. http://www.semaest.fr/nos-realisations/vital-quartier/</p>
";"18/04/2017 12";"53";"48";"5";"1";"6750175510";"3894"
"5152";"Que vuelva Madrid Eat a la Plaza de Azca en Tetuán";"<p>Una vez al mes se celebraba Madrid-Eat en la plaza de Azca, siempre que he ido, (aunque no he ido siempre), se veía un ambiente agradable, gente joven, padres con niños, familias y varios food trucks con comida variada. Pensé que este era un buen aliciente para el barrio, para quedar en él y pasar un rato agradable al aire libre con la pareja, amigos, familia, etc. Hoy me he enterado de que la Junta de Distrito de Tetuán lo ha prohibido y lo cierto es que me da mucha rabia ver como puede desaparecer algo así, por lo que abro esta propuesta como vecino del barrio de Tetuán, para que la Junta de Distrito tenga en cuenta los intereses de los habitantes del barrio antes de tomar este tipo de decisiones. Sinceramente, si esta va a ser la línea a seguir hay mucho que repensar como votante. Espero que sepáis rectificar.</p>
";"21/04/2017 11";"129";"118";"11";"0";"6783253014";"9787"
"5156";"Aparcamiento bicicletas piscina casa de campo";"<p>En la piscina de la casa de campo no hay aparcamiento de bicicletas, si hay una señal que impide el acceso, en la calle tampoco hay mucho sitio para dejarla.</p>

<p>Propongo habilitar una zona para bicis en el interior del recinto.</p>
";"21/05/2017 00";"115";"108";"7";"4";"7078876403";"9485"
"5157";"Madrileños exiliados";"<p>Soy un madrileño que lleva desde 2008 fuera de España. No me he podido regustrar en Madrid Decide porque no estoy empadronado. Al contrario de lo que algunos periódicos titulan últimamente, muchos talentos exiliados no volverán nunca. La brecha creada por esta crisis y por la nefasta gestión de un partido ladrón y corrupto ha provocado que muchos ya llevemos casi una década fuera. Muchos tenemos familias multinacionales, hijos, carreras irrenunciables... Nos gustaría volver. Pero nos gustaría volver a un país que no existe, un país que valore la formación, la creatividad, las ideas y, sobre todo, lo que los que estamos fuera podemos ver con una nitidez que el vivir en España no permite: la condescendencia con la que se mira a América Latina, por ejemplo; que se tome como algo normal que un partido tan corrupto siga en el poder; que la gente no se muera de vergüenza; que sigamos siendo el segundo país del mundo con más desparecidos, muchos de ellos bajo un monumento al fascismo que sigue siendo respetado... Es tanto lo que tenemos que aportar... 
Pero no quiero extenderme mucho. Me acerco a este foro con una idea en mente: poner en un lugar público (se me ocurre, por supuesto, la Puerta del Sol), una mesa (con sombrillas si es posible) que funcione como punto de información para que la gente de nuestra ciudad pueda tener un encuentro con los exiliados que estemos este verano de vacaciones en España; que haya un diálogo, que la gente se entere de qué supone vivir a 10000 Km de un lugar que poco a poco deja de llamarse casa. Mi idea es, simplemente, invitar a los exiliados a que ocupen esa mesa y que la gente se acerque a preguntar: dar visibilidad a un fenómeno de dimensiones equivalentes al exilio de 1939 y que no merece ser olvidado, como lo fue aquel. Creo que puedo juntar a una buena tropa de gente maja que pueda participar y yo me ofrezco a organizar lo que haga falta. Lo que quería era decirle todo esto a nuestra alcaldesa, pero no sé cómo llegar a ella. Hágase! Sería muy bonito, constructivo, educativo.</p>
";"21/05/2017 07";"77";"50";"27";"3";"7071998577";"1493"
"5158";"Prohibición de los pisos turisticos sin licencia.";"<p>Es sencillo, el que no esté habilitado, homologado y acondicionado con un aislamiento extra que se clausure. Los propietarios no son conscientes de las molestias que ocasionan el constante trasiego de personas ajenas al edificio.</p>

<p>Por no hablar del negocio sumergido que implica alquilar y no declarar los ingresos es defraudar a Hacienda. Mucha culpa también la tienen las inmobiliarias que embaucan/convencen a los propietarios para quitar la clausula de subarriendo.</p>
";"22/05/2017 16";"279";"248";"31";"30";"7097830217";"19288"
"5159";"Basta de autobuses privados en doble fila en Paseo Infanta Isabel";"<p>Todas las mañanas,de Lunes a Viernes, paso sobre las 7 y la cantidad de autobuses privados que aparcan en el carril Bus,hasta en doble fila,como ocurre frente al museo de Antropolgía,es inaceptable.</p>

<p>No dejan pasar a los autobuses de la EMT, obstaculizan el tráfico pues, además del carril Bus, ocupan el carril derecho mientras los conductores hacen paradas para desayunar en los bares de la zona.</p>

<p>La policía municipal debería ocuparse de que los autobuses privados sólo se detengan a recoger o dejar viajeros y evitar que sigan obstaculizando la circulación.</p>
";"23/05/2017 18";"78";"69";"9";"1";"7103568034";"5307"
"5160";"CARRIL BICI EN AVENIDA DE OPORTO";"<p>ME PARECE MUY MALA IDEA QUE POR HACER UN CARRIL BICI BIDIRECCIONAL EN LA AVENIDA DE OPORTO SE HAGA DE UNA SOLA DIRECCION LA CALLE LA VIA Y LA CALLE VALLE DE ORO Y POR ELLA SE TRASLADE TODA LA CIRCULACION DE COCHES Y AUTOBUSES DESDE PLAZA ELIPTICA A GENERAL RICARDOS. YA SUFRIMOS LOS VECINOS DE LA CALLE VALLE DE ORO LAS PARADAS DE TRES AUTOBUSES (81,108 Y 484) Y EL PASO DE OTROS DOS (481 Y 486) CON LA CONSECUENTE CONTAMINACION ACUSTICA Y ATMOSFERICA.. ENTRE AUMENTO DE CIRCULACION, PARADAS DE AUTOBUSES Y PASOS DE CEBRA EN CADA ESQUINA SE HA REDUCIDO ENORMEMENTE LAS PLAZAS DE APARCAMIENTO Y NOS TIENE FRITOS A MULTAS. ADEMAS LA SALIDA A GENERAL RICARDOS SE VÁ A CONVERTIR EN UN CUELLO DE BOTELLA PARA LA SALIDA DE LA CIRCULACION CON LAS CONSECUENTES MOLESTIAS PARA LOS VECINOS.</p>

<p>¡Y ENCIMA AMPLIAN LAS ACERAS PARA QUE LOS BARES LAS OCUPEN CON TERRAZAS, CON LO CUAL LOS PEATONES TAMPOCO PUEDEN PASEAR, ESTO NO HAY QUIEN LO ENTIENDA!</p>
";"23/05/2017 21";"77";"52";"25";"8";"7098972712";"1823"
"5161";"Ayudas a parados autónomos españoles sin recursos...";"<p>Porqué españoles..?  no es racismo, sólo que nosotros, los esañoles, no disfrutamos de las ayudas a fondo perdido de los extranjeros, cosa que me parece perfecta.</p>

<p>Propongo que se destine una partida presupuestaria para ayuda a parados sin recursos pues al parecer dejas de tener derechos si no trabajas para cuenta ajena... es que no cotizas..? acaso hacienda, seguridad sopcial o sea el estamento oficial que sea, si dejas de pagar tus impuestos no te interviene la cuenta corriente..?</p>

<p>La ayuda podría ser con cursos de integración o trabajos varios para el ayuntamiento dependiendo de la capacidad de cada persona.</p>

<p>Solo se trata de que nuestro ayuntamiento sea solidario con el colectivo de autónomos en esta crisis tan dura.</p>
";"24/05/2017 00";"122";"88";"34";"2";"7102657043";"3895"
"5162";"Gratuidad a los parados de larga duración en todo la red de transporte de Madrid";"<p>En la actualidad los parados deben moverse cada día más por Madrid y sus alrededores en busca de un trabajo, esto supone un coste adicional a la ya precaria situación en la que estamos.</p>
";"24/05/2017 01";"212";"164";"48";"3";"7106676719";"8973"
"5163";"Fomentemos el idioma español.";"<p>En la actualidad el hablar español parece no estar de moda. Es más, desde que nos vendieron el bilingüismo esos politicos que se les llena la boca diciendo que son españoles, hemos ido de mal en peor. Para empezar el articulo neutro se va utilizando cada vez menos, toda palabra o vocablo lo intentamos traducir al ingles, nos estamos convirtiendo en anglofilios. Además hasta para las cosas más básicas si no sabes el idioma de Shakespeare, puede que te tachen de fracasado. ¡¡Pero que me están contando si el español es el segundo idioma más hablado del mundo!!!!!!! Pongamos el idioma español en su sitio y volvamos a ser lo que siempre hemos sido un pais a la vanguardia de la cultura. Estamos en España, pues fomentemos como es debido nuestro idioma: EL ESPAÑOL</p>
";"24/05/2017 01";"141";"111";"30";"9";"7105953046";"6376"
"5164";"Que vuelvan los autobuses nocturnos coincidentes con las lineas de metro";"<p>Como hubo durante algún tiempo, sería maravilloso que volvieran a circular, al menos los fines de semana, los autobuses nocturnos que siguen el recorrido de las líneas de metro. Eso evitaría tener que ir desde cualquier sitio a Cibeles y ahí coger el correspondiente que pasa por tu barrio. Muchas gracias a todos.</p>
";"24/05/2017 16";"285";"280";"5";"3";"7121050961";"27017"
"5165";"Pregunta 1 sobre Parque Lineal del Manzanares";"<p><strong>¿Cómo abrir un espacio de participación y debate que aporte ideas, sugerencias y alternativas para configurar un plan de futuro a este parque y oriente las correspondientes decisiones que el planeamiento y la inversión deba adoptar para ello?</strong></p><p>Este debate pertenece al proceso de participación ciudadana respecto a dicho parque y su entorno.</p><p>Más información en https://decide.madrid.es/proceso/parque-lineal-manzanares</p>";"24/05/2017 17";"33";"27";"6";"21";"7109058444";"1718"
"5166";"Pregunta 2 sobre Parque Lineal del Manzanares";"<p><strong>¿Qué oportunidades para el desarrollo social y el empleo social y local ofrece todo este espacio y el conjunto de los Parques del Manzanares?</strong></p><p>Este debate pertenece al proceso de participación ciudadana respecto a dicho parque y su entorno.</p><p>Más información en https://decide.madrid.es/proceso/parque-lineal-manzanares</p>";"24/05/2017 17";"36";"30";"6";"15";"7109416313";"2000"
"5167";"Pregunta 3 sobre Parque Lineal del Manzanares";"<p><strong>¿Qué problemas y soluciones respecto a la calidad medioambiental del río y su entorno te parecen más relevantes?</strong></p><p>Este debate pertenece al proceso de participación ciudadana respecto a dicho parque y su entorno.</p><p>Más información en https://decide.madrid.es/proceso/parque-lineal-manzanares</p>";"24/05/2017 17";"50";"43";"7";"29";"7111482808";"3096"
"5168";"Pregunta 4 sobre Parque Lineal del Manzanares";"<p><strong>¿Qué futuro jugará el río como vertebrador de la movilidad urbana sostenible en el eje norte-sur?</strong></p><p>Este debate pertenece al proceso de participación ciudadana respecto a dicho parque y su entorno.</p><p>Más información en https://decide.madrid.es/proceso/parque-lineal-manzanares</p>";"24/05/2017 17";"42";"36";"6";"25";"7110774313";"2571"
"5169";"¿Deberíamos pedir a nuestros representantes más por el calentamiento global?";"<p>No hay que ser muy despierto para ver como en los últimos años (sólo en Madrid) las temperaturas medias han subido considerablemente, las lluvias cada vez son menos frecuentes y por consiguiente los espacios ""verdes"" cada vez lo son menos. Eso sin contar con dudosa calidad del aire que en Madrid se respira.</p>

<p>Incluso al comienzo de este año hemos podido ver árboles ¡con flor!. </p>

<p>Sin entrar a valorar si se trata de un efecto producido por los ciclos naturales que a lo largo de miles de millones de años ha pasado la tierra o si el ser humano tiene el 100% de la culpa o el 50%/50%</p>

<p>Yo entiendo que es un tema espinoso, que sabemos que está ahí, pero tampoco hay una solución clara y sencilla (no vas a parar absolutamente todas las fábricas del país y los coches eléctricos son muy caros y con poca autonomía y etc. etc.) por lo que muchas veces dichas soluciones van más allá del ""ahora"".</p>

<p>Entonces....por difícilcil y a medio/largo plazo que sea, ¿Deberíamos de ignorar el tema?</p>

<p>Señora Carmena,  el futuro es hoy. Nosotros somos los hijos del ""¿Qué futuro vamos a dejar a nuestros hijos?""</p>

<p>Retomando el título del debate, ""¿Deberíamos pedir a nuestros representantes más por el calentamiento global?"", que realicen políticas más activas y directas:</p>

<p>Que los coches oficiales sean eléctricos.</p>

<p>Reforestar zonas quemadas e incluso hacer plantaciones de árboles selectivas.</p>

<p>Que todos los nuevos edificios sean inteligentes y sostenibles 100%</p>

<p>Cambiar el alumbrado público, marquesinas,....por bombillas que acumulen nergía solar y que iluminen más cuando pasa alguien por debajo.</p>

<p>Implantar tecnologías innovadoras como las placas que acumulan energía al ser pisadas.</p>

<p>Placas solares en tejados</p>

<p>ETC. ETC. </p>
";"24/05/2017 21";"159";"148";"11";"4";"7118922599";"12752"
"5170";"Dotar del servicio de cafetería/bar a la piscina de Francos Rodríguez";"<p>En los últimos años, las instalaciones de esta piscina han sufrido un enorme deterioro tanto de los vestuarios como las zonas comunes, por lo que sería necesario un plan para su rehabilitación.</p>

<p>Este es el segundo año que la piscina municipal de Francos Rodríguez se abre sin servicio de cafetería. Sería deseable que se dotara de este servicio a los usuarios o al menos de máquinas expendedoras de bebidas y helados. La no existencia del mismo supone que la gente traiga sus propias bebidas y comidas de casa y como consecuencia se produzca un gran deterioro en el estado de las zonas comunes, donde se come y bebe sin recoger en muchos casos los envases. </p>
";"25/05/2017 14";"66";"56";"10";"1";"7120267333";"3903"
"5171";"IMPUESTO CANINO YA!";"<p>El tema ""excrementos caninos"" ha sido debatido sobradamente y no es intención de aburrir, pero hay que constatar que Madrid es una pocilga en la que -con respeto hacia aquellos que se esfuerzan por que sus mascotas no hagan sus necesidades en espacios públicos- hay una cantidad de excrementos y restos de los mismos insalubre. Al margen de una falta de higiene e imagen es un factor que limita el uso libre de espacios. Padres que tienen que buscar ""cacas"" antes de que sus niños puedan jugar en lugares públicos o transeuntes ""esquiando"" para evitar pisar heces podrán entender de que se habla.</p>

<p>Cuando la salud pública se ve afectada o el espacio de ciudadanos es limitado por excrementos cuya limpieza se realiza injustamente con cargo a toda la ciudadanía, la solución pasa por proteger el interés general de los ciudadanos por espacios limpios, cobrando el coste a los propietarios de las mascotas mediante un impuesto, similar a fumadores que pagan un impuesto de tabaco. </p>

<p>Dicho esto se considera oportuno la introducción de un IMPUESTO CANINO para sufragar los considerables gastos que genera la limpieza de heces y orina de mascotas en espacios publicos o bién considerar un impuesto municipal especial a todo alimento suministrado a mascotas con el mismo objetivo.</p>
";"25/05/2017 16";"299";"235";"64";"36";"7124783628";"13439"
"5172";"El Barrio de las Letras está desasistido por completo.";"<ul>
	<li>Es un barrio que deliberadamente está siendo desprovisto de tiendas tradicionales e incluso servicios básicos para un habitante del barrio como carnicerias, pescaderías o verdulerías por poner ejemplos. Todo está volcado al turista. Veo muy bien que venga el turismo a Madrid, pero que vayan a lugares habilitados para dicha <u>actividad económica.</u>
</li>
	<li>Todo se enfoca al turismo, la policía hace la vista gorda con la gente que bebe en las calles y no limpian. Si continua así Madrid perderá la poca esencia auténtica que le queda y será un mero parque temático para el uso y el disfrute del turista, mientras los habitantes del centro tenemos que aguantar todo.</li>
</ul>
";"25/05/2017 21";"101";"92";"9";"7";"7126386974";"7560"
"5173";"Más columpios para niños 0-3";"<p>En general hay pocos columpios para niños pequeños en los parques madrileños.</p>
";"26/05/2017 00";"130";"114";"16";"3";"7127566721";"8593"
"5174";"Sobre colectivos xenofobos";"<p>En Murcia se ha aprobado una moción sobre este tema: http://www.lacronicadelpajarito.es/region/ayuntamiento-murcia-prohibe-que-colectivos-neonazis-sigan-repartiendo-alimentos-solo-a</p>

<p>Por favor, que nuestro ayuntamiento haga algo similar con colectivos neonazis que usan el reparto de alimentos como capote para hacer apología de sus ideas.</p>
";"28/05/2017 19";"67";"50";"17";"6";"7149826751";"2462"
"5175";"MULTAS POR ENSUCIAR CALLES";"<p>Propongo sanciones económicas a la gente que no respeta la calle y con esto me refiero a las personas que no recogen los excrementos de sus animales y las que tiran basura,papeles,colillas,etc. al suelo..</p>

<p>Hay muchísimas papeleras en Madrid y aun así la gente tira cosas al suelo por lo que algunas calles se encuentran en un estado lamentable.</p>

<p>Propongo sanciones económicas a todas las personas que lo hagan y si son menores, a sus padres. Si no tenemos educación por lo menos tengamos castigos</p>
";"30/05/2017 19";"300";"294";"6";"9";"7182358560";"28224"
"5176";"Ayudas a las vivienda a madres  y a  padres separados";"<p>Como ya sabeis. Es dificil afrontar esta situacion tanto cambio de calles tanta cosas que pueden esperar..  een cambio nuestras situaciones estan para ya...  muchas maes. Solteras y se de algunos padres. Que no tienen hogar o estan apunto de desahuciar y no  se encuentra respuesta muchos pisos de la comunidad de madrid se encuentran cerrados. Ahi listas .enormes de personas que quedaran. Sin techo y lo que no radican es que enpujan a la gente a okupa...  ahi soluciones para esto? Ahi ahora algo mas importante que arreglar una callee y que las familias duerman en el lindo paseo de las delicias quee quieren hacer</p>
";"31/05/2017 10";"120";"89";"31";"4";"7177380543";"4301"
"5177";"Aplicar ley de igualdad de género en el callejero de Madrid";"<p>Una vez que se han renombrado calles aplicando la Ley de Memoria, el ayuntamiento y las juntas municipales de distrito deberían identificar aquellas calles que pudieran ser susceptibles de aplicar la Ley de Igualdad de Género, como aquellas que hacen refencia a profesiones. Por ejemplo, se me ocurre, ""a bote pronto"", calle de Arquitectos y Arquitectas, Fundidores y Fundidoras, Hilanderos e Hilanderas, Bordadores y Bordadoras, Embajadores y Embajadoras y otras. Sería un gesto para dignificar a las mujeres que ejercen estas profesiones y la mejor medida para aplicar políticas feministas, de empoderamiento y reconocimiento de la mujer trabajadora.</p>
";"01/06/2017 11";"116";"35";"81";"7";"7169553240";"-1387"
"5179";"Contaminación acústica en Usera";"<p>Cordiales saludos.</p>

<p>Abro este debate para discutir el problema de la contaminación acústica en general, a través de mi experiencia personal y concreta en la calle Marcelo Usera.</p>

<p>Esta calle sufre severos problemas de contaminación del aire debido a su estrecho trazado, el gran flujo de vehiculos que recibe y la presencia de numerosos garajes de reparación de coches a lo largo del barrio, pero entiendo que esta problemática requiere soluciones más complejas. El caso es que me he instalado en esta calle al igual que otros tantos jovenes que buscan una zona de viviendas a precios asequibles que muestre signos de revitalización y no podemos salir de nuestro asombro al ver la manera en la que las fuerzas de las autoridad lidian con el problema de la contaminación acústica. A lo largo de esta calle transcurre un flujo constante de coches y un gran número de estos emiten unos altísimos niveles de contaminación acústica debido, principalmente, al volumen excesivamente alto con el que utilizan sus equipos de sonido. Me extraña ver cómo la policía no media ante esta situación ya que creo que esto es uno de los problemas principales de esta calle. A los coches se unen otras fuentes como: transeúntes ébrios y un edificio entero ocupado por un grupo de personas notablemente conflictivo que dificultan la convivencia en la calle, y en el barrio en general. ¿Existen soluciones que se estén barajando ante este problema? ¿Tenemos que lidiar con este alto grado de contaminación acústica como si fuese algo irremediable e inherente a un barrio como Usera?</p>

<p>Un saludo y mi más sincero agradecimiento al ayuntamiento de Ahora Madrid por dar voz a los ciudadanos a través de un portal como este.</p>
";"06/06/2017 22";"60";"50";"10";"2";"7242870403";"3333"
"5180";"Contaminación acústica de madrugada por recogida de basuras";"<p>La contaminación acústica es un problema muy grave para la salud, principalmente psicológica, de los ciudadanos. Se la asocia a menudo, y por error, a la naturaleza propia de la ciudad. Este hecho lleva a asumirla con frecuencia como algo normal. Y no lo es en absoluto.</p>

<p>El problema al que se enfrentan decenas de barrios y calles de Madrid es de especial gravedad dado que es el propio Ayuntamiento el que la provoca a través de su servicio de recogida basuras.</p>

<p>El de Ahora Madrid es un gobierno, nos consta, preocupado por la ecología. Bien. En mi casa, situada en el Barrio de la Concepción, no tenemos aire acondicionado por creer que, usado de forma masiva y en zonas donde puede paliarse el color por otros medios, daña el medio ambiente de manera innecesaria. Fruto de esta decisión, nos vemos obligados a abrir las ventanas en verano para aliviar las altas temperaturas y poder dormir. Un camión de recogida de basuras que presta su servicio a la 1:08 de la madrugada es un atentado contra la salud pública y el ruido que provoca es intolerable para una vivienda que tenga las ventanas abiertas. En mi casa, además, vive un bebé de 8 meses que todas las noches se despierta con el ruido que provoca, no solo el vehículo, sino las conversaciones a gritos de sus operarios.</p>

<p>Mi pregunta para el Ayuntamiento es sencilla, ¿me recomiendan instalar aire acondicionado para evitar el calor en verano ya que no puedo hacerlo por el medio 'tradicional' por culpa de su servicio de recogida de basuras? de ser afirmativa la respuesta, ¿estaría dispuesto a subvencionar la instalación de alguna forma o en algún porcentaje? Y de ser negativa la respuesta, ¿podrían -y sírvanse leer esta cuestión como un ruego- cambiar el horario del servicio de recogida de basuras en verano para que no se preste nunca más tarde de las 23:00h?</p>

<p>Atentamente, un ciudadano insomne.</p>

<p> </p>
";"10/06/2017 01";"110";"80";"30";"0";"7272886403";"3636"
"5181";"Permitir que los animales se puedan bañar en las fuentes ornamentales";"<p>Propongo que se modifique la ""Ordenanza Reguladora de la Tenencia y Protección de los Animales"" para permitir que los animales se puedan bañar en las fuentes ornamentales, lo que actualmente constituye una infracción leve que conlleva una multa.</p>

<p> </p>
";"12/06/2017 20";"218";"32";"186";"5";"7285415079";"-2260"
"5182";"Pongamos contenedores en la calle y no dentro de los portales.";"<p>Vivo en calle Segovia, distrito Arganzuela y me parece tercermundista tener los contenedores dentro del portal cuando apenas tenemos paso con ellos en todo el medio. Otro de los aspectos es que llegando el calor, el olor es insoportable y se mete hasta las casas. Mi propuesta es que habiendo espacio en la calle ¿porque tenemos que tenerlos dentro?. Los contenedores de carga lateral, dan cabida por lo menos a 6 de los pequeños, con lo cual reduciríamos el ruido que ocasiona el camión al descargar 6 en vez de un contenedor. Para rizar el rizo aunque eso claro ya aumentaría el coste, podían soterrarlos, a diario veo personas robando el cartón y dejando todo lleno de mierda alrededor del mismo, soterrándolos creo que eso se acabaría.</p>
";"14/06/2017 16";"73";"44";"29";"7";"7314125779";"904"
"5183";"Personal para jardinería, mantenimiento, obras etc";"<p>Buenas tardes,</p>

<p>Yo he participado siempre en sus encuestas y comunicados pero no lo volveré hacer, ya que considero que es imprescindible, primero arreglar y mantener lo que tenemos ahora, es decir, jardines, aceras, calles, periodicidad de autobuses, seguridad en la ciudad etc.</p>

<p>Un ejemplo, en el distrito 28033 que abarca, arturo soria, ciudad lineal y pinar de chamartín tiene 4 operarios para jardineria y limpieza, lo mismo ocurre en el 28036. Me parece vergonzoso que tengamos  en el paseo de la avda de burgos, 26 posterior unos cristales que son un peligro para niños y animales y como nos estamos cansando lo triraremos a la m30, por nuestra seguridad. El supervisor de zona tiene conocimiento de estos cristales desde hace más de un año, y ahí siguen.</p>

<p>Es lamentable que la Sra Carmena quiera hacer ""Obras Faraonicas"" como sus predecesores pero los madrileños y ""madrileñas"" queremos que se cuide lo que hay.</p>

<p>Gracias, saludos</p>
";"15/06/2017 13";"71";"61";"10";"2";"7330476599";"4381"
"5185";"Volver a dejar dos carriles para vehículos en Gran Vía de Hortaleza ";"<p>Volver a dejar dos carriles para vehículos en Gran Vía de Hortaleza Y pasar el carril bici al bulevar central. </p>

<p>Recuperar la circulación fluida en esta arteria ya que en horas punta es insufrible ahora mismo</p>
";"16/06/2017 13";"71";"52";"19";"6";"7336724510";"2416"
"5186";"BICIMAD en zona SUR de MADRID: Puente de Vallecas y Villa de Vallecas";"<p>Sería un gran avance en el Sur de Madrid, tan perjudicados por efectos nocivos de Valdemingómez que se dieran avances en el uso de la bici, para que al menos nuestro Medio Ambiente y nuestra salud no se vean más incrementados en contaminación. La implantación de Bicimad sería muy útil para todos los vecinos de Vallecas.</p>

<p>Asimismo, serviría de gran dinaminzación para impulsar el Sur de Madrid, tan perjudicado y olvidado por nuestros ayuntamientos. Es una medida que impulsaría otra forma de transporte y serviría de gran concienciación para el Sur de Madrid, tan olvidado en servicios y tan contaminado.</p>

<p> </p>
";"16/06/2017 22";"117";"103";"14";"6";"7346754610";"7835"
"5187";"Tarjetas unificadas de todos los servicios municipales";"<p>Se trataría de crear unas ""Tarjetas Ciudadano"" que ya existen en algunas ciudades como Gijón o Zaragoza. Sirven para todos los servicios públicos (bicicletas de alquiler, carné de bibliotecas municipales, piscinas, polideportivos o realizar gestiones con la administración local). Se pueden recargar para aquellas actividades de pago (bicicletas o autobúses). Por un lado, unifica todas las tarjetas, con el consiguiente ahorro de espacio en nuestras carteras, es más cómodo, el saldo vale para varias actividades y lleva consigo un ahorro de papel (abonos de EMT, tarjetas, papeles), además de una modernización de la institución.</p>
";"19/06/2017 09";"134";"129";"5";"3";"7374234735";"11937"
"5188";"Jornada de trabajo hasta las 17:00 PM durante todo el año.  ";"<p>Sería interesante estudiar la posibilidad de implantar una jornada de trabajo hasta las 17:00 de la tarde durante todo el año, abandonando la jornada reducida de los viernes y del verano. La idea es que el padre y la madre puedan conciliar y llevar a cabo su trabajo de forma adecuada.</p>

<p>Esto podria dar la posibilidad de que muchos miembros de familia no tuvieran que pedir la jornada reducida en su trabajo que como la mayoría de vosotros sabréis supone una notable reducción en los ingresos mensuales justo cuando más se necesita.</p>

<p>Es por esto que solicito apoyos para presentar una propuesta de estudio que determine si esta medida es viable o si existen otras que puedan de igual forma solucionar este terrible problema que sufrimos muchos ciudadanos. </p>

<p>Gracias. </p>
";"19/06/2017 16";"126";"100";"26";"4";"7371744871";"5873"
"5189";"ASENTAMIENTOS ILEGALES";"<p>Desde hace unos años hay lugares dentro de la capital que están totalmente tomados por gente sin recursos, en una mala situación personal o que viven de la mendicidad.   Lógicamente cada caso es particular y no podemos generalizar, pero ¿ donde está el límite ?,  ¿ que podemos hacer para solucionar este problema que va en aumento?</p>

<p>Conozco el caso del asentamiento en los terrenos de Adif en la zona de Méndez Alvaro, donde creo que no me equivoco si digo que casi cien personas están viviendo en chabolas y en condiciones infrahumanas.  Además de su situación personal, los vecinos sufrimos esta situación que no es agradable.  Gente viviendo en la calle, haciendo sus necesidades a 50 metros del parque infantil, gritos en la noche, peleas e incluso varios casos de incendios.</p>

<p>La solución no está en incriminarles y expulsarles para desplazar el problema a otra parte de la ciudad, pero tampoco creo que la solución sea no hacer nada.  </p>
";"23/06/2017 01";"99";"95";"4";"8";"7409529566";"8732"
"5190";"Museos de los distritos";"<p>Propongo crear en cada distrito de la ciudad un Museo del Distrito. En él se contaría, mediante paneles, maquetas, vídeos... su historia, evolución, urbanismo... Su pasado, su presente y su futuro. Además de por el público en general, podría ser visitado, como actividad de sus colegios, por los escolares de la zona. Así aprenderían la historia de las calles donde viven y las respetarían. Lo que no se conoce, no se quiere; lo que no se quiere, se desprecia y no se cuida. Estas visitas podrían estar dirigidas por guías profesionales y/o por l@s abuel@s y padres y madres del barrio, que les contarían cómo fue su infancia allí.</p>

<p>También se podrían dar conferencias de expertos y charlas y tertulias de gente mayor que ha pasado su vida en esa zona. Y quizá crear un fondo en vídeo con sus recuerdos. Y proyectar documentales y películas en las que salga el distrito.</p>

<p>Se podrían exponer elementos del mobiliario urbano y privado que han dejado de tener su utilidad pero que merecen ser conservados por su valor histórico o sentimental, por ejemplo bancos, papeleras, cabinas de teléfono, letreros de tiendas y calles... Aquel poste de la luz que estuvo años en la esquina de la avenida, el luminoso del bar de toda la vida que cerró, el letrero del cine que había en la plaza, una losa del antiguo suelo de la calle, uno de las antiguas farolas que durante años dieron luz al barrio...</p>

<p>¿Qué os parece?</p>
";"23/06/2017 23";"59";"38";"21";"3";"7408051742";"1094"
"5191";"Editorial para publicaciones sobre la Historia de Madrid";"<p>Abro este debate para impulsar la necesidad de crear una editorial municipal dedicada al estudio, difusión e investigación de la historia, cultura, arte y tradiciones de Madrid. Ya sé que hay editoriales que publican libros sobre Madrid pero vengo observando, desde hace ya tiempo,  que lo que se publica es siempre lo mismo y que hace falta publicar investigaciones nuevas.</p>

<p>Planteo pues una editorial gestionada directamente desde el Ayuntamiento que se preocupe por la publicación de calidad y de espacio a las investigaciones históricas. Creo que además se debería contar con el Archivo Villa para esta editorial ya que en él se custodia el legado docuemntal de Madrid y los investigadores recurren a él con frencuencia.</p>
";"24/06/2017 09";"66";"50";"16";"1";"7415543115";"2575"
"5192";"Préstamo de bicis no eléctricas más baratas";"<p>Me parece genial que existan las bicis eléctricas y que se haya municipalizado el servicio. Sin embargo me parece caro. Entiendo que el coste de estas bicis debe ser elevado, pero al mismo tiempo me parece que su precio es excesivo.</p>

<p>Por eso planteo que en las mismas estaciones en las que se prestan las bicis eléctricas que tanto ayuda en las cuestas de nuestra ciudad, podría haber bicicletas ""normales"" más baratas cuyo alquiler no superase el de ciudades como Lyon en Francia. Podrían ser, de hecho, la mismas bicis que allí y que son las mismas que en algunas otras ciudades españolas como Sevilla.</p>
";"28/06/2017 17";"56";"39";"17";"1";"7456564013";"1532"
"5193";"Limpieza Calle Neguilla y Genista en zona Puerta del Ángel";"<p>Las calles Neguilla y Genista, son practicamente el único acceso que une la Puerta del Ángel con la calle Errmita del Santo, a los Colegios y a Madrid Rio. En definitiva una zona residencial pero de paso y muy transitada. Los que residimos en esta zona, hemos perdido ya la cuenta del tiempo que ha pasado desde que los servicios de limpieza pasaron por nuestra calle. La suciedad y el deterioro llegan a límites de total abandono, con los peligros sanitarios y de seguridad que se asocian a zonas totalmente abandonadas.</p>

<p>Los vehículos aparcados en estas calles, conviven en las aceras con la vegetación que crece en el asflto y en la acera y que en época estival se corre el riesgo de incendio al no ser arrancadas por la falta de limpieza mantenimiento.</p>

<p>La escalera y rampa que une las calles de Neguilla y Genista con la calle Pablo Casal, esta siempre llena de excrementos suciedad y cristales, que le hace prácticamente inaccesible. Si tenemos encuenta que es el acceso directo al Colegio Ermita del Santo, donde diariamente pasan cientos de niños y el peligro de que se corten o malogren por el entorno de dejación, que me atreveria a calificar de hostil e impropio de un vecindario sano.</p>

<p>Solicito que por parte del Ayuntamiento, se incluyan La calle Neguilla y Genista en el protocolo de la limpieza y mantenimiento y vigilancia, en las mismas condiciones que zonas prioritarias de la zona.</p>
";"29/06/2017 12";"20";"18";"2";"0";"7466185307";"1440"
"5194";"World Pride: Se pisotean los derechos de los residentes de Centro ";"<p>Quede claro mi apoyo a la igualdad de derechos sin discriminación por orientación sexual.  Dicho ésto no puedo más que indignarme por APLASTAR -literalmente aplastar- el derecho al descanso, al silencio y a la libertad de movimientos de los vecinos y residentes de la zona Centro de Madrid.</p>

<p>Hubo un año en que se limitó el número de decibelios de las fiestas del orgullo gay.  Este año, no solo se ha dado carta blanca para que pongan altavoces, música  y concentraciones masivas de personas con altísimos niveles de decibelios y hasta altas horas de la madrugada.  Y no solo eso, sino que eso no es de un dia ni de dos, sino de media semana o más, que ni se puede pasear por ciertas zonas céntricas, ni se puede dormir, ni se puede descansar.</p>

<p>Tanto la señora Carmena como la señora Cifuentes son responsables de esta nueva agresión contra la salud de los vecinos y residentes de la zona Centro.  Han primado intereses económicos donde hosteleros, comercios y demás se hacen de oro estos días a costa -una vez más- de APLASTAR el derecho a la salud de los residentes.</p>

<p>  ¿Cómo es posible que la Puerta del Sol esté OKUPADA y masificada durante varios días por unas fiestas?  ¿Por qué no se llevan esas celebraciones a recintos feriales fuera de zonas de residentes?</p>

<p>Personalmente me es totalmente indiferente si son fiestas del orgullo gay, del no gay, de la visita del Papa, o de equipos de fútbol.  NO HAY DERECHO a que nos hagan la vida imposible a los vecinos del centro con este tipo de autorizaciones,</p>

<p>¡¡Por favor, que RESPETEN NUESTRA SALUD de una vez!!  Si quieren fiestas a muchos decibelios que se las pongan debajo de la ventana de la alcaldesa o de la presidente de Madrid.  Pero no a los ya hiper agredidos (terrazas, fiestas y demás)  y sufridos vecinos del Centro de Madrid.  Esto ya es INSOPORTABLE.</p>

<p> </p>

<p> </p>

<p> </p>

<p> </p>

<p> </p>

<p> </p>

<p> </p>

<p> </p>

<p> </p>
";"29/06/2017 17";"93";"65";"28";"30";"7468907619";"2586"
"5195";"Fiestas del orgullo gay";"<p>¿Qué os parece si instamos al gobierno nacional a que tome la fiesta del orgullo gay como fiesta nacional? Que sea festivo.</p>
";"01/07/2017 14";"111";"27";"84";"2";"7471609951";"-1386"
"5196";"ATASCO MONUMENTAL EN MADRID";"<p>ÉSTO SI QUE CONTAMINA!!! Miles de coches atrapados por unas inoportunas obras  de asfaltado, pero....A QUIÉN SE LE OCURRE ASFALTAR EL 4 de julio en plena hora punta???? Sólo al Ayuntamiento ""ecológico"" de Carmena</p>
";"04/07/2017 18";"65";"48";"17";"1";"7518630400";"2289"
"5202";"¡¿Obras en Eduardo Barreiros a las 3 de la mañana ?!";"<p>Es intolerable que se realicen unas obras a las 3 de la mañana, en el tiempo de descanso de la gente del barrio. Independientemente de la obra, creo que se puede realizar a una hora que no altere el sueño a los vecinos de los alrededores a dicha obra: 8-9 de la mañana.</p>

<p>He llamado a la policía municipal y me indican que si se trata de una avería del Canal de Isabel II tienen autorización a trabajar a estas horas.</p>

<p>Son las 3:30 de la mañana, sólo espero que se tenga en cuenta mi denuncia para poder garantizar el descanso de los residentes de las urbanizaciones colindantes.</p>
";"08/07/2017 03";"37";"27";"10";"0";"7550428295";"1240"
"5206";"LIMPIEZA TRES OLIVOS";"<p>Además de limpiar las calles, deberían limpiar las zonas peatonales, parques, y terrenos aledaños a las calles (cunetas, zonas de aparcamiento...) </p>
";"12/07/2017 15";"39";"36";"3";"0";"7600563908";"3046"
"5208";"Ampliacion del servicio de BiciMad a algunas calles importantes.";"<p>Muy buenas, creo que estaria muy bien y atraeria mas clientes la ampliacion del servicio de BiciMad a algunas avenidas, calles o paseos importantes, tales como la calle General Ricardos en la zona de carabanchel, el Paseo de Extremadura en el barrio Latina o la calle Francos Rodriguez en el distrito de Tetuan por poner un ejemplo. Prestar servicio en estas calles no en su completa totalidad porque algunas como General Ricardos son muy largas pero si hasta cierto punto por ejemplo, hasta el metro de Oporto o Urgel.</p>
";"13/07/2017 19";"88";"70";"18";"2";"7611827352";"4136"
"5214";"Yolanda Rodríguez Martínez. Concejal Hortaleza. #nocambiobasuras ";"<p>Concejala, esperamos y exigimos que cumpla el acuerdo de la propuesta del pleno de 18 de julio 2017, en la que se aprueba la paralización de implantación de nuevos contenedores de basura en Sanchinarro y Valdebebas,donde contamos con cuartos de basura por exigencia técnica, y  explique a grupos políticos y vecinos las supuestas ventajas de sacar las basuras a la calle y ensuciar nuestros barrios con basuras y olores durante todo el día. Confiamos en que esta no sea una medida dictatorial y sin duda perjudicial y problemática como ya se está comprobando, además de discriminatoria. No a ensuciar Madrid y nuestros barrios.</p>
";"19/07/2017 19";"57";"48";"9";"3";"7671745719";"3284"
"5216";"Cambios de los horarios de las terrazas";"<p>De domingo a jueves de 8 de la mañana a 1:30.</p>

<p>De viernes, sabado y festivo de 8 a 2:30.</p>

<p> </p>
";"21/07/2017 22";"66";"18";"48";"11";"7675199199";"-818"
"5225";"¿Por que no se han admitido los votos d las hojas de firmas x la votación final?";"<p>Buenas tardes:</p>

<p>Ante todo darle las gracias a esas mentes privilegiadas que cuando quieren deciden cambiar las cosas, cuando nos habían confirmado por activa y por pasiva y de gente muy cercana a la institución que de lo que trato en el debate era legal y se podia presentar siempre que fuera dentro del plazo y en la forma de hoja de firmas.</p>

<p>Soy un ciudadano que se siente engañado, frustrado, decepcionado, por que no se han admitido dichas firmas, firmas de muchos cientos de personas que lo han hecho por que era legal, por que estaba en las bases y en ningún momento se específica que no valgan para la fase final. Muchas personas votaron de esa manera ya que no tienen acceso a internet o no saben moverse por el mundo web fuera a parte de la forma difícil inventada para la votación web, poco clara y muy liosa. Hay personas que aunque no se lo crean no tienen móvil.</p>

<p>En fin una más después de todo lo trabajado y todo lo que hemos movilizado para presentarnos a dichos presupuestos.</p>

<p>Me gustaría a mi y a ese ciento de personas, que se sienten engañadas, nos respondieran los responsables de dicha decisión a la pregunta:</p>

<p>¿Por que no se han admitido los votos de las hojas de firmas para la votación final?</p>

<p>Atentamente,</p>

<p>Un ciudadano que se siente engañado.</p>
";"26/07/2017 18";"37";"22";"15";"3";"7733024728";"416"
"5227";"Ciudad de los Ángeles y Cubiertas verdes,";"<p>Resido en la Ciudad de los Ángeles desde hace muchos años, y este texto consituye mi opinión únicamente y no ha sido consensuado ni con vecinos ni con autoridades.</p>

<p>Hace algunos años hubo un plan para adecuar edificios en su mayoría construídos para la fábrica Barreiros (Actualmente PSA), mejorando la accesibilidad mediante ascensores, mejora de fachadas, doble acristalamiento etc. Una característica que pasó desapercibida fueron que todos estos edificios tienen en vez de una cubierta una azotea.</p>

<p>Con la demanda de espacios verdes, de ciudades cada vez mas abarrotadas y sin vegetacion han surgido las llamadas azoteas verdes.</p>

<p>Me gustaría saber si habría algun proyecto europeo, o estatal,  que financiara un proyecto piloto para adecuar estos edificios que en su mayoria han sido remodelados y cuyas azoteas están ahora cubiertas de piedras, (por lo que podrían soportar el peso de una azotea verde), por azoteas verdes, extensivas y/o intensivas y que no supusiera gran costo para los vecinos, en su mayoría jubilados con pensiones que no permiten muchas alegrías y que ya han sufragado unas recientes obras.</p>

<p>Creo que esta experiencia serviria para ver como se puede mejorar el ambiente, además no creo que sea excesivamente costo ya que la mayoria de edificios han pasado por estudios técnicos para soportar las cubiertas de piedras, así como remodelaciones que incluyen la impermeabilización de las mismas, y los beneficios podrían ser considerables en cuanto a la mejora de la calidad del aire, el calor etc.</p>

<p> </p>
";"04/08/2017 10";"21";"16";"5";"2";"7822370513";"838"
"5229";"Abandono de las calles Jacinto Verdaguer y Mercedes Arteaga";"<p>He abierto un debate para plantear al Ayuntamiento el estado de abandono total de estas calles que están cerca de Marques de Vadillo (Carabanchel) y que se situan prácticamente en paralelo a General Ricardos. Estas calles son muy transitadas tanto por peatones como por coches dado que tienen bastantes comercios y también son muy utilizadas para aparcar los vehículos, que antes lo hacían en la calle General Ricardos. En general las calles dan muy mal aspecto, sobretodo por las noches, por su poca iluminación y también por la falta de limpieza.</p>

<p>En muchas ocasiones las bolsas de basura y cartones se acumulan fuera de los contenedores de basura por estar estos llenos o porque la gente directamente no la mete dentro o rebusca entre ella. Esto da una sensación bastante desagradable. Estas semanas atrás han cambiado los contenedores viejos de basura viejos por unos nuevos. La empresa que los ha colocado ha tenido poca delicadeza y prácticamente los ha tirado allá donde hayan caido: No están alineados ni juntos en muchos casos, quitan plazas de aparcamiento en otros, están subidos sobre la acera o sobre las rejillas de ventilación del parking subterráneo,... </p>

<p>Es habitual observar aceras en mal estado, sin reparar, en algunos casos levantadas por árboles. El tránsito por ellas es complicados tanto para sillas de ruedas, personas mayores y carritos de bebés por el total deterioro y, en muchos casos, por los vehículos que se encuentran subidos en las aceras. Se da la curiosidad de que la Comunidad de Madrid tiene una oficina de Atención a la Discapacidad en una de estas calles. El tráfico por estas calles y alrededores es un verdadero caos tanto por la saturación de vehículos aparcados en doble y triple fila en horario comercial,  como por el estado del asfalto lleno de baches y agujeros pordoquier. Parece que estas calles nunca están en los planes de asfalto del Ayuntamiento.</p>

<p>Por último, pese a tener una comisaría de policía cerca, es habitual los robos en los vehículos aparcados en ellas. Carteles con el texto ""No tengo nada en el coche. Por favor, no robar"" o cristales de ventanillas por el asfalto es una imagen que se ve regularmente.   </p>
";"10/08/2017 13";"40";"37";"3";"1";"7889878343";"3145"
"5231";"¿LE CAMBIAMOS EL NOMBRE AL CENTRO-CENTRO DE CIBELES?";"<p>Hay que tener poca imaginación para llamar a una instalación cultural y de participación ciudadana CENTRO-CENTRO. Este debate trataría de encontrar un posible nombre alternativo a dicho centro.</p>

<p>Dado que el Palacio de Comunicaciones de Cibeles, en el que se ubica el Centro-Centro fue diseñado por los arquitectos Antonio Palacios y Joaquín Otamendi, sugeriría que pasara a denominarse CENTRO DE CULTURA Y CIUDADANÍA PALACIOS-OTAMENDI. ¿Qué os parece?</p>
";"16/08/2017 22";"60";"36";"24";"3";"7946045404";"719"
"5233";"Que vuelvan los jardineros con sus mangueras.";"<p>Refrescar. Mantener jardines interbloques. Cuidar que los árboles estén bien hidratados. Y de paso limpiar las aceras.</p>
";"18/08/2017 16";"119";"114";"5";"4";"7976320704";"10442"
"5234";"A la atención del responsable del barrio la Prope hasta Clara del Rey.";"<p>Los vecinos de la zona, llevamos varios meses esperando que asfalte la calle de Juan Bautista de Toledo. despues de arreglar las aceras, de estos hace varios meses, hasta el momento no se ha asfatado la calle de Juan Baustista de Toledo, con grandes socavones desde la calle López de Hoyos hasta Clara de Rey. Cada vez que cruzamos de una acera a la otra, estamos a punto de caernos y ropernos un brazo, piernas o caderas, etc. etc. Pero,  el cerebrito responsable, no debe de tener mucha capacidad y eficiencia mental para asimilar los peligros que esto conlleva.</p>

<p>Por favor, arreglelo cuanto antes. Si usted hace las cosas mal, al final recaerá todo sobre la propia Alcadesa, ya que es la mayor responsable.</p>
";"20/08/2017 13";"26";"20";"6";"0";"7984430469";"1076"
"5235";"Barrio de la Cocepción- Suciedad";"<p>Desde hace meses el barrio está asqueroso. No barren, ni limpian, y está la basura acumulada del Invierno sin limpiar. El parque Calero está mas sucio y descuidado que nunca. LLeno de hojas, barro, suciedad, ya no hay jardineros, ni hay mantenimiento del Parque. Es lamentable el estado en el que se encuentra....</p>

<p>Las calles están inmensamente sucias. Qué está pasando con la limpieza? Han habido recortes? Los vecinos estamos indignados.</p>
";"20/08/2017 19";"53";"45";"8";"5";"7991471287";"3141"
"5236";"Soluciones reales contaminación + NO corte acceso M30 norte desde Casa de Campo";"<p>El pasado 25 de julio el ayuntamiento cortó de forma definitiva el acceso a la M30 norte desde la casa de campo (túnel de las moreras) y creo que esta opción se debería reconsiderar, ya que para la gente que vivimos en el distrito de Latina, es fundamental este acceso para poder acceder a la M30 norte, sobre todo en los días laborables.</p>

<p>Desde el ayuntamiento se argumenta que es una medida medioambiental, pero bajo mi punto de vista, esta medida no va a hacer que los madrileños no cojamos el coche para ir a trabajar y con esta medida, lo único que ocurrirá es que agravará el tráfico de la zona dentro de la avenida de portugal, paseo de extremadura, principe pío y avenida de valladolid... Por lo que la contaminación será la misma o peor... y aire tambié irá hacia la Casa de Campo.</p>

<p>El ayuntamiento debería aportar soluciones más resolutivas como:</p>

<p>- Fomentar ayudar REALES para transportes escolares.</p>

<p>- Fomentar las rutas de empresa.</p>

<p>- Fomentar el teletrabajo.</p>

<p>Pero no fastidiarnos a los trabajadores día tras día...</p>

<p>Nadie queremos un Madrid contaminado y tampoco queremos perder horas al día en atascos interminables. Así que por favor, propongo que el ayuntamiento reconsidere la apertura de este acceso a la M30 y que piense en soluciones más constructivas para reducir el tráfico en los días laborables.</p>

<p>Saludos.</p>
";"21/08/2017 14";"83";"58";"25";"9";"7997014896";"2306"
"5237";"el SER y las personas con movilidad reducida";"<p>cuando llevas a una persona con movilidad reducida la dejas en el portal , cine , mercado , domicilio etc y te vas a aparcar donde puedas generalmente zona SER y plazas verdes o azules , algunas veces dejas el coche un rato y otras toda la noche y acompañas a la persona con movilidad reducida a hacer lo que sea , a nadie se perjudica pero comienzo a recibir denuncias por estacionar con autorización no válida , solo se me ocurre que quieran sacar unos pocos euros más en el SER , no sé si le sucede a más personas , es en Madrid capital</p>

<p>dicha persona tiene la tarjeta de aparcamiento para personas con movilidad reducida en vigor en madrid , creo que válida en europa</p>
";"23/08/2017 19";"35";"25";"10";"6";"8016929882";"1071"
"5238";"Pancarta de Welcome Refugees";"<p>Buenos días, quería comentar para ver qué opiniones hay sobre la pancarta. A mi me parece que es un acto propangandístico que no ayuda en nada a los pretendientes a refugiados y además supone un derroche de dinero público, cuando España está en una situación demasiado crítica como para que una parte de la sociedad decida qué hacer con el dinero del resto.</p>

<p>Por este motivo pienso que el ayuntamiento no debe intervenir, sino aquellas personas que se consideren moralmente obligadas, las que ayuden a los refugiados con su patrimonio dando ejemplo.</p>
";"23/08/2017 20";"120";"76";"44";"11";"8018553703";"2026"
"5239";"Abran el retiro más horas";"<p>Debe estar abierto, al menos hasta las 3 de la mañana</p>
";"24/08/2017 05";"103";"27";"76";"2";"8007804057";"-1284"
"5240";"Abran bibliotecas toda la noche, no en épocas de exámenes";"<p>Bibliotecas deben estar abiertas toda la noche y varias horas más y acceso internet libre, ...</p>

<p>Gracias</p>
";"24/08/2017 05";"93";"66";"27";"3";"8023650277";"2767"
"5241";"Abran metro más horas en la noche";"<p>Es necesario y absurdo el mal servicio, a parte del ruido e iluminación horrorosas</p>
";"24/08/2017 05";"168";"147";"21";"8";"8030740902";"11025"
"5242";"Instalar cubiertas en parques infantiles";"<p>Desde la creación de esta plataforma se han desarrollado diferentes propuestas para la instalación de cubiertas en nuestros parques infantiles, todas ellas fueron archivadas. Las cubiertas no solo suponen que los niños puedan jugar en horas y días con mucho sol o lluviosos, que en Madrid se estima que son aproximadamente 180 al año!!!, si no que permite rentabilizar un mobiliario que ya ha sido pagado por todos y que en muchos casos vemos desierto gran parte del tiempo.</p>

<p>He creado una propuesta detallada sobre este asunto, que pueden ver y apoyar en https://decide.madrid.es/proposals/19236-cubiertas-en-parques-infantiles. No obstante,  aunque casi todos los padres madrileños tienen interés y los ciudadanos de otros municipios (Meco, Bilbao,..) en los que se han desarrollado propuestas similares están satisfechos, es interesante saber cual es la opinión de todos los ciudadanos, que son los que tienen que decidir.</p>

<p>Muchas gracias por sus opiniones y todo aporte que pueda mejorar la propuesta es siempre bien recibido.</p>
";"25/08/2017 10";"76";"55";"21";"10";"8035601958";"2460"
"5243";"Denuncias anónimas ";"<p>Que se pueda denunciar a la policía municipal anónimamente . Le Facilitaría a más personas reportar delitos y mantendría Madrid más segura .</p>
";"03/09/2017 11";"106";"68";"38";"3";"8124491386";"1924"
"5244";"Horarios terrazas de.barws";"<p>Las.terrazas.de.bares situadas en los bajos.de bloques de viviendas deberian cerrar a.las 12 de la.noche y especialmente si están bajo las ventanas de los dormitorios. </p>
";"05/09/2017 17";"113";"90";"23";"2";"8151741155";"5336"
"5245";"Cartillas de vacunación y seguimiento AGOTADAS para los recién nacidos.";"<p>Los recién nacidos de la comunidad de Madrid no tienen libro de vacunaciones y seguimiento. Desde la maternidad proporcionan una triste fotocopia de una hoja donde apuntan la vacuna puesta y pegan el resultado de la prueba auditiva. Y en los centros de salud más de lo mismo.</p>

<p>""Están agotadas"" es la respuesta en todos los casos mientras imprimen una nueva hoja para que la colecciones con cada nueva vacuna.</p>

<p>Una vergüenza.</p>
";"17/09/2017 11";"64";"58";"6";"4";"8270540965";"4712"
"5247";"Encuesta sobre movilidad - Ayuda estudiantes";"<p>Buenos días, un grupo de estudiantes estamos desarrollando un estudio sobre qué necesidades tienen los habitantes de las grandes ciudades sobre transporte y movilidad y como la tecnología actual podría ayudar a mejorar los desplazamientos. Os pedimos por favor que hagáis llegar la encuesta personas que vivan en gran núcleos urbanos. Muchas gracias por vuestra colaboración!!! https://docs.google.com/forms/d/e/1FAIpQLSd2PtbBizcKXbNletRBHUIl0LTNwfi2IwSV1iweJqeJdEJ8gw/viewform?c=0&amp;w=1                          </p>
";"23/09/2017 19";"33";"28";"5";"1";"8329656843";"1951"
"5248";"¿Porque se da licencia de Apertura a un estadio de futbol sin accesos?";"<p>Cualquier ciudadano ""de a pie"" que quiera abrir un negocio, renovar su casa, etc tiene que cumplir una normativa al respecto, que algunas de ellas van encaminadas a no importunar/molestar a vecinos o personas que pasan habitualmente por la zona, y si no las cumples el ayuntamiento te sancionara o ne te dara licencia.</p>

<p>Todos sabiamos (y el ayuntamiento tambien) que dar licencia de apertura al Wanda Metropolitano sin los accesos y aparcamientos que requiere un edificio que mueve a 60000 personas hacia el, causara importantes problemas de trafico en la zona, por ejemplo, hacer un recorrido que cuando sales del trabajo habitualmente tardas ""2 minutos"", a la misma hora, en dias de futbol se tarda ""45 minutos"".</p>

<p>En definitiva, este es el ejemplo por el cual tenemos la certeza de que los politicos y politicas sean del signo que sean no cambian, aunque nos digan que con ellos vamos a conquistar el cielo   </p>

<p> </p>
";"28/09/2017 09";"55";"46";"9";"0";"8377259978";"3094"
"5249";"Mejorar insonorización en MediaLab prado";"<p>Con ocasión de la celebración del congreso GIGAPP2017 se han celebrado reuniones simultáneas en las diferentes minilabs que existen en MediaLab. Un espacio que resulta interesante, recuerda algo a Blade Runner.</p>

<p>Con objeto de mejorar la calidad de la audición sería conveniente establecer algún sistema que manteniendo el carácter participativo del espacio evite interferencias de ruido entre las salas.</p>
";"28/09/2017 18";"25";"20";"5";"0";"8376913594";"1200"
"5250";"La multas impuestas a las motos estacionadas SON ILEGALES.";"<p>La multas impuestas por los agentes de movilidad del ayuntamiento de Madrid a las motos estacionadas en calles céntricas de Madrid SON ILEGALES.
Escribo en este sitio que presume de ser un sitio abierto de opinión, para denunciar lo que está siendo un abuso autoritario cuyo único fin es el recaudatorio, saltándose los derechos del ciudadano que están reflejados en el propio código de movilidad del Ayuntamiento.</p>

<p>El hecho es que el pasado mes de abril fui multado por aparcar a las 15:50h  de la tarde mi motocicleta en la Gran Vía. El vehículo estaba ""cívicamente"" estacionado en la acera, por un periodo de 10 minutos, pegado al bordillo de la calzada, en un trecho de acera que supera los 6 metros de ancho. Al estar estacionando mi vehículo observé en la acera de enfrente a dos agentes de movilidad que me vieron estacionar y seguí hacía mi destino, ustedes piensen lo que quieran sobre este hecho. Cuando regresé para irme me percaté de que me habían dejado un recibo de multa en el asiento del  vehículo. En él se reflejaba como infracción: el ""obstaculizar el paso de transeúntes"". Repito: 15,50h, sin tránsito de gente, acera amplia y vehículo pegado a la calzada Por lo que en ese mismo instante tomé varias fotos del vehículo y así poder aportar pruebas en caso de me llegase ""la infracción"".</p>

<p>Esperé a que me llegase la multa por correo para recurrirla. Cuando esta llegó la cuantía a pagar 30 con reducción del 50% a pronto pago. Formulé el recurso, argumentando los hechos y aportando fotos del momento de la infracción tomadas por el móvil para que se vea perfectamente que la motocicleta en nada perjudica el tránsito. Tras pasado un tiempo vuelve a venirme la notificación, me indican que no aporto suficientes pruebas, a pesar de he incluido en la reclamación fotos del lugar y momento. Vuelvo a recurrir y finalmente me ha llegado la sanción definitiva sin posibilidad de nuevo recurso instándome a que pague la multa y dejándome como última opción acudir a los tribunales. Y el único aporte que el Ayuntamiento hace es que prevalece la palabra del Agente de Movilidad ante el denunciado, eso si sin necesidad de aportar ninguna prueba más allá de su palabra que es vale más que la mía, esto en primer lugar deja mucho que desear como vulneración de la igualdad de derechos entre ciudadanos y que te deja inexorablemente indefenso ante cualquiera de estos agentes recaudatorios. A todo esto en ambos recursos he solicitado pruebas como fotos, a lo que están obligados los agentes y no he recibido nada de nada</p>

<p>Denuncio aquí que esta multa ES ILEGAL totalmente, el hecho es que el artículo 62 del Código de Ordenanza de Movilidad por el que se me ha multado dice esto:</p>

<p>Los vehículos de dos ruedas, ya sean motocicletas, ciclomotores o bicicletas, estacionarán en los espacios específicamente reservados al efecto. En el supuesto de que no los hubiera, siempre que esté permitido el estacionamiento, podrán estacionar en la calzada junto a la acera en forma oblicua a la misma y ocupando una anchura máxima de 2 metros, de forma que no se impida el acceso a otros vehículos o el paso desde la acera a la calzada. No se autoriza el estacionamiento de motocicletas y ciclomotores en estacionamientos destinados a bicicletas y viceversa. En los espacios específicamente reservados para el estacionamiento de motocicletas y ciclomotores, queda prohibido el estacionamiento de vehículos de cuatro ruedas, salvo que exista señalización
específica que lo permita. Cuando no sea posible el estacionamiento en calzada o en los espacios reservados previstos anteriormente, los vehículos de dos ruedas podrán estacionar en las aceras, andenes y paseos de más de 3 metros de ancho con las siguientes condiciones:
1. Paralelamente al bordillo, lo más próximo posible al mismo, cuando las aceras, andenes o paseos tengan una anchura inferior a seis metros.</p>

<p>En resumen, está permitido estacionar en la acera manteniendo unas normas básicas de civismo y respeto hacía los transeúntes.</p>

<p>Durante los dos últimos años se ha reflejado en diversos artículos de la prensa nacional que estas sanciones son ilegales y que vulneran precisamente el propio Código de Movilidad. Lo ideal sería crear una plataforma de damnificados por estas sanciones y acudir a los tribunales. El hecho de que un ciudadano normal no pueda permitirse los gastos de ir a un juicio, al que según la opinión de mi abogado tendría ganado, es la garantía para seguir ejerciendo este ABUSO DE AUTORIDAD, porque la Administración no está obligadas por Ley pagar las costas del juicio.
Señora Carmena y responsables del servicio de Movilidad de Madrid, busquen otro tipo de financiación y dejen de ABUSAR de los ciudadanos que buscamos en vehículos pequeños una forma de movernos por la ciudad de manera más cívica que utilizar un coche. Dejen de sancionar ILEGALMENTE a los usuarios de motocicletas que estacionamos de la mejor forma posible en LOS ESPACIOS QUE NOS PERMITE LA LEY.</p>

<p>Mi enfado es monumental, no se trata de pagar esta cuantía de 30, no es una cifra grande, pero si que para mi es muy grande es la vulneración de mis derechos como ciudadano. El impuesto de circulación que se aplica por motocicletas de media/alta cilindrada en Madrid (el más alto de España) equivale al de un automóvil que cuadruplica su tamaño, dobla la cilindrada y contamina muchísimo más.</p>

<p>Creo que lo último que me queda es empezar a publicar en todos los medios que pueda este asunto. Y como ciudadano de Madrid, creo que el primer sitio por el que debía de empezar era este. Asumir una infracción que no tiene fundamento y que como única justificiación es que vale más la palabra de un ""agente de Movilidad"" que la de un ciudadano, como mínimo nos retrae a tiempos un tanto oscuros de nuestra historia</p>
";"30/09/2017 12";"89";"49";"40";"5";"8390557659";"495"
"5251";"mayor control de la policia en los parques y plazas";"<p>Dejar de molestar a los vecinos en la plaza que hay en la calle plata, se dedican a estar toda la noche a gritos y con la musica y es imposible dormir y no se pasa ningúin policia y encima si les dices algo se moleste. mayor control de policia por la noche. </p>

<p>Como en esta plaza se que hay muchas otras que se dedican a armar jaleo durante la noche, en esta que les indico pueden estar hasta las 4 y 5 de la mañana a gritos y con musica alta. No he visto nunca patrullas de policia pasando</p>
";"03/10/2017 11";"104";"101";"3";"0";"8434234849";"9517"
"5252";"Los nuevos contenedores en Madrid";"<p>Los nuevos contenedores son poco útiles. Las personas mayores no pueden abrirlo, hay que hacer mucha fuerza, y dejan las bolsas en el suelo.En Moratalaz donde vivo ya hay muchos rotos. Contienen demasiada basura que con el calor en poco tiempo empieza a oler mal.Ha sido una mala idea, cambiar el modelo de contenedor y eso siempre nos costará dinero.</p>
";"04/10/2017 10";"93";"76";"17";"9";"8439094936";"4821"
"5253";"Control de ocupacion y estetica de las terrazas";"<p>Cada vez se abren mas terrazas parece que de forma descontrolada. En muchos casos la ampliacion de las aceras solo sirve para umentar la ocupacion por terrazas. Las sillas y mesas , salvo excepciones se almacenan en las aceras de noche. Se ocupan las aceras de forma abusiva sin control de numero de mesas, de tal forma que a veces los peatones tenemos dificultades para circular. Esteticamente si se abren al menos que exista un control estetico uniforme. &lt;La variedad de esteticas sin ningun orden afea enormemente la ciudad</p>
";"05/10/2017 00";"98";"83";"15";"8";"8445822014";"5759"
"5254";"El poder de deliberación de esta plataforma online";"<p>Para los usuarios, ¿cómo esta plataforma virtual ayuda y soluciona los problemas de Madrid? ¿Qué podría ser mejor? ¿Ustedes hallan esto un buen medio de comunicación?</p>
";"05/10/2017 01";"36";"14";"22";"5";"8427329147";"-311"
"5255";"Prevaricación y colocaciónes a dedo de amigos ";"<p>En la junta municipal de Puente de Vallecas encontramos un caso sangrante de asesor a dedo. El señor asesor Juan José García Espartero percibe un sueldo de 51.000 anuales como asesor cultural en un distrito.  ¿Sus logros? Como podrán comprobar a través de la página de transparencia madrid los estudios de esta persona se resumen en tener la EGB. Desde los años 70 hasta 2015 ha sido dueño y gestor de una sala de conciertos en Vallecas, conocida por ser punto de reunión de grupos de izquierdas (casualidad).  Bueno, pues en 2015 cambia la titularidad de la sala y la traspasa. ¿A quien? A su hermano... y comienza sus andanzas como asesor, percibiendo un jugoso sueldo. La traspasa repito a su hermano, vamos, que sigue siendo suya.... El nombre de la sala es Hebe, sita en puente de Vallecas, aunque la empresa es V.K.S.L. Con un par de búsquedas por internet se puede comprobar todo.  Muy bien, pues no se que clase de conocimientos culturales puede tener este hombre. Quizás los tenga, y sea un erudito, pero dudo mucho de que sus servicios nos cuesten 51.000 al año por asesorar a un distrito en el ámbito cultural.</p>

<p>Un medico cobra bastante menos o un catedrático, bombero, incluso altos funcionarios del estado o ayuntamiento. </p>

<p>Lo sangrante es que muchos como yo votamos a Ahora Madrid hartos de los políticos que se turnan para enriquecerse. Queríamos nuevos políticos, íntegros y decentes. Ahora me siento engañado al ver cosas como esta.... si esto ocurre a nivel junta de distrito, que no ocurriría en el ayuntamiento. </p>

<p>Puente de Vallecas se cae a cachos; es sucio, inseguro.... y se paga 51.000 a un asesor que es amigo del concejal de turno? </p>
";"05/10/2017 14";"98";"83";"15";"15";"8451840089";"5759"
"5256";"¿Expropiar a fondos buitre para crear un parque de vivienda protegida?";"<p>Los madrileños del centro de Madrid están siendo expulsados por los fondos inversores. Tras la venta masiva de los pisos a fondos buitre, sus inquilinos son notificados por sus propietarios para que abandonen la vivienda.</p>

<p>Mientras, los fondos buitre se hacen con miles de viviendas en el centro de Madrid para reformarlas y revenderlas a precio más caro. Los pisos son posteriormente adquiridos por empresas que les dan salida como negocio de alquiler vacacional. </p>

<p>Incapaces de pagar los cada vez más caros alquileres, los vecinos se ven obligados a abandonar la capital. Mientras el centro se llena de empresas inversoras que los convierten en un negocio turístico, sus antiguos inquilinos se convierten en ocupas.</p>

<p>Esta historia se repite año tras año, mes tras mes, día tras día. Mientras, el Ayuntamiento de Madrid no tiene pisos para alquileres sociales, a precios ligeramente por debajo del de mercado. </p>

<p>¿Estás de acuerdo en que el Ayuntamiento y la Comunidad de Madrid expropien pisos del centro de las ciudades a los fondos buitre para formar un patrimonio de pisos en propiedad, y alquilarlos a familias con bajos recursos?</p>
";"06/10/2017 23";"136";"108";"28";"4";"8465162998";"6352"
"5259";"Masacre de árboles";"<p>Mi barrio es Casa de Campo. Desde finales de septiembre veo atónita como cometen una masacre de los árboles que llevan décadas dándonos sombra y protegiéndonos de la contaminación de la M30. La tala es totalmente indiscriminada; muchos de estos árboles eran sanos. El cartel que puso el Ayuntamiento decía que iban a podar o talar si fuese necesario, los operarios han cogido la segunda opción sin más. También dicen que han consultado con las asociaciones de vecinos de la zona, no me lo creo; nadie en su sano juicio puede estar de acuerdo con una tala de tantas dimensiones que tiene unas consecuencias tan desastrosas, tanto para el medioambiente como para nuestra calidad de vida como residentes del barrio. Tristemente es tarde para estos preciosos árboles, pero ¿qué se puede hacer para impedir que sigan con la masacre?</p>
";"09/10/2017 15";"118";"104";"14";"5";"8493926047";"7932"
"5260";"Las molestas bicicletas en Tetuán/ Chamberi";"<p>Las calles que no disponen de carril bici, aquellos que van con la bicicleta circulan por donde quieren,  sobre todo por la acera, un día de estos va a haber un accidente con los peatones, debería estar prohibido la circulación de bicicletas en las aceras.</p>
";"09/10/2017 19";"81";"58";"23";"4";"8489183193";"2506"
"5261";"REMODELACIÓN DE 11 PLAZAS DE MADRID";"<p>No entiendo que en la remodelación de 11 plazas estén incluidas plazas que están hechas prácticamente nuevas (como p.e la plaza del Encuentro de Moratalaz) y otras son sólo un descampado (como Puerto Canfranc en Puente de Vallecas). Un descampado donde no existe nada y que es una reivindicación histórica de los vecinos que se urbanice algo allí. No me parece que esta plaza vaya a votación cuando es obligación del Ayuntamiento hacer algo allí</p>
";"10/10/2017 07";"106";"70";"36";"26";"8493999763";"2245"
"5262";"Mas aparcamientos para autobuses turísticos en Madrid Centro";"<p>Los que trabajamos conduciendo autobuses turísticos nos las vemos y deseamos para poder subir y bajar turistas (que dejan mucho dinero en nuestra ciudad) en algunos sitios importantes de Madrid. No tenemos aparcamientos disuasorios cercanos, no nos dejan parar en ningún sitio. A veces ni siquiera en frente de los hoteles como el Palace, multándonos por dejar clientes en la puerta del Hotel. Nosotros los  autobuses hacemos un bien a la ciudad, no solo por el dinero que dejamos en impuestos (pagamos mas numerito que un turismo) sino porque somos una pieza importante que mueve el turismo en nuestra ciudad.</p>
";"10/10/2017 12";"58";"21";"37";"1";"8480670134";"-579"
"5263";"REMODELACIÓN/REPARACIÓN URGENTE DE LA PLAZA DE LA REMONTA";"<p>Es urgente realizar una reforma de la Plaza de Remonta que no se limite simplemente a parchear con cemento las zonas levantadas por el incesante tráfico de coches y camiones (aunque está restringido el tráfico en teoría). El estado actual es lamentable, con numerosas zonas levantadas, cascotes. etc. Es esta una plaza muy frecuentada por niños y ancianos, lo que supone un riesgo importante, amén del terrible aspecto que presenta. Si se va a seguir permiitiendo el acceso de vehículos a la plaza se debería acometer un proceso de sustitución del enlosado con resistencia a este tráfico. </p>

<p>Por otra parte, el estado de limpieza de las calles adyacentes (Voluntarios catalanes, p.ej.) es sencillamente bochornoso, lo que dice mucho y mal de la falta de civismo ciudadano y de la insuficiente limpieza</p>
";"10/10/2017 13";"82";"69";"13";"1";"8500354860";"4712"
"5264";"Cambio de sentido de Calle de la Raza en el cruce de la calle Alcala";"<p>Desde finales del mes de Agosto y tras las obras que tuvieron lugar en el barrio de Canillejas este verano, resultó el cambio de sentido de diversas calles colindantes Alcalá.</p>

<p>Entre ellas se encuentra la calle de la Raza, la cual llevaba siendo toda la vida una calle en el que se permitia la circulacion desde la calle Esfinge, y que desde ese momento se ha cambiado el sentido para que solo se pueda acceder a ella desde las calles de chalets que rodean dicha zona.</p>

<p>Todo ello ha conllevado a problemas tan grandes como son los atascos y colapsos que desgraciadamente no son pocos en esta zona, sin nombrar los dias de partido en el Wanda Metropolitano, donde el barrio de Canillejas se convierte en una auténtica ratonera.</p>

<p>La obligación unicamente de poder girar a la derecha o izquierda y no poder seguir de frente desde la calle Esfinge en su cruce con Alcalá, no favorece, en absoluto Srs concejales, el ya desastroso trazado vial que tiene este barrio. </p>

<p>Desconozco cual es el fin de este cambio, pero les invito a acercarse al barrio en plena hora punta para que vean que esta medida carece de sentido alguno, que solo genera más estrés y peligros para los mismos conductores.</p>

<p>Les pido que reconsideren esta decision.</p>

<p>Gracias.</p>
";"10/10/2017 16";"27";"17";"10";"4";"8492576107";"440"
"5265";"NUEVOS CUBOS (de carga lateral) DE RECOGIDA";"<p>El AYUNTAMIENTO DE MADRID TIENE PLANEADO COLOCAR NUEVOS CUBOS (de carga lateral) EN LAS CALLES DE LA ZONA NUEVA DEL PAU DE CARABANCHEL ALTO., ESTE NUEVO SISTEMA SUPRIMIRÍA LOS CUBOS QUE SE GUARDAN EN LAS COMUNIDADES TENIENDO QUE DEPOSITAR LAS BASURAS EN LOS CONTENEDORES QUE PERMANECERÍAN TODO EL DÍA EN LA CALLE.</p>
";"10/10/2017 18";"56";"26";"30";"3";"8485022041";"-185"
"5266";"Ampliar los espacios verdes de Madrid";"<p>Hola a tod@s.</p>

<p> </p>

<p>Abro este debate para escalar la problemática de la contaminación en madrid y la escasez de espacios verdes.</p>

<p>Desde el ayuntamiento deberían promover el espacio de zonas verdes.  Madrid es una jungla de cemento y cada año la lluvias son más y más escasas, lo que hace que muchas veces la calidad del aire sea pésima y sobrepase los registros de ""no saludables"".</p>

<p>Estamos cansados de registrar niveles altos de contaminación en Madrid y esto es el desencadenante de muchas enfermedades y una merma en la calidad de vida. Creo que apostar por zonas verdes es una gran solución para resolver este problema. </p>

<p>Las zonas verdes absorben la contaminación y depuran el aire, nos dan sombra y espacios comunes, embellecen la ciudad, regulan las temperaturas, atraen la lluvia, y, en definitiva, nos hace más felices.</p>
";"11/10/2017 09";"164";"153";"11";"2";"8514178793";"13247"
"5267";"Recogida de exclementos de animales por parte de sus dueños";"<p>Me gustaría debatir está propuesta, de estos colectivos personal de Concerje y porteros. De fincas urbanas, con el trato vejatorio, insultos o hacerse el tonto cuando les sorprende, y amonesta algunos dueños que les pilla infragantis, en las descomposiciones de sus animales, en los portales, en aceras cercanas a ellos, con presupuesto 0 euros en conservación y limpieza en la vía pública. A mi me gusta los animales, y no los tengo es por este u otro motivo,  en la convivencia diaria con otros ciudadanos, de mi municipio o ciudad que pudieran afectarse por aquellos dueños incivico de sus mascota. Enrique1963</p>
";"11/10/2017 13";"157";"153";"4";"16";"8516979919";"14520"
"5268";"SERVICIOS MUNICIPALES ESCOLARES";"<p>La falta de lluvia esta elevando los niveles de contaminacion. Y la ciudad esta llena de coches conducidos por 1 persona. Muchos usan el coche para poder recoger a sus hijos y llevarlos despues a sus extraescolares. Un sistema de autobuses que cubran varios colegios, atendidos por personal municipal; un sistema de ""porta equipajes de niños"" para poder llevar a los niños en bici, que pudiera dejarse en el colegio (que fuera publico). Cualquier otra cosa que ayude a que no usemos el coche, ya que el clima lo permite y respiremos todos mejor aire</p>
";"11/10/2017 15";"54";"47";"7";"3";"8510617733";"3481"
"5270";"Arreglar pavimento de la calle Avicultura";"<p>En esta calle, el pavimento está levantado y a falta de trozos, las raices de los árboles están en la superficie y la gente mayor tropieza y se cae. Hay unos macetones enormes que están rotos y los árboles, son tan frondosos que casi tapan el suelo... parece una selva. Estamos hartos de llamar al 010 para reclamar y sin solución. Además este teléfono no es gratuito. La limpieza de la calle brilla por su ausencia.</p>
";"12/10/2017 19";"26";"23";"3";"1";"8519534979";"1769"
"5271";"Poda de árboles en Sierra Toledana, distrito Puente Vallecas";"<p>Necesidad de que este año o ya el que viene, cuando sea temporada de la poda de árboles, se haga en Sierra Toledana, al menos en los números impares, ya que la comunidad de propietarios lo solicitó por escrito a la Junta Municipal. Los vecinos hemos podido ver y sentir como pequeñas ramas caían sobre nosotros.</p>
";"12/10/2017 19";"41";"35";"6";"0";"8520791730";"2475"
"5272";"Desvío líneas 63, 143, N9";"<p>No estaría mal que hiciesen un estudio de viabilidad sobre el desvío de las líneas 63,143,N9, desviandola cuando entra desde la A3 a la calle el Bosco, subir por calle Maruja García Romero, hasta conectar con Ramón Perez de Ayala para girar a la izquierda y volver a incorporarse de nuevo a la calle el Bosco, de esta manera daría mucho más servicio, se acercaría a más usuarios, teniendo en cuenta la población que hay en esa zona, solo en la colonía de los Taxistas hablamos de más de 10.000 vecinos que harían uso de esas líneas que pasan por Doctor Esquerdo o Plaza Conde Casal. No tendríamos que llegar a Pacifico para hacer transbordos bien a la Línea 1 direccióon Vallecas, o conectar con otros autobuses que suben por la Avenida de la Albufera.  El tramo que propongo que se estudie su desvío tiene dos paradas de Bus, en un lado  la calle linda con la A3, y en el otro da con un cerro sobre el que están las viviendas de Las Marismas que son las más cercanas a las paradas y aún así están a unos 150 metros de distancia de la parada más cercana, teniendo en cuenta que en al menos la primera parada de la calle el Bosco hay una subida muy pronunciada para personas mayores que vienen por ejemplo desde el Gregorio Marañon. Este cambio no creo que aumentara el recorrido total de la línea en más de 5 minutos.</p>
";"12/10/2017 20";"20";"17";"3";"0";"8518266535";"1190"
"5273";"Resperar el Patrimonio Histórico de Madrid ";"<p>Creo que en Madrid que cada vez que se encuentran restos arqueológicos al hacer alguna obra, estos se maltratan y deasaparecen. En el taller de Cantería de la Casa de Campo hay un montón de obras de arte, como esculturas, fuentes, restos del antiguo puente de Segovia, restos de la muralla arabe de Madrid, que están a la interperie y tirados como si fueran escombros. </p>

<p>Madrid precisamente no es una ciudad llena de historia, asique propongo que además de seguir indagando y buscando hallazgos y monumentos, estos se cuiden, restauren y se coloquen en la ciudad para disfrute de todos. </p>

<p>Propongo que en la remodelación de las plazas del centro se incluyan estos monumentos.</p>
";"12/10/2017 23";"102";"98";"4";"0";"8528803405";"9031"
"5274";"Muralla arabe de Madrid";"<p>Bajo las obras del nuevo Museo de las Colecciones Reales se han descubierto restos de la Muralla Arabe,  entre los que posiblemente se encuentre parte de la Puerta de la Sagra.</p>

<p>Los van a exponer dentro del museo, pudiendo verse únicamente en el tiempo que estés dentro del museo.</p>

<p>Creo que lo mejor es que se expongan al aire libre, ya que una muralla está hecha como sistema defensivo y fronterizo de una ciudad y está para que todo el mundo pueda disfrutar de ella.</p>

<p>Por lo menos que la puerta de la Sagra y algunos tramos estén al aire libre.</p>
";"12/10/2017 23";"107";"102";"5";"2";"8528840900";"9246"
"5275";"Restaurar las iglesias y conventos de Madrid Centro";"<p>Algunas de las Iglesias y Conventod del centro de Madrid, por no decir la mayoría son horribles por fuera, como la del Carmen, Sacramento, San Martín, Antonio de Los Alemanes, San Ginés, San Jose, Carmelitas....</p>

<p>Para aumentar el turismo y la estética de la ciudad, propongo que se les de un lavado de cara.</p>
";"12/10/2017 23";"90";"42";"48";"3";"8506465799";"-280"
"5276";"Añadir fuentes y esculturas a las plazas del Centro";"<p>Estaría bien que algunas de las fuentes y esculturas olvidadas en el taller de Canteria de la Casa de Campo se restaurarán y se pusieran en las plazas del centro.</p>

<p>Son piezas de mucho valor e Historia y deberían volver a ser visibles para todos </p>
";"12/10/2017 23";"78";"68";"10";"2";"8525340728";"5056"
"5277";"Equilibrar riqueza entre la zona norte y sur de Madrid.";"<p>zonas de grandes edificios como ocurre en la Castellana norte (y con su ampliación ya propuesta), pero en la zona Sur de Madrid para equilibrar económicamente los barrios ricos del norte.</p>

<p>Replanificar la ampliación del paseo de la Castellana hacia la zona norte con más torres que enriquecen aún más la zona más rica de Madrid y produce más desequilibrio entre norte y sur. </p>

<p>Esta replanificación supondría crear esa zona de gran riqueza económica en la zona sur de Madrid, en cualquiera de las zonas municipales existentes, o incluso aprovechando zonas mal aprovechadas.</p>

<p>Una idea sería recalificar terrenos municipales en cualquiera de los barrios del sur de Madrid, que permitiera crear una gran zona de torres como en la zona norte y que podría venderse al sector privado, utilizando esa inversión privada para crear instalaciones municipales que ayuden a los vecinos del sur. </p>

<p>Una posibilidad sería la estación de contenedores del Abroñigal, que tiene una ubicación ideal con conexión con M30, M40 y A4, con posibilidad de crear parada de cercanías al tener ya conexión con Atocha, y a escasos metros de la estación Sur de Autobuses. Todo esto lo haría ideal para que sea una zona interesante a inversores (La estación pertenece a ADIF/RENFE, por tanto pseudo-publico, y al igual que se expropia a particulares para hacer una carretera, también se puede hacer aquí..) Esta posibilidad es una de las muchas que podría valorar el ayuntamiento cualquiera de los barrios del sur afectados (cerca de la caja mágica, en la zona de Entrevías pegado a M40, incluso soterrando todo el nudo sur con la inversión privada que se obtenga con la venta de esos terrenos construyendo las torres en toda esa nueva zona resultante) y que podría mejorar barrios como:</p>

<ol>
	<li>Puente de Vallecas</li>
	<li>Moratalaz</li>
	<li>Usera</li>
	<li>Carabanchel</li>
	<li>Villaverde</li>
	<li>Villa de Vallecas</li>
</ol>

<p> </p>

<p> </p>

<p> </p>

<p> </p>

<p>Las ventajas serían innumerables como por ejemplo:</p>

<ul>
	<li>Provocar que la zona sur de Madrid mejorara económicamente, mejorando la igualdad económica en la ciudad. </li>
	<li>Crear puestos de trabajo en la zona sur</li>
	<li>Mejora del tráfico ya que la mayor parte de desplazamientos son de trabajadores del sur a oficinas del norte (reducción de atascos)</li>
	<li>Crear nuevos focos de desarrollo en nuevos puntos de Madrid.</li>
	<li>Posibiliad  de crear con la inversión privada nuevas instalaciones municipales para los vecinos</li>
	<li>Igualdad de oportunidades para gente del sur y del norte</li>
	<li>etc...</li>
</ul>
";"13/10/2017 00";"106";"84";"22";"5";"8524656344";"4913"
"5278";"Bajar precio de la vivienda";"<p>Es inexplicable que hace años la gente pidiera pagar sus pisos sin apuros e incluso en mano, teniendo la mayoría de las veces un solo sueldo, y que en 30 años el precio se haya multiplicado por más de 10.</p>

<p>Es decir que con lo que pagamos ahora, nuestros padres podían haberse comprado 10 casas.</p>

<p>No puede ser que estemos toda la vida pagando la hipoteca, porque dudo mucho que el valor de la vivienda sea el que es, cuando hace tan solo unos años era muchísimo menor.</p>

<p>Lo que creo es que probablemente en beneficio de 4 personas involucradas en tramas urbanísticas, la mayoría de los ciudadanos tenemos que estar toda la vida pagando, y otros ni siquiera podemos pagarlo, para que estos 4 se forren.</p>

<p>No podemos quedarnos con los brazos cruzados y conformarnos con esta injusticia.</p>

<p>Debemos exigir que el precio de la vivienda sea real, es decir que paguemos solo por lo que cuesta e realidad.</p>
";"13/10/2017 01";"121";"103";"18";"1";"8527192858";"7235"
"5279";"CAMBIO DE CALLES Y MONUMENTOS";"<p>No es normal que estén cambiando los nombres de las calles de capitanes y generales de la época, nos guste o no es historia de nuestro país, y me parece lamentable que sigamos con esa mentalidad de querer borrar la historia. Para bien o para mal es nuestra historia y no se debería de olvidar no de tapar.</p>

<p>Basta ya de tanta sensibilización, sigamos para adelante que siempre estamos en guerra por lo mismo!!! </p>
";"13/10/2017 13";"81";"38";"43";"9";"8513250115";"-234"
"5280";"Reestruturación Mediana Avenida de las Suertes";"<p>En la mediana que separa la Avenida de las Suertes se producen una serie de puntos negros de visión cuando te acercas a las rotondas dirección desde Villa de Vallecas a la salida de la M40, M45, A3 y viceversa. Es decir, cuando te aproximas a las rotondas la altura de las plantas hace que la visibilidad sea muy reducida. Podrían plantear reformar esos tramos de acceso a las rotondas con otro tipo de vegetación (rastrera, por ejemplo) que permita ver mejor la circulación.</p>
";"13/10/2017 16";"32";"31";"1";"0";"8531030074";"2906"
"5283";"parque entre avenida de niza y julia garcia boutan";"<p>si conoceis este parque pequeño, cada vez que llueve como esta en cuesta abajo todo el agua es arrastrada hacia abajo y va bajando por la avenida de niza hasta la plaza de grecia que esta en frente del WANDA metropolitano y se forman balsas de barro y agua, incluso teniendo que desviar el trafico por avenida de niza, propongo que los arquitectos presenten un proyecto para mejorar este problema para mas tarde VOTARLO entre todo el mundo que quiero con los proyectos finalistas</p>

<p>saludos</p>
";"14/10/2017 17";"22";"19";"3";"0";"8537504091";"1381"
"5284";"Boca de metro en la línea 8 a la altura de Arturo Soria";"<p>Aunque no sé si es competencia del Ayuntamiento de Madrid...</p>

<p>Siempre veo el mapa de la línea 8 de metro y, entre Colombia y Pinar del Rey echo en falta una boca de metro!!!. Hay una longitud muy grande, sino la más grante entre bocas de metro. Creo que a esta zona, o llegas en autobús o en coche. Y con autobús ultimamente hay mucho ataco. ¿Nadie más lo ha pensado nunca?</p>

<p> </p>
";"14/10/2017 20";"47";"42";"5";"2";"8542470071";"3306"
"5285";"Someter a votación la conservación de Parque Juan Carlos I el nombre Barajas.";"<p>Los madrileños decidimos cambiar el nombre de Parque Felipe VI por Parque Forestal Valdebebas. ¿Sería bueno hacerlo también con el de Don Juan Carlos?</p>
";"15/10/2017 02";"107";"40";"67";"8";"8525775599";"-1009"
"5286";"Decidir si se sería correcto cambiar el nombre de calles, estatuas, plazas de re";"<p>En pleno siglo XXI que se guarden el nombre de plazas, calles y tal con el nombre de reyes e incluso cardenales como el de Cisneros es algo que tendría que hacernos reflexionar para saber si somos realmente ciudadanos o que somos.</p>
";"15/10/2017 03";"85";"25";"60";"9";"8526848428";"-1029"
"5287";"Micro Barrios si, pero en el Viso, Conde Orgaz y calle Serrano";"<p> La propuesta de los micro barrios no está mal, pero a este gente hay que alojarla en los mejores lugares para que la integración sea máxima.</p>

<p>El proyecto de base estaba mal al alojar a esta población en zonas donde ya hay bastantes núcleos de realojo. Se necesita que está gente con grandes carencias conozca lo mejor de cada familia para una mejor integración. Siempre hay que partir de la máxima para que algo se vaya fraguando. Con esto se mejora la integración y la multiculturalidad.</p>
";"15/10/2017 14";"67";"37";"30";"4";"8541192916";"386"
"5288";"Vecinos de tercera";"<p>Los madrileños que vivimos fuera de la M-40 somos vecinos de tercera. (Entre m30 y m40 son de segunda)</p>

<p>No tenemos acceso a bicis o vehiculos del ayuntamiento. No tenemos plazas de aparcamiento cerca de estaciones de Metro o Renfe. Somos los que tenemos peor transporte público (no tenemos líneas circulares), necesitando hacer dos transbordos o usar dos tipos de transporte para llegar a cualquier sitio, razón por la que usamos el coche particular, y encima somos a los que penalizan cada vez que hay contaminación. Como si la contamización estuviera solo en el centro de Madrid.</p>

<p>Me siento orgullosa de ser madrileña y me encanta el centro de Madrid. Me gusta mi barrio, pero si vienen amigos de fuera, me gusta enseñarles el centro de Madrid, con su variedad de gente, de escenarios, de tiendas, de monumentos, de museos... No busco que mi barrio sea el Centro, lo que quiero es que me faciliten el acceso al Centro.</p>
";"15/10/2017 16";"62";"50";"12";"3";"8549769611";"3064"
"5289";"Cambiar el nombre del Instituto Juan de la Cierva";"<p>Juan de la Cierva fue un inventor español pero también fue un colaborador importantísimo de los sublevados contra la República.</p>

<p>Junto con el que era embajador español en Londres en julio de 1936, participó en un engaño consistente en desviar un dinero enviado por la República para la compra de armas para el gobierno legítimo de manera que al final sirvió para su compra por los rebeldes.</p>

<p>Además participó también en el alquiler del avión que transportó a Franco desde Canarias hasta Marruecos.</p>
";"15/10/2017 22";"82";"12";"70";"3";"8536617077";"-848"
"5290";"Problemática aparcamiento para residentes del barrio de Moscardó en Usera.";"<p>Al inaugurar el nuevo megacentro comercial plaza rio 2, en una zona ya de por sí problemática para aparcar ,como es el barrio de moscardó (al ser una zona colindante con la zona de estacionamiento regulado), los vecinos nos vemos abocados a no poder aparcar en sus calles, ya que el nuevo centro comercial sólo permitirá 2 horas de estacionamiento gratuito, con lo cual las zonas colindantes al centro comercial donde los vecinos de la calle San Zacarías, Eugenio Caxes, Antonio López, San Graciano ,Avenida de Manzanares,etc, solían aparcar, se llenaran de clientes de dicho C.C. dejando a los vecinos sin opción. Sería interesante que el ayuntamiento de Madrid, ampliara la zona de estacionamiento regulado a nuestro barrio, al menos para asegurar plazas de aparcamiento a los residentes(Zona verde). </p>
";"16/10/2017 12";"44";"36";"8";"3";"8557293098";"2290"
"5291";"Jardines con malas hierbas";"<p>Creo necesario que en vez de gastar el dinero en cambiar nombres de calles y remoledar plazas que estan en buen estado se emplee ese dinero en quitar las malas hierbas de jardines y calles que nos estan comiendo poco a poco y son un nido de ratas</p>
";"16/10/2017 14";"90";"71";"19";"8";"8559678384";"4102"
"5292";"Reforestación de espacios inutilizados en Madrid";"<p>Una mayor reforestación contribuye a la reducción en cuanto a contaminación se refiere, además de proporcionar espacios de ocio a la población y dar un mejor uso a espacios o zonas actualmente inútiles o con altos niveles de contaminación. Por último supondría también una mejora del impacto visual.</p>

<p>Cabe añadir que en muchas ocasiones no supondría un gran coste.</p>
";"17/10/2017 13";"162";"161";"1";"0";"8577535604";"15901"
"5293";"alternativa a la calle ISLA DE OZA  utilizando la Avenida de martines maristas";"<p>Al ensanchar las aceras del primer tramo de la calle isla de oza se ha reducido a 1 el numero de carriles para los vehiculos y con lo cual un unico sentido. Agradecemos la peatonalizacion, pero FALTA una alternativa a ese cierre de carril para poder llegar a la calle Antonio machado de alguna manera que no sea rodeando todo el barrio por calles estrechas. En resumen, en un trayecto que antes tardabas 30 segundos ahora tardas de 7 a 8 minutos. LA ALTERNATIVA PODRIA SER INTERVENIR EN LA AVENIDA DE MARTINES MARISTAS, TRANSFORMANDO LAS ESCALERAS Y EL DESNIVEL EXISTENTE PARA CREAR UN NUEVO CARRIL Y ACCESO A LA CALLLE ANTONIO MACHADO.</p>

<p>gracias.</p>

<p> </p>
";"17/10/2017 20";"18";"12";"6";"4";"8564376856";"400"
"5294";"El coste de los proyectos frente a sus ventajas - Más claridad por favor";"<p>Estoy intentando votar por primera vez y me resulta muy muy dificil. <strong>Para encontrar el coste de los proyectos hay que navegar y buscar numeritos pequeños entre todas las imágenes</strong> o bajarse todas las memorias... ¿no sería bueno que todos seamos conscientes de lo que cuesta cada proyecto? Para eso, bastaría con poner el coste estimado más visible, junto a la descripción.</p>

<p>Podríamos decir que ""no queremos"" elegir lo más barato, y eso está claro, pero no quita que el coste sea fundamental en la decisión. Un proyecto nos puede gustar ligeramente más, pero ser 10 veces más caro que el otro. Más aún, el presupuesto es limitado, y el dinero que se gasta en cada cosa, se resta de otras, que pueden ser educación, sanidad, otras reformas, o incluso una bajada de impuestos... <strong>En todo en nuestra vida nos fijamos en el coste de forma sistemática</strong>: en el supermercado, en las tiendas, cuando algo nos gusta lo siguiente que miramos es el precio.</p>

<p><strong>Cuando hablamos del dinero de todos, ¿no debiéramos tomar cada decisión siendo muy conscientes del coste?</strong></p>
";"18/10/2017 13";"53";"52";"1";"4";"8582592767";"5003"
"5295";"Caquitas y pises de los canes";"<p>Quisiera iniciar un debate que no paro de darle vueltas ya que a diario paseando, sobre todo en barrios de aceras estrechas, me encuentro una gran cantidad de deposiciones y sobre todo de meos de los perros. La mayor parte de los dueños estan concienciados y recogen las cacotas, pero dado el gran número de perros que hay, unos 300.000 perros, tocamos a uno de cada díez personas tiene uno, eso hace que con muy pocas personas que no las recojan provoquen una gran suciedad que termina por generalizarse en la mayoría del resto de personas que tienen un can. Creo que se debería invertir en concienciar a las personas en cuales son las buenas prácticas, ya sea con campañas, cursos del ayuntamiento que ayuden a manejarles y indicaciones en el suelo de las zonas en las que es donde deben orinar o defecar.</p>

<p>Por que encontré por casualidad que en la ordenanza de Policia del Ayuntamiento de Madrid indica que habría que dirigir al perro a la calzada cuando quiera orinar e incluso a un imbornal de alcantarilla cuando quiera hacer desposiciones. Creo que la gran mayoría no lo conoce ya que me parece mucho más cómodo llevarle al perro a este lugar y no tener si quiera que recoger lo que deje y simplemente intoduciendolo en la alcantarilla toda la ciudad estaría más limpia, de la misma forma ocurre con los orines.</p>

<p>Hay algunas zonas que sin tener restos de cacas, tienen autenticos regueros, o sus manchas que elevan unos olores que no creo que sea agradable para nadie, incluido aquellos que lo provocan.</p>

<p>Por todo ello creo que desde el Ayuntamiento se debería abordar diferentes estrategias encaminadas en mejorar la higiene de la ciudad, en lo que afecte a los canes y estas serían.</p>

<p>1.- Pintar con una indicación llamativa a la altura del acerado donde este situado un imbornal de alcantarilla invitando que sea la zona para las deposiciónes.</p>

<p>2.-Campañas de concienciación, mediante cursos, anuncios y docencia de los agentes de policia que patrullen andando la ciudad.</p>

<p>Creo la cultura de hacerlo en la acera se ha asentado pero con tiempo y docencia se puede cambiar. La gente por imitación podrá ir adoptando unas prácticas mas higienicas.</p>

<p>A ver que os parece.</p>

<p>Saludos a todas!</p>
";"19/10/2017 08";"141";"137";"4";"20";"8594379570";"12922"
"5296";"Autobus zona Cocheron de la Villa";"<p>La zona de Cocheron de la Villa es una zona urbanizada con tiendas, una guarderia y gran cantidad de vecinos, que no cuenta con linea de autobus....este tema ha salido hasta en la televisión...es una zona que cae justo en medio de los metros de Miguel Hernandez y Sierra de guadalupe, pero ninguna linea de autobus nos acerca a ninguna de las dos paradas.....La mejor opcion seria el desvio de alguna de las lineas de autobuses que pasan por la avenida de la albufera a la altura del Polideportivo Palomeras....como la linea 54...</p>

<p> </p>

<p>Gracias!!</p>
";"19/10/2017 11";"22";"19";"3";"0";"8585256077";"1381"
"5297";"Maxificación comercial en la zona de Quevedo.";"<p>Queria remarcar la necesidad de mantener la zona de Quevedo- Eloy Gonzalo fuera de comercios y franquicias elitistas que lo único que consiguen es molestar al vecindario y ocasionar problemas higienicos con los residuos que producen. En estos últimos años son muchos los nuevos negocios que están abriendo en Chamberi, concretamente en Quevedo, deshaciendose de los negocios tradicionales de toda la vida y cambiandolos por franquicias, las cuales abusasn  de la luminosidad cegando a aquel que esté paseando por la acera tranquilamente. Estos negocios van desde ""El Prerrachica"" principal culpable del malestar en la calle Cardenal Cisneros y ocasionando numerosos problemas de higiene, así como los coches aparcados en segunda fila que es inexplicable cuando el propio local tiene parking privado con aparcacoches. Seguido están nuevos locales del mismo calibre que fomentan un consumo elitista en la zona, con gente que no tiene ningun interésen el barrio. Desde el punto de vista del negocio es algo positivo pero mi queja empieza cuando la zona de Quevedo era hasta ahora una zona residencial y se está convirtiendo en una continuación del ""moderneo"" de fuencarral que sube desde el moderneo de Chueca y Malasaña. Por otro lado para colmar el vaso la Glorieta de Quevedo en cuestión de meses se ha visto arrollada por franquicias como Vips, Starbucks, Tierra... </p>

<p> </p>
";"19/10/2017 12";"41";"17";"24";"1";"8571594121";"-290"
"5298";"Paso peatonal entre  Cerro de los Álamos Blancos y Avenida Arroyo del Monte";"<p>Actualmente aún se encuentra pendiente la construcción de un paso peatonal mediante escaleras entre la Calle Cérro de los Álamos Blancos y la Avenida Arroyo del Monte.</p>

<p>Necesaria para la comunicación peatonal con el nuevo barrio de Arroyo del Fresno.</p>
";"19/10/2017 19";"15";"12";"3";"0";"8585818269";"720"
"5299";"GENERAL RICARDOS; contaminación por tráfico que supera la velocidad!";"<p>LA CALLE GENERAL RICARDOS PODRÍA SER UNA AVENIDA MENOS CONTAMINADA POR EL TRÁFICO!!</p>

<p>TOMAR MEDIDAS:</p>

<p>A corto plazo, sin suponer apenas inversión PODRÍA PONERSE LIMITADORES DE VELOCIDAD en la avenida principal, y BADENES en las perpendiculares para reducir emisión y facilitar el tránsito.</p>

<p> </p>

<p> </p>
";"20/10/2017 20";"54";"43";"11";"1";"8600756919";"2548"
"5304";"El Ayuntamiento vela por los intereses de todos los ciudadanos ?";"<p>Es admisible que toda una ciudad  se corte sin previo aviso por una actividad llamada perfomance ? Como madrileña y amante de la cultura me dispuse a ir al Teatro de la Comedia para ver la representación de La dama duende, previo pago de sus entradas a 21 euros cada una. Nos subimos al coche y las arterias principales madrileñas estaban cortadas, total llegamos tarde y no pudimos acceder a la representación.  Como madrileña tengo derecho a circular por mi ciudad y dejar mi coche en un aparcamiento. Han cercenado mi derecho y mi cartera, aparte de mi voluntad de ir al teatro porque no se ha avisado de que Madrid estaba totalmente cortada. Es una vergüenza! </p>
";"22/10/2017 01";"61";"18";"43";"7";"8596475379";"-737"
"5305";"ampliacion zona ""ser"" aparcamiento  distrito ciudad lineal ";"<p> hola,hace de frontera con la m 30  y en gran parte son edificios antiguos sin garajes privados,  especialmente la elipa, pueblo nuevo, quintana ,concepcion , etc. en este debate es para la aplicacion de aparacamiento residentes, zona verde / azul , saludos</p>
";"22/10/2017 18";"64";"23";"41";"2";"8603374438";"-646"
"5306";"Cursos financiados de adiestramiento de perros";"<p>Si dais una vuelta por europa o si habéis vivido en algún otro país que no sea España, habréis visto el trato que se le da a los animales de compañía y que tanto difiere del que le damos en este país.</p>

<p>Como ya sucede en muchas otras ciudades europeas, desde hace muchos años, creo que sería de de gran utilidad y ayuda para la convicencia ciudadana, que el ayuntamiento de Madrid ofrezca cursos de adiestramiento a los propietarios de animales. Financiados en su totalidad, o parcialmente. El hecho de que los porpietarios tengan a sus mascotas educadas, hace que la convivencia sea más amena. Los propietarios podrán llevar a sus perros en metro, a las tiendas, etc. Repito, como ya sucede en muchas ciudades europeas.</p>

<p>Aparte de ésto, por supuesto estoy a favor de multar a los propietarios que no recojan las deposiciones de sus perros o que no sigan las leyes que regulen la entrada a ciertos establecimientos. Por ejemplo si la ley dice que el perro no puede entrar en una guardería, pues que respete eso. Pero si la ley permite que pueda entrar en un restaurante, también respetar al dueño y a su mascota. Si están educados, y lo deberían estar debido a éstos cursos financiados, no habrá problema.</p>

<p>Recopilación de Propuestas relativas a Perros y mascotas: https://decide.madrid.es/proposals/9073</p>

<p> </p>
";"23/10/2017 15";"77";"35";"42";"9";"8613114641";"-318"
"5307";"Creación de un Salario Vital (Living Wage) de Madrid";"<p>En algunas ciudades europeas se distingue entre el Salario Mínimo y un Salario Vital. Por ejemplo en Londres, a partir de una serie de criterios, como el coste del alquiler, el precio de la escolarización o de los medios de transporte, el ayuntamiento actualiza todos los años un salario recomendado, el Living Wage. Este salario tiene en cuenta que el salario mínimo no resulta suficiente en absoluto para mantener unas condiciones de vida mínimas en una ciudad como la nuestra.

Por ello pediría al ayuntamiento la creación de esta recomendación. Una pequeña medida que podría ayudar a muchos y muchas.</p>
";"23/10/2017 22";"58";"38";"20";"8";"8628063682";"1179"
"5308";"Sobre las medidas anticontaminación";"<p>El sistema de escenarios ha demostrado no ser eficaz al 100%. Propongo una modificación:</p>

<ul>
	<li>En todos los escenarios: Aumentar la frecuencia de transporte público: Metro, EMT y metro ligero (No se puede decir que no, hay material rodable de sobra en metro y en EMT autobuses de sobra). Sobre todo por las mañanas a primera hora como las tardes a última hora.</li>
	<li>En los escenarios 2 y 3: Apertura y uso GRATUITO de cualquier transporte público. Se puede hacer usando la tarjeta MULTI sin que consuma viajes. Recordemos que Madrid es una ciudad de MILLONES de personas. Y no se puede paralizar.</li>
</ul>

<p>Con esto se mejoran dos cosas: 1º Que el transporte sea más ameno para el madrileño de a pie 2º se aumenta el numero de contratos. Saldrá el tipico: ""Pero eso es cosa de la CAM"". Se puede proponer desde el ayuntamiento a la Comunidad. Otra cosa es el afán de mejorar las cosas.</p>

<p>Digo, por último que si alguien se le ocurre alguna mejora más que la ponga en comentarios, por favor. Estoy abierto a más mejoras.</p>

<p> </p>

<p>Añado propuesta para votarla: https://decide.madrid.es/proposals/19903-modificacion-y-mejora-de-las-medidas-anticontaminacion</p>
";"24/10/2017 10";"78";"71";"7";"16";"8640970980";"5825"
"5309";"Resultados 11 plazas mas que previsibles";"<p>He revisado las votaciones de la campaña 11 plazas ya que voté en un par de ellas, la inmensa mayoría ni las conocía, y comentandolo con amigos y familiares, este comentario fue bastante repetido. Lo curioso es que todos sabíamos que no iba a salir en contra ni una sola de las votaciones... que curioso que todas y cada una de ellas el 80% más o menos, se que algunas es por menos, pero no baja del 60, estén a favor de remodelarlas.</p>

<p>O el Ayuntamiento es un lince y no falla una, o aquí huele a chamusquina como en muchas otras votaciones, consultas.... </p>
";"24/10/2017 16";"35";"22";"13";"8";"8633535087";"565"
"5310";"¿Sería podrían realizar actividades en parroquias de carácter ludico o festivo?";"<p>En el siglo XXI este en el que vivimos creo que esta existiendo Madrid una fuerte secularizacion.  Esto no tiene que ser malo a priori pero ya hay muchos párrocos no saben ya que hacer. ¿ Sería podrían utilizar el mobiliario parroquial para actividades o servicios con fines lúdicos que no tengan que ver con la religión?</p>
";"27/10/2017 22";"51";"14";"37";"3";"8655722773";"-631"
"5311";"Contaminación: ¿Que pasa con la hora de ida y hora de vuelta de cada día?";"<p>Para atacar la contaminación estamos utilizando sólo el enfoque de paliar los efectos del transporte de las personas, pero ¿se está haciendo algo para evitar la causa?</p>

<p>Cada mañana veo el sinsentido de gente cruzando la ciudad, tardando 1h en cada trayecto, para ir a un puesto de trabajo en la otra punta de la ciudad que igual tendría y preferiría más cerca de casa, y gente haciendo el trayecto contrario. ¿Tiene eso sentido en puestos numerosos como camareros, limpieza, administrativos, etc? Incluso en empresas con varias sedes o administraciones no se hace nada por distribuir a la gente en función de sus preferencias geográficas porque no ven un incentivo para ello. ¿Es lo más adecuado casos como por ejemplo el Santander que crea una ""ciudad"" a las afueras y miles de personas tienen que desplazarse alli cada día contaminando y perdiendo tiempo? Claro, a la empresa no le supone problema, el problema se genera a los demás...</p>

<p>Por ello pienso que se deberían establecer políticas encaminadas a reducir los tiempos de desplazamiento: incentivos a la contratación de personal que viva cerca para tipos de trabajo habituales, limitaciones a la creación de zonas sólo residenciales o sólo laborales, medidas de concienciación, etc.</p>
";"28/10/2017 13";"46";"42";"4";"6";"8680165193";"3469"
"5313";"Arreglo y limpieza de parques de distritos zona sur";"<p>Buenos dias la idea de abrir un debate sobre este tema es por que cada dia veo los parques y jardines de carabanchel mas abandonados que nunca, me sorprende ver que hay o va a ver una partida de presupuestos para parques y jardines y luego ver que estan totalmente abandonados......sin ir mas lejos puedo indicar que la Plaza de Cantoria esta totalmente abandonada arbustos de mas de 2 metros que llevaran sin podar o arreglar años, pinos inclinados o con ramas que ya casi tocan las ventanas de las viviendas y por no decir la suciedad que hay en toda ella y alrededores que hasta hace 4 dias habia hasta plagas de ratas, por favor antes de gastar un dineral en parques o plazas nuevas vamos arreglar y cuidar los que hay en distritos como carabanchel, villaverde, usera......que nos tienen totalmente abandonados!!! Y LO QUE MAS GRACIA ME HACE ES QUE HAY PERSONAS MUY CERCANAS A LA CORPORACION MUNICIPAL QUE PASAN A DIARIO POR LA PLAZA ANTES CITADA Y NO HACEN NADA!!!! </p>
";"29/10/2017 12";"62";"62";"0";"2";"8693655816";"6200"
"5314";"Salida de alumnos Colegio San Viator";"<p>Buenos dias mi debate es acerca de la situacion que crean los padres que quieren recoger a sus hijos en la mismita puerta del colegio San Viator (Plaza Fernadez Ladreda) con el peligro y situacion que lleva conllevando esta accion durante años, estos padres aparcan en doble fila incluso a veces en triple fila en la misma rotonda con el colapso de trafico que esto conlleva k a veces llegan los coches parados hasta la carretera de Toledo, como no les sirve de poco colapsar la rotonda pues tambien ocupan todo el carril derecho de marcelo usera entrando desde plaza eliptica, la hora de entrada y sobre.todo de salida es de locos, solicito que den alguna solucion a eso o bien desde.la junta de distrito de Usera o por parte del ayuntamiento ya que no ves ni una patrulla de municipales controlando la salida y entrada, que habido hasta pequeñas colisiones entre vehiculos......IMAGINO QUE MUCHOS COLEGIOS ESTARAN EN LA MISMA SITUACION</p>
";"29/10/2017 12";"32";"31";"1";"11";"8690436110";"2906"
"5315";"Paseo Extremadura";"<p>Es necesario abrir un nuevo debate para proponer ideas al Paseo de Extremadura.</p>

<p>El Ayuntamiento está trabajando en remodelarlo y es el momento para opinar y aportar ideas. Es una entrada muy importante de la ciudad, que está completamente colapsada.</p>

<p>¿Qué soluciones propondríais?</p>
";"30/10/2017 15";"42";"37";"5";"1";"8700290471";"2819"
"5316";"Aparcamiento para bicicletas en el Wanda Metropolitano";"<p>Al Wanda Metropolitano llega el Carril bici. Sin embargo, incomprensiblemente,  no podemos ir al futbol en bicicleta porque no tenemos donde dejarlas con seguridad. Desde muchos barrios de Madrid sería media hora de bici y no nos planteariamos tener que ir en coche o en Metro (abarrotado)</p>
";"30/10/2017 19";"86";"78";"8";"0";"8705299815";"6348"
"5318";"Hostel entre Calle Juanelo y Calle de la Encomienda";"<p>Entre las calles mencionadas en el título, que se encuentran entre la Plaza de Cascorro y la Calle de Mesón de Paredes, entre La Latina y Tirso de Molina, está el antiguo Cine Odeón, un edificio que se hubiera podido recuperar para Teatro, Centro Cultural, Centro Social, etc. No fué así, lo están derribando para después construir un Hostel con el doble de altura (4 plantas), y 4 plantas de parking. En esta zona abundan ya los hostales, hostels y pisos turísticos. Se está convirtiendo en un parque temático lleno de mochilas rodantes y jolgorio nocturno, los alquileres por las nubes. No me parece el sitio adecuado para más negocios de hotelería, y encima con un parking, que en una zona restringida al tráfico, de calles estrechas, traerá de nuevo lo que se logró eliminar: ruido y contaminación por coches. Pienso que debería haber una planificación urbanística que ponga un tope para según que tipo de actividad y que fomente la pluralidad de negocios para recuperar el carácter de barrio y que sean de utilidad para los habitantes (tiendas interesantes y de utilidad diaria y variadas), que se recupere la vida vecinal, el barrio, la convivencia, y sí, que también haya algunos negocios de turismo, pero en el caso de los airbnb, que sean legales, y los hostales ya existentes, pero no estoy a favor de permitir más hoteles u 'hostels' grandes en una zona como ésta.</p>
";"02/11/2017 11";"26";"18";"8";"2";"8722452449";"692"
"5319";"Disminucion del trafico en el Nudo Norte";"<p>A dia de hoy el trafico que circula hacia la zona Norte de Madrid es inmanejable. Genera una gran contaminacion y retenciones en horas punta. En el nudo Norte de Madrid trabaja mucha gente en Empresas como Telefonica, BBVA, Telecinco y una larga lista de compañias. Los accesos por carretera no estan adecuados para la movilizacion de tantas personas, sobretodo cuando el ratio es 1 coche = 1 persona. Entiendo que muchas personas dependen del coche para moverse hacia su trabajo, bien porque tienen hijos que llevar al colegio o guarderia o porque el tiempo que invierten en llegar al trabajo es inabordable si se hace en transporte publico. Sin embargo hay mucha gente que va por comodidad pero la utilizacion del transporte publico no es una solucion porque la Linea 10 va totalmente llena con una frecuencia de 1 m entre tren y tren.</p>

<p><strong>Abro este debate para pedir que el Ayuntamiento medie con las Empresas privadas y asi proporcionarles las herramientas con las que éstas puedan implantar nuevas formas de acceso al puesto de trabajo para la gente que vive en Madrid. </strong></p>

<p>¿No es responsabilidad de las Empresas asegurar el acceso de sus trabajadores al puesto de trabajo de una forma sostenible?</p>

<p>¿Cuando una Empresa de mas de ""X"" numeros de trabajadores abre no deberia tener un plan de movilizacion de empleados consensuado con el ayuntamiento?</p>

<p>¿No deberia el ayuntamiento fomentar/pedir/exigir a las Empresas que tengan un servicio de lanzaderas que minimicen el impacto que generan en el trafico de la ciudad en las horas puntas?</p>

<p>¿No puede el ayuntamiento proporcionar a las Empresas espacios dedicados y estrategicamente colocados para que éstas puedan llevar a cabo sus iniciativas?</p>
";"02/11/2017 12";"54";"50";"4";"3";"8730896347";"4259"
"5320";"SOBRE EL PROYECTO GREENFINGERS PARA MAR DE CRISTAL";"<p>Entiendo, porque el proyecto ganador es un arcano, con planos mal definidos y generalidades varias, que desaparece la calle Ayacucho, quedando unicamente la calle Arequipa, solo con doble sentido.  Bien, la segunda via en importancia para la entrada en IFEMA y sus multiples y gigantescas oficinas de los alrededores, la unica conexión entre la M30 y la M40, para acceder a IFEMA, la unida salida a la M40 para gran parte de los vecinos de Hortaleza, se convertira en una gran CATASTROFE, FUENTE DE POLUCCION INNECESARIA, y un gran quebradero de cabeza para los vecinos de la zona. Por no olvidar la zona de botellon autorizado, y posiblemente fiestas, que a todas luces representa el proyecto. ¿Un aparcamiento de drones?.  Pero estamos en el mundo real, o ya nos hemos puesto en contacto con Amazon, para un proyecto que hace aguas en Estados Unidos.   Vamos a llenar de drones Hortaleza?. ¿ Y por donde van a circular el 104 y 171 ?.  Porque vuelvo a repetir convertir la calle Arequipa que ya es un suplicio actualmente con dos carriles de direccion unica, en una calle de doble sentido es una dislate.  Ya es una autentica locura el actual carril bici.  Glorieta Sandro Pertini, 8 de la mañana : atascao interminable hasta la M30. Coches y mas coches, humos, bocinas, mal humor..... Carril bici en el mismo sentido, NI UN SOLO CICLISTA. Huelgan los comentarios.</p>

<p> </p>
";"03/11/2017 09";"19";"15";"4";"4";"8732860167";"868"
"5321";"Boca de metro valdeacederas";"<p>Quiero sugerir que los ciudadanos que vivimos en el barrio de valdeacederas, disponemos de boca de metro al otro lado de la calle Bravo Murillo y eso supone cada dia cruzar esa calle tan transitada de coches a gran velocidad y varios carriles, por cientos de personas todos los dias poniendose en peligro la vida de cada uno de ellos y con las prisas algunos cruzan en situaciones peligrosas. Por eso solicito para todos los que vivimos allí que habiliten una boca de metro en el lado de la acera  zona (Plaza Remonta) aprovechando la remodelacion de la plaza de la Remonta, ya que se ganará en seguridad y comodidad para el 80 por ciento de los usuarios que utilizan esa boca de metro(Valdeacederas) que esta justo al lado contrario a la mayoria de los usuarios y como he dicho antes es peligroso y poco acessible. Gracias</p>
";"04/11/2017 13";"23";"21";"2";"2";"8747930695";"1734"
"5323";"Cumplimiento decla ley.";"<p>Desearia saber que medidas tiene previsto realizar el Ayuntamiento de Madrid para que se cumpla la ley 1/30 del #taxi dado que el cumplimiento de todas las leyes por todos es la base necesaria para una convivencia pacifica.</p>
";"05/11/2017 16";"14";"10";"4";"1";"8752842833";"428"
"5324";"Autobuses de Cruz Roja aparcados ocupando calles motor en marcha";"<p>Desde hace mucho tiempo los autobuses de la Cruz Roja tienen designado unas calles para aparcar, concretamente Pablo Iglesias y San Fco de Sales.</p>

<p>No solo <strong>impiden totalmente la visibilidad</strong> tanto para conductores como para peatones en los cruces, dado sus grandes dimensiones, sino que además todas las mañanas previo a trabajar deciden poner sus <strong>motores en marcha </strong>(desconozco la función) 10 o 15 minutos antes de salir a sus destinos provocando una <strong>humareda </strong>que peatones, perros y corredores que son los que habitualmente freucentan las aceras a esas horas y en esa zona que es el parque nos tenemos que tragar.</p>

<p>Sales a una zona verde y recibes todo lo contrario</p>
";"07/11/2017 10";"44";"36";"8";"2";"8776821053";"2290"
"5325";"Autobus de Barajas a San Chinarro Valdebebas";"<p>Hay que dar comunicacion entre barrios, necesitamos un autobus que comunique los barrios de Barajas, San Chinarro y Valdebebas, que aunque están cerca , para desplazarse a ellos hay que hacer multitud de cambios de transporte publico , con lo que se pierde muchísimo tiempo.</p>
";"07/11/2017 19";"40";"37";"3";"1";"8782551606";"3145"
"5327";"Permitir a los coches con etiqueta ECO acceder al distrito Centro (Plan A)";"<p>Somos muchos los madrileños que hemos comprado haciendo un esfuerzo un coche con la etiqueta ECO, mucho más respetuosos con el medio ambiente con el fin de poder adaptarnos a las restricciones por causa de la polución que cada vez son más frecuentes. La zona ""Cero emisiones"" impide ahora para todos nosotros acceder con nuestro vehículo al distrito Centro, siendo solo los electricos o híbridos enchufables los unicos vehículos autorizados para no particulares. Estos vehículos son,por norma general, mucho más caros que los demás vehículos siendo de imposible acceso para muchos. Las ayudas para la compra de estos vehículos ha sido casi insignificante y muy limitada. ¿Quiere decir que aquellos ciudadanos con un poder adquisitivo menor no tendremos derecho a circular por el distrito Centro, incluso habiendo adquirido coches que emiten mucha menos cantidad de gases contaminantes?  </p>
";"08/11/2017 12";"62";"34";"28";"4";"8780429726";"329"
"5328";"¿Sería podría cuestionar de una vez por todas utilidad del DNI?";"<p>Se que es un debate del Ministerio del Interior pero como están las cosas creo que es conveniente adelantarlo como tema municipal. Estoy un poco harto de esos funcionarios de la administración del Estado que cuando realizas una solicitud, para comprobar que  que eres realmente tu, tienes que enseñarles tu DNI y algunos de ellos hasta el libro de familia, donde trabajas, con quien vives. Hay gente que no sabe que estos funcionarios tienen una mentalidad pseudofranquista y luego esos datos los transmiten a sus superiores gente que creen que están en la administración pues por ""gracia divina"" y por ello te pueden estar preguntando porque se sienten superiores a ti. Porque seguramente sean ""hijos de"" y se sentirán como por aquel entonces. Es decir desconocen, que tienen que prestar un ""servicio publico"" y realizar su trabajo sin menoscabar derechos fundamentales como son la intimidad personal y la libertad del ciudadano que quiere dejar de estar tutelado.¿ Tan difícil es disponer de un código de identificación elegido por ti o una contraseña para salvarguardar tu intimidad? ¿O también disponer de máquinas y no de estas personas tan amables que te hacen tantas preguntas?</p>
";"08/11/2017 14";"46";"9";"37";"2";"8773351547";"-547"
"5329";"Cuidar la calle Alcalá más allá de la M-20";"<p>Es evidente que los barrios más desfavorecidos son los que están más allá de la M-30. El contraste está muy pronunciado sobre todo en el Barrio de Quintana, por donde pasa la calle Alcalá.</p>
";"08/11/2017 23";"56";"54";"2";"0";"8796787943";"5014"
"5330";"Necesitamos voluntari@s para testear usabilidad en Decide Madrid";"<p>Hola,</p>

<p>Estamos desarrollando un prototipo de herramienta para mejorar la participación en Decide Madrid y nos gustaría invitaros a participar en un estudio de usabilidad. La herramienta es fruto de una colaboración entre el MIT y el ParticipaLab de MediaLab Prado.</p>

<p>El objetivo del estudio es el de probar el prototipo y ayudarnos a identificar áreas de mejora de la herramienta. La prueba en sí consiste en testar la herramienta según un protocolo establecido y responder a unas preguntas sobre la experiencia de uso. Con su ayuda, podremos mejorar la herramienta y convertirla en realidad.</p>

<p> </p>

<p>Calculamos que la prueba llevaría unos 45 minutos y tendría lugar en los locales de MediaLab Prado (Calle Alameda 15, Madrid) entre el 13 y el 15 de Noviembre.</p>

<p> </p>

<p><strong>Aquellas personas interesadas en ayudarnos, por favor contactad conmigo por privado para que podamos fijar una cita</strong></p>

<p> </p>

<p>Gracias por adelantado</p>

<p> </p>

<p>Un saludo,</p>

<p> </p>

<p>Equipo Wikum #ICDemocracia17 http://medialab-prado.es/article/collective-intelligence-for-democracy-2017</p>
";"10/11/2017 14";"37";"22";"15";"1";"8801484168";"416"
"5331";"Buscamos usuarias/os de decide.madrid.es para sesión de testeo en Medialab-Prado";"<p>En el marco del taller internacional de Inteligencia Colectiva para la Democracia se están llevando a cabo hasta 10 proyectos sobre herramientas que ayuden a la mejora de procesos para una mayor profundización democrática en nuestras ciudades. 3 de estos proyectos trabajan con una clara vinculación con la plataforma decide.madrid.es. Buscamos personas usuarias de decide.madrid.es interesadas en participar asistiendo a una sesión de testeo con los equipos que desarrollan estos 3 proyectos. El lugar del testeo será el centro de Medialab Prado ubicado al lado en Atocha, muy cerca del Caixa Forum. Aquellas personas interesadas en ayudarnos, por favor enviadnos un mensaje privado para que podamos fijar una cita. También puedes obtener más información sobre los proyectos e inscribirte en este enlace: http://medialab-prado.es/article/encuentro-con-usuarios-de-decidemadrid-y-proyectos-de-inteligencia-colectiva-para-la-democracia</p>
";"10/11/2017 19";"30";"17";"13";"4";"8802372695";"226"
"5334";"Tráfico en Navidad";"<p>¿Cómo teneis pensado canalizar el tráfico que se puede formar en Gran Vía a raiz de la nueva reforma de Carmena?</p>
";"14/11/2017 13";"43";"21";"22";"2";"8836083754";"-48"
"5336";"Trasbordos de bus a metro o entre bus y bus no superado un tiempo.";"<p>Los trasbordos que se hacen entre bus y bus al viajar en diferente linea, si no pasa un tiempo largo, debería ser en el mismo viaje, utilizado en el billete.</p>
";"18/11/2017 10";"172";"171";"1";"4";"8896977325";"16901"
"5338";"Permitir a residentes aparcar en su zona y en azul los días de contaminación";"<p>Los residentes pasamos un tiempo elevado dando vueltas para poder aparcar en zona verde los días de alta contaminación ya que no hay suficientes plazas verdes para nosotros y los parkings están llenos esos días. ¿No sería mucho menos contaminantes permitirnos aparcar nuestro coche en zona azul, siempre y cuando sea nuestra zona, esos específicos días?</p>
";"20/11/2017 12";"105";"82";"23";"2";"8909301177";"4607"
"5339";"Tarjeta Multi: mejorar la  visibilidad del saldo el los lectores";"<p>Que mejoren la visibilidad del numero de viajes disponibles en la pantalla del lector del Tarjet Multi. De momento, tanto en el Metro de Madrid, y en las líneas de autobuses urbanos y interurbanos, es <strong>muy difícil</strong>, sino imposible, ver rápidamente y con claridad cuantas viajes disponibles hay en la tarjeta.</p>
";"22/11/2017 12";"169";"165";"4";"12";"8937334711";"15718"
"5341";"Pagar Bus especial Aeropuerto";"<p>Buenos días. Estoy súper indignada. Hoy al ir al aeropuerto me he encontrado con una avería en la Renfe y no iba a llegar al aeropuerto a mi hora ni de broma. Así que tenía varias opciones de transporte público (porque teniendo un abono b2 que me cuesta 72 no voy a pagar un taxi ni nada parecido....)</p>

<p>Opción a) seguir esperando a la Renfe, cuyo andén estaba petado, y teniendo en cuenta que la gente llevaba esperando media hora....
Opción b) ir al metro hacer varios transbordos y tardar un vida entera
Opción c) coger el bus que sale de Atocha y va directo a la T4.</p>

<p>Decido obviamente ir en bus porque ya estoy en Atocha y es la vía más rápida. 
Pues tengo una sorpresa al subir a este autobús... Mi abono transporte b2 que me lleva siempre sin problemas al aeropuerto en metro.. renfe.. etc NO ME VALE... ME TOCA PAGAR 5</p>

<p>Y mi pregunta es... ¿por que?
Es un bus que llega al mismo destino que si voy en renfe o en metro
En cuyo servicio no pago ningún euro extra....</p>

<p>Estoy MUY enfadada</p>
";"04/12/2017 09";"61";"48";"13";"7";"9046538088";"2754"
"5342";"No al ""aterrazamiento"" de la Gran vía";"<p>Por lo que ha pasado en otras calles presuntamente ""peoteonalizadas"" y ahora plagadas de terrazas que hacen en momentos difcil la circulacion. Que ademas no tiene el minimo control estetico y que sirven de almacen de sillas y mesas. Todo proviene de un negocio nacido cuando se prohibio fumar en lugares cerrados. La trampa es que en las terrazas si, incluso cerradas, o sea se fuma y se bebe en publico,. Quien hizo la ley hizo la trampa.</p>

<p>En vista de que eso ya es incontrolable por lo que se ve en nuestras calles, yo pediria que la peatonalizacion de la Gran Via conllevara la prohibicion de poner terrazas cerradas en esta via por dignidad y comodidad de la calle. Salvemos la Gran Via de convertirse en una muralla de cajones que no permita ni siquiera ver las fachadas. Alarmista? no, basta con pasear por algunas calles de madrid para ver lo que se pretende.</p>
";"06/12/2017 01";"168";"132";"36";"25";"9066821916";"7542"
"5343";"prohibir  aparcar en zona verde a partir de las 21:00";"<p> </p>

<p>prohibir aparcar en zona verde a partir de las 21:00 incluso sábados y domingos. Vivo en una zona céntrica  donde hay muchas  tiendas, discotecas ........  Cada vez que llego por la tarde a casa</p>

<p>temo la situación que me espera. Unos 10-20 vecinos estamos dando vueltas y vueltas para encontrar en nuestra propio zona aparcamiento, no exagero mas de una vez me he tirado dando vueltas mas de 30-45 min. Me pregunto que sentido tiene tener la zona  pagada? Además estoy convencido que todos esos coches que ocupan aparcamientos  son visitantes de bares y discotecas ya que las tiendas están cerradas.</p>

<p>De esa forma la gente aprenderá que si desean salir de copas o discotecas meparece estupendo peroque dejen el maldito coche en casa y utilizen  el transporte publico. </p>
";"06/12/2017 13";"119";"47";"72";"10";"9050320918";"-987"
"5344";"sentido obligatorio circulación de los peatones en el Centro";"<p>Que no podemos circular libremente por el Centro de Madrid y hay que seguir un sentido determinado? La Sra Carmena ha perdido el sentido común, si es que alguna vez lo tuvo. Dedíquense a gobernar, si es que saben, y si no dejen a otros  que se molesten en interesarse por los problemas que de verdad tenemos en la ciudad.</p>
";"08/12/2017 05";"124";"40";"84";"25";"9067308004";"-1419"
"5345";"Novedades en la plataforma Decide Madrid";"<p>Hola,</p>

<p>Desde el equipo de administración de Decide Madrid abrimos hilo para ir informando de las novedades que se van implementando en la plataforma de participación. </p>

<p>Empezamos con estas dos nuevas funcionalidades que contamos en el siguiente post: https://diario.madrid.es/decidemadrid/2017/11/24/como-seguir-propuestas-y-proyectos-y-subir-documentos-en-decide-madrid/</p>

<ul>
	<li>Ya se pueden <strong>seguir propuestas y proyectos</strong> y <strong>recibir alertas </strong>en caso de que la persona que propone envíe un mensaje gracias a la incorporación del botón de Seguir.</li>
	<li>Se ha <strong>mejorado la subida de documentos</strong>: puedes subir hasta 3 archivos en PDF (de un máximo de 3 MB por documento).</li>
</ul>

<p>Continuaremos informando de próximas novedades,</p>

<p>Saludos</p>

<p> </p>

<p> </p>
";"14/12/2017 10";"59";"49";"10";"16";"9148473656";"3238"
"5346";"Normativa Municipal sobre metros cuadrados para vivienda.";"<p>Desearía fuera revisada la normativa actual sobre los metros cuadrados mínimos para una vivienda. En la actualidad muchas personas vivimos solas y no son necesarios los 30m. exigidos como mínimos para una vivienda nos es suficiente un estudio con cocina, sofá cama y baño para hacerlo. Siempre y cuando la norma sobre luz externa y suministro de agua cumpla la normativa actual.</p>
";"17/12/2017 09";"58";"18";"40";"7";"9160209885";"-682"
"5347";"cambio de reponedores de bolsas caninas";"<p>hola, cuando se pusieron las nuevas papeleras con expendedores, era la misma empresa del contrato de papeleras,quien reponia las bolsas cada 24 horas. y funcionaba muy bien. desde que salieron los nuevos contratos de limpieza, son los propios empleados quien reponen esas bolsas y hay sitios de la ciudad,donde tardan mucho en reponer.                                                                                                                               propongo que se vuelva hacer como al principio ,osea que lo haga la empresa que repara las papeleras y que los trabajadores de la limpieza se dedique a lo suyo ,que es limpiar madrid. un saludo y gracias</p>
";"20/12/2017 12";"82";"70";"12";"7";"9210753478";"4951"
"5348";"Calles eléctricas";"<p>Para fomentar el uso del coche eléctrico creo que tendría sentido crear una pequeña red de calles eléctricas, calles pequeñas (un carril por sentido o un solo carril) pero que sean paralelas a vías muy transitadas.</p>

<p>Estas calles tendrían su uso limitado a vehículos 100% eléctricos, tanto para transitar como aparcar, y cada plaza de aparcamiento tendría un cargador eléctrico.</p>

<p> </p>

<p>Esta propuesta favorece que:</p>

<ul>
	<li>Esas calles tengan menos ruido (y por el momento menos trafico)</li>
	<li>Los usuarios de coches eléctricos tengan (por el momento) una reducción importante en el trafico</li>
	<li>Los usuarios de coches eléctricos sepan que pueden aparcar fácilmente y encontrar un cargador</li>
</ul>

<p> </p>

<p>Esto tendría que fomentar que:</p>

<ul>
	<li>más gente compre coches eléctricos, sin necesidad de dar ayudas concretas a personas (si tienes una de esas calles a una distancia razonable tienes aparcamiento y trafico preferente)</li>
	<li>más gente utilice plataformas de coches eléctricos (car2go, emov, etc), y quien las use pueda aparcar más fácilmente</li>
	<li>más gente opte por pedir un taxi/uber/cabfi eléctrico (al tener transitar por vías más rápidas), fomentando que estos profesionales compren coches eléctricos.</li>
</ul>

<p> </p>

<p>Además de considerar que puede tener un impacto mayor que otras medidas en la adopción del coche eléctrico, creo que es una medida de la que todos nos podemos beneficiar, ya que no todos podemos comprar un coche eléctrico, pero muchos más pueden alquilar o usar uno en ciertas ocasiones.</p>
";"20/12/2017 23";"75";"44";"31";"4";"9207149444";"762"
"5351";"¿Cómo pueden los Foros Locales aprovechar mejor la plataforma Decide Madrid?";"<p>Explorando sinergias entre Decide Madrid y Foros Locales. </p>
";"28/12/2017 14";"42";"27";"15";"4";"9283519579";"771"
"5353";"Uso de la plataforma por vecinos de otras localidades";"<p>Creo que la plataformade decide madrid es una herramienta muy util para la ciudad de madrid y tambien para los vecinos que viven en ella, yo vivo en rivas vaciamadrid y veo atado de pies y manos en cuanto intento realizar propuestas en esta plataforma dado que me piden estar empadronado en madrid, yo creo que una forma bastante plural es que no solo la gente de madrid vote por madrid sino tambien los vecinos y gente que venimos de fuera podamos realizar propuestas en esta plataforma, yo creo que la mejor forma de mejorar la ciudad es entre todos y eso incluye a la gente que vivimos fuera.</p>

<p>Un saludo</p>
";"09/01/2018 12";"54";"17";"37";"5";"9391556332";"-629"
"5354";"Peatonalizar todo el barrio de Chueca";"<p>Se debería peatonalizar todo el barrio de Chueca. El tamaño de las aceras es absurdamente pequeño y hay que bajar y subir a la acera cada vez que pasan coches, con el peligro que eso supone, porque en la acera no cabe más que una persona, y casi ni eso.</p>
";"15/01/2018 16";"145";"107";"38";"1";"9470813707";"5091"
"5355";"No al poblado chabolista gitano en el Campo de Fútbol Puerta Bonita";"<p>De un tiempo a esta parte Carabanchel se ha convertido en un paraíso para gente parasitaria, con la pasividad del ayuntamiento, las okupaciones son algo que cada vez preocupa más al ciudadano medio, que ahora teme irse de fin de semana y encontrarse su casa habitada a su vuelta y sin solución durante años. Esto se está viendo cada vez más en los pisos bajos donde fuerzan los barrotes y, con la impunidad que les garantiza la ley, sumada a la buena consideración que tienen las okupaciones por parte del equipo de Carmena, hace que mucha gente se quede sin su casa por culpa de unos sinverguenzas.</p>

<p>Pero esto también afecta a los edificios públicos y a edidificios de antiguas empresas. Así podemos ver que Oporto tiene ocupada su antigua sede de la Seguridad Social, multitud de edificios y de pisos con propietarios y, lo último, EL CAMPO DE FÚTBOL DEL PUERTA BONITA, en pleno Oporto. Podéis asomaros y ver un cada vez más creciente poblado chavolista de la etnia gitana, una vista esperpéntica de lo que hasta hace poco fue un punto de referencia del deporte del barrio.</p>

<p>Los efectos que traen sus moradores ya se están haciendo notar, ayer me ofrecieron smartphones por la calle (dejo a vuestra imaginación la procedencia) y hoy me han pedido dinero de manera un poco, digamos, intimidante, y esto irá a más en beneficio de la degradación del corazón de Oporto. </p>

<p>A estas alturas sólo espero que los vecinos tengan conocimiento de por dónde vienen los problemas y de quién los consiente. Tengo claro que, debido a la lobotomización de lo políticamente correcto, muchos de los que sufrirán sus consecuencias sólo veran racismo, fascismo, bla bla bla bla... malos tiempos para el sentido común y lo objetivo. El romanticismo infantil de la idea de la okupación, por parte de muchos gobernantes, no hace sino complicar más la vida a la gente de a pie harta de tanta corrupción de altas y bajas esferas.</p>

<p>Queremos un barrio digno, tranquilo, donde vivir sin sobresaltos, donde los hogares no estén expuestos a okupación y donde los espacios públicos sean en beneficio común, de todos los vecinos y no de unos caraduras parasitarios que se amparan en la pasividad que nos gobierna. Por favor, desalojen este foco de problemas, este poblado chabolista y devuelvan al barrio este lugar en forma de parque, residencia, centro cultural, deportivo, ... cualquier forma en la que sea lo que debería ser, un bien común.</p>
";"19/01/2018 22";"100";"94";"6";"0";"9518020606";"8272"
"5356";"PRESUPUESTOS PARTICIPATIVOS DESASTRE EN LA TRAMITACIÓN Y EJECUCIÓN";"<p>No puedo entender, que del año 2016, revisando los proyectos de presupuestos participativos aprobados en mi barrio de Salamanca, ningun proyecto está ni ejecutado, ni en ejecución. La mayoría de los proyectos siguen en estado 1 ""En estudio y analisis"". </p>

<p>Si vas a nivel de detalle en cada proyecto, algunos de los proyecto ahora se detectan que son inviables tecnicamente, lo cual me hace preguntarme para que se hizo un filtro tecnico previo.</p>

<p>No puedo entender que para estos proyectos donde la mayoria son de poca entidad (quiero decir envergadura), aunque haya que analizar y contratar, despues de un año  sigan en el estado inicial (en estudio), aunque la mayoria tiene mucha literatura en las observaciones del estado de tramitación, aunqwue avances en ternimos generales muy pocos, o casi inexistentes. </p>

<p>Bajo mi punto de vista es una pesisma gestion, y una tomadura de pelo. Ya se han aprobado los proyectos de 2017, los cuales me imagino que se van acumular con todos los que están sin ejecutar de 2016. Haciendose una bola infinita.</p>

<p>De verdad para que nos hace participar en estos proyectos, que luego no sirven para nada y no se ejecutan. ¿Es esta la nueva gestión? la de la palabras y promesas vacias. No podemos estar en manos de unos gestores con tan poca destreza.</p>

<p>De verdad que verguenza, y me da tanta pena haber participado en esto que se llama ""presupuestos participativos"" para nada,</p>

<p>¿que opinais?</p>

<p> </p>
";"20/01/2018 10";"59";"42";"17";"28";"9515894385";"1779"
"5357";"Reducir la contaminacion de una vez en la ciudad de Madrid";"<p>Esto no puede seguir ni un dia mas asi, nos estamos matando poco a poco. Señora Ines Sabanes tome las medidas oportunas y hagalo ya. Se les ha votado por algo, esperando algo de ustedes. Si tienen que cerrar el trafico de manera indefinida en el centro de la ciudad haganlo, ¡Pero ya!.</p>

<p>La velocidad en la m-30 deberia ser a 70 km/h de manera perpetua, y en la m-40 a 90 km/h.</p>

<p>Es nuestra salud la que esta en juego.</p>

<p>Ni un minuto mas con aire contaminado</p>
";"25/01/2018 10";"165";"149";"16";"9";"9574163214";"12010"
"5358";"Despolitizar FOROS LOCALES";"<p>Creo que es necesario que no se permita la participacion en los Foros Locales a ninguna persona afiliada o con vinculos a partidos politicos y asociaciones, entidades o empresas contratadas por las instituciones públicas.</p>

<p>Se supone que Los Foros Locales se crearon para que el ciudadano/vecino de barrio participará en las decisiones de políticas de su ámbito más cercano.</p>

<p>La existencia de cargos y participación política dentro de las mesas de los foros implica cierta manipulación del ciudadano ya que suelen ser quienes gestionan, tramitan, tienen los contactos, influyen.... con lo cual se desmotiva al ciudadano y no se consigue la participación deseada ni el fin para lo que se supone que se han creado.</p>

<p>Conozco a personas que se apuntaron y cuando vieron y se dieron cuenta de lo que hay detrás... se quedaron en su casa y corrieron la voz para que sus vecinos no se dejen manipular.</p>

<p>Dejen los Foros Locales para que la gente humilde y sencilla obtenga empoderamiento en la gestión pública.</p>

<p>Ustedes que opinan?</p>

<p>Además, pienso que los dinamizadores de los foros que son contratados y cobran nómina tendrían que estar empadronados en el distrito en el que trabajen.</p>

<p>Ahh. Y otra cosa... están uniendo fuerzas para el tema de los Presupuestos Participativos. Así sólo se realiza lo que sugieren los ""lideres"" de los Foros Locales</p>
";"26/01/2018 19";"80";"62";"18";"20";"9581557634";"3410"
"5359";"Reparto presupuestos por distrito.";"<p>El distrito de Vicalvaro en base a su población le queda en el reparto de presupuestos una cantidad totalmente infima para todas las necesidades que tiene, ya que antes igual que hoy se nos ningunizaba. Por lo tanto llevamos un retraso muy grande en servicios y una extensión de terreno y de población muy amplia. Digo todo esto sin comparaciones porque no se trata de quitar a otros distritos sino de tener unos servicios municipales dignos en este. No se trata de que los servicios se ofrezcan a una o dos asociaciones, si no a los propios pobladores</p>
";"27/01/2018 18";"40";"35";"5";"4";"9591386575";"2625"
"5360";"Mejora de la movilidad ciclista.";"<p>Buenas tardes, dejo aquí una serie de puntos que considero necesarios para mejorar la circulación y la convivencia de los ciclistas en la ciudad, espero su participación para añadir, quitar o modificar algún punto si es necesario.</p>

<ol>
	<li>Impartir en los colegios clases sobre el código de circulación en Madrid capital.</li>
	<li>Crear centros donde se puedan practicar con seguridad las buenas conductas sobre la bicicleta</li>
	<li>Realizar talleres para todos los públicos en espacios municipales donde se den pequeños trucos y consejos a las personas interesadas en montar en bicicleta en su día a día.</li>
	<li>Realizar paseos guiados en bicicleta por las calles de Madrid.</li>
	<li>Incentivar a empresas y centros educativos a fomentar el uso de la bicicleta (instalar aparca bicis,  pequeños incentivos económicos a los trabajadores que más la usen...)</li>
	<li>Para mejorar la movilidad es importante que la bicicleta resulte más atractiva que el coche en los desplazamientos cortos por lo que sería necesario temporizar los semáforos para que estas tuvieran que esperar lo menos posible.</li>
	<li>Hacer que los ciclistas respeten las normas de circulación imponiéndoles las sanciones necesarias así como que el resto de usuarios de la vía los respeten a ellos y a los espacios reservados a la circulación de bicicletas.</li>
	<li>Obligar a los ciclistas a llevar medios de seguridad y visibilidad como casco,chalecos,luces...</li>
</ol>
";"29/01/2018 18";"112";"89";"23";"17";"9612927287";"5244"
"5361";"Mejorar las líneas verdes en zona residentes SER";"<p>Por donde yo aparco, por lo menos, parece que ninguno sabemos aparcar en zona verde.</p>

<p>Por un lado, hay muchos aparcamientos en paralelo o ""inclinados"", y las líneas no están  pintadas completas o están muy desgatadas.</p>

<p>Si esto lo juntamos con que están calculadas al milímetro... el resultado es que en cada calle de zona verde que tiene aparcamientos paralelos, la gente aparca como le da la gana y hay 2 o 3 sitios que se dejan sin usar, porque desde que uno aparque en medio de la línea el de al lado hace lo mismo y así... total, que te pasas el rato dando vueltas porque tenemos una mala señalización y porque, lamentablemente, parece que no somos conscientes de que si no aparcamos bien, otro vecino no podrá aparcar.</p>

<p>Habría que pintar las líneas completas e incluso implementar un sistema de control riguroso, no por ser residente podemos ""dejar tirado"" el coche donde nos de la gana, hay que ser cívicos y ponerlo en su sitio, que para eso hay líneas en el suelo.</p>
";"30/01/2018 12";"39";"29";"10";"1";"9615287595";"1412"
"5362";"Ordenacion e integracion de maquinas de aire acondicionado en las fachadas";"<p>Dichas maquinas estan puestas por las fachadas sin ningun orden, tal y como le parecio al vecino. Propongo que se coloquen en una misma columna, se pinten del color de la pared y se cubran con un protector enrejillado del color de la pared, lo mismo que las canaletas de procteccion de los tubos.</p>

<p>La ciudad ganaria en estetica</p>
";"30/01/2018 14";"97";"74";"23";"2";"9619524382";"3890"
"5364";"El Canal de Isabel segunda cuando te corta el agua para activar la cobra 70  un";"<p>Buenas tardes ayer me cortaron el agua y no en la primera vez y por conectarte la otra vez cobran casi 70  cuándo Iberdrola por desgracia no se cobra menos de la mitad me parece que 70  por darte la palanquita del agua es un atraco a mano armada creo que deberíamos entre todos quejarnos al Ayuntamiento o a la Comunidad de Madrid no sé cuál es su verdadera competencia porque esto es una p*** vergüenza</p>
";"31/01/2018 17";"45";"22";"23";"3";"9617779869";"-48"
"5365";"Disminuir en 100 millones la carga fiscal de las familias en Madrid";"<p>Buenas tardes, propongo utilizar los 100 millones, para disminuir la carga fiscal de las familias en Madrid. Implicaría mayor ingreso disponible, mayor ahorro para las familias y mayor consumo, con el consiguiente círculo virtuoso.</p>

<p> </p>

<p> </p>
";"04/02/2018 15";"74";"61";"13";"17";"9671200468";"3956"
"5366";"Crear un Paseo Peatonal que atraviese La Gavia desde Calle Real de Arganda";"<p>Es evidente que el La Gavia se concibió como un barrio para circular, para pasar en coche y se olvidó de las personas, de los peatones. Es un barrio difícil para pasear desde la Calle Real de Arganda hasta la Avenida del Ensanche de Vallecas, lleno de cruces y pasos de cebra que lamentablemente a menudo los conductores no respetan, implicando riesgo y stress al paseante. El parque de la Gavia es una especie de isla (aislada) de las zonas circundantes por vías rápidas urbanas.</p>

<p>Propongo crear una VÍA de preferencia PEATONAL, paralela a la avenida de la Gavia entre la Calle Real de Arganda y la Avenida del Ensanche de Vallecas con posibilidad de prolongación hasta la Avenida del Mayorazgo. La avenida de la Gavia dispone de 3 carriles por sentido y por tanto espacio suficiente para crear un agradable paseo arbolado, bien señalizado para el paseo de viandantes que incite al uso de la vía publica, el acceso al parque de la Gavia e incentive la actividad física para los vecinos de la zona. Actualmente, la circulación de vehículos a gran velocidad por la zona no invitan a utilizar la via pública y acceder al parque</p>
";"06/02/2018 09";"49";"43";"6";"0";"9688265326";"3246"
"5367";"No permitir construcciones de viviendas que invaden en altura, la calzada";"<p>Como ejemplo, este mastodonte del Grupo Altosa que se está construyendo en la Plaza Norte frente al parque de la Ventilla. Las vistas al parque van a quedar solo para ellos, los bloques cercanos tendremos ese enorme edificio delante y la plaza queda confinada para uso de ellos. Hasta nos van a cortar las corrientes naturales de aire. Inclusive por encima de tres calles, ¡tres!, se han diseñado un arco para que pasen los coches porque las viviendas van por encima de las carreteras. Es un aberración construir así</p>

<p>http://www.grupoaltosa.es/?page=308&amp;mo=inmuebles&amp;id=36&amp;opc=v</p>

<p> </p>

<p> </p>

<p> </p>
";"11/02/2018 07";"49";"37";"12";"5";"9734420383";"1887"
"5368";"Seguimiento proyectos aprobados en presupuestos participativos ";"<p>Me gustaría que hubiese algún apartado en la web que hablase de como se están ejecutando los  proyectos de presupuestos participativos de años anteriores. Me da la sensación de que hay proyectos que se incumplen y de la mayoría no se sabe nada. Además esto aumentaría la participación en los presupuestos participativos </p>
";"15/02/2018 09";"73";"70";"3";"13";"9782069318";"6424"
"5369";"Proyecto Fomentar la Adopción de los Animales del CPA ";"<p>-<strong>Objetivo</strong>: Dar a conocer a los ciudadanos que pueden adoptar un animal en el Centro de Protección Animal municipal. Que todos los ciudadanos tengan acceso a la información del centro, dado que es municipal.</p>

<p>-<strong>Petición</strong>: Que parte de los espacios MUNICIPALES sean destinados a la difusión de los animales del Centro de Protección Animal CPA ""La Fortuna para fomentar su adopción.</p>

<p>-<strong>Porqué</strong>?: Por qué cientos de animales esperan allí a ser Adoptados y la mayoría de los ciudadanos desconoce esta realidad.</p>

<p><u>Memoria</u> Solicitamos su apoyo para que parte de los espacios MUNICIPALES, bien sean públicos (bibliotecas, centros socioculturales, centros deportivos, juntas municipales etc.), o gestionados por empresas privadas en convenio con el ayuntamiento ( publicidad de Metro y autobuses) destinen un pequeño espacio a la difusión de los animales del Centro de Protección Animal CPA "" La Fortuna"".</p>

<p>El objetivo es fomentar su adopción y que los ciudadanos sepan que existen estos centros donde se puede adoptar. La difusión consistiría en trípticos, cartelería del centro y animales y crear una campaña de adopción (tal y como se hace en otras áreas municipales: Cultura, igualdad, medio ambiente...)</p>

<p>De esta forma procurar ampliar las posibilidades de adopción para los Animales y satisfacer seguramente a gran parte de la ciudadanía que desconoce que existe este centro y las posibilidades de adopción de estos animales. Tratemos de reaccionar ante el abandono de animales con una campaña de difusión de la adopción del centro municipal.</p>

<p>Es vital para una ciudad como Madrid... pionera, solidaria, cálida</p>
";"15/02/2018 15";"298";"286";"12";"103";"9790639323";"26296"
"5371";"¿Qué falla? ¿Dónde está el problema?";"<p>Las competencias, las políticas activas y pasivas de empleo, la cultura social en relación al mercado de trabajo, ... ?</p>

<p>Como muchas personas, estoy cada día más hundida en la extrema dificultad de reparar los daños que la crisis y falta de empleo han hecho en mi vida.</p>

<p>No es la falta de formación, ni la actitud ni las capacidades. Las tengo: repertorio de cursos, talleres, certificados de profesionalidad, formación reglada, ... experiencia y ganas, habilidades y práctica, ...  Entonces ¿qué es lo que falla?</p>

<p>El declive grave que sufrimos es responsabilidad de las administraciones públicas. Su falta de implicación, desacierto en el desarrollo de sus competencias, ineficacia y desidia para dar respuesta en tiempo y forma al ciudadano.</p>

<p>No culpen a los individuos que forman esta sociedad porque son el espejo de los resultados de las acciones de los organismos y administraciones de este país, comunidad, ayuntamiento, distrito, barrio.</p>
";"20/02/2018 13";"19";"16";"3";"3";"9825566826";"1094"
"5373";"Remodelación del Paseo Santa María de la cabeza. ";"<p>La contaminación ambiental que hay en este paseo es realmente de preocupar. El ayuntamiento debería de hacer un estudio para comprobar los limites de ruido y humo que existen a diario en este tramo.</p>

<p>La remodelación del Paseo de Santa María de la Cabeza puede ser la única solución que hay para reducir el gran volumen de tráfico que pasa. Las opciones que hay para tal fin puden ser reducir los 6 carriles que hay, distribuir mejor las salidas/entradas, mejorar los transportes públicos para dar mayor facilidad de acceso a Madrid centro sin necesidad de meter el vehículo, crear parkings públicos por plaza elíptica o puntos estratégicos de entrada a la ciudad...  </p>

<p>En cualquier caso debería de ser motivo de estudio y llevar a cabo soluciones para mejorar este tramo.</p>
";"21/02/2018 14";"55";"48";"7";"0";"9840618823";"3578"
"5375";"no  excrementos   en   parques   ,   ";"<p>parques  como  el  de  las  cruces  o  el  beatriz  galindo  en  manuel  becerra  esta  lleno  de  mierda  de  perro   en  su  cesped  ,  uno  se  echa  y  se  ensucia  </p>

<p>no  es  justo   da  asco   ,  alg  que  es  ara  todos  ricos  y  pobres  tiene  que  estar  enmierdado   por  la  miierda  de  estos  animales</p>
";"22/02/2018 00";"142";"136";"6";"11";"9850970994";"12450"
"5376";"Instalaciones deportivas en la calle Viejas.";"<p>Las instalaciones deportivas de la calle Viejas estan casi en deshuso, tiene campo de futbol que en tiempo fué de la EMT, equipo al que pertenecí, también tiene frontón donde se puede jugar al balonmano y al baloncesto, tiene piscinas, pistas de tenis y la mayor parte de las instalaciones están en deshuso, ya hemos visto lo que ha pasado con lo que fué la ciudad deportiva del Real Madrid y sería una pena en el caso que pasara algo así, pregunto, podría volver a tener la actividad que hace años tuvo. </p>
";"22/02/2018 10";"20";"18";"2";"0";"9845555544";"1440"
"5377";"¿Tarjeta azul que abarque mas zonas !";"<p>Los usuarios de transporte publico que tiene tarjeta azul muchas veces ven inconvenientes en llegar a zonas tipo B1 o B2, no seria mejor a este colectivo de discapacidad que utilizan esta tarjeta ampliarla en esas zonas y ahora que ha sacado la multi ahorrarse esa tarjeta y complementarla con la tarjeta azul, igual pasa con la de los jubilados mayores de 65 años, solo se utiliaza para la zona A y tener mas cobertura y ampliar tambien por los ingresos de dinero, para acceder a ella que sea gratuita para discapacidades, solo el pago de cada mes para acceder al transporte publico</p>
";"22/02/2018 13";"39";"36";"3";"1";"9850020961";"3046"
"5378";"Los dueños de perros no tenemos espacio para disfrutarlos";"<p>Abro este debate debido a las graves limitaciones que sufrimos los dueños de perros: no podemos pasear por lso parques de Suances ( ya que osn históricos) no hay pipican, no se les puede soltar en ningun sitio, y si además tenemso hijos, no podemso disfrutar de las mascotas en ninguna parte porque en todos lados ""molestan"". Es como una especie de acoso, y TODOS LOS CIUDADANOS TENEMOS DERECHO A DISFRUTAR DE LOS PARQUES. </p>

<p>PROPONGO CREAR UN PARQUE DE PERROS GRANDE EN EL PINAR ABANDONADO DE MARQUÉS DE SUANCES, FRENTE A LA NUEVA CLÍNICA. </p>
";"22/02/2018 14";"99";"37";"62";"7";"9831325129";"-934"
"5383";"Vertederos a la puerta de edificios residenciales.";"<p>Nunca pensé que iban a mantener y extender un sistema de recogida de residuos que consiste de hecho en la instalación de vertederos en la vía pública.</p>

<p>Es increible que las comunidades de vecinos tengan un horario para sacar los cubos de la basura y en estos vertederos se pueda arrojar todo tipo de residuo a cualquier hora.</p>

<p>Los vecinos del número 14 de la Plaza de Tirso de Molina padecemos desde el pasado mes de septiembre las consecuencias de la instalción de uno de estos mal llamados puntos de reciclaje, utilizado como vertedero y urinario. ¿Cómo se decidió instalarlo frente al número 14, sabiendo que en su ubicación anterior era una inmundicia? ¿Cómo es posible que ante las reclamaciones formales de los vecinos se conteste que es una zona de mucho tránsito y no lo pueden mantener siempre en las condiciones de limpieza adecuadas?</p>
";"25/02/2018 23";"38";"33";"5";"4";"9882742976";"2431"
"5384";"USO DE LA TARJETA AZUL EN RENFE";"<p>Buenas tardes. Creo que es bueno que se pueda usar en la Renfe dentro de Madrid Capital. Segun el CRTM, el antiguo ayuntamiento gobernado por el PP no firmó un convenio con Renfe para que la pudieramos usar dentro de la ciudad. </p>

<p>Nos podemos beneficiar, una vez suscrita, muchas personas usuarias para desplazarnos por tema de ocio y/o trabajo</p>
";"28/02/2018 14";"39";"34";"5";"2";"9909092428";"2528"
"5385";"MAYOR ENDURECIMIENTO CONTRA LA LGBTFOBIA";"<p>SOLICITO LA DIMISIÓN DE LA DIRECCION DEL CENTRO JUAN LUIS VIVES POR PERMITIR LA LGBTFOBIA Y NO SANCIONAR NI A LOS USUARIOS QUE LAS PRACTICAN NI A LAS EDUCADORAS QUE LAS CONSIENTEN. ESTO VULNERA LA  </p>

<p><strong><em>Ley 3/2016, de 22 de julio, de Protección Integral contra la LGTBifobia y la Discriminación por Razón de Orientación e Identidad Sexual en la Comunidad de Madrid.</em></strong> </p>

<p> </p>

<p> </p>
";"28/02/2018 14";"96";"64";"32";"0";"9906319478";"2133"
"5386";"Optimización de la Administración de Residuos en Madrid";"<p>España está muy atrasada a lo que refiere su manejo de residuos. <u>¡Nos estamos ahogando en nuestra propia basura!</u></p>

<p><strong>El 60% de basura en España va a vertederos</strong>. En 2025, según el reglamento acordado ya por las instituciones comunitarias de la UE, debemos reciclar al menos el 55% de los residuos municipales. En 2035, el porcentaje debe llegar al 65%. Actualmente, <strong>España lleva 8 años reciclando sólo un 29,7% </strong>(con variaciones mínimas), sin haber visto una mejora marcante desde hace años.</p>

<p>En Madrid aproximadamente el 40% de los residuos se tiran sin ser tratados primero. </p>

<p>A parte de que no reciclamos lo suficiente, es decir, un porcentaje muy bajo es separado en las diferentes categorías, y no tenemos la categoría de basura biológica, el sistema de residuos que va después de que el ciudadano haya tirado su basura NO ES SUFICIENTEMENTE AVANZADO. </p>

<p>Propuestas:</p>

<p>· Programas de concienciación de la ciudadanía sobre su producción de reisudos crónica y sobre los problemas que esta provoca.</p>

<p>· Una mayor inversión monetaria en mejorar y <strong>actualizar</strong> la administración de los residuos de Madrid. Hagamos que la capital sea un ejemplo positivo. ¡No a los vertederos!</p>

<p>· Impulsar el debate público y POLÍTICO sobre este tema, para que se puedan tomar medidas concretas y drásticas para cambiar el sistema residual madrileño.</p>
";"01/03/2018 18";"77";"73";"4";"7";"9925450048";"6541"
"5387";"Amnistiar a los corruptos";"<p>Esta propuesta me fué retirada, y creo que de no malinterpretarse, se podría reabrir; bueno, la verdad es que esa es mi intención.</p>

<p>Comence utilizando este titulo <strong>""Absolvamos a los corruptos""</strong>, seguido de un tema <strong>""Invertir en rehabilitar delincuentes (mandar proyecto a Soto del Real)""</strong></p>

<p>Si entrais en el debate, me encantaría aclarar la confusión que pudo producirse, y de hacerme entrar en razón, admitiré que <strong>mi propuesta era inapropiada</strong>, claro que tendría que responderos mañana pues estoy en <strong>LA CASA ENCENDIDA</strong> y solo dejan 2 horas de internet al día.</p>

<p>Eso daría para otro debate, pero me interesan más los corruptos.</p>

<p>Es la primera vez que hago esto, y no sé como se hace...soy Jose </p>

<p> </p>
";"04/03/2018 19";"69";"4";"65";"4";"9937190984";"-353"
"5388";"Necesidad de una linea de bus en Ronda Segovia - La Latina";"<p>En Ronda de Segovia solo tenemos una linea de bus, la Circular, vivímos muchisimas familias que a diario debemos movernos con niños y personas mayores para poder cumplir con la educación y nuestros quehaceres.</p>

<p>La Ronda de Segovia es una calle extremadamente pendiente, un 50 % en algunos tramos, nos movemos con carritos de bebe y varios hijos a la vez, solo hay unas escaleras muy pendientes  que nos facilitan el acceso al parque de la cornisa .</p>

<p>Creemos que es necesario una nueva linea de bus que falicilite la movilidad de la gene que vivimos en la zona Ronda Segovia, La latina, Centro.</p>
";"04/03/2018 23";"41";"39";"2";"1";"9955235894";"3519"
"5389";"¿Es justo cambiar el nombre de una calle sin la participacion de los que viven?";"<p>Respecto al cambio de nombre de la Avenida Hermanos Garcia Noblejas  ¿Alguien les ha preguntado a los que viven en esta calle para elegir cambiar el nombre? NO   ¿Alguien les ha preguntado a los que viven en esta calle que nombre quieren? NO    ¿No habra algún nombre mas corto para esta calle?  AVENIDA DE LA INSTITUCION LIBRE DE ENSEÑANAZA ... un nombre cortito    ¿Como se llamara ahora la parada de metro de Garcia Noblejas? ¿AVENIDA DE LA INSTITUCION LIBRE DE ENSEÑANZA?    ¿Eso es democracia participativa donde los afectados no tienen derecho a opinar? Estoy de acuerdo con el cambio de nombre pero no en la forma de hacerlo. Ademas podia renombrar Arturo Soria con el numero 1 y 2 desde la Plaza Alsacia. y usar el método de metros pares e impares desde el principio de la calle para poner los números de las casas. Pero supongo que eso molestaría a todos los residentes en la Calle Arturo Soria</p>
";"05/03/2018 14";"114";"76";"38";"44";"9957941230";"2533"
"5390";"Sabéis que no existe transparencia sobre las sanciones por consumo de alcohol";"<p>Ni el Ayuntamiento, ni Madrid Salud, tienen transparencia respecto a las sanciones por consumo de alchool en via publica que imponen la policia municpal en Madrid.</p>

<p>No existe ninguna estadistica de las multas impuestas que son alegadas, ni recurridas ni que han ido al contensioso administrativo. Ni el resultado de estos procedimientos.</p>

<p>No existe estadisticas porque quedaria en evidencia que la mayoria de sanciones se imponen sin ninguna prueba, y que los sancionados no alegan, ni recurren por verguenza. </p>

<p>Toda la informacion en    https://decide.madrid.es/proposals/1528 </p>
";"05/03/2018 14";"70";"62";"8";"1";"9961843998";"4782"
"5391";"Paneles solares en madrid";"<p>Paneles solares para ahorro de energia infraesructutas de madrid. Gasto necesarioa</p>
";"06/03/2018 13";"209";"202";"7";"1";"9978235003";"18846"
"5392";"Propuesta prevención abandono y maltrato animal ""Educa2""";"<p>Cada 3 minutos se abandona una mascota en España (La cifra más alta de la unión Europea). Hasta ahora los recursos operativos (servicios de recogida, protectoras, perreras municipales, adopciones, etc) entran en juego al final de la cadena. Cuando el animal ya ha sido maltratado o abandonado es cuando se activan los diferentes servicios de ayuda. Desde Educa2 proponemos un modelo interventivo basado en la prevención de la aparición de las causas que conducen a los propietarios a maltratar o abandonar a sus mascotas.</p>

<p>Hemos presentado una propuesta a los Presupuestos Participativos de Madrid para trabajar en la prevención del abandono y el maltrato animal desde un punto de vista diferente al que se realiza actualmente. Nuestra estrategia es crear grupos de trabajo abiertos a todos donde poder trabajar los problemas cotidianos que nos surgen con nuestra mascota, de esta manera, dotando de conocimientos al propietario  podremos evitar que haya una pérdida de interés y enseñaremos a como fortalecer el vínculo con su compañer@, también queremos dar formaciones en colegios, en centros de mayores, empresas, para crear una conciencia de responsabilidad a la hora de elegir tener una mascota y dar a conocerlas necesidades y cuidados básicos que tienen. Os invitamos a que apoyéis nuestra propuesta y también a que nos sigáis en nuestra página de Facebook ""Educa2"" donde comunicaremos nuestros próximos talleres a los que podréis asistir con vuestras mascotas!</p>
";"06/03/2018 15";"103";"96";"7";"2";"9975062058";"8295"
"5393";"Sobre ""18 líneas maestras de la nueva Ordenanza de Movilidad"" Rodajes cinematog";"<p>Lo pongo aquí porque no me ha dado tiempo a llegar al plazo. Con la esperanza de que se tenga en cuenta:</p>

<p>Me refiero al p. 17. RODAJES parr 2º y a la frecuente -desde hace años- ocupación para rodajes publicitarios y de series tv del cuadrante/parrilla de calles Caracas-Españoleto (especialmente)-General Arrando/Zurbano-Santa Engracia.</p>

<p>Recojo en estos comentarios el sentir de muchos vecinos.</p>

<p>1.Diden vds: "".....promoción ......... de la imagen de la ciudad que producen los rodajes"". No es cierto.Me he molestado en ver todo lo rodado aquí.Lo que aparece en pantalla lo mismo podía ser se Teruel,Valladolid,....ó cualquier otra ciudad.Solo quienes frecuentamos/vivimos por aquí lo reconoceríamos como de Madrid.Distinto sería si apareciesen lugares reconocibles de Madrid.</p>

<p>2. Las molestias ni se las pueden imaginar.Bien se lo imaginaron los de la calle Claudio Coello cuando quisieron rodar allí la muerte de Carrero Blanco:Protestaron y se trasladó a c/ Españoleto y no una vez, dos documentales distintos en dos años distintos. ¿Tenemos que hacer lo mismo que los de C.Coello? Pues lo haremos.</p>

<p>-¿Saben lo que es ir a buscar aparcamiento -tras una jornada de trabajo ó con personas mayores- a Ventas ó al Barrio de la Concepción desde aquí??? Y los residentes pagamos anualmente al Ayuntamiento por aparcar aquí no a km. de aquí.</p>

<p>-¿Saben lo que es no poder acceder a tu casa ó salir de ella mientras se repite una y otra vez la escena?</p>

<p>-¿Saben lo que es encontrate tu balcón lleno de objetos -pinzas de colores,globos, etc- que debieron lanzar en el rodaje?</p>

<p>-etc., etc.,Irritante.</p>

<p>3. Dicen vds. como una gran concesión ""...máximo de 2 días dejando un tiempo mínimo de ¡¡¡15 días naturales!!! para autorizar nuevamente otra ocupación por rodaje en la misma zona o zonas muy próximas. Si ahora es cada ...dos/tres meses y es insoportable.</p>

<p>* ¿¿No podráin llevarse estos rodajes en calles irreconocibles como tales de Madrid a otras calles igualmente irreconocibles -por ejemplo peatonales ó con menos densidad de población/coches ó más facilidad para aparcar?</p>

<p>* ¿Cuanto pagan al Ayuntamiento por tales rodajes? Nos gustaría saberlo.Porque promoción de la ciudad,en absoluto.Molestias para sus vecinos:Total. Ustedes verán si le compensa a un ayuntamiento al servicio de la ciudadanía.</p>

<p>* NO a la Turistificación y platós de rodaje en los barrios!!</p>

<p> </p>

<p> </p>

<p> </p>
";"06/03/2018 15";"17";"10";"7";"0";"9959879244";"176"
"5394";"Auditar tarjetas SER residentes";"<p>Dado que el ayuntamiento cobra a cada residente por la tarjeta verde, debe asegurarse de que existen tantas plazas verdes como tarjetas emite. Esos datos deberian ser auditados y publicados por distrito.En aras de la transparencia.</p>

<p> </p>

<p> </p>

<p> </p>
";"06/03/2018 21";"46";"42";"4";"5";"9973904444";"3469"
"5395";"Exigir la retirada de cerramientos en terrazas.";"<p>Resulta incomprensible que pese a ser ilegal la gente siga cerrando las terrazas con  armatrostes de aluminio, sin ningún tipo de permiso y rompiendo la estética de los edificios, por no hablar de la nula homologacion en materia de seguridad que dichos cerramientos suponen.</p>

<p>El Ayuntamiento debería tomar cartas en el asunto. Es tremendo que ninguna administración haya tomado cartas en el asunto. Otro caso de similares caracteristicas son los aparatos de aire acondicionado, puestos arbitrariamente en tantísimas fachadas de nuestra Ciudad.</p>
";"07/03/2018 17";"119";"66";"53";"10";"9974167927";"721"
"5396";"elegir un hospital aunque no pertenece ";"<p>elegir un hospital al que nose  pertenece en la zona pero te viene bien por los servicios de consultas o operaciones quirúrgicas y hacerle como referencia o referente  aunque te tengas que desplazar un poco más </p>
";"08/03/2018 22";"55";"48";"7";"5";"9993822918";"3578"
"5401";"ÁRBOLES EN LA PUERTA DE SOL";"<p>SOLICITO QUE SE PLANTEN. DARIA MAS VIDA A LA PLAZA. </p>
";"11/03/2018 11";"149";"120";"29";"4";"10021092769";"7328"
"5402";"REFUNDACION DEL SAMUR SOCIAL";"<p>SOLICITO EL DESPIDO DEL SAMUR SOCIAL. NO AYUDAN A LA GENTE QUE REALMENTE LO NECESITEN Y NO SON SOCIALES. SÓLO BUSCAN COBRAR A FINAL DE MES.</p>

<p>TENDRIAN QUE SER PROFESIONALES CON MAYOR CALIDAD HUMANA</p>

<p>GRACIAS</p>
";"11/03/2018 11";"43";"22";"21";"4";"10006602740";"51"
"5403";"Nueva tasa en el aeropuerto para dejar y recoger viajeros";"<p>Hace unos días me han comentado que hay una nueva tasa en el aeropuerto para los coches particulares que lleven y recojan a  viajeros.</p>

<p>¿Sabéis si es verdad? si es así, me parece vergonzoso. Estas tasas deben suprimirse ya!</p>
";"12/03/2018 20";"76";"9";"67";"3";"10016683083";"-686"
"5404";"Exigir medidas de seguridad para ciclistas";"<p>Sería imprescindible, por su propia seguridad, que los ciclistas tengan prohibido circular sin que sean perfectamente visibles, con la iluminacion adecuada, para ser vistos por los vehiculos.</p>

<p>No se les debe dejar circular por las aceras para evitar accidentes con los peatones. Y debería ser obligatorio el uso de casco protector, para evitar que los posibles accidentes les causen lesiones graves.</p>

<p>Hay que vigilar especialmente, para evitarlo, que una gran cantidad de ciclistas se saltan de forma habitual los semaforos y los stop, pues generalmente no los respetan.</p>
";"16/03/2018 17";"84";"72";"12";"4";"10072962795";"5142"
"5405";"Complejos deportivos libre uso ";"<p>hay complejos deportivos de fútbol baloncesto o frontones en aluche vilavede san Fermín carambachel orcasurvArganzuela etc ,, que no tienen un mantenimiento ni seguimiento y las encuentras sucias,,  y sin mantenimiento ni seguimiento ,no todas por implicación de quien juega por no estar reguladas y de libre uso sería bueno regular  aunque sigan siendo libres </p>
";"17/03/2018 16";"23";"17";"6";"0";"10075019709";"813"
"5406";"Cese concejales disturbios lavapies";"<p>Que cesen a los concejales que han juzgado y criminalizado la correcta actuacion de la policia local. Que se apoye a la policia cuando hace su trabajo desde el ayuntamiento de Madrid</p>
";"17/03/2018 19";"104";"69";"35";"4";"10078617055";"2255"
"5407";"El ayuntamiento no cumple con su programa electoral. ";"<p>Votando las propuestas que hacen sobre el PAU de Carabanchel, mi barrio, no dejo de asombrarme al ver que sigue apareciendo la creación del parque Manolito Gafotas. La construcción de este parque, aparecía en el programa electoral del actual equipo de gobierno del ayuntamiento pero no se ha hecho nada. Me siento igual de estafado por ellos que por todos los anteriores gobiernos locales. También prometieron potenciar el transporte público de los extrarradios de Madrid hacia el centro pero tampoco han hecho nada. Se ve que sólo les interesan las obras de embellecimiento de plaza España y la Gran Via,el resto de Madrid ya veo que no les importa mucho pero eso sí podemos votar propuestas para nuestros barrios......... esto es una estafa. </p>
";"18/03/2018 10";"51";"33";"18";"7";"10082965242";"970"
"5408";"Porque no unir línea 9 en Vicálvaro con 2 y 7 para crear una conexión básica de ";"<p>Que os parece ,pienso que muchos no necesitaríamos llevar el coche si existiera una buena conexión circular de la zona este.</p>

<p> </p>

<p> </p>

<p> </p>

<p> </p>

<p> </p>

<p> </p>

<p> </p>

<p> </p>

<p> </p>

<p> </p>
";"18/03/2018 19";"54";"49";"5";"2";"10093495414";"3992"
"5409";"Retirada de estatua dedicada a Francisco Largo Caballero";"<p>Los ciudadanos de Madrid tenemos que soportar ver cada vez que pasamos por el <em>Paseo de la Castellana </em>la estatua a uno de los mayores enaltecedores de la violencia de nuestro pais, no es otro que Francisco Largo Caballero.</p>

<p>Uno de tantos ejemplos de este golpista es el discurso del 8 de noviembre de 1933 (si, antes de comenzar la Guerra Civil Española) en la localidad pacense de Don Benito:</p>

<p>«Vamos legalmente hacia la evolución de la sociedad. Pero si no queréis, haremos la revolución violentamente. (Gran ovación.) Esto, dirán los enemigos, es excitar a la guerra civil. Pongámonos en la realidad. Hay una guerra civil. ¿Qué es si no la lucha que se desarrolla todos los días entre patronos y obreros? Estamos en plena guerra civil. No nos ceguemos, camaradas. Lo que pasa es que esta guerra no ha tomado aún los caracteres cruentos que, por fortuna o desgracia, tendrá inexorablemente que tomar»</p>

<p>Quien quiera informarse ma acerca de este personaje es libre de buscar mayor información.</p>

<p>No tenemos absolutamente nada que agradecerle ni nada por lo que admirarle, mas bien al contrario, ¿en que se diferencia este señor de otros calificados como revolucionarios y/o golpistas? recapaciten ustedes y dejen a un lado sus ideologías políticas para dar lugar a la sensatez. A mi me produce nauseas que el pueblo de Madrid rinda homenaje a un ser tan vil como este, no se a ustedes.</p>
";"19/03/2018 23";"79";"30";"49";"8";"10085265220";"-721"
"5410";"Penalización del transporte en BUS";"<p>Si no estoy en un error, hace más de un año se votó por mayoría la propuesta de Billete único para transporte público, y, especialmente, la posibilidad de poder cambiar de línea de bus con una única validadación, dentro de un tiempo estimado.</p>

<p>¿Alguién sabe por qué, a día de hoy, aún no se ha ejecutado dicha méjora en el transporte público?</p>

<p>¿Alguién podría decirme por qué el bus está penalizado con un mayor coste si hay necesidad de cambiar de línea?</p>

<p>Se quiere fomentar realmente el transporte público, o todo es un postureo eco-bio-megagüay-alternativo?</p>

<p>Supongo que esta web y los votos sirven para algo, no?.</p>

<p>O estamos TODOS  aquí haciendo el canelo?</p>

<p>Gracias y Salu2s.</p>
";"20/03/2018 09";"58";"55";"3";"37";"10111262626";"4931"
"5411";"Recuperemos el verde en Madrid";"<p>Propongo agrupar las iniciativas y realizar las siguientes actuaciones para que Madrid vuelva a tener verde y no sea solo una isla de cemento.</p>

<p>Techos verdes y Jardines Verticales,</p>

<p>Vegetación en las zonas ""vacias"" medianas/ cruces entre carreteras en M-30 y en M-40</p>

<p>Ningun alcorque sin árbol</p>

<p>Más parques y Jardines en las plazas de CEMENTO de Madrid.</p>

<p>Actuaciones para incentivar que los ciudadanos coloquen en sus balcones plantas/ y mejoren el Cuidado de sus Jardines comunitarios. Como por ejemplo premio al balcón/Jardín más bonito, con algún tipo de beneficio para la comunidad. Servicio de paisajimo del ayuntamiento, indicar plantas más adecuadas, o más fáciles de cuidar a las comunidades y que menos agua gasten... No se.. o dejar que si hay un alcorque vacío y un vecino quiere plantar un árbol le dejen hacerlo..</p>

<p>Es hora de que Madrid vuelva a ser verde.</p>

<p> </p>
";"20/03/2018 11";"84";"77";"7";"0";"10112117198";"6416"
"5413";"PARQUE CALERO";"<p>Desde el incidente horrible del Parque del Retiro, y desde hace una hora, hay una patrulla de ""jardineros"" talando a destajo los árboles del Parque Calero. Esperemos que esten talando con cabeza, porque estan dejando el parque PELADO. Tengan en cuenta que los árboles llevan ahi muchos años, y hacer medidas "" a la desesperada"" y porque no ocurran accidentes como en el Retiro, puede significar que se carguen el Parque de un plumazo solo por hacer una medida oportunista. POR FAVOR, REVISEN LOS PARQUES, PERO CON EQUIPOS ESPECIALISTAS Y NO A LA DESESPERADA</p>
";"27/03/2018 19";"24";"19";"5";"1";"10177378716";"1108"
"5414";"impunidad con la que actúan algunas empresas";"<p>Ante todo quiero felicitar al equipo de gobierno de Ahora Madrid por su buena gestión hasta la fecha a pesar de los inconvenientes presentados.</p>

<p>Mi debate es acerca de empresas que campan a sus anchas por la ciudad de Madrid realizando abusos inmobiliarios en alquileres de habitaciones y pisos compartidos. He interpuesto una denunica por una de ellas por incumplimiento de contrato al no devolver la fianza en tiempo y forma establecido en las clausulas del contrato, seguro que ya sabrán a qué empresa me refiero. Mi propuesta es establecer una empresa municipal de alquiperes en la ciudad, que controle tanto los precios abusivos como el cumplimiento de los contratos.</p>

<p>Gracias por darnos la oportunidad de expresar nuestras inquietudes problemas y por darles solución.</p>
";"28/03/2018 08";"25";"11";"14";"2";"10171608370";"-132"
"5416";"Ordenanza de Conservación, Rehabilitación y Estado Ruinoso de las Edificaciones";"<p>He llamado al 010 por un problema que tengo con mi Comunidad de Propietarios, llevo 2 meses con una gotera y se niegan a repararla. Me ha extrañado la respuesta de la persona que me ha atendido, diciendome que el Ayuntamiento de Madrid no se hace cargo de reclamar estas reparaciones y al decirle que existia una ordenanza, me pide que le indique cual era dicha ordenanza ya que ella no conocia ninguna. Me dice además que el Ayuntamiento solo se hace cargo si es un problema de seguridad.</p>

<p>Le he tenido que explicar la siguiente resolución del defensor del pueblo para que me creyera: https://www.defensordelpueblo.es/resoluciones/los-responsables-de-unas-humedades-incumplen-la-orden-de-subsanarlas/#</p>

<p>Luego me he leido la ordenanza y dice claramente:</p>

<p><strong>Artículo 7. Actuaciones de conservación.</strong></p>

<p>1. Las actuaciones de conservación tendrán por objeto mantener los edificios y construcciones en las condiciones mínimas de:</p>

<p>a) Seguridad para que no implique riesgo para las personas y bienes, por lo que se deberán realizar las obras y trabajos necesarios de afianzamiento, refuerzo o sustitución de elementos dañados de la estructura, cimentación, soportes, vigas, forjados, muros de carga u otros elementos estructurales que comprometan directamente la resistencia mecánica y la estabilidad del edificio. Asimismo, deberán ser reparadas las fachadas (interiores, exteriores y medianeras) y otros elementos cuyo estado suponga un riesgo para la seguridad de las personas, tales como chimeneas, falsos techos, cornisas, salientes, vuelos o elementos ornamentales o de acabado.</p>

<p>b) Salubridad de forma que no atente contra la higiene y la salud pública, por lo que se deberán realizar las obras y trabajos necesarios para que <strong>no se produzcan filtraciones de agua a través de la fachada, cubierta</strong> o del terreno y se deberá mantener en buen estado de funcionamiento las redes generales de fontanería y saneamiento de modo que se garantice su aptitud para el uso a que estén destinadas.</p>

<p> </p>

<p>Me preocupa que las personas que atienden el 010 no esten informadas de esta ordenanza y me preocupa también que tenga que ser el defensor del pueblo el que indique al Ayuntamiento sus obligaciones.</p>
";"04/04/2018 18";"33";"29";"4";"4";"10260066108";"2196"
"5417";"ciudad digital ";"<p>estimados abro el debate, espero sugerencias</p>
";"09/04/2018 19";"21";"12";"9";"2";"10301276542";"171"
"5419";"Leña al Retiro";"<p>Despues del desgraciado acidente de hace poco en el retiro que costo la vida a un niño, el debate ha sido sepultado por el ayuntamiento. Como vivo cerca y me siento directamente afectado por lo que pasa en el parque me gustaria reseñar algunas cosas. El parque se cerro sin previo aviso el dia viernes 26 de mayo por obras o sea preparacion del parque para irse contentos de vacaciones. Al dia siguiente estaba abierto aunque las predicciones decian que habria viento. Si no recuerdo mal en domingo ocurrio el tristisimo acidente de la muerte del niño. Incidente rodeado de sospechas y encubrmientos. Se orden de salida o no? Como y quien la dio y donde? Y el arbol se cae en el sitio donde nunca deberia haberse caido, en la salida de los usuarios del parque y frente a una terraza ( una mas ampliada y masificada , dentro del parque que siempre pense que nadie seria capaz de crear dentro de el parque). Despues de esa muerte de la que alguien seguro que es responsable se cierra el parque por quince dias. Despues se reabre parcialmente y veo que el culpable ha sido el parque... he contado mas de 100 arboles talados. Y no digo que no fuera necesario hacerlo, lo que dico es que esa furia arboricida podria haberse evitado si el mantenimiento del parque hubiera sido correcto, eso hubiera permitido la reposicion en su momento correcto. Alguien no lo hizo o no lo controlo debidamente y ahi deberian buscarse responsables de esta muerte. A la alcaldesa Botella le paso algo parecido y le dieron leña por todos lados solo falto llamarla asesina. Y es verdad que lo hizo mal por eso esta donde esta..por eso y mas cosas. Pero ciñendonos al parque Botella enloquecio tambien con el parque y lo lleno de eventos machacantes para un parque historico , cada domingo y casi cada dia nos levantabamos con  un evento multitudinario .Lo machaco. Vino el nuevo ayuntamiento Carmena y hay que reconocer que corrigio ese dislate y ya no hay ese numerito cada dia de carreras festivales etc. Pero si a ella se le pidio justicia en la plaza publica de forma furibunda , ahora deberiamos preguntarnos y pedir cuantas  a los responsabes de esta desgracia que los hay. Si heredaron un parque en malas condiciones son los responsables de no haber echo lo que debian sanearlo y cuidarlo como debe ser. El Parque del Retiro no es uno mas. Ayer conoci que lo han presentado para  Hacerlo monumento de la humanidad o algo asi. Pues vaya plan..Pero lo principal es que hay culpables de la muerte  de ese niño , y por ser ecuanime del militar que murio hace 4 años aplastado por otro arbol y estan los de ahora donde estan , por ser funcionarios ineficaces que se esconden detras de mil tretas para no reconocer que no son dignos de la confiana que les dimos. Pero deberia acuar la justicia . O no?</p>
";"16/04/2018 13";"34";"24";"10";"4";"10374115086";"988"
"5422";"Todos los domingos hay cortes";"<p>Siempre hay cortes por carreras o múltiples mierda s que afectan al día a dia de los madrileños.</p>

<p>2 horas para un trayecto de 15 minutos hemos tardado hoy en llegar diversas personas al tanatorio de San Isidro. Es una auténtica vergüenza. Mi abuela llegando tarde  gente de 80 años que tiene que venir andando desde Rosales porque ni los autobuses les llevan....</p>

<p>Espero que los elogios de 4 matados que podían dedicarse a correr en otro sitio y no en medio de la ciudad, les compensen connñas críticas que tiene el Ayuntamiento hoy en este tanatorio. Es tema de conversación en muchas salas</p>

<p> </p>
";"22/04/2018 14";"69";"32";"37";"7";"10423592099";"-231"
"5425";"Sanidad centros ambulatorios";"<p>hola mi debate es el siguiente cambias de ambulatorio y en el cambio cambias de médicos te hacen un seguimiento pero de repente se acaba un producto que lo daba la enfermera en concreto prontosan dice que es un producto caro y no tiene más que Esa persona vaya cada viernes hacer una revisión y se duche con agua los siguientes días por que no puede dar el producto en concreto es el centro ambulatorio guayaba es decir que no hay una seguridad social que te puedan dar esos productos para que lo pagamos entre todos </p>
";"25/04/2018 16";"18";"14";"4";"1";"10464726351";"777"
"5427";"Moteros: El Ayuntamiento de Madrid nos Roba ";"<p>Hola Moteros, acabo de crear página ""El ayuntamiento de Madrid nos Roba"" para los afectados de las improcedentes sanciones a las motos argumentando la señal inventada de prohibir aparcar motos en la Gran Vía. </p>

<p>En la Navidad de 2016 a la Señora Carmena la molestan las motos debidamente estacionadas cumpliendo rigurosamente con la actual Ordenanza de Movilidad para la Ciudad de Madrid del 29/09/2005 y decide inventarse una señal que no incorpora en el Catálogo Oficial de la Circulación y Marcas viales según remite el Código de Tráfico y Seguridad Vial en Artículo 55 apartado 1.</p>

<p>La señal inventada no existe entre las publicadas en el TEMA 4: SEÑALIZACIÓN VERTICAL, ni está debidamente colocada según el TEMA 3: SEÑALES DE CIRCULACIÓN Apartado 3: COLOCACIÓN Y DIMENSIONES de la página 43 se dice textualmente Las señales se colocarán de manera que los conductores y usuarios a quienes se dirijan puedan reconocerlas fácilmente del Normas y señales reguladoras de la Circulación de la Dirección General de Tráfico del Ministerio del Interior.</p>

<p>Posteriormente obliga a los Agentes de Movilidad a denunciar a los vehículos que no respeten su ilegal invento y las alegaciones de los recursos de los ciudadanos que estacionan cumpliendo rigurosamente la Ordenanza de Movilidad de la Ciudad de Madrid son desestimadas dejando como única vía la Judicial o esta alternativa de denunciar en Redes Sociales estos abusos y atropellos del Ayuntamiento de Madrid a sus ciudadanos</p>

<p>La página ""El Ayntamiento nos roba"" de Facebook es una página donde los afectados podamos tener un espacio y defendernos del robo recaudatorio de unas denuncias impuestas ilegalmente con una Administración que no atiende nuestros recursos y únicamente nos deja la costosa Vía Judicial Contencioso Administrativa con Tasas y Letrados de costes siempre muy superiores a las sanciones. </p>

<p>Te agradezco tu visita y ""Me gusta"" a la página recién creada que tienes disponible en: https://www.facebook.com/El-Ayuntamiento-de-Madrid-nos-roba-2050025371989681/</p>

<p><strong>DRAE</strong> Diccionario de la Real Academia Española Robar: Acepción 2. Tomar para sí lo ajeno, o<u> hurtar de cualquier modo que sea</u>. Hurtar: Acepción 1.<u> Tomar o retener bienes ajenos contra la voluntad de su dueño, sin intimidación en las personas ni fuerza en las cosas.</u></p>
";"27/04/2018 17";"84";"29";"55";"2";"10472532349";"-897"
"5428";"Tabúes que impiden la civilización";"<p> </p>

<p>Propuesta constructiva, objetivamente libre de ofensividad y orientada a minimizar violaciones.</p>

<p>La información insertada estaba fundamentada y bajo ningun concepto pornográfica.</p>

<p>Posiblemente el término <strong>""Pederastia""</strong> le haya hecho darse por aludido y ha optado por apretar el boton <strong>""eliminar"".</strong></p>

<p>Estamos en la era de la información donde debería predominar la imparcialidad, claro que podría excluirte tu pobre preparación.</p>

<p>Repite el nombre del titulo y encuéntrale sentido. </p>

<p> </p>

<p> </p>

<p> </p>
";"28/04/2018 20";"24";"4";"20";"0";"10486572919";"-266"
"5430";"Control de manteros en Gran Vía";"<p>Entiendo que todo el mundo tenga que ganarse la vida, de una forma y otra, no voy a criticar el fondo si no la forma.</p>

<p>Con las obras de remodelación de Gran Vía se ha visto reducido el espacio de peatones en el lado del edificio de Telefónica (Derecho destino a Plaza España) y en el cruce de Gran Vía a la altura de Montera, se ha reducido pues han hecho un area para vehículos de obras o similar que estrecha bastante el espacio para los peatones.</p>

<p>Pues es ahí donde los manteros se ponen unos frente a PRIMARK, obvio, de ahí sale mucho cliente, y otros a la altura de Montera, pero en ambos casos haciéndo casi imposible el paso a los ciudadanos pues bloquean con sus mantas más de la mitad de las aceras.</p>

<p>No pido que les detengan ni nada por el estilo, pero una patrulla por ahí de vez en cuando no vendría mal para moverles y que facilitaran el paso.</p>
";"02/05/2018 14";"153";"131";"22";"8";"10543622859";"9332"
"5432";"Avenida de Andalucía ";"<p>El estado del asfalto de la Avenida de Andalucía es lamentable y peligroso. En este caso el ayuntamiento debería hacer algo ya sin esperar a la participación ciudadana. </p>
";"08/05/2018 12";"73";"70";"3";"7";"10602995142";"6424"
"5435";"Accesibilidad metro Prosperidad ";"<p>Me gustaría saber por qué aún no es accesible el metro de Posperidad. Desconozco el número de ciudadanos que usamos esta estación de metro a diario, pero sin duda es muy alto. Prosperidad es uno de los barrios con más densidad de población de todo Madrid. Además, las obras no supondrían ningún trastorno para los edificios circundantes al estar ubicada la estación en la misma plaza.</p>

<p>Son muchas las personas que no pueden moverse del barrio por no estar el ascensor instalado.</p>

<p>Gracias.</p>
";"12/05/2018 22";"61";"59";"2";"5";"10646460256";"5513"
"5436";"Cinesa Madrid";"<p>""Eurovisión en pantalla grande""</p>

<p>Aplaudo la iniciativa y ocurrencia de proyectar la gala en los cines. Desconozco la asistencia a otras salas y si será un fracaso comercial, pero al escribiente que acudió a uno de la promoción le regalaron cuatro horas de entretenimiento acompañado de un cubo de palomitas y un litro de refresco a buen precio (5 euros).</p>

<p>Disponer de Auditorios u otros Recintos Municipales para el certamen del 2019 ya no estaría bien debido a que ya es ""Copyright de Cinesa"".</p>

<p>Espabilen y déjense de prejuicios.</p>
";"13/05/2018 12";"62";"12";"50";"0";"10631955909";"-735"
"5437";"Suprimir  impuestos de plusvalia, transmisión patrimonial, herencia y donación";"<p>Se debería suprimir los impuestos de plusvalia, transmisión patrimonial, herencia y donación, por injustos, desiguales y confiscatorios.</p>

<p>Recordemos que la Constitución Española en su articulo 31 dice:</p>

<ol>
	<li>Todos contribuirán al sostenimiento de los gastos públicos de acuerdo con su capacidad económica mediante un sistema tributario justo inspirado en los principios de igualdad y progresividad que, en ningún caso, tendrá alcance confiscatorio. </li>
</ol>

<p>La disminución de recaudación se podrian compensar perfectamente con una modificacion del IBI, cambiando la recaudación en un reparto estatal, autonomico y local. (en vez de sólo local)</p>
";"15/05/2018 21";"211";"182";"29";"14";"10677717235";"13197"
"5438";"Votar en contra de las propuestas";"<p>Buenas tardes,</p>

<p>No entiendo por qué no se puede votar en contra de determinadas propuestas.</p>

<p>No es ni lógico ni democrático.</p>

<p>Por favor, corríjanlo.</p>

<p>Saludos</p>
";"17/05/2018 14";"128";"121";"7";"14";"10695630811";"10776"
"5439";"Controlar el precio de los alquileres";"<p>Es desproporcionado el precio del alquiler en Madrid. Por favor hacer algo. Las socimi se están aprovechando junto con los caseros que solo ven como poder exprimir el piso cada vez más y oprimir a las familias. Ayuda!!!!</p>
";"17/05/2018 22";"315";"281";"34";"8";"10700779407";"22033"
"5440";"Zona de suelta de Perros en el parque de Santander.";"<p>El parque de Santander en la zona de Canal tiene una preciosa zona de paseo y parque infantil que perfectamente puede albergar una zona de suelta de perros, a ser posible más cuidada que un sencillo corral con arena, para que toda la familia, incluidos los cuadrúpedos, puedan aprovechar el paseo. </p>
";"18/05/2018 06";"60";"28";"32";"0";"10680054542";"-186"
"5442";"Tasa por contaminación";"<p>Cada vehículo que se mueve por Madrid deberá pagar una tasa de mínimo 2 euros por dia.</p>
";"18/05/2018 14";"119";"34";"85";"4";"10681043557";"-1457"
"5443";"Vía verde de la Gasolina. Un proyecto de 30 años sin finalizar ";"<p>En mi barrio teníamos un sueño: convertir una antigua vía de tren en un precioso pasillos verde. Después de 30 años de espera, se hizo pero, justo el tramo frente a mi terraza se quedó sin terminar y lo que es peor, me colocaron un parking al aire  justo pegado al edificio.  De verdad que la paciencia de los vecinos no tiene límites y es indignante que por falta de negociación entre Adif y el Ayuntamiento todavía estemos así y sin visos de solucionar. Un water de perros,  eso es en lo que se ha convertido el tramo de Joaquín Ibarra. Yo pido desde este foro que desbloqeen de una vez este tema que ya vale, que no es por dinero es porque a nadie le importa, es dejadez.</p>
";"18/05/2018 17";"50";"44";"6";"0";"10701255171";"3344"
"5445";"NO a la libertad de horarios comerciales";"<p>Es horrible que en Madrid se abra el comercio de lunes a domingo y hasta las diez de la noche. </p>

<p>Me dan pena las personas que trabajan en estos comercios y esto hace ver que la ciudad no descansa... </p>

<p>Cuando viajo y hay ciudades que tienen otro horario respetando los descansos, las ciudades se disfrutan más. </p>

<p>Pienso que realmente estos horarios tan amplios perjudican gravemente al pequeño comercio (todas las tiendas de barrio cierran porque no pueden soportar la competencia que esto les genera) y sólo benefician a grandes superficies y las tiendas de chinos.</p>

<p>¿Realmente necesitamos un horario tan amplio? </p>

<p>Bajo mi punto de vista NO.</p>
";"20/05/2018 10";"166";"83";"83";"16";"10706939285";"0"
"5446";"Propuestas duplicadas en los presupuestos participativos";"<p>Me sorprende encontrar propuestas duplicadas o muy similares, y con presupuestos igualmente muy similares o idénticos entre las que han pasado a la fase de votación de los presupuestos participativos. Ejemplos:</p>

<p>- ""Plantar árboles en alcorques vacíos"" (10.1 M) y ""Por una ciudad más verde y limpia: plan integral de arbolado y zonas verdes"" (9 M), ambas para toda la ciudad.</p>

<p>- ""Asfaltado y baches de Madrid"" (9 M) y ""Asfaltado calles en mal estado"" (9 M), igualmente, para toda la ciudad.</p>

<p>Hay muchos más, pero cito estos dos por lo obvio que me resulta a simple vista -¡basta con ordenarlos por coste para que aparezcan en la misma página!- y la incongruencia que supone, ya que uno, al votar por una de esas dos opciones, pierde la parte correspondiente del presupuesto, no sabiendo bien si debería votar por ambas, por asegurarse de que alguna de ellas resulte vencedora y así el objetivo final de las mismas, perdiendo así la posibilidad de destinar parte de su presupuesto a otras opciones también interesantes, o si debería diluír su presupuesto entre un mayor número de propuestas.</p>

<p>Supone ello además que otras propuestas hayan podido quedar fuera de las que han pasado a la fase final de votación en favor de otras que sean esencialmente iguales.</p>

<p>Puedo entender que resulte imposible eliminar la totalidad de las posibles duplicidades, bien porque pueda haber diferencias de matices entre unas y otras, o bien porque el número de propuestas presentadas resulte tan grande que no sea fácil identificar todas aquellas que se parezcan entre sí, pero me parece que hay ejemplos muy obvios como los que cito que me hacen dudar mucho del proceso y de la diligencia del mismo. Me gustaría que desde ""Decide Madrid"" se aclarase cómo se ha llevado a cabo.</p>

<p> </p>
";"21/05/2018 12";"113";"111";"2";"8";"10735308482";"10707"
"5447";"Protecciones en puentes Madrid Rio";"<p>Estimados/as;</p>

<p>Me gustaría proponer a debate la inicitiva popular de instalar protecciones en los puentes de Madrid Rio.</p>

<p>Es una propuesta que me parece interesante, ya que estas ubicaciones son clave para ciudadanos y turistas por su gran transito peatonal. </p>

<p>Los muros en la zona peatonal son demasiado bajos y pueden propìciar caidas de forma involuntaria. Seguramente exista alguna manera de realizar este proyecto sin agredir la arquitectura de los mismos.</p>

<p>Podeis ver fotos en </p>

<p>http://www.madrid.es/portales/munimadrid/es/Inicio/Vivienda-y-urbanismo/Urbanismo/Madrid-Rio?vgnextfmt=default&amp;vgnextoid=5acc7f0917afc110VgnVCM2000000c205a0aRCRD&amp;vgnextchannel=2af331d3b28fe410VgnVCM1000000b205a0aRCRD&amp;idCapitulo=5966080</p>
";"21/05/2018 13";"40";"26";"14";"3";"10722773671";"780"
"5450";"¿Se debería impedir modificar una propuesta una vez haya recibido apoyos?";"<p>¿Creéis que se debería impedir modificar las propuestas una vez se hayan apoyado al menos una vez? Porque si apoyamos una propuesta y luego el autor cambia su contenido igual terminamos apoyando cosas contrarias a lo que pensamos.</p>
";"28/05/2018 10";"66";"58";"8";"7";"10799661997";"4393"
"5451";"Esta pagina web es muy incómoda de uso";"<p>No he conocido nunca una página web con mas pega y problemas de uso.</p>
";"28/05/2018 11";"82";"27";"55";"2";"10779944368";"-921"
"5452";"empleo y vivienda en la Comunidad de Madrid";"<p>¿Cuál debería de ser la política de empleo y de vivienda en la Comunidad de Madrid?</p>

<p>Ya que el paro no baja deberían de garantizar una ayuda de 400 euros para todos los desempleados que no cobren prestación independientemente de sus circunstancias familiares, y no como ahora que solo dan subsidio a familias con cargas familiares. Es lícito porque lo dice la ley suprema que es la constitución: todos los españoles tienen derecho al trabajo y a disfrutar de una vivienda digna.</p>

<p>Para que no se desvíe de su propósito y se abuse esta medida se debería de complementar con una política de inmigración que controlara la llegada de inmigrantes atraidos por el efecto llamada.</p>

<p>En el tema de la vivienda ya renunciamos a la posibilidad de tener una vivienda en propiedad, como era hábito antes de la crisis, sino que hablamos del alquiler social con rentas de 200 euros mensuales. Esto disuade las nuevas ocupaciones. </p>

<p>Ya que existe un parque de viviendas vacías en Madrid que sus propietarios retienen para que suban los precios y obtener el máximo beneficio posible no sería, en principio, necesario la promoción y construcción de nuevas viviendas. Se facilitarían estas viviendas a los desempleados en alquiler social con ayudas estatales para los propietarios.</p>

<p>Se podría además regular una normativa que actúe de forma integral y que permita intervenir a la guardia civil en los desahucios de aquellos inquilinos que destrocen las viviendas mandando a estas personas a los servicios de asistencia social o eventualmente a la cárcel si cometieran actividades delictivas. Establecer una demora máxima en el pago del alquiler de 5 meses y en caso de incumplimiento se les deshauciarían y del mismo modo anterior se derivarían a la asistencia social. Esto daría seguridad jurídica a ambas partes.</p>

<p>Estas medidas me parecen que se ajustan a la realidad en que vivimos, no vulneran las leyes y son proporcionadas.</p>
";"31/05/2018 21";"44";"32";"12";"4";"10828651310";"1454"
"5454";"""¡Los técnicos que mataron a Supertramp!""";"<p>Estos debates, ¿merecían ser eliminados?</p>

<ul>
	<li>La ley del Talión (posiblemente necesario)</li>
	<li>L@ muñec@s sexuales (totalmente necesario)</li>
	<li>Eutanasia (la podrías necesitar)</li>
</ul>

<p>""Donde no hay justicia es un peligro tener razón"" Quevedo.</p>

<p>Y por si os parecía violento: ""La vida es muy peligrosa; no por las personas que hacen el mal, sino por las que se sientan a ver lo que pasa"" Einstein</p>
";"10/06/2018 13";"24";"5";"19";"0";"10913402952";"-291"
"5455";"Piscina de San blas más segura";"<p>Buenos días: Hace unos meses que en el polideportivo de san blas están haciendo mejoras.  Espero de todo corazón que también cambien los muros de acceso y aumente la seguridad en todo el recinto. Sin acceso a gente que no paga,  que no cumple las normas y que atemorice a los que entran pagando.  Es una pena no poder disfrutar del barrio por falta de civismo y seguridad. </p>
";"13/06/2018 08";"48";"44";"4";"1";"10958227364";"3666"
"5456";"Irrespirable Madrid";"<p>Sufrimos una contaminación desmesurada y creo que deberian tomarse medidas urgentes, no todo es por el trafico rodado, tambien influyen las industrias, los chemtrails, la cantidad de pesticidas que se usan etc etc, para mi Madrid se ha vuelto irrespirable.</p>
";"13/06/2018 08";"147";"141";"6";"13";"10964223345";"12948"
"5457";"bono metro madrid";"<p>El sistema actual de bono metro de Madrid no tiene sentido, debería ser un bono de regarga por dinero y no por bonos y nos evitariamos precisamente como dice Pedro Duque, nuestro actual ministro de ciencias el tener que recargar en el aereopuerto un suplemento, no por ser de recarga por dinero quiera decir que tenga que ser más caro si no que si se mantiene una recarga x constante pues cada billete de metro vendría con descuento o si no se mantiene esa recarga x pues a precio normal, creo que podría ser tan sencillo como eso.</p>
";"13/06/2018 11";"84";"77";"7";"3";"10961646589";"6416"
"5458";"Educar a los usuarios de transporte público";"<p>Ya hay pegatinas en el Metro de Madrid enseñando a la gente a comportarse de manera cívica y respetuosa con los demás. Todavía no ha calado mucho, porque sigo viendo actitudes muy desagradables, como hurgarse la nariz y pegar los restos biológicos en las barras de agarrarse. ¿Cómo se puede concienciar al personal de que esa conducta es repugnante?</p>
";"13/06/2018 19";"92";"88";"4";"14";"10966511215";"8034"
"5459";"Fuencarral";"<p>Porque lo llamn Fuencarral- El Pardo, en Fuencsrral no se realizan ningun tipo de mrjoras, calles llenas de suciedad, ba basura, aceras destrozadas, , un pño  parque infantil, en una mal llamada zo a peatonal, ( donde cirvula scooters , coches , camik es,etc. desde que llegue a Fuencarral he ido viviendo un deterriodo en crecimiento, no hay mas que ver los presupuestos para el distrito, alucinas con las obras que hay en proyecto para Fuencarral pueblo</p>
";"13/06/2018 19";"22";"17";"5";"2";"10956806762";"927"
"5461";"STREET WORK PARQUE CALERO";"<p>Desde que el Ayuntamiento ha decidido poner el espacio para que la gente entrene en la calle, a partir de las 20 h se llena de especimenes con reproductores de musica rap a todo volumen, y molestan a todos los vecinos, ademas, son intimidantes.</p>

<p>Recordemos que los parques publicos no son patrimonio de los raperos, están los mayores, los niños y la gente que pasea a sus perros.</p>

<p>Esta gente no tiene otros lugares para su diversion que no sea un espacio publico?</p>

<p>Regulacion de los ruidos y el botellon YA</p>
";"14/06/2018 21";"45";"29";"16";"1";"10966258097";"837"
"5462";"Inseguridad y decadencia del puente de Vallecas";"<p>Quiero mostrar mi indignación con respecto a la gestión de esta localidad. He vivido en esa zona durante casi 5 años y me considero una persona culta y educada. Creo que es una zona con muchísimo potencial ya que está cerca de la zona centro, hay muchas casas bajas y se están reformando muchos edificios antiguos, pero la inseguridad, suciedad, y poco civismo de la gente me ha obligado a salir de esa zona. Hay narcopisos por toda la zona, todo el mundo los conoce porque ven entrar y salir a los toxicómanos, la policia secreta los conoce, pero dicen que no pueden hacer nada hasta que no lo dicte un juez... Tan difícil es, de verdad? Creo que es necesaria una limpieza de esta zona ya.  Se está conviertiendo en un guetto cuando podría ser una zona maravillosa. Mi indignación es contra este siste¡ma judicial, lento e inefectivo cuando se trata de zonas menos favorecidas, seguro que si hubiese ""narcopisos"" en la zona de la calle Serrano, al día siguiente estaban desmantelados,  me apuesto  mi oeja izquierda....esto es igualdad ante la justicia????</p>
";"17/06/2018 09";"69";"62";"7";"4";"10999822972";"4942"
"5466";"¿Calle de la Gran Vía o Gran Vía de Madrid?";"<p>¿Calle de la Gran Vía o Gran Vía de Madrid? <strong>¿Es correcto y lógico que una calle se llame calle de la Gran Calle?</strong> ya que Gran Vía es lo mismo que gran calle. A mí me parece una <u>redundancia absurda</u>. Creo que sería más lógico y bonito que sólo se llamase GRAN VÍA ó GRAN VÍA DE MADRID. </p>
";"20/06/2018 11";"48";"35";"13";"7";"11024821839";"1604"
"5467";"¿Quién fue Serrano y por qué tiene una calle importante?";"<p>¿Quién fue Serrano? Es posible que mucha gente no sepa quien fue...y tiene una calle importante. No estaría mal poner en las calles de madrid unas placas elegantes y discretas en algunos puntos de las calles, como las cuatro esquinas del principio y el final, que expliquen (de manera objetiva y sin exagerar las tendencias políticas) quien fue el personaje que da nombre a la calle y en que época vivió. Ejemplo para la calle Serrano. placa que ponga </p>

<p><em>Francisco Serrano y Domínguez (San Fernando, 17 de diciembre de 1810-Madrid, 25 de noviembre de 1885), duque de la Torre y conde consorte de San Antonio, fue un militar y político español que ocupó los puestos de regente, presidente del Consejo de Ministros y último presidente del Poder Ejecutivo de la Primera República Española. </em></p>

<p>Y a lo mejor hasta poniéndo un retratro que ponga cara a la persona...</p>

<p>Creo que daría un toque cultural a las calles y ayudaría a que la gente mejore sus conocimientos de Historia. </p>
";"20/06/2018 11";"81";"76";"5";"5";"11032231563";"6661"
"5468";"Carsharing como soluición a (casi) todos los problemas de movilidad de Madrid";"<p>Buenos días, </p>

<p>Después de leer la mayoría de debates acerca de los problemas de movilidad de Madrid que hay en esta web, pregunto: ¿No es el 'carsharing' y sus derivados como BiciMad y similares la solución a prácticamente todos ellos? Obviamente en conjunción con un magnífico (aunque en algunos puntos mejorable) sistema de transporte público como el que funciona en Madrid. Por partes:</p>

<p>- Aparcamiento: Aumentando el número y ámbito de funcionamiento del carsharing hasta la totalidad de los distritos hasta la M40, la gente empezaría a plantearse el comprar un coche, ya que para la mayoría de desplazamientos cotidianos, contará con diferentes empresas que le ofrecen vehículos que utilizar. Esto reducirá el parque móvil y hará que haya más plazas libres, optimizando el espacio.</p>

<p>- Ruido: Estos vehículos son, en la mayoría de empresas, eléctricos, por lo que el ruido se vería reducido significativamente. Solo compañías que ofrecen coches de alquiler para largo recorridos (se me ocurre bluemove, seguro que hay alguna más) ofrece vehículos de combustión, pero ya es una mejora muy grande.</p>

<p>- Contaminación: En línea con los dos puntos anteriores: menos coches y siendo la mayoría eléctricos, igual a menos contaminación. Más plazas de aparcamiento, igual a menos vueltas para aparcar, lo que es igual a menos contaminación.</p>

<p>Para desplazamientos más largos, como indico, contamos con otras empresas especializadas, y, con el ahorro de no tener un coche en propiedad y todos los gastos que conlleva, sería rentable alquilar para casos puntuales.</p>

<p>Esto no tiene que funcionar para el 100% de la población, cada uno tenemos nuestras circunstancias, pero creo que mejoraría mucho la situación solo el hecho de extender el funcionamiento de estos servicios al resto de distritos.</p>

<p>Entiendo que son empresas privadas, pero quizá con los incentivos adecuados se podría acabar en gran medida con el ruido, la contaminación y los problemas de movilidad.</p>

<p> </p>

<p>Un saludo</p>

<p> </p>

<p> </p>
";"20/06/2018 12";"52";"42";"10";"5";"11027672792";"2584"
"5469";"Limpieza del Barrio Arcos";"<p>Buenos días, me gustaría saber porque en el barrio de Arcos, exactamente desde el número 36 de la calle Arcos de Jalón con Amporta hasta el número 110 no hay limpieza de los jardines exteriores ni riegos, tampoco hay mantenimiento de los árboles ni limpieza en sus calles interiores es de vergüenza que haya esta discriminación entre barrios ya que parece que sólo pagan sus impuestos los vecinos del barrio de la Rosas.</p>

<p>Creo que deberían de pasarse los representantes de Medio Ambiente, para que vieran la suciedad que hay. Y los problemas de plagas de cucarachas y otros insectos que ello conlleva.</p>

<p>Se debería de mirar un poco más por los barrios más antiguos.</p>

<p>Muchas gracias</p>

<p>Un saludo</p>

<p> </p>
";"22/06/2018 10";"19";"19";"0";"1";"11047132377";"1900"
"5470";"Solar del antiguo mercado de Puerta Bonita";"<p>¿Qué ha pasado con el proyecto aprobado del espacio multiusos?</p>

<p>Los vecinos y comerciantes esperamos con escepticismo que algún día comiencen a construirlo</p>
";"26/06/2018 13";"18";"17";"1";"1";"11086882909";"1511"
"5471";"Metro 24 horas los fines de semana";"<p>Me dirijo a ustedes porque me gustaría proponer la apertura del metro las 24 horas los fines de semana, como capital de España deberiamos de dar ejemplo ( otras ciudades de provincia lo tienen)</p>

<p>Un saludo y espero que mi propuesta sea admitida</p>

<p>Marta </p>
";"27/06/2018 18";"174";"164";"10";"7";"11108561707";"14514"
"5472";"pasos de peatones inexistentes o mal colocados";"<p>En la calle Camilo José Cela esquina a calle Antonia Ruiz Soro, falta un paso de peatones y dada la proximidad al colegio de la Guindalera va a haber un accidentre porque las personas, las que pueden pasar, lo hacen entre los coches. No está situado adecuadamentre el paso de peatones de c/ Cartagena con calles Ferrer del Rio y Marqués de Ahumada, y la gente pasa intentando coordinarse con el semáforo, pero existe un riesgo e atropello. La policía me da la razón y dice que ha dado parte al Ayuntamiento, pero este pasa olímpicamente. En fin, mucho internet y poco cumplimiento de la seguridad ciudadana.</p>

<p>Por cierto, las anotaciones existentres al margen son bastante estúpidas porque tratan de pastorearnos y considerarnos estúpidos.</p>
";"27/06/2018 21";"30";"27";"3";"0";"11101239898";"2160"
"5473";"Obligar a los dueños de perros a verter una botellita de agua sobre los orines";"<p>En otras ciudades  como Castellón o Alcobendas ya es obligatorio: verter una botella de agua sobre el orín del perro para que no huela. Los perros orinan sobre las esquinas de las calles dos o tres veces cada día. Hay decenas y decenas de perros haciéndolo cada día en cada esquina, siendo centenares cada semana. Que se acumulan si no se vadea la calle. En invierno, con las lluvias se soporta mejor, pero en verano es asqueroso ir por la calle y ver centenares de orines que se acumulan, que con el calor es totalmente insoportable</p>
";"27/06/2018 23";"135";"110";"25";"9";"11105450722";"6925"
"5474";"¿Es realmente necesario reasfaltar Madrid Rio?";"<p>En las primeras semanas de la canícula sobre la capital los madrileños estamos asistiendo a el levantamiento de los víales de Madrid Rio para realizar su reasfaltado, desde el cruce inferior sobre la A-42 hasta casi el Puente de Segovia, orilla izquierda del rio dirección norte. Cual es la finalidad de dicha reforma teniendo en cuenta que la zona a la que nos referimos lleva menos de diez años abierto al públiclo y el único tráfico rodado que soporta es el de los vehículos de mantenimiento del ayuntamiento. </p>

<p>Es cierto que el uso de este magnifico espacio conlleva un desgaste y con el paso del tiempo habían aparecido algunas grietas que no suponían peligro alguno ni para viandantes ni ciclistas. ¿Esta justificada la magnitud de dicha reforma más aún cuando hay barrios que llevan sin recibir ni una mejora en sus calles desde hace años? ¿Cuáles son las prioridades del consistorio? ¿Continuaremos los vecinos que vivimos fuera de la M-30 olvidados por nuestros representantes? </p>

<p>Espero y deseo que algún responsable del Gobierno Municipal respondiera a estas preguntas. </p>
";"29/06/2018 12";"31";"26";"5";"22";"11117296006";"1761"
"5475";"Sancionen a las empresas que pegan carteles ilegalmente en nuestras calles.";"<p>Según el articulo 2 de la ""Ordenanza Reguladora de la Publicidad Exterior"" (ANM 2009\2) del Ayuntamiento de Madrid. Resulta evidente que el ayuntamiento no esta cumpliendo esta ordenanza, ya que en algunos barrios nos vemos totalmente inundad@s por esta practica, literalmente empapelan nuestras calles (farolas, señales de trafico, paradas de autobus, fachadas de edificios, hasta en la entrada de los portales e incluso en arboles), lo cual supone un deterioro significativo del paisaje urbano. Mas grave si cabe, son algunos barrios que estan sufriendo procesos de gentrificación, donde empresas inmobiliarias estan desplegando grandes campañas de pega de carteles ilegales buscando vendedores de pisos. En un tramo de cien metros te pueden pegar tranquilamente 50 carteles o más, y si algún vecino se toma el trabajo de retirarlos, al dia siguiente te vuelven a empapelar la calle y te ponen mas carteles si cabe, y de forma mas agresiva. Esta claro que estas empresas tienen un gran sentido de impunidad y tal agresiva actividad puede causar incluso una sensación de acoso a personas que viven en esos barrios de alquiler. En definitiva, no estoy pidiendo nada especial, solo que se aplique la ley, valdria que le asignaran a algunos policias municipales (de vez en cuando) que levantaran acta de estas infracciones, fotito a la publicidad puesta ilegalmente y que el ayuntamiento aplique las sanciones administrativas previstas en la ley. Eso no solo mejoraria nuestros barrios y paisaje urbano, ademas con coste cero podria ser una fuente de ingresos interesante para el ayuntamiento mientras no se acabe de resolver este problema.  </p>
";"29/06/2018 18";"76";"76";"0";"8";"11126713088";"7600"
"5476";"Aceras de al menos 1 metro de ancho";"<p>Andar por el centro de Madrid, así como por muchos de sus barrios es imposible ya que en muchas calles las aceras no sobrepasan los 40 - 50 centimetros de ancho que encima son ocupadas por los cubos de basura. Estas calles son intransitables para personas en silla de ruedas o padres con el carrito del bebe. El resto de persona tenemos que andar en fila india, pero sí que hay sitio para que los coches aparquen en la calle. ¿No debería priorizarse a los peatones? En otras regiones como es el caso de Castilla y León hay una ley que exige un mínimo de metro y medio en las aceras, y en aquellas que no había espacio se han quitado los coches y punto, o se han creado parkings para estos vehículos. No estoy en contra de los coches, pero sí que se priorice el espacio para el peatón ya que aceras de 50 centímetros son indignantes e intransitables</p>
";"30/06/2018 14";"48";"40";"8";"4";"11128844733";"2666"
"5477";"Limitar el número de perros en Madrid por el excesivo número de orines ";"<p>Actualmente en Madrid, según datos del Ayuntamiento en 2017, hay 281.339 perros censados, que producen cada uno tres orines diarios en las vías públicas. Estamos hablando de 5.900.000 meados a la semana, y más de 23.000.000 de orines al mes. Y todos sabemos que la gran mayoría de perros no orinan en árboles o parques si no que van orinando por cada farola y fachada de edificios que encuentran a su paso. ¿No debería limitarse el número de perros por mera salud pública? ¿Habéis pensado qué pasaría si cada madrileño tuviera un animal en casa? Sería totalmente insostenible e insalubre como está sucediendo ahora. Por favor, da asco andar por Madrid, tiene que haber un control de perros.  </p>

<p>(Y que nadie diga que las personas también mean los sabados por la noche, que sí, también estoy de acuerdo que debería controlarse más eso, pero estoy generando un debate sobre los perros en concreto con cifras concretas para abrir los ojos de excesivo número de perros que hay en Madrid)</p>
";"30/06/2018 14";"85";"46";"39";"13";"11121664591";"378"
"5478";"Acondicionamiento del barrio de Opañel (Cód. de la propuesta: MAD-2018-06-2316)";"<p>Me conozco la zona como la palma de la mano. Por eso puedo y debo decir que todo lo que dices es totalmente cierto y al <strong>100%</strong>, aunque te ha faltado incluir otras cosas más que también son partes del problema: las paredes de las fachadas de los edificios y la mayoría de los bancos públicos están pintarrajeados por grafiteros (vandalismo urbano, se llama), las farolas y los postes de señalización y de semáforos están empapelados con publicidad barata, etc.</p>

<p>Ahora bien, si piensas y crees -como dices- que haciendo solamente una limpieza municipal y más pedagogía cívica se resuelven todos estos problemas... te equivocas de cabo a rabo. Todos estos problemas persistirán y continuarán por mucha limpieza que se haga y por mucha pedagogía que se practique... si no van acompañadas de otras medidas adicionales. Por ejemplo:</p>

<p>a) <strong>Campañas mediáticas municipales</strong> peródicas, dirigidas a concienciar y sensibilizar a la gente (hasta los autobuses y el Metro pueden utilizarse para colocar ""spots"" y ""slogans"" de difusión dentro de estas ampañas).</p>

<p>b) <strong>Medidas coercitivas y sancionadoras ejemplares</strong> (y por lo tanto disuasorias). Y en los casos de insolvencia... prestación de servicios sociales sustitutorios (a limpiar las calles una temporada). Y si no los realizan.... a la cárcel. Asi de claro.</p>

<p>c) <strong>Instalación de cámaras de vigilancia</strong> e implantación de un <strong>sistema de denuncias anónimas</strong> que permitan identificar a los autores y demostrar los hechos con pruebas y testigos (anónimos y protegidos, por supuesto).</p>

<p>Creo que implementando todas ellas: campañas de difusión, mayor limpieza, pedagogía, vigilancia o videovigilancia, denuncias anónimas y sanciones ejemplares y disuasorias... los problemas estarían resueltos (o por lo menos su impacto se reduciría en un <strong>80%</strong>). ¿Tú que opinas?</p>
";"30/06/2018 15";"16";"16";"0";"0";"11128297744";"1600"
"5479";"Eliminar Impuesto de la Vivienda (IBI) a las casas no contaminantes o eléctricas";"<p>Si queremos una ciudad sin humos debería premiarse y potenciarse que las viviendas no contaminen ni emitan gases a la ciudad. Debería ealizarse un plan integral para que las viviendas sean eléctricas, y no quemen gas ni gasóleo para la calefacción. Deberia premiarse a las viviendas que sean eléctricas suprimiendose el Impuesto de la Vivienda (IBI) para premiarlas y potenciar nuevas viviendas no contaminantes</p>
";"02/07/2018 15";"37";"23";"14";"12";"11143249978";"559"
"5480";"Muebles viejos continuamente en calle Sánchez Preciado";"<p>En la calle Sánchez Preciado, distrito 28039, a la altura del número 55 es indecente la costumbre que han cogido de tirar todos los muebles viejos ahí, al lado de los contenedores. Continuamente hay que estar llamando para que lo retiren porque, además, del malísimo efecto y de que las calles no están para eso, hay justamente un transformador de luz que añade un peligro. Deberían acotar la zona de alguna manera, multar severamente a quién hace esto, que son muchos y recordar que para eso están los puntos limpios, lo mismo que existe un número de teléfono al que se llama y te dan tu hora de tirar el mueble viejo y que te lo recojan. Es bastante desagradable asomarte a tu terraza, pasear por la calle o traer visitas y que la panorámica sea un estercolero de maderas, colchones, rieles, en fín...que han cogido la costumbre de vaciar sus casas ahí.</p>

<p> </p>
";"04/07/2018 12";"13";"12";"1";"2";"11164809955";"1015"
"5481";"Tenemos diesel, Y?";"<p>Entiendo y comparto la idea de poner limitaciones y dar solucion a la contaminación, no a la forma.</p>

<p>1º no subir impuestos por tener un diesel, lo que hay es que prohibir su venta, y desde ya, sin miramiento, no se puede continuar vendiendo un coche y luego inflar a sus propietarios a impuestos y restrinciones.(opservación: la mayoria de los vehiculos comerciales y taxis, son diesel)</p>

<p>2º si te gasta mas de 50 en pasar la ITV todos los años y te dan acto para circular, a que viene ahora decrite que no puedes circular por cierta zonas, que sobra ¿la ITV o la prohibición?. (choca, ¿Verdad?)</p>

<p>3º si el dueño de un diesel que vive en zona restrigida puede usar indistitamente su zona como el resto de madrid, los que viven ejemplo vallecas, y no pueden ir al centro en coche, al usar un procentaje ""X%"" se tendra que hacer un descuento equivalente al ""X%"" en el impuesto que religiosamente pagamos anualmente conocido como el ""númerito""</p>
";"12/07/2018 10";"21";"16";"5";"8";"11242768300";"838"
"5482";"Asfaltado en Madrid Río ""ISLA DE CALOR""";"<p>Queria abrir debate sobre el asfaltado del víal/carril para peatones y bicicletas realizado en Madrid Río. Bajo mi humilde opinión creo que asfáltar con aglomerado asfáltico en color negro es un error muy grande. Ayer por la tarde fui a pasear/correr por dicho vial y debido a la absorción solar tiene una emisividad de calor brutal que se acentua en zonas soleadas y se atenua en zonas de sombra, provocando un isla de calor paralela al margen del río manzanares, bastante molesta para los usuarios del parque. Es incomprensible que zonas verdes que sirve para atenuar el calor de las urbes, se sigan instalando materiales con gran absorción solar en vez de poner materiales de colores claros que sean mas reflectantes y contribuyan a un ambiente mas fresco. Resumiendo hemos perdido confort y calidad de vida en Madrid Río.</p>

<p>Procedan a aplicar un slurry de calidad y de color acorde a lo comentado.</p>

<p>Saludos</p>
";"12/07/2018 13";"31";"26";"5";"12";"11247215702";"1761"
"5483";"El Ayuntamiento promueve el ruido mientras hace creer que lucha contra él.";"<p><em><strong>""El Ayuntamiento de Madrid inicia una campaña contra el ruido nocturno con mediadores en la calle""   </strong></em>http://www.elmundo.es/madrid/2018/06/06/5b18098ee5fdea02448b464f.html</p>

<p>Esta noticia, si fuera cierto que el ayuntamiento está contra el ruido, debería ser muy aplaudida. Pero es un ejercicio de hipocresía total.  Por qué?  Pues porque por una parte<strong> el ayuntamiento dice estar contra el ruido y por otra promueve y autoriza el montaje de escenarios estruendosos en lugares cercanos a vecindarios c</strong>omo la Puerta del Sol, el barrio de Chueca, etc.  Y lo peor, es que esos escenarios son una fuente de c<strong>ontaminación acústica muy agresiva, con altísimos decibelios y hasta altas horas de la madrugada, i</strong>mpidiendo el descanso de los vecinos <strong>y saltándose su propia normativa contra el ruido</strong>.</p>

<p>Me pregunto con qué cara el ayuntamiento quiere presentar la cara amable de parecer que ""<em>hace algo contra el ruido"" </em>mientras que con la otra le <strong>da barra libre a los nefastos ""empresarios de la noche"" </strong>para que cometan todo tipo de tropelías y agresiones contra la salud de los vecinos y residentes de las zonas afectadas.</p>

<p>Según parece, para el Ayuntamiento y la Comunidad de Madrid es muchísimo más importante favorecer la ""diversión"" causando molestias, ruidos, bloqueando accesos a tu propio barrio y favorecer intereses lucrativos de un lobby de empresarios nocturnos se haga de oro a costa de machacar la salud de sus ciudadanos.  Por lo visto, ahora los Derechos Humanos han cambiado:  el derecho a la salud está por debajo del supuesto ""derecho"" a armar jaleo y poner todo a mil decibelios y que los especuladores del ocio nocturno se hagan de oro.</p>

<p>Conozco gente, vecinos que durante las fiestas MADO-2018  han huído de sus viviendas a otros lugares para poder vivir tranquilos. El ayuntamiento, que dice estar contra la ""gentrificación"", provoca la misma gentrificación con su política a favor del ruido.  </p>

<p>Esta política ruidosa se ha hecho en 2017 y se ha vuelto a repetir en 2018.  </p>

<p><em><strong>""Los vecinos de Chueca denuncian la 'barra libre' de ruido en las fiestas del Orgullo en Madrid"" </strong></em>: http://www.elmundo.es/madrid/2018/06/30/5b37c3f322601d9e608b4586.html</p>

<p>https://www.elconfidencial.com/espana/madrid/2016-06-07/orgullo-gay-pregon-ilegal-multas-chueca-carmena_1212577/</p>

<p><em><strong>""Nos expulsan de nuestro barrio"" :</strong></em>  https://www.abc.es/espana/madrid/abci-ruido-y-restricciones-orgullo-hartan-vecinos-expulsan-nuestro-barrio-201807040434_noticia.html   </p>

<p>Y antes que algún desinformado vuelque sus prejuicios en algún comentario, ya les advierto que ésto no tiene nada que ver ni contra la orientación sexual de nadie, ni contra la tendencia política de nadie. <strong> Este debate es contra el ruido, y nada más.</strong>  Quien quiera ver otros fantasmas, es problema suyo y estará volcando sus propios prejuicios.</p>
";"14/07/2018 14";"19";"16";"3";"2";"11265639622";"1094"
"5484";"CIRCULACION VEHICULOS ELECTRICOS POR APR";"<p>LA OFERTA CADA DÍA MAS AMPLIA DE VEHÍCULOS ELECTRICOS COMPARTIDOS, TIPO CAR2GO, ZYTI, EMOV.... ESTÁ MUY BIEN Y PARECE SER QUE PRETENDE EVITAR LA GRAN CONTAMINACIÓN CON VEHÍCULOS DIESEL Y GASOLINA PRIVADOS. PERO EL PROBLEMA ES QUE DEBERÍA HABILITARSE POR LA ALMENDRA CENTRAL O LA ZONA APR, APARCAMIENTOS ZONA AZUL/VERDE Y PARKING, EXCLUSIVAMENTE PARA ESTOS VEHICULOS. ES IMPOSIBLE NI DEJARLOS NI COGERLOS POR ESTA ZONA. IGUALMENTE, DEBERÍA HABER APARCAMIENTOS DISUASORIOS POR LA PERIFERIA PARA DEJAR LOS COCHES PRIVADOS Y COGER ESTOS VEHÍCULOS.</p>

<p>ESTO FACILITARÍA MUCHO MAS EL USO DE ESTOS VEHÍCULOS EN UNA CIUDAD TAN GRANDE COMO MADRID. SI SE PROHIBE ENTRAR Y APARCAR EN LA APR A LOS NO-RESIDENTES, LAS ZONAS VERDES Y AZULES DEBERÍAN SER PARA ESTOS COCHES ELECTRICOS.</p>
";"14/07/2018 18";"18";"15";"3";"4";"11266938651";"1000"
"5485";"Sobre el Open Tenis";"<p>He escuchado que el ""dueño y amo"" del Open Tenis pide ampliar el chiringuito y que dicha ampliación la pague el Ayto.</p>

<p>Al parecer, el Ayto esta de acuerdo, pero...</p>

<p>Esté o no esté de acuerdo, creo que lo que procede es que se haga un Referendum Ciudadano para saber si los que tenemos que pagar la fiesta (los ciudadanos), estamos de acuerdo o no (sobre todo, sabiendo que son no se cuantos chorrocientos de millones de euros).</p>

<p>Luego, si la mayoría de los que vamos a pagar la ""inversión"" estamos de acuerdo, pues que la lleven al Pleno y que ahí cada Partido vote lo que considere oportuno (aunque deberían respetar la decisión de la mayoría de los ciudadanos), pero, desde mi punto de vista, al tratarse de una ""inversión"" más allá de la legislatura (creo que nada más y nada menos, que a ¡1 década!), creo que procede hacerlo como ya vengo planteando desde hace varios años.</p>

<p>Contratos sin posibilidad de blindaje y no más allá de la legislatura. (116 apoyos)</p>

<p><u>https://decide.madrid.es/proposals/19959</u></p>

<p> </p>

<p>Creo que en este caso, para bien (o para mal, según lo que opine cada cual), existe unanimidad de los partidos para hacer esta ""inversión"".</p>
";"16/07/2018 20";"17";"5";"12";"3";"11276054129";"-205"
"5486";"Esperpento en el Congreso con RTVE";"<p>Este país esta llegando a cotas de sub-realismo imposibles de superar.</p>

<p>Pues me entero hoy, que una votación, donde, previsiblemente iba a haber una mayoría a favor (no entro en lo conveniente o no de dicho tema, que me trae sin cuidado), resulta que ha salido ¡en contra por 1 voto!, pero agarrate que vienen curvas.</p>

<p>Lo mejor del tema, es que ha salido lo contrario de lo que se preveía (insisto, no entro ni a favor ni en contra por lo que se verá en el siguiente párrafo), porque 2 personas que tenía que votar a favor, no han ido, y otras 2 (el colmo de los colmos), ""se han equivocado al pulsar el botón"" (se los van a tener que poner en color rojo, verde, amarillo e idiota).</p>

<p>¡ALUCINANTE!</p>

<p>Estamos pagando a estos inútiles de políticos más de 2.000/mes para que pulsen un puñetero botón, ¿¡y ni eso saben hacer bien!?</p>

<p>¡TELA MARINERA!</p>

<p>Esto me confirma que la propuesta que vengo re-poniendo desde hace 2 años, ahora, hace más falta que nunca para acabar con el despilfarro y el adoctrinamiento del NO-DO y similares.</p>

<p>Cerrar las televisiones públicas (RTV1, RTV2, 24Horas) y todas las las autonómicas (las independentistas, la de propaganda del PP-TeleMadrid y todas las demás).</p>

<p>Y que todo este despilfarro de adoctrinamientos varios lo tengamos que costear todos los españolitos... como si no hubiera otras emergencias más importantes que el fúrbol, los toros, Top chefs, Corazones/corazones, En tu casa o en la mía, y demás tele-basura.</p>

<p>Cerrar las televisiones autonómicas (todas). (53 apoyos)</p>

<p><u>https://decide.madrid.es/proposals/14702</u></p>

<p> </p>

<p>A ver si alguien recoge el guante y presenta en Change.org una propuesta para la eliminación de TODAS las televisiones ""públicas"".</p>
";"16/07/2018 21";"22";"18";"4";"17";"11289450661";"1145"
"5487";"¿Ya está todo lo importante hecho en Madrid?";"<p>No se si seré el único en Madrid al que le ha ocurrido, que este año, ya no he visto suficientes proyectos que me llamarán la atención para invertir mi dinero.</p>

<p>Tanto en mi Distrito como Para todo Madrid, he llegado a gastar poco más del 50% del Presupuesto que tenemos.</p>

<p>No se, casi todos los proyectos eran proyectos de Distrito, que al superar el presupuesto de sus Distrito se habían pasado a ""Todo Madrid"", pero que claro, salvo excepciones, a los de otros Distritos no nos interesan lo suficiente.</p>

<p>De los pocos que he visto este año ""Para todo Madrid""... es que muchos de ellos, o eran cantidades astronómicas que se comían todo el Presupuesto, o eran cosas que sólo benefician a unos pocos (demasiados pocos), propuestas a mi entender intrascendentales o frívolas, y al final, no he visto propuestas realmente interesantes.</p>

<p>Es el primer año que me pasa (los 2 anteriores SI llegue a gastar todo el Presupuesto disponible en ambas partes).</p>

<p>¿A alguien más le ha pasado (yo es que no soy de gastar por gastar, y si no veo proyectos realmente interesantes, pues eso de gastar, simplemente, porque hay que gastar TODO el Presupuesto, SI o SI, pues, como que no lo veo)?</p>

<p> </p>

<p>Postdata: quiero aprovechar al oportunidad para agradecer en mi nombre y los creadores originales de las Propuestas, a todas aquellas personas que han tenido a bien apoyar las 3 Propuestas finalistas mías.</p>

<p>Otros años, este agradecimiento, lo he hecho mediante notificación, pero este año, al haberme borrado el Ayto mi usuario, mis debates, mis comentarios, no puedo enviar dicha Notificación de agradecimiento a todas las personas que han apoyado mis Propuestas en los Presupuestos Participativos.</p>

<p>https://decide.madrid.es/presupuestos/presupuestos-participativos-2018/proyecto/9957</p>

<p>https://decide.madrid.es/presupuestos/presupuestos-participativos-2018/proyecto/10186</p>

<p>https://decide.madrid.es/presupuestos/presupuestos-participativos-2018/proyecto/10161</p>
";"16/07/2018 21";"20";"16";"4";"8";"11288315490";"960"
"5488";"Peatonalización sí o no";"<p>¡peatonalización?</p>
";"17/07/2018 17";"61";"48";"13";"6";"11299696392";"2754"
"5489";"Obras de la Gran Vía o de cómo se destroza el centro de Madrid.";"<p>Si la Gran Vía no va a ser capaz de absorber ni siquiera el tráfico de transporte público, ¿qué hacemos? ¿No volvemos a pasar nunca más por ella? ¿La evitamos como si no existiera? ¿Todo esto para que algunos tengan una acera muy grande para ir a comprar al Primark y a Zara?</p>
";"21/07/2018 18";"55";"20";"35";"18";"11323593209";"-545"
"5490";"El banco de flores de la estatua de Álvaro de Bazán";"<p>¿Por qué se ha quitado el banco de flores de la estatua de Álvaro de Bazán en la plaza de la VIlla? ¿Por qué se ha dejado como un erial? ¿A quién le molestan las flores?</p>
";"21/07/2018 18";"18";"18";"0";"0";"11340460401";"1800"
"5491";"Suciedad en Orcasitas";"<p>Hola.</p>

<p>Quería hacer constar mi preocupación por la cantidad de basura que hay en el barrio de Orcasitas. Parece que los barrenderos no pasan por la carretera de Orcasitas a Villaverde, está llena de basura, botellas de plástico, latas, papeles, plásticos.... hay muchisima suciedad cerca del carril bici, que no es de un o 2 dias, sino de meses. Y el carril bici ha sido invadido por las plantas. </p>

<p>Otro tema son las cacas de los perros, hay que ir mirando al suelo para no pisarlas.</p>

<p> </p>
";"25/07/2018 20";"18";"18";"0";"1";"11381261555";"1800"
"5492";"Qué opinan sobre quitar la estatua de Largo Caballero";"<p>Qué piensan sobre eso? No mató mucha gente? Quiero abrir la discusión sin casuar polémica o inmadureces. Creo que es un debateque se tiene que dar. </p>
";"25/07/2018 21";"27";"15";"12";"4";"11372380528";"166"
"5493";"Hacer de Madrid una ciudad más verde - Queremos más árboles";"<p>Buenos días.</p>

<p>Llevo un tiempo dando largos paseos en las tardes y he observado la gran diferencia de calidad del aire y temperatura que se produce de caminar y transitar por zonas más verdes (como la calle Arturo Soria, llena de árboles y vegetación) a zonas donde las zonas verdes escasean o son inexistentes.</p>

<p>Además de percibir una mejora en la respiración y calidad del aire de esas zonas comparadas con las otras, creo que a la larga mejoraría el ambiente de la ciudad. Sombras donde refugiarse en verano, ayudarían a suavizar las temperaturas. De unos años a esta parte el ayuntamiento ha asfaltado gran parte de las aceras donde antes había árboles, plazoletas de barrio donde se podía estar tranquilamente ahora son aceras grises.</p>

<p>Con un Madrid más verde ganamos todos.</p>
";"26/07/2018 08";"50";"50";"0";"4";"11390806960";"5000"
"5494";"Remodelación Mercado y Polideportivo de La Cebada";"<p>Llevamos más de 10 años esperando la remodelación del mercado y la construcción del nuevo polideportivo de la Plaza de La Cebada. Parece que hay dinero para remodelar todos los mercados de Madrid excepto este. </p>

<p>¿Para cuándo la construcción de un nuevo polideportivo en el solar colindante al mercado?</p>

<p>En estos años han salido varios proyectos pero no se acaba de aprobar ninguno. Y mientras el barrio con un mercado antiguo y un solar en lugar de un espacio que los vecinos y todos los madrileños podrían disfrutar.</p>

<p> </p>
";"26/07/2018 11";"25";"25";"0";"0";"11388946734";"2500"
"5495";"Madrid Central: Espacio para turistas y madrileños de primera.";"<p>¡Buenas tardes! </p>

<p>Estoy viendo el proyecto de Madrid Central el nuevo proyecto que a partir de noviembre restringirá el acceso al tráfico privado en el distrito Centro. Un nuevo área que estará delimitado por lineas rojas y mi preocupación es si al inutilizar vías fundamentales para el tráfico de Madrid no va a generar problemas en las zonas colindantes a las lineas rojas, tanto de tráfico como de aparcamiento, consiguiendo en éstas el efecto contrario al que se espera obtener con la nueva medida. Por otro lado, veo que acceder al centro puede convertirse en un lujo sólo accesible a las economías más altas, es cierto que está el transporte público, pero os invito a ir desde alguna de las zonas nuevas de Madrid (El ensanche de vallecas, Sanchinarro...) en transporte público hasta sol con tres niños, de verdad, que es más fácil llegar a Toledo. Eso sí, una vez que consigas llegar no dudo que va a quedar precioso en las fotos!!</p>
";"26/07/2018 14";"18";"11";"7";"4";"11380428531";"244"
"5496";"Luces en acceso Gregorio SANCHEZ herranz";"<p>no entiendo  porque justo ese tramo está con las farolas apagadas siempre, es un peligro cogrrcese acceso , cusndo hay luz antes y después , pero justo ahi , llevan las farolas apagadas sirmire, por  favor que las enciendan ya!!! Gracias </p>
";"26/07/2018 18";"10";"10";"0";"0";"11387714122";"1000"
"5497";"Troll de manual o Cómo detectar a un troll";"<p>Antes de nada, instarles a comentar en https://wordpress.com/post/democraciaparticipativamadrid.wordpress.com/19</p>

<p>Pues este debate (y todos sus comentarios) pueden ser borrados arbitrariamente en cualquier momento.</p>

<p> </p>

<p>Desde un principio, la web de Madrid Decide se vió asaltada por una orda de trolls de derechas cuyo único objetivo era boicotearla (a los totalitarios no les gusta la Democracia Participativa (bueno, que demonios, ni siquiera les gusta la Democracia ""Representativa"")).</p>

<p>Nunca le podré estar lo suficientemnte agradecido al usuario cienpies</p>

<p>https://decide.madrid.es/debates/244-poder-ver-todos-los-comentarios-de-un-usuario-para-descubrir-trolls</p>

<p>Por haber realizado la primera propuesta que realmente puso la primera piedra para acabar (aunque no definitivamente, por que en aras de lo ""políticamente correcto"", Ahora Madrid, sigue dándo carta blanca a algunos trolls, que sigue mal-metiendo e intoxicando en la web de Decide Madrid) con los trolls de Foro-Coches y la derecha más intolerante.</p>

<p>Pese a todo, y a que se les ha puesto la cosa realmente difícil a los trolls, Ahora Madrid a cometido (a mi entender) el tremendo error de permitir que los usuarios puedan ocultar su perfil de Propuesta (exabruptos en el caso de los trolls) y de comentarios (comentarios tóxicos) en aras de lo ""Políticamente correcto"".</p>

<p>Aquí voy a explicar una serie de normas para descrubrir a los trolls que todavían quedan:</p>

<p>1º Normalmente, son usuarios nuevos, con pocas o ninguna propuesta, que sólo entran a intoxicar. Para que no se les detecten, cumplen la norma básica y esencial de cualquier troll, a saber, Ocultar su Perfil de Propuestas y Comentarios, para que nadie pueda comprobar que sólamente son elementos de derechas pagados para intentar hundir la web.</p>

<p>Pongo aquí un ejemplo de uno de ellos, aunque no el único.</p>

<p>https://imgur.com/a/PfrR7qf</p>

<p>2º Casi todos, el primer post que ponen es sobre 2 temas en exclusiva:</p>

<p>a) Suciedad en Madrid</p>

<p>b) Mal estado de firme de carreteras o pavimento</p>

<p>Es evidente que se trata de trolls, porque obvian lo que ya saben todos los madrileños, y es que ambos temas se deben de tramitar por Avisos Madrid, pero claro, eso no les daría visibilidad y la posibilidad de poder atacar (de forma neutral y desinteresada) al Ayto.</p>

<p>Por supuesto, este tipo de personajes, JAMAS les habrá oido quejarse de la suciedad cuando gobernaba su partido PP (bueno, afirmarán, que nunca ha existido suciedad ANTES de la llegaba de los ""perro-flautas"" y demás ordas de Bolivarianos y la conspiración judeo-masónica).</p>

<p>Obviamente, también se les olvidará (omitirán) que los contratos de limpieza son los que ya había a su llegada y están blindados por más años de los necesarios.</p>

<p>Que curioso, que cuando les pongo el link:</p>

Como pagar las cláusulas abusivas de los contratos blindados de limpieza de Madrid. (34 apoyos)

<p>https://decide.madrid.es/proposals/21828</p>

<p>TODOS dan la callada por respuesta.</p>

<p>En cuanto al otro (parece ser que sólo tienen estos 2 temas recurrentes en la boca) tema de las carreteras y pavimentos, claro, es algo que también denunciaron con el anterior consistorio (a no, calla, que antes esto no existía y había una gran inversión en este area, de hasta 0, si es que claro, no se puede compatibilizar el dinero en Suiza con inversión en carreteras y pavimento).</p>

<p>Pero NO, según estos personajes, los hoyos y agujeros han llegado a Madrid con el nuevo gobierno de polillas Venezolanas que se comen las losetas, y las botas nazis que utilizan los perro-flautas cuando usan sus coches y que destrozan el asfalto como los Picapiedra que son.</p>

<p>https://imgur.com/a/TIRW3PJ</p>

<p>Además, como ya todo el mundo en España y la Comunidad de Madrid sabe, las únicas carreteras que están en mal estado son las del Ayto de Madrid, tooooooooooodas las demás están impecables, que es que da gusto ir por ellas.</p>

<p>Pese a todo, siguen, y siguen entrando, para seguir intoxicando, mal-metiendo y seguir creando un ambiente tóxico.</p>

<p>https://www.youtube.com/watch?v=iRkR7q-WgMA</p>

<p>Cuando un usuario tenga su perfil de Propuestas y Comentarios oculto (opacidad = 10, transparencia = 0), desconfíen de lo que proponga o diga.</p>

<p>Por supuesto, que los trolls se abstengan de comentar en este blog, yo no voy a ser tan ""políticamente correcto"" como ha sido el Ayto.</p>
";"28/07/2018 18";"13";"5";"8";"0";"11395739422";"-115"
"5498";"Nacido para ser gobernado";"<p>https://wordpress.com/post/democraciaparticipativamadrid.wordpress.com/21</p>

<p>Pues este debate (y todos sus comentarios) pueden ser borrados arbitrariamente en cualquier momento.</p>

<p> </p>

<p>Cansa, realmente cansa, ver como los trolls, una, y otra, y otra vez, vienen a Madrid Decide con su mantra</p>

<p>https://imgur.com/a/Nge3uyZ</p>

<p>Me parece muy bien, si ellos quieren ser meras ovejas que necesiten de pastores, pero por favor, que no nos taladren a los demás con su rollo.</p>

<p>Además, es que ni siquiera son coherentes, ni siquiera es un ""Yo quiero ser gobernado hasta las últimas consecuencias"", noooooooooooooooooo,</p>

<p>es que lo que ellos proclaman es:</p>

<p>""Debéis ser gobernados hasta las últimas consecuencias, pero sólo, única, y exclusivamente, cuando gobiernen ""los mios""""</p>

<p>Es decir, ""cuando gobiernen los mios, debéis obedecer ciegamente, cuando gobiernen otros, no, debéis ser críticos"".</p>

<p>Pues miren caballeros, aparte de que yo no me considero otro borreguito más de la manada, yo lo que necesito es una verdadera Democracia Participativa para NO tener que tener una fe ciega en nadie.</p>

<p>NO necesito que nadie tome ninguna decisión por mi, no soy un bebe y ya tengo yo suficiente criterio para saber (y exponer en una propuesta o en varias), lo que necesito.</p>

<p>Si eso es mayoritariamente (o no) una necesidad de los madrileños o la sociedad, lo decidiremos nosotros (los madrileños o la sociedad), pero no necesito/amos a ningún político que tome las decisiones por nosotros.</p>

<p>Si Ud. quiere ser ""Gobernado hasta las últimas consecuencias"", entonces, al menos, sea coherente, y no se queje cuando sean ""otros"" (que no le gusten) los que ""Gobiernen"".</p>

<p>Eso de SOLO quejarse cuando NO gobiernan ""los mios"", NO es precisamente imparcial e insesgado.</p>

<p>Si Ud lo único que persigue NO es mandar (que es distinto de ""Gobernar""), demuéstrelo haciendo Pro-pu-es-tas Cons-truc-ti-vas en vz de SOLAMENTE despotricar.</p>

<p>Si Ud propone algo que a mi me parezca beneficioso para la mayoría de los ciudadanos, se lo voy a apoyar, sea Ud, de Izquierdas, de Derechas, de centro, de Villa-Arriba, o de Villa-Abajo, del R.Madrid o del At. de Madrid y NO voy a dejar de apoyársela por una anti-patía personal, ESO, amigo, es lo que tiene la Democracia Participativa, y es que, le permitirá a Ud. aunque NO gobiernen ""los suyos"" el poder sacar adelante Propuestas y hacer cosas (siempre que consiga Ud un apoyo mayoritario sin violencia) aunque NO Gobiernen los suyos, sin tener que esperar a que ""Gobiernen"" (porque puede pasar más tiempo del que le gustaría).</p>

<p>Yo NO necesito ""líderes"", ni ""gurús"", ni ""líderes espirituales"", para saber cuales son mis necesidades.</p>

<p>Los políticos (y más aún, los políticos ""profesionales""), sobran.</p>

<p>Lo único que necesitamos son BUENOS GESTORES, que se limiten a IMPLEMENTAR BIEN, las necesidades que los ciudadanos les demandemos.</p>

<p>NO hace falta nada más.</p>
";"28/07/2018 18";"14";"5";"9";"0";"11395434681";"-142"
"5499";"Barrio de San Fermín abandonado";"<p>El barrio más abandonado de Madrid, nula vigilancia y problemas de convivencia con la etnia problemática que todos conocemos. He comprobado que de diversas llamadas a policía municipal por escandalo nocturno en ninguna han ido. Zonas verdes tomadas por gente sentada en sillas plegables con música a todo volúmen hasta altas horas de la madrugada coreados por los perros del vecindario destrozando el descanso del vecindario que tiene que trabajar al día siguiente. Dejan las zonas verdes y las calles donde se reunen llenas de basura y no se limpia en bastante tiempo por lo que el barrio da sensación de estar siempre sucio, parece el Bronx en sus peores tiempos. Ninguna iniciativa de mediación con este colectivo por parte de este ayuntamiento que se dice progresista. En definitiva, un barrio completamente abandonado por sus responsables en el gobierno.</p>
";"29/07/2018 09";"16";"16";"0";"1";"11416183346";"1600"
"5500";"Hace falta un Conserje en Madrid Decide";"<p>https://democraciaparticipativamadrid.wordpress.com/2018/07/29/hace-falta-un-conserje-en-madrid-decide/</p>

<p> </p>

<p>¿Porqué en CUALQUIER organísmo público (sea del ámbito que sea: Ayto, Comunidad, Estatal) siempre existe un bedel, conserje o Información y sin embargo, esta figura no existe en Madrid Decide?</p>

<p>Es algo que no entiendo en absoluto.</p>

<p>Semana tras semana (desde hace 2 años y medio), vengo observando como se repiten, una, y otra, y otra vez, las mismas ""Propuestas"" que NO son tales, y en las que bastaría con informar al creador que una Propuesta en Decide Madrid NO es el cauce adecuado para solucionar su problema.</p>

<p>Se repiten sin parar, las referentes a alcorques que se tramitan por su App concreta, las de aceras, rebajes, etc, que también se tramitan por sus canales adecuados (Avisos Madrid) y así un sin fin más:</p>

<p>Ej:</p>

<p>https://decide.madrid.es/proposals/23066-plantar-arboles-en-todos-los-alcorques-vacios</p>

<p> </p>

<p>Gracias al voluntarioso esfuerzo de algunos ciudadanos que ayudan e informan, nos podemos enterar de cuales son los cauces adecuados, pero es que, esto NO tendrían/tendríamos que hacerlo los ciudadanos.</p>

<p>Esto debería hacerlo un funcionario retribuido del Ayto, al igual que siempre hay alguién en Información o Conserjería.</p>

<p>Es más, las propuestas NO deberían de publicarse al momento, si no que debería de haber una revisión previa, para, que si se trata de uno de estos casos, se informe al creador, y, en el caso de que el creador considere que ya se a resuelto su problema, QUE DICHA PROPUESTAS NO SE LLEGUE A PUBLICAR (o se publique, si el usuario considera necesario que se publique).</p>

<p>Esto, ya lo deje expuesto hace 2 años y medio en la propuesta:</p>

<p>2 - Para poder reunificar propuestas (desarrollado). (69 apoyos)</p>

<p>https://decide.madrid.es/proposals/20503</p>
";"29/07/2018 17";"17";"9";"8";"7";"11409242628";"52"
"5501";"Estudio estadístico y empírico Propuestas Madrid Decide";"<p>Enlace por si vuelven a borrar mis debates</p>

<p>https://democraciaparticipativamadrid.wordpress.com/2018/07/29/estudio-estadistico-y-empirico-propuestas-madrid-decide/</p>

<p> </p>

<p>Cogiendo las Propuestas de 3 páginas, desde</p>

Cambiar las tarjetas de transporte por NFC/STICKERS.

<p>hasta</p>

MAS POLICIA MUNICIPAL EN LOS BARRIOS FUERA DE LA M-30

<p>Nota: He extendido de 100 a 107 las muestras por existir 7 propuestas mías de Recopilatorios que NO son propuestas realmente y que podrían distosionar la muestra (osea, que al final son 100 Propuestas analizadas).</p>

<p>Voy a proceder a hacer un pequeño muestreo estadístico.</p>

<p>Vaya por delante, que encuadrar algunas propuestas en Propuestas de Distrito, Propuesta para TODO Madrid, Propuesta para Comunidad de Madrid, Propuesta de ámbito estatal, puede no ser del todo exacto pues desconozco al 100% las competencias de cada área.</p>

<p>También es discutible alguna propuesta que puede considerarse de Distrito o bien Para todo Madrid, dependiendo de como se entienda (por ejemplo las líneas de EMT).</p>

<p>Resultados:</p>

<p>Propuestas de Distrito/Barrio: 56%</p>

<p>Propuestas Para todo Madrid: 36%</p>

<p>Comunidad: 3%</p>

<p>Estatales: 4%</p>

<p>No son propuesta: 1%</p>

<p>Como una sóla muestra de 100 Propuestas no me ha parecido suficiente he cogido otra muestra adicional de otras 100 Propuetas.</p>

<p>Las que van desde la página 13:</p>

<p>https://decide.madrid.es/proposals/23055-vales-de-compra-en-papel-que-no-se-borre-la-tinta</p>

<p>hasta</p>

<p>https://decide.madrid.es/proposals/22957-adioslycamobile-di-no-a-la-publicidad-que-oculta-las-fachadas-de-los-comercios</p>

<p>Con los siguientes resultados:</p>

<p>Propuestas de Distrito/Barrio: 63%</p>

<p>Propuestas Para todo Madrid: 26%</p>

<p>Comunidad: 7%</p>

<p>Estatales: 3%</p>

<p>No son propuesta: 1%</p>

<p>Creo que con esta muestra estadística y esta prueba empírica queda más que demostrado lo que vengo diciendo desde hace ya 2 años y medio, y es que la mayoría las propuestas son de Distrito/Barrio/Comunidad de Madrid/Estatales/No son.</p>

<p>Tenerlas TODAS juntas en el mismo cajón hace que las SI son realmente para TODO Madrid no tengan apenas visibilidad mezcladas con todas las demás.</p>

<p>Ya vengo reclamando desde hace mucho tiempo, que deberían de estar por separado:</p>

Recopilación de Propuestas relativas a Mejora de la Administración de la web 1.

<p>https://decide.madrid.es/proposals/17361</p>

Recopilación de Propuestas relativas a Mejora de la Administración de la web 2.

<p>https://decide.madrid.es/proposals/19085</p>

<p>Concretamente, TODAS las relacionadas con sub-secciones:</p>

<p>1  Reducir a 2.500 apoyos el límite para las propuestas de Distrito. (268 apoyos)</p>

<p>https://decide.madrid.es/proposals/20514</p>

<p>5  Sub-secciones para distritos y <s>que no se quite visibilidad a otras propuestas</s>. (25 apoyos)</p>

<p>https://decide.madrid.es/proposals/21205 (Parcialmente implementada (50%) con la opción Mapa de Madrid por Distritos y la obligación de clasificar en Distrito al crear la propuesta).</p>

<p>5  Sub-secciones para las propuestas de carácter Autonómico y Estatales. (23 apoyos)</p>

<p>https://decide.madrid.es/proposals/22061</p>

<p>5  Crear una sub-seccion (histórico) para las propuestas que se vayan realizando. (71 apoyos)</p>

<p>https://decide.madrid.es/proposals/22062</p>

<p>5  Crear sub-secciones por cantidad de apoyos (46 apoyos)</p>

<p>https://decide.madrid.es/proposals/22063</p>

<p> </p>

<p>Esto resulta doblemente paradójico, cuando esto mismo que se solicita para las Propuestas Ordinarias, SI se ha implementado ya para las Propuestas en los Presupuestos Participativos, como se puede observar:</p>

<p>https://imgur.com/a/DEJlwJe</p>

<p>¿Alguien tiene alguna explicación?. Yo no.</p>
";"29/07/2018 18";"13";"7";"6";"5";"11409325453";"53"
"5502";"¿Es sensato poner el nombre real en abierto en Madrid Decide?";"<p>https://democraciaparticipativamadrid.wordpress.com/2018/07/31/es-sensato-poner-el-nombre-real-en-abierto-en-madrid-decide/</p>

<p> </p>

<p>Veo como algunos ciudadanos bien intencionados, ponen su nombre real en abierto (espero que no sean tan irracionales como para dejar también un nº de teléfono y/o dirección en abierto).</p>

<p>Yo NO aconsejo hacerlo.</p>

<p>Hay demasiados nazis del VOX (y de otras agrupaciones políticas) en Madrid, que ya están componiendo listas negras y rosas (como en la dictadura), con todas aquellas personas que hagan propuestas que ellos puedan considerar contrarias a sus ideario.</p>

<p>Sean precavidos, no cometan el error de poner su verdadero nombre en abierto (y mucho menos, dar otro tipo de datos).</p>
";"31/07/2018 11";"16";"6";"10";"7";"11422995699";"-150"
"5503";"Lo que funciona y lo que no para sacar adelante una Propuesta";"<p>En previsión de que el Ayto de Madrid me vuelva a borrar arbitrariamente TODOS mis debates (me llevan mis horas de redacción), dejo un enlace a un blog, para que no se pierda este debate y/o comentarios (a no ser que se pongan en el blog, también corren el riesgo de desaparecer junto con el debate).</p>

<p>https://democraciaparticipativamadrid.wordpress.com/2018/07/29/lo-que-funciona-y-lo-que-no-para-sacar-adelante-una-propuesta/</p>

<p> </p>

<p>Vaya aquí desde mi experiencia durante 2 años en Decide Madrid, una pequeña compilacióno de lo que NO funciona a la hora de hacer una propuesta.</p>

<p>A medida que pueda, iré mejorando esta entrada con ejemplos de lo que NO se debe hacer.</p>

<p><strong>Los packs Todo en 1</strong></p>

<p>Entiendase por packs todo en 1 aquellas propuestas en las que se piden 15 cosas diferentes.</p>

<p>Estan abocadas al fracaso, ya que nadie las va a apoyar, pues si bien puedan estar de acuerdo con algunos puntos, seguramente estén en desacuerdo con alguno o varios de los restantes y esto hace que NO se apoye (sobre todo, si el autor, no atiende a la enmiendas parciales para corregir su redacción).</p>

<p>A este particular, me gustaría recordarles el post:</p>

<p>https://democraciaparticipativamadrid.wordpress.com/2018/07/28/los-packs-todo-en-uno-o-las-propuestas-integrales/</p>

<p>Ej:</p>

<p>https://decide.madrid.es/proposals/23112-asfaltado-ampliacion-de-aceras-y-arbolado-en-puerta-del-angel</p>

<p> </p>

<p><strong>Las quejas particulares</strong></p>

<p>Me refiero a aquello que ni siquiera son Propuestas (no se propone nada), si no, que son una mera queja (que tiene otros trámites, no se tramitan por Madrid Decide).</p>

<p>El ponerlas en Madrid Decide no sirbe para absolutamente nada (ni siquiera son leídas, y lo único que hacen es crear ruido y restar visibilidad al resto), y, salvo que se busque criticar al Ayto, su canal adecuado es:</p>

<p>https://sede.madrid.es/portal/site/tramites/menuitem.62876cb64654a55e2dbd7003a8a409a0/?vgnextoid=32eddd9d6baed010VgnVCM2000000c205a0aRCRD&amp;vgnextchannel=f2eaa38813180210VgnVCM100000c90da8c0RCRD&amp;vgnextfmt=default#</p>

<p>Ej:</p>

<p>https://decide.madrid.es/proposals/22925-mal-funcionamiento-de-la-gestora-de-la-agencia-tributaria</p>

<p> </p>

<p><strong>Propuestas que ya se tramitan por otros canales concretos</strong></p>

<p>Alcorques, pavimentos levantados, alcantarillas obstruidas, quejas, reclamaciones y un largo etc, se tramitan por otros canales.</p>

<p>El crear una propuesta en Madrid Decide no servirá para nada (sólo para crear más ruido).</p>

<p>Es como si para resolver un tema de IRPF en vez de ir a un centro de Hacienda Pública fueramos a una sucursal de la Seguridad Social.</p>

<p>Alcorques</p>

<p>http://www-2.munimadrid.es/DGPVE_WUAUA/welcome.do</p>

<p>Alcantarillas obstruidas, rebajes de aceras, pavimentos en mal estado y un largo etc</p>

<p>Avisos Madrid</p>

<p>http://www.madrid.es/portales/munimadrid/es/Inicio/El-Ayuntamiento/Atencion-a-la-ciudadania/Aplicacion-movil/Aplicacion-movil-Avisos-Madrid-?vgnextfmt=default&amp;vgnextoid=c67bd881111f7410VgnVCM1000000b205a0aRCRD&amp;vgnextchannel=b9254bbed88f7410VgnVCM1000000b205a0aRCRD</p>

<p>https://sede.madrid.es/portal/site/tramites/menuitem.1f3361415fda829be152e15284f1a5a0/?vgnextoid=c6e7bd6ec8523310VgnVCM2000000c205a0aRCRD&amp;vgnextchannel=3476fbff20758310VgnVCM2000000c205a0aRCRD</p>

<p>https://play.google.com/store/apps/details?id=com.iam.lineaMadrid&amp;hl=es</p>

<p>Ej:</p>

<p>https://decide.madrid.es/proposals/23342-reponer-los-arboles-que-se-han-caido-en-plaza-sagrado-corazon-de-jesus</p>

<p>https://decide.madrid.es/proposals/23133-plantar-mas-arboles-en-zona-centro-de-madrid-y-maceteros-con-plantas</p>

<p> </p>

<p><strong>Las Propuestas genéricas</strong></p>

<p>Me refiero a aquellas propuestas que no solicitan nada en concreto o que son tan generales que quedan indefinidas.</p>

<p>Me refiero a ese tipo de Propuestas al estilo:</p>

<p>Quiero la paz mundial. Quiero acabar con el hambre en España.</p>

<p>Quiero que la gente sea feliz en la casa de gominola en la calle de la piruleta.</p>

<p>https://youtu.be/IPi8UZcJfQk</p>

<p>Su definición tan vaga y su falta de concrección en medidas a tomar, hará que nadie la apoye.</p>

<p>Ej:</p>

<p> </p>

<p><strong>Propuestas Egoistas</strong></p>

<p>Quizás clasificar una Propuesta como Propuesta Egoista sea más complicado, porque su escala de grises.</p>

<p>Es bastante difícil y complicado saber hasta que punto una propuesta es egoista o interesada.</p>

<p>¿Es egoista pedir un paso de cebra a 10 metros de tu portal?</p>

<p>Pues supongo que dependerá.</p>

<p>Si ese paso de peatones SOLO lo utilizas tú, pues SI, obviamente, se trataría de una propuestas bastante egoista.</p>

<p>Ahora bien, si resulta que ese paso de cebra, estaría en un lugar estratégico donde lo cruzan más de 1.000 personas al día. pues a lo mejor ya no es una propuesta egoista.</p>

<p>Normalmente, este tipo de propuestas (egoistas) no recibirán muchos apoyos, ya que sólo beneficien a una persona, a un lobby, o a un grupo muy reducido de beneficiarios.</p>

<p>Ej: (cuestionables)</p>

<p>https://decide.madrid.es/proposals/23226-creacion-de-un-monorail-madrid-desde-el-cielo</p>

<p>https://youtu.be/SWaSuFmoGKU</p>

<p> </p>

<p><strong>Propuestas sin puntos y aparte</strong></p>

<p>Simplemente, son ilegibles y desmotivan totalmente a leerlas.</p>

<p>https://decide.madrid.es/proposals/23133-plantar-mas-arboles-en-zona-centro-de-madrid-y-maceteros-con-plantas</p>

<p> </p>

<p><strong>Propuestas poco o nada desarrolladas</strong></p>

<p>https://decide.madrid.es/proposals/23103-mas-bliotecas</p>

<p>Creo que con ejemplo sobran las explicaciones.</p>

<p>Aunque, evidentemente, hay excepciones.</p>

<p>https://decide.madrid.es/proposals/22890-eliminacion-pagas-vitalicias-y-privilegios-de-politicos-bajada-sueldos</p>

<p> </p>

<p><strong>Cosas que creo (no estoy seguro) que SI mejoran una propuesta</strong></p>

<p>Una foto inicial de portada y ubicarlas geográficamente.</p>

<p>Una buena redacción: con puntos y aparte y sin utilizar mayúsculas en todo el texto.</p>

<p>Si lleva un vídeo con explicación les será mucho más fácil vender la idea.</p>

<p>No nos llevemos a engaños, en general, las personas, los ciudadanos, somos SUMAMENTE vagos para leer, pero un vídeo ayuda mucho (sobre todo si se tiene problemas de visibilidad).</p>

<p>Un podcast o Propuesta auditiva (grabación de voz), también facilita las cosas a los vagos y a las personas con poca visión.</p>

<p> </p>

<p> </p>

<p> </p>
";"03/08/2018 20";"16";"10";"6";"3";"11462710231";"250"
"5504";"Versos al paso";"<p>Buenos días a todas, </p>

<p>Acabo de recibir vía WhatsApp la propuesta ""Versos al paso"" una iniciativa que me parece bonita, atractiva, muy sugerente y que nos ayudará a humanizar un poquito más nuestra ciudad. Sin embargo, al observar la foto que se adjunta, entiendo a modo de ejemplo para entender la propuesta, ya me entran más dudas sobre su idoneidad, tal y como se plantea (pintado esobre el asfalto) </p>

<p>¿Alguien ha pensado lo peligroso que puede resultar que la gente se pare mientras cruza para leerlo? O se baje de la acera al asfalto para leerlo? </p>

<p>No sería mejor que figure en un cartel en la acera, por ejemplo, con un aviso que de paso recuerde que al cruzar por un paso de cebra hay que extremar las precauciones?.</p>

<p>Buen día a todas, mi agradecimiento a tantas propuestas ilusionan tes. </p>

<p>Blanca. </p>
";"07/08/2018 09";"10";"4";"6";"2";"11492941599";"-80"
"5505";"¿Democracia Participativa o Buzón de Sugerencias Colectivo por Adscripción?";"<p>Por si no quieren arriesgasrse a perder sus comentarios con el borrado arbitrario de este debate.</p>

<p>https://democraciaparticipativamadrid.wordpress.com/2018/08/10/democracia-participativa-o-buzon-de-sugerencias-colectivo-por-adscripcion/</p>

<p> </p>

<p>Esta claro que esta web NO esta funcionando bien.</p>

<p>Todavía no se ha conseguido que ni una sola propuesta ciudadana pueda llegar tan siquier a votarse (recuerdo que las 2 que se han llegado a votar ha sido porque tenían un 100% de visibilidad al estar fijas en la parte superior de las propuestas, opción que ha desaparecido).</p>

<p>El Ayuntamiento debería pasar por esta web TODAS las cosas que quiera llevar a cabo, para que ellos mismos comprueben la fustración que produce el intentar llevar a cabo una Propuesta en esta web por culpa de su mal diseño/funcionamiento.</p>

<p>Es cierto, que ha mejorado mucho en estos 2 años y medio últimos, pero, NO en las necesidades fundamentales y primordiales (es mi opinión subjetiva, que mientras no se implementen las primeras propuestas, esta web NO va a funcionar):</p>

<p>Recopilación de Propuestas relativas a Mejora de la Administración de la web 1.</p>

<p>https://decide.madrid.es/proposals/23403</p>

<p>Recopilación de Propuestas relativas a Mejora de la Administración de la web 2.</p>

<p>https://decide.madrid.es/proposals/19085</p>

<p> </p>

<p>Más que en un espacio de VERDADERA Y REAL Democracia Participativa se ha convertido en un espacio para ""Sugerencias Colectivas por Adscripción"".</p>

<p>Es cierto, que el Ayto ha llevado voluntariamente a cabo muchas, muchísimas propuestas adelante, pero... desconozco que criterios se han seguido para escoger que propuestas se llevan a la práctica (información 0 por parte del Ayto a este respecto).</p>

<p>Tampoco es que piense que TODO lo están haciendo fatal.</p>

<p>La parte de proceso de Presupuestos Participativos esta muy bien (otra cosa es la ejecución e información).</p>

<p>También estan bien diseñados los procesos de votación para las Consultas Ciudadanas.</p>

<p>Pero lo que es el resto de Propuestas (""Ordinarias""), se ha convertido en un mero Buzón de Sugerencias y NO en una verdadera Democracia Participativa.</p>
";"10/08/2018 19";"12";"5";"7";"3";"11527526033";"-83"
"5506";"Listado Exhaustivo de motivos por los que un político debe de dimitir.";"<p>En vista de que se han borrado todos mis anteriores debates, vuelvo a poner el que en su día hice a raíz del caso del (presuntamente) Master falsificado de Cifuentes.</p>

<p>Por si no quieren perder su comentarios/aportaciones:</p>

<p>https://democraciaparticipativamadrid.wordpress.com/2018/08/10/listado-exhaustivo-de-motivos-por-los-que-un-politico-debe-de-dimitir/</p>

<p> </p>

<p>En su momento, cuando comenzo todo ese tipo de ""periodismo"" basura, ese tipo de ""periodismo"" que SOLO es propaganda, en el que se atacaba arbitrariamente, con mentiras, con exageraciones, con información sesgada, con información manipulada, con información descontextualizada a los miembros de un determinado grupo político, ya en aquel momento, manifeste mi total asco y rechazo por ese tipo de ""periodismo""/propaganda del ""todo vale si es contra x"".</p>

<p>Ese tipo de ""periodismo"" en el que NO se evaluaba a un político por los ACTOS DELICTIVOS ASOCIADOS A CARGO POLITICO (prevaricación, tráfico de influencias, comisiones, sobres, contabilidad B, etc, etc, etc) que cometía DURANTE su mandato, si no, que se iba más allá en el tiempo, rebuscando entre los cubos de basura de su pasado, para ver si había algo que ""algunos iluminados"" consideraban que fuera motivo para que NO se puedan presentar a un cargo político (sea este, un antigüo caso de enfermedad mental - Cleptomanía, ya curado, o cualquier otra cosa super-grave, me es indiferente)).</p>

<p>Fue el inicio del periodismo-basura, del ""todo vale con tal de atacar al adversario político"", y cuando digo TODO, digo TODO (se abrió la veda): golpes bajos, piquetes de ojos, patadas a la entrepierna, etc, etc, etc,</p>

<p>cosa, que es aún peor, cuando la ejercen unos supuestos (no nos olvidemos de la presunción) ""periodistas"", QUE DEBERIAN DE SER IMPARCIALES (otra cosa, es lo que tal o cual político, quiera decir ante las cámaras sobre un ""adversario"" político).</p>

<p> </p>

<p>Me refiero a ese tipo de ""periodismo pantuflo"" y a los mentiruscos que ya se sintetizaba en:</p>

<p>https://www.youtube.com/watch?v=8ocGzt-Ui4s</p>

<p> </p>

<p>Así ocurrió, que esta bola de nieve cuesta abajo, se fue agrandando y agrandando (todavía recuerdo el contra-ataque también barriobajero de las ""declaraciones""/insinuaciones del Sr. Monedero sobre narices, coca, etc, sobre otro político).</p>

<p>Ya ironizaba en su momento, que al paso del ""todo vale"" al que se iba, se iba a llevar a solicitar que tal o cual político (me da igual quien: Rajoy, Sánchez, Rivera o Iglesias) debiera de dimitir, no porque haya sido honrado y NO haya metido la mano en la caja pública, si no, porque cuando era pequeño, en el patio del colegio, le robo un bollicao al compañero.</p>

<p>Pues bien, mis peores augurios se han cumplido.</p>

<p>Hace poco he leído a un miembro del PP (ironías de la vida, este tipo de periodismo-basura que este y otros grupos a propiciado, finalmente, se ha vuelto contra ellos mismos y sobre el ahora su nuevo Presidente, Sr. Casado), sobre el tema de la carrera y el Master del Sr. Casado:</p>

<p>""esto es un acoso inaceptable, ¿hasta cuando nos vamos a retro-traer en la vida de un político para mirárselo todo con lupa?, ¿hasta el colegio (premonitorio mi anterior debate, donde sólo lo dejaba caer a modo de ironía, pero que veo que la realidad supera a la ficción)?""</p>

<p>Es cierto, que el PP y sus medios de propaganda satélites empezaron con este tipo de periodismo-basura del ""todo vale"", y ahora, ironías de la vida, les pasa factura, pero eso no quita, en que siga estando en desacuerdo (como lo estaba en su momento) con el mirar lo que ha hecho un político ANTES de meterse en política.</p>

<p>En su momento, defendía (y sigo defendiendo), que se debe exigir responsabilidades políticas (dimisión de su cargo público, aunque no entro en si el partido quiere mantenerlo en algúna cargo DENTRO de su propio partido y COBRANDO del partido) SOLO por los actos asociados a su cargo político (prevaricación, tráfico de influencias, etc) y SOLO durante su mandato.</p>

<p>Mencionaba, que a mi parecer, también era excesivo, por ejemplo, que se hubiera expulsado a un Concejal de un pueblo Gobernado por Ciudadanos, porque le habían puesto una multa por conducir con una tasa de alcoholemia superior a la permitida (nada que ver, con su cargo político).</p>

<p>Decía, también que para quien toma la decisión de expulsarlo del partido es fácil, porque le hace quedar bien y un ejemplo de integridad (habría que ver que hubiera ocurrido si al que hubieran multado hubiera sido el que tomo la decisión de expulsarlo del partido), y también es verdad que da validez a dicho partido (al ser el primero en dar ejemplo) para poder exigir ese mismo nivel de exigencia a CUALQUIER POLITICO DE CUALQUIER PARTIDO PARA EL MISMO CASO (sienta un precedente ""POSITIVO"").</p>

<p>Yo ya dije, que NO necesito ir tan lejos, que no necesito tanto, porque al final, si uno se pone extremadamente pejilguero, le saca pegas a CUALQUIER político (este porque esta divorciado, aquella porque es madre soltera, este porque fuma, aquel porque es gay y así hasta el infinito y más allá).</p>

<p>Yo, lo único que le exigo a un político (al que sea, del partido que sea), es que no cometa actos delictivos asociados a su cargo político (prevaricación, tráfico de influencias, etc) DURANTE su gestión, poque si se va más allá... entonces no se puede presentar a un cargo político ni el Papa, ni el Dalai Lama, ni Teresea de Calcuta, ni el nobel de la paz, porque a todos, todos, se les va a sacar algo de su vida (hasta de cuando eran un feto, al tiempo).</p>

<p>¡Basta ya!</p>

<p>Si se quiere ir más allá (cosas que NO son delitos asociados a cargo político), se debe de crear un listado exhautivo, pero igual y común para todos los partidos y políticos (reglas del juego comunes), y no que cada uno diga que lo del ""otro"" esta mal, pero lo suyo no (subjetividad máxima).</p>

<p>Si algún patido ""da ejemplo"", considero que SI puede exigir a otros que cumplan E-XAC-TA-MEN-TE lo mismo (y NO, no me vale, el ""es practicamente lo mismo"", ""es muy parecido"" o ""es similar"").</p>

<p>En cualquier caso, deben ser cosas recogidas exhautivamente por ADELANTADO, y la primera vez que ocurra, NO debería de ser motivo para dejar el cargo político, pero SI (si hay consenso), se debería ampliar el listado de motivos de dimisión, para la siguiente vez que se vuelva a dar dicho caso.</p>

<p>Todo esto, viene a cuento, del acoso y linchamiento que esta recibiendo el Sr. Casado por el tema de su Master (no menos cierto, es que fue, precisamente su partido y sus medios ""periodísticos"" de propaganda, los que comenzaron con esta dinámica basurera).</p>

<p>¿Realmente el Sr. Casado esta ilegitimado para su cargo político o para ser Presidente de Gobierno, porque hace la más de 20 años, cuando estudiaba un Master, lo compro (supuestamente)?</p>

<p>Aunque eso fuera cierto (cosa que todavía no se ha demostrado).... ¿eso le invalida para un cargo público?</p>

<p>Por favor.... todo DENTRO DE SUS CONTEXTO.</p>

<p>Si resulta que en esta Universidad a TODO el que ponga pasta sobre la mesa le regalan (presuntamente) un master, entonces, NO es un tema concreto y puntual de políticos, partidos o politico concreto es un tema de que quien tiene pasta se puede comprar un Master en esta Universidad y punto. </p>

<p>CU-AL-QUIE-RA, NO SOLO el Sr. Casado al que se quiere linchar por motivos partidistas.</p>

<p>Si NO ha sido un privilegiado, ni ha tenido un trato de favor (TENIENDO EN CUENTA EL CONTEXTO)...</p>

<p>¿porqué lo que ha hecho él es peor que lo que haya hecho cualquier otro alumno de master de dicha universidad (presuntamente)?</p>

<p>¿acaso le pedimos al resto de alumnos de Masters de esta Universidad que dimitan de sus cargos políticos?, ¿no, verdad?</p>

<p>Entonces, ¿porqué en el caso del Sr. Casado SI se le pida que dimita (y eso, que no se ha demostrado nada)?</p>

<p>Por favor, ¡BASTA YA DE ESTE FARISEISMO!</p>

<p>¡BASTA YA DE PERIODISMO-BASURA!</p>

<p>¡BASTA YA DEL ""TODO VALE""!</p>

<p>¡LISTADO EXHAUSTIVO DE MOTIVOS POR LOS QUE UN POLITICO DEBE DE DIMITIR PARA TODOS</p>
";"10/08/2018 21";"15";"11";"4";"0";"11535051370";"513"
"5507";"Fiestas patronales";"<p><strong>Buenos dias queria saber por que en una fiesta tan importante como la de San Cayetano o la de San Lorenzo del barrio de lavapies el pregon lo tenga  que dar una persona sin papeles y luego se ponen a insultar y a criticar a la policia municipal. </strong></p>

<p><strong>Que pasa que no hay otra persona para dar el pregon del barrio ya que es un buen barrio que hay gente de toda vida viviendo en el barrio que tambien pueden dar el pregon de dichas fiestas.</strong></p>

<p><strong>Lo que yo veo que esta alcadesa solo le interesa las personas sin papeles que los propios vecino del bario que si tienen papeles y son Madrileños   </strong></p>
";"13/08/2018 10";"25";"19";"6";"3";"11563146494";"988"
"5508";"¿Porqué se retiro la opción de Propuestas Fijas?";"<p>Por si me vuelven a borrar todos mis debates y comentarios y para que no pierdan sus comentarios:</p>

<p>https://democraciaparticipativamadrid.wordpress.com/2018/08/13/porque-se-retiro-la-opcion-de-propuestas-fijas/</p>

<p> </p>

<p>Los que llevamos aquí varios años, recordaremos perfectamente, que las 2 únicas Propuestas Ciudadanas que se han podido llegar a votar en Referendum Ciudadano, lo consiguieron gracias a 2 cosas:</p>

<p>a) La más importante. La reducción del número de apoyos necesarios del 2% (56.000) al 1% (28.000) gracias a una Propuesta de... Ciudadanos (NO, no de Ahora Madrid), una semana antes (o poco menos) de que la Propuesta fuera a ""caducar"" (otra triquiñuela para que ninguna Propuesta Ciudadana, pueda jamás llegar a salir adelante), ya que iba a cumplir el año (y en ese caso, se borra, en base a una triquiñuela legal).</p>

<p>https://youtu.be/ieBeZrjyPz0?t=295</p>

<p>https://youtu.be/ieBeZrjyPz0?t=199</p>

<p>b) Las 2 Propuestas que llegaron a rebasar los 28.000 apoyos tuvieron visibilidad del 100% ya que estaban fijas (es decir, era totalmente imposible NO verlas) en la 1ª página DELANTE/ENCIMA de todas las demas (independientemente de como se ordenaran).</p>

<p>Dejo aquí una captura de donde estaban ubicadas:</p>

<p>https://youtu.be/ieBeZrjyPz0?t=199</p>

<p>Estaban a modo de Banner Fijo.</p>

<p> </p>

<p>¿Porqué desapareció esta opción (Propuestas Fijas ANTES del resto de Propuestas Ciudadanas) después de dicho Referendum?.</p>

<p>Nadie lo sabe. Nunca ha habido ninguna explicación al respecto.</p>

<p>Lo que si es cierto, es que desde entonces, NINGUNA propuesta ha llegado a los 28.000 apoyos.</p>

<p>Curioso.</p>
";"13/08/2018 12";"13";"5";"8";"4";"11553899679";"-115"
"5509";"¿Cada cuanto tiempo como máximo se debería de realizar un Referendum Ciudadano?";"<p>Actualmente, esta pregunta no es muy preocupante ni apremiante, ya que, como ninguna Propuesta sale adelante, no hay que preocuparse ""de momento"", pero...</p>

<p>¿Qué pasaría si un año de estos se llevan a cabo las propuestas</p>

<p>Recopilación de Propuestas relativas a Mejora de la Administración de la web 1.</p>

<p>https://decide.madrid.es/proposals/23403</p>

<p>Recopilación de Propuestas relativas a Mejora de la Administración de la web 2.</p>

<p>https://decide.madrid.es/proposals/19085</p>

<p> </p>

<p>y empiezan a salir adelante 3 o 4 propuestas (espero ser el primer madrileño en sacar adelante 10 Propuestas antes de palmarla) por mes?</p>

<p> </p>

<p>Si bien los Referendums Ciudadanos, no tienen ningún coste de personal (lo realizan/realizamos voluntarios), SI tiene un coste (mínimo, y que se puede reducir con la futura propuesta derivabada de</p>

<p>https://decide.madrid.es/debates/5510-como-reciclar-sobres-de-referendums-ciudadanos) en cuanto a sobres y papeletas.</p>

<p>Obviamente, este coste es mayor si se hace un Referendum para cada Propuesta que salga adelante, además, de tener que votar cada semana la Propuesta que vaya saliendo adelante.</p>

<p>Creo que es más lógico (y racional), que se agrupen varias Propuestas/Preguntas y se hagan un númeor máximo de Consultas Públicas al cabo del año, como ya se hace en otros países civilizados y con verdaderas Democracias como los USA, etc.</p>

<p>Creo que lo lógico sería hacer como máximo 4 consultas (trimestrales) como máximo, y agrupar en dichas Consultas Ciudadanas las Propuestas que hayan salido adelante desde la última consulta hasta la actual.</p>

<p>Podría quedar como excepción, aquellas propuestas que por necesidad de Urgencia (homenaje a persona mayor, que pueda fallecer en cualquier momento, Emergencias Sociales, etc) fuera necesario proceder a su Referendum en el menor tiempo posible tras conseguir los apoyos necesarios.</p>

<p>¿Cuál creen que sería el periodo adecuado?</p>
";"13/08/2018 13";"15";"6";"9";"1";"11553603877";"-120"
"5510";"¿Cómo reciclar sobres de Referendums Ciudadanos?";"<p>https://democraciaparticipativamadrid.wordpress.com</p>

<p> </p>

<p>Este debate es una reposición (ya que se me han borrado TODOS los debates y COMENTARIOS - para que luego digan que soy de Ahora Madrid y bla, bla, bla -) del que ya puse en su momento a los pocos días del (hasta ahora) único Referendum Ciudadano sobre Propuestas Ciudadanas </p>

<p>https://decide.madrid.es/primera-votacion-ciudadana-resultados</p>

<p> </p>

<p>Al igual que entonces, lo que pregunto es si se considera que sería una buena idea, para ahorrar costes/gastos:</p>

<p>a) Que los sobres NO contengan un membrete o pregunta de la consulta, ya que esto los hace i-reutilizables.</p>

<p>Si los sobres, son de colores (había uno blanco para un tema y otro verde para el otro) pero sin ninguna pregunta, los que sobren, se pueden volver a utilizar en próximos Referendums.</p>

<p>b) Si el Ayto graba/realiza un pequeño vídeo de 30 sg, donde enseñe a los ciudadanos como utilizar y cerrar el sobre SIN utilizar el pegamento (introducir la solapa por el interior del sobre), se consiguen 2 ventajas.</p>

<p>1) Los sobres que se pegan, lleva más tiempo abrirlos, que aquellos en los que simplemente, se mete la solapa por el interior.</p>

<p>2) Si los sobres no se pegan para cerrarlos, se pueden volver a re-utilizar en futuras Consultas Públicas (supuesto no tengan ninguna pregunta en el frontal).</p>

<p>c) Si reciclamos, el Amazonas durará unos pocos años más.</p>
";"13/08/2018 13";"12";"5";"7";"0";"11554304473";"-83"
"5511";"Vieja política";"<p>Dejo enlace exterior, para que no se pierdan los comentarios si me vuelven a borrar los debates.</p>

<p>https://democraciaparticipativamadrid.wordpress.com/2018/08/15/vieja-politica/  (mejor dejar los comentarios en ambos sitios para que no se pierdan).</p>

<p> </p>

<p>Ahora Madrid quería acabar con la ""vieja política obsoleta"", quería ""dar voz al pueblo mediante una verdadera democracia, una Democracia Participativa"", quería dejar atrás el ""aquí hago lo que me da a mi la gana, y los demás a callar y obedecer"", quería ""empoderar"" a los ciudadanos, soltar ""el poder"" e ir entregándoselo a los ciudadanos, y SI, es cierto, que en cierto grado (minúsculo) lo han hecho (aunque parece que les cuesta ir ""cediendo"" ese poder a los ciudadanos).</p>

<p>Una Democracia Participativa NO es SOLO, llevar a cabo lo que quieren y VER-DA-DE-RA-MEN-TE necesitamos los ciudadanos, también es hacerlo COMO QUIEREN LOS CIUDADANOS.</p>

<p>Ya hemos sufrido a nivel nacional la tomadura del pelo por parte del PP, de llevar adelante la ILP sobre ""Dación de pago"", y al final, hicieron lo que quisieron, y NO tenía NADA que ver con lo que se proponía en dicha ILP.</p>

<p>""La adaptaron"" (triquiñuela legal) a sus intereses y conveniencia, cual traje de sastre.</p>

<p>Pues parece que Ahora Madrid ha recogido el testigo de estas malas artes, y empieza a hacer lo mismo que la ""vieja política pre-democrática"".</p>

<p>""Sí, sí, vosotros decir lo que queréis que ya haremos nosotros lo que nos de la gana"".</p>

<p>Al final, resulta que es como el chiste aquel:</p>

<p>https://imgur.com/a/yy13Kyt</p>

<p>Pues NO Sres de Ahora Madrid, NO, eso NO es Democracia Participativa.</p>

<p>A día de hoy sigue habiendo 0 información y 0 transparencia, en cuanto a la implementación de la Propuestas Ciudadanas (en Presupuestos Participativos o Propuestas ""Ordinarias"") al TITULAR/ES DE LA PROPUESTA.</p>

<p>Ningún titular de las Propuestas de Presupuestos Participativos, nos ha dado información a los ciudadanos del resultado de la implementación de las Propuestas, y sin esa Transparencia e Información, esto NO es una Democracia Participativa 100%, si no, más bien lo que ya reflejaba en:</p>

<p>https://decide.madrid.es/debates/5505-democracia-participativa-o-buzon-de-sugerencias-colectivo-por-adscripcion</p>

<p>Y no, no vale con hacer las cosas bien, hay que hacerlas perfectas.</p>

<p>Una Democracia Participativa 100% pasa porque las Propuestas se lleven a la práctica de la forma más aproximada a lo que su creador o creadores proponían.</p>

<p>Sí, sí, ya se que hay que tener en cuenta que, en la mayoría de las ocasiones no se van a poder llevar a la práctica tal y como esta planteado inicialmente, por 30.000 temas varios.</p>

<p>- Los terrenos no son propiedad del Ayto.</p>

<p>- Trabas jurídicas o denuncias (partidistas) de ""invasión de competencias"".</p>

<p>- Bloquear el dinero desde el Gobierno Central de los Presupuestos, para joder a los ciudadanos, y que las Propuestas Ciudadanas NO se puedan llevar adelante (parece ser, que esto último, ya ha cambiado, con el cambio de partido político en el Gobierno, y el cambio del encargado de Hacienda Pública, veremos, por cuanto tiempo, hasta que se vuelvan a poner palos en las ruedas a las necesidades de los ciudadanos de Madrid).</p>

<p>- Mayor presupuesto económico del inicialmente planteado.</p>

<p>- Problemas técnicos (imposibilidad de construir en un determinado sitio, etc).</p>

<p>- Competencia desleal hacia el sector privado.</p>

<p>y un largo etc, que todos, incluso los críticos (de forma constructiva y apartidista) con Ahora Madrid, somos conscientes, y no reprochamos al Ayto, porque sabemos que no es culpa suya, pero aún así...</p>

<p>se debe SI o SI, contar con los titulares (más aún cuando se trata de asociaciones de enfermos, consumidores, etc), para el desarrollo e implementación final.</p>

<p>Al menos, si se quiere puentear e ignorar a los creadores (individuales o colectivos) de las Propuestas en el desarrollo y ejecución de las Propuestas, a los titulares de Propuestas (en mi caso, de momento, sólo 7 Propuestas de Presupuestos Participativos y ninguna de Propuesta Ordinaria), se nos debería dar el derecho público de dar nuestra Aprobación a lo realizado por el Ayto, o al menos, que se nos permita el derecho de ""Abstención"" (o el término jurídico que se utilice).</p>

<p>Cuando la novela de un escritor es llevada al cine, se le concede a este el derecho de dar su Aprobación al resultado (incluso contando con él durante el rodaje), o al menos, se le da el derecho de ""Abstención"" en los créditos para desligarse de la película.</p>

<p>Un ""Esto no tiene nada que ver con mi libro/idea y es la mera interpretación del director"".</p>

<p>Me gustaría saber, sobre todo, la opinión del resto de Titulares de alguna de las otras Propuestas de Presupuestos Participativos (de este año, o anteriores), al respecto.</p>
";"15/08/2018 14";"19";"7";"12";"0";"11573370425";"-184"
"5512";"Mejorar el empoderamiento ciudadano";"<p>Dejo aquí enlace externo, por si me vuelven a censurar (soy una mosca cojonera para Ahora Madrid) y me vuelven a borrar todos mis debates.</p>

<p>En el blog externo pueden dejar también sus comentarios sin miedo a que se puedan perder al borrarse el/los debate/s.</p>

<p> </p>

<p>Esta muy bien que el Ayto y Ahora Madrid, nos permita opinar a los ciudadanos y nos consulte sobre proyectos que tienen pensado llevar adelante de ""motus propio"", pero es mi parecer, que el Ayto debería pasar los mismos trámites y exigencias que nos pone a los ciudadanos para que nuestras Propuestas puedan llevarse adelante.</p>

<p>Hasta ahora se ha consultado mucho a los ciudadanos, pero no TODO.</p>

<p>Por otra parte, el Ayto, debería tener el mismo grado de exigencia consigo mismo que el que tiene con los ciudadanos, es decir, si quiere llevar algo a la práctica (construcción de 4 torre en Plaza Castilla, operación pelotazo/Chamartín/BBVA, operación pelotazo/Calderón, operación Esquina de Florentino Pérez), debería de exponerlo en esta misma web.</p>

<p>Estoy seguro que si así fuera, a las 2 semanas, esta web funcionaba a la perfección y las propuestas ciudadanas saldrían adelante como churros (por la cuenta que les traería).</p>

<p>No es de recibo que se nos exiga tanto a los ciudadanos, y se nos ponga todo tipo de trabas, mientras que ese grado de exigencia es 0 para lo que quiere llevar el Ayto adelante.</p>
";"15/08/2018 16";"21";"9";"12";"4";"11575384946";"-128"
"5514";"Funcionarios interinos para el acceso a la categoría de Auxiliar Administrativo ";"<p>Que se reactive de una vez, ya ha pasado un año y seguimos parados. Dar trabajo a la gente o por lo menos que no se ponga la miel en los labios para luego no salga nada.</p>
";"21/08/2018 09";"12";"9";"3";"0";"11639780154";"450"
"5515";"Unificar red ciclista en la ciudad";"<p>Revisando la red de carriles bici existente en la actualidad, nos encontramos con un grave problema que han creado las últimas dos administraciones que han gestionado la ciudad de Madrid.</p>

<p>Vale....han apostado por darle espacio a la bici como medio de transporte alternativo, pero a costa de desarrollar una red ciclista de lo más demencial.</p>

<p>Se han diseñado todo tipo de carriles bici....encima de las aceras (C/ O'donnell, Av/ de los Andes, Institución Libre de Enseñanza, Serrano,...), separando el tráfico del carril bici (Av/ Francisco Largo Caballero,...), pintando un carril bici en la acera (Gran Via de Hortaleza), los famosos carriles 30,....</p>

<p>Cualquier persona que venga de una ciudad con más cultura ciclista, podrá comprobar que la red de la ciudad es un caos, fruto de unos responsables políticos que solo piensan en inagurar carriles bicis, sin importales en buscar una filosofía de transporte ciclista común a toda la ciudad.</p>

<p>Es necesario unificar el trazado ciclista en la ciudad, haciéndolo seguro y accesible a gente de todas las edades. No podemos seguir construyendo carriles bicis con diseños diferentes. Esto solo provocaría que el sentimiento de seguridad de algunos ciclistas se limite a determinadas zonas.</p>

<p>Os invito a ofrecer ideas para poder desarrollar una red ciclista en condiciones en la ciudad. Bienvenidas son todas las ideas.</p>
";"22/08/2018 13";"29";"25";"4";"3";"11657057394";"1810"
"5516";"¿Quien recoge las cartas de los buzones de CORREOS de las comunidades?";"<p>Todas las comunidades de propietarios tienen un buzón arriba a la izquierda que dice «CORREOS».
¿Los carteros recogen alguna vez las cartas de su interior? 
En mi comunidad el buzón está lleno de cartas que los vecinos ponen dentro por dirección o destinatario equivocado. 
Estas cartas no llegarán a destino. 
Podeis comentar si esto les pasa en más comunidades...</p>
";"26/08/2018 14";"8";"8";"0";"1";"11695063969";"800"
"5517";"En bares restaurantes precios iguales cartas menú ";"<p>Estoy viviendo en Aluche y en un kilometreo cuadrado cada bar tiene los cafes, refrescos de diferentes precios,, te vas al metro Aluche un precio te vas a Rafael finat tiene buenos precios,, en la calle camarena otros,, es un lio se debia tener precios unificados y una carta que muchos bares lo tiene,, para poder elegir el stio donde tomar el cafe ,,refresco o menu,, otros no tiene ni carta ,,ni precios ya se sabe que esto estaba previsto pero reincidir en le tema,,,,GX </p>
";"28/08/2018 12";"21";"1";"20";"6";"11703787926";"-90"
"5518";"Lenguaje adecuado";"<p>Me gustaría que alguien, del Ayuntamiento, le explicara a la concejala de Arganzuela que cuando da un discurso para las fiestas del barrio se está dirigiendo a hombres y mujeres.</p>

<p>Puedo entender que lo de usar el género neutro ya no se lleve, y ahora lo cool es usar el masculino y el femenino o el femenino y el masculino, que no voy a imponer ningún criterio, pero lo que no concibo es que se use solo el femenino, como si las fiestas fuesen solo para las mujeres y los hombres fueramos unos apestados o no existieramos.</p>

<p>Ya en el colmo de la tontería idiomática presentó a los dos activistas contra el racismo como <strong>estas dos activistas, </strong>cuando en realidad había un hombre y una mujer.</p>

<p>Se supone que una concejal de distrito debe tener la cultura suficiente como para entender esto, espero que así ocurra.</p>
";"07/09/2018 07";"22";"12";"10";"9";"11806694022";"109"
"5519";"Obras en Olavide y su entorno";"<p>Acaban de pintar las plazas de aparcamiento en la calle Juan de Austria, modificando la disposición de las plazas. Han pasado de ser en linea a ser en batería. Después de ver cómo las pintaban he buscado el motivo del cambio, y al parecer hay una demanda ciudadana que pide obras en el barrio para peatonalizar Olavide y modificar la disposición de las plazas de aparcamiento y las normas de circulación de las calles próximas. Vivo en el barrio hace más de 40 años y jamás he oído que se reivindicará algo parecido. Lo que si se oído es que sería estupendo que nos dejarán tranquilos, y que no nos hicieran la vida más complicada. Están queriendo hacer del barrio una zona turisturíca, dedicada al ocio. Y aquí vivimos mucha gente que queremos poder dejar el coche en doble fila un minuto para bajar a los niños o descargar el coche. Es vergonzoso que un ayuntamiento gobierne en base a las opiniones que dejamos en estas plataformas los que tenemos tiempo, ganas o enfados. Es mentira que se reivindique la reforma, en todo caso lo habrá sugerido alguien que tiene, además de interés, tiempo para solucionarnos a todos la vida. Probablemente no necesita el coche para trabajar. Me gustaría saber si hay alguien más que este harto de que nos traten a todos como a idiotas. Están publicadas estás actuaciones en el Boletín del Ayuntamiento?</p>

<p> </p>
";"11/09/2018 00";"11";"7";"4";"6";"11844499589";"190"
"5520";"Obra nueva sobre obra nueva";"<p>En la calle lira, en Junio, se hicieron obras en parte de la acera y calzada para hacer un aparcamiento de motos. </p>

<p>2 meses más tarde, se levanto de nuevo todo para que el Canal de Isabel II, realizase obras.</p>

<p>¿Estamos tan sobrados de presupuesto para este desperdicio de dinero?.</p>

<p>Es solo un ejemplo. He visto muchas ""mejoras urbanas"", sobre ""otras mejoras"", en escasísimo tiempo.</p>

<p>Creo que esto es innecesario.</p>

<p>Planifiquen mejor, por favor.</p>
";"14/09/2018 17";"4";"3";"1";"0";"11879480305";"150"
"5521";"Necesidad de concejalía de mobilidad en Madrid";"<p>Uno de los problemas históricos que tiene la ciudad de Madrid es la mobilidad. Por eso resulta incomprenible que no se dedique una concejalía específica para tal fin. Ese probleme se ve agrandado al estar la gestión de la mobilidad incluíta entre las funciones de la conserjería de medioambiente. Estando esta concejalía dirigida por el grupo político EQUO que tiene como uno de sus principales puntales ideológicos la supresión del transporte privado, no hay voluntad política para solucionar los problemas de mobilidad. </p>

<p>Independientemente de la ideología de cada uno, la mobilidad tiene problemas muy graves que necesitan una gestión independiente y motivada. Luego se puede trazar un plan estratégico para reducir el tráfico privado, pero idependientemente de eso los problemas existentes a día de hoy hay que solucionarlos. Por ello, pido la creación de una concejalía específica dirigida por alguien que no pertenezca a un partido que abogue por solucioanr problemas a base de matar moscas a cañonazos. </p>

<p> </p>

<p> </p>
";"17/09/2018 00";"5";"3";"2";"3";"11901472250";"60"
"5522";"Limpieza de la calle Torrelaguna";"<p>La calle Torrelaguna y sus alrededores estan cada día más sucios:</p>

<p>1- El ayuntamiento tiene que hacer algo.</p>

<p>2- Ciudadanos, dejad ya de una vez de tirar basura al suelo!</p>
";"17/09/2018 20";"5";"4";"1";"4";"11913288404";"240"
